name,realm,rating,cls,spec,play,win,lose
Bloodzin,frostwhisper,1736,deathknight,blood,136,74,62
Rahbekius,kazzak,1654,deathknight,blood,264,127,137
Goochtickler,kazzak,1554,deathknight,blood,114,59,55
Rahbekies,kazzak,1551,deathknight,blood,87,50,37
Эваер,blackscar,1445,deathknight,blood,136,65,71
Hoggster,kazzak,1372,deathknight,blood,117,48,69
Maylined,antonidas,1334,deathknight,blood,72,34,38
Horrorda,defias-brotherhood,1242,deathknight,blood,73,38,35
Wickedgray,outland,1170,deathknight,blood,54,15,39
Schwuischädl,eredar,1155,deathknight,blood,40,21,19
Nîghtmáre,ravencrest,1124,deathknight,blood,47,24,23
Arthaslegend,magtheridon,1047,deathknight,blood,72,29,43
Кмамехочу,howling-fjord,997,deathknight,blood,66,23,43
Oxcidium,archimonde,980,deathknight,blood,42,22,20
Ducados,forscherliga,952,deathknight,blood,24,12,12
Mosesishere,blackmoore,947,deathknight,blood,30,10,20
Dreodis,der-mithrilorden,923,deathknight,blood,60,16,44
Minoporc,archimonde,863,deathknight,blood,69,27,42
Truehero,magtheridon,852,deathknight,blood,24,9,15
Pechugona,zuljin,806,deathknight,blood,60,15,45
Rakia,defias-brotherhood,757,deathknight,blood,51,17,34
Hjertesalat,ravencrest,747,deathknight,blood,26,10,16
Schiva,eredar,745,deathknight,blood,35,12,23
Эваердк,gordunni,671,deathknight,blood,12,7,5
Helixnc,silvermoon,576,deathknight,blood,18,6,12
Smalldk,silvermoon,574,deathknight,blood,18,6,12
Оосака,gordunni,573,deathknight,blood,24,6,18
Airok,proudmoore,566,deathknight,blood,18,6,12
Downtoclown,argent-dawn,480,deathknight,blood,12,5,7
Zdan,sylvanas,476,deathknight,blood,12,5,7
Dàreals,draenor,384,deathknight,blood,6,4,2
Akamechân,frostmourne,382,deathknight,blood,6,4,2
Hellcrosser,blackrock,381,deathknight,blood,12,4,8
Naxmet,dun-modr,381,deathknight,blood,30,4,26
Pinkish,argent-dawn,379,deathknight,blood,12,4,8
Барагган,thermaplugg,288,deathknight,blood,6,3,3
Minidkshow,ravencrest,288,deathknight,blood,12,3,9
Schopenhauer,turalyon,288,deathknight,blood,12,3,9
Buklow,argent-dawn,287,deathknight,blood,9,3,6
Dromadeus,sylvanas,286,deathknight,blood,12,3,9
Cyphîllyth,auchindoun,192,deathknight,blood,6,2,4
Маккриманс,gordunni,192,deathknight,blood,6,2,4
Ciørkîng,archimonde,192,deathknight,blood,6,2,4
Aurelianus,arygos,192,deathknight,blood,6,2,4
Kirimvose,tarren-mill,192,deathknight,blood,6,2,4
Mouledk,hyjal,192,deathknight,blood,6,2,4
Mámmôn,malygos,192,deathknight,blood,12,2,10
Glacuis,suramar,190,deathknight,blood,12,2,10
Fixmybones,frostmane,96,deathknight,blood,6,1,5
Drruiel,twisting-nether,96,deathknight,blood,6,1,5
Глэмнутый,howling-fjord,96,deathknight,blood,6,1,5
Ilopango,blackmoore,96,deathknight,blood,6,1,5
Livanto,ahnqiraj,96,deathknight,blood,6,1,5
Maradk,drakthul,96,deathknight,blood,6,1,5
Geraltbg,twisting-nether,96,deathknight,blood,6,1,5
Intrih,arathor,48,deathknight,blood,9,1,8
Calculated,spinebreaker,42,deathknight,blood,11,5,6
Хайвейтухэлл,soulflayer,2188,deathknight,unholy,114,60,54
Страхолит,soulflayer,2160,deathknight,unholy,224,113,111
Кромгона,soulflayer,2154,deathknight,unholy,178,109,69
Lilshiet,stormreaver,2121,deathknight,unholy,102,51,51
Нишимба,soulflayer,2115,deathknight,unholy,448,224,224
Bóby,ravencrest,2103,deathknight,unholy,444,221,223
Aryash,silvermoon,2035,deathknight,unholy,90,46,44
Bíllÿ,kazzak,2003,deathknight,unholy,104,56,48
Валькейн,blackscar,1997,deathknight,unholy,72,38,34
Conqueròr,tarren-mill,1992,deathknight,unholy,285,137,148
Rottenpete,grim-batol,1971,deathknight,unholy,84,45,39
Leónid,kazzak,1962,deathknight,unholy,72,36,36
Bigdickdk,ragnaros,1962,deathknight,unholy,76,36,40
Elite,xavius,1960,deathknight,unholy,538,271,267
Марактус,gordunni,1952,deathknight,unholy,124,75,49
Enzy,drakthul,1936,deathknight,unholy,53,30,23
Zd,ghostlands,1933,deathknight,unholy,106,50,56
Worlviuz,argent-dawn,1932,deathknight,unholy,153,77,76
Amnésyx,ysondre,1929,deathknight,unholy,94,50,44
Smallbaboon,stormreaver,1926,deathknight,unholy,72,33,39
Кромгон,soulflayer,1917,deathknight,unholy,127,64,63
Шадоудез,gordunni,1914,deathknight,unholy,57,31,26
Shadowdeathj,kazzak,1913,deathknight,unholy,54,27,27
Péterpain,antonidas,1912,deathknight,unholy,138,72,66
Ðavy,silvermoon,1910,deathknight,unholy,72,36,36
Zdi,tarren-mill,1905,deathknight,unholy,81,40,41
Èvíl,stormscale,1904,deathknight,unholy,66,33,33
Itreachesout,ravencrest,1903,deathknight,unholy,275,141,134
Hólix,kazzak,1900,deathknight,unholy,161,92,69
Bedstemoor,ravencrest,1899,deathknight,unholy,144,72,72
Storhøf,sanguino,1897,deathknight,unholy,120,64,56
Bøby,kul-tiras,1894,deathknight,unholy,72,36,36
Azüla,ysondre,1892,deathknight,unholy,72,33,39
Évìl,stormscale,1884,deathknight,unholy,69,34,35
Akaliz,die-aldor,1876,deathknight,unholy,66,35,31
Ipanic,argent-dawn,1875,deathknight,unholy,228,120,108
Eyyoo,blackmoore,1875,deathknight,unholy,70,35,35
Necrølyte,sylvanas,1874,deathknight,unholy,120,64,56
Murky,kazzak,1873,deathknight,unholy,499,243,256
Кромгондк,soulflayer,1873,deathknight,unholy,66,27,39
Annabolik,ravencrest,1871,deathknight,unholy,95,44,51
Лордпафос,blackscar,1866,deathknight,unholy,109,59,50
Yazga,blackmoore,1863,deathknight,unholy,77,33,44
Шайбовёрт,gordunni,1861,deathknight,unholy,151,76,75
Narali,argent-dawn,1859,deathknight,unholy,72,34,38
Fxckingmad,ravencrest,1857,deathknight,unholy,108,54,54
Sélyne,dalaran,1857,deathknight,unholy,72,33,39
Wôrgenator,kazzak,1856,deathknight,unholy,76,31,45
Väkü,silvermoon,1855,deathknight,unholy,135,71,64
Aeneriah,tarren-mill,1854,deathknight,unholy,194,110,84
Rahbekius,kazzak,1854,deathknight,unholy,156,75,81
Азуэла,gordunni,1853,deathknight,unholy,60,45,15
Fabricius,blackrock,1847,deathknight,unholy,66,36,30
Sarconis,quelthalas,1846,deathknight,unholy,81,43,38
Аронас,blackscar,1846,deathknight,unholy,92,47,45
Cässius,dun-modr,1846,deathknight,unholy,54,23,31
Меланндрис,gordunni,1845,deathknight,unholy,60,44,16
Øtherànóther,stormscale,1843,deathknight,unholy,54,30,24
Ezlyy,ravencrest,1843,deathknight,unholy,114,60,54
Vallenhal,twisting-nether,1840,deathknight,unholy,78,36,42
Nómòre,ravencrest,1839,deathknight,unholy,60,30,30
Ampdk,ravencrest,1838,deathknight,unholy,78,44,34
Nextyi,blackmoore,1838,deathknight,unholy,48,21,27
Happsor,eredar,1837,deathknight,unholy,95,47,48
Mockingbirdo,sanguino,1836,deathknight,unholy,36,24,12
Акамахи,ashenvale,1836,deathknight,unholy,125,68,57
Fennro,ysondre,1836,deathknight,unholy,300,147,153
Bephomet,onyxia,1835,deathknight,unholy,213,101,112
Thezftw,kazzak,1834,deathknight,unholy,142,72,70
Hotcherryx,dun-modr,1833,deathknight,unholy,354,174,180
Butthurtx,stormscale,1831,deathknight,unholy,52,31,21
Sprangers,ravencrest,1831,deathknight,unholy,58,28,30
Slade,blackrock,1831,deathknight,unholy,178,85,93
Namzera,draenor,1827,deathknight,unholy,114,70,44
Sang,deathwing,1827,deathknight,unholy,232,121,111
Рыжаяпедаль,soulflayer,1826,deathknight,unholy,60,36,24
Undeadcell,ravencrest,1826,deathknight,unholy,60,34,26
Leanâdle,hyjal,1826,deathknight,unholy,179,95,84
Radan,stormscale,1821,deathknight,unholy,48,26,22
Zokko,blackrock,1820,deathknight,unholy,59,31,28
Cealdris,blackmoore,1819,deathknight,unholy,30,20,10
Сацкэх,howling-fjord,1819,deathknight,unholy,219,118,101
Обледенение,gordunni,1819,deathknight,unholy,36,19,17
Vakü,burning-legion,1818,deathknight,unholy,802,394,408
Charlytango,archimonde,1818,deathknight,unholy,60,29,31
Бургер,soulflayer,1816,deathknight,unholy,90,39,51
Dämos,blackmoore,1815,deathknight,unholy,168,87,81
Catloaf,silvermoon,1815,deathknight,unholy,48,21,27
Savra,stormscale,1814,deathknight,unholy,46,27,19
Zugzugdecay,kazzak,1814,deathknight,unholy,72,42,30
Glower,burning-blade,1814,deathknight,unholy,76,44,32
Змейняша,soulflayer,1814,deathknight,unholy,121,62,59
Crenshawx,twisting-nether,1814,deathknight,unholy,324,162,162
Holîx,kazzak,1814,deathknight,unholy,95,43,52
Frege,tarren-mill,1813,deathknight,unholy,156,78,78
Andreàs,silvermoon,1813,deathknight,unholy,60,30,30
Necrofear,grim-batol,1813,deathknight,unholy,144,71,73
Брексиен,gordunni,1813,deathknight,unholy,54,20,34
Аоепупс,gordunni,1811,deathknight,unholy,91,43,48
Ayra,nethersturm,1809,deathknight,unholy,115,65,50
Amenokoim,blackrock,1809,deathknight,unholy,102,52,50
Râke,teldrassil,1809,deathknight,unholy,126,55,71
Allmawt,argent-dawn,1808,deathknight,unholy,89,51,38
Dräpârn,sylvanas,1808,deathknight,unholy,117,67,50
Смердонос,grom,1808,deathknight,unholy,333,184,149
Qtxi,nozdormu,1808,deathknight,unholy,493,261,232
Stely,alonsus,1805,deathknight,unholy,57,32,25
Køley,draenor,1804,deathknight,unholy,53,30,23
Elyth,kazzak,1804,deathknight,unholy,218,116,102
Zdlol,ghostlands,1804,deathknight,unholy,114,59,55
Ronsôn,terrordar,1803,deathknight,unholy,66,36,30
Icegrin,silvermoon,1803,deathknight,unholy,150,81,69
Dk,tarren-mill,1802,deathknight,unholy,102,46,56
Exoflake,kazzak,1801,deathknight,unholy,64,36,28
Maylined,blackrock,1801,deathknight,unholy,48,19,29
Кромгак,soulflayer,1800,deathknight,unholy,86,46,40
Grepetta,argent-dawn,1800,deathknight,unholy,243,121,122
Qhew,kazzak,1800,deathknight,unholy,60,25,35
Shanariel,khaz-modan,1799,deathknight,unholy,219,119,100
Unhóly,tarren-mill,1796,deathknight,unholy,193,104,89
Zerachy,blackmoore,1795,deathknight,unholy,66,38,28
Verminosis,stormscale,1791,deathknight,unholy,78,31,47
Oweiowei,blackrock,1790,deathknight,unholy,108,59,49
Puzikovatr,tarren-mill,1790,deathknight,unholy,54,25,29
Лордэскорт,gordunni,1789,deathknight,unholy,248,121,127
Jesûsx,ravencrest,1787,deathknight,unholy,130,69,61
Дайтоолгоун,deathguard,1785,deathknight,unholy,135,71,64
Nazgül,drakthul,1781,deathknight,unholy,157,88,69
Адэлина,soulflayer,1781,deathknight,unholy,170,92,78
Тхиро,gordunni,1781,deathknight,unholy,131,58,73
Likewise,twisting-nether,1780,deathknight,unholy,173,80,93
Вирко,eversong,1778,deathknight,unholy,238,125,113
Féarless,archimonde,1773,deathknight,unholy,75,40,35
Aifam,twisting-nether,1772,deathknight,unholy,372,188,184
Táli,tarren-mill,1770,deathknight,unholy,50,24,26
Nødder,ragnaros,1769,deathknight,unholy,363,194,169
Gladiadk,ysondre,1769,deathknight,unholy,110,46,64
Бешенсство,soulflayer,1768,deathknight,unholy,80,39,41
Олинфия,soulflayer,1768,deathknight,unholy,96,45,51
Amyntasz,twisting-nether,1761,deathknight,unholy,60,24,36
Argonat,silvermoon,1759,deathknight,unholy,192,103,89
Inâste,thrall,1759,deathknight,unholy,90,44,46
Apacstanya,ragnaros,1758,deathknight,unholy,120,55,65
Фростинг,gordunni,1757,deathknight,unholy,42,23,19
Некросморк,soulflayer,1755,deathknight,unholy,52,31,21
Disæse,blackrock,1753,deathknight,unholy,60,34,26
Дэхон,gordunni,1753,deathknight,unholy,99,51,48
Дайтоолгоун,gordunni,1750,deathknight,unholy,211,99,112
Sanlex,twisting-nether,1747,deathknight,unholy,157,74,83
Castlevanía,ravencrest,1744,deathknight,unholy,279,144,135
Sangíus,blackmoore,1744,deathknight,unholy,479,237,242
Inflex,silvermoon,1744,deathknight,unholy,147,72,75
Deathmonsta,auchindoun,1741,deathknight,unholy,128,61,67
Verminosis,argent-dawn,1739,deathknight,unholy,75,39,36
Кларенси,soulflayer,1739,deathknight,unholy,78,32,46
Mirídiuss,silvermoon,1738,deathknight,unholy,88,44,44
Фалькра,soulflayer,1734,deathknight,unholy,54,29,25
Krisigaped,blackhand,1731,deathknight,unholy,48,25,23
Envious,archimonde,1729,deathknight,unholy,54,24,30
Maëra,ysondre,1726,deathknight,unholy,84,36,48
Nèrfx,ragnaros,1725,deathknight,unholy,90,45,45
Zagoôo,outland,1723,deathknight,unholy,60,25,35
Vexxed,magtheridon,1722,deathknight,unholy,159,90,69
Quizon,tarren-mill,1721,deathknight,unholy,132,60,72
Merekx,emerald-dream,1720,deathknight,unholy,60,32,28
Synthwave,tarren-mill,1720,deathknight,unholy,159,78,81
Psychopathz,tarren-mill,1718,deathknight,unholy,66,36,30
Кулькулегал,ashenvale,1717,deathknight,unholy,66,34,32
Geraltbg,twisting-nether,1716,deathknight,unholy,48,22,26
Garrinchá,stormscale,1715,deathknight,unholy,54,25,29
Маххес,howling-fjord,1714,deathknight,unholy,157,80,77
Darkarthás,aegwynn,1714,deathknight,unholy,36,18,18
Koranderx,argent-dawn,1713,deathknight,unholy,30,18,12
Тыпидо,howling-fjord,1713,deathknight,unholy,82,48,34
Кидер,blackscar,1712,deathknight,unholy,107,58,49
Олинф,deathguard,1712,deathknight,unholy,176,85,91
Athanatøs,archimonde,1709,deathknight,unholy,275,139,136
Vainajala,die-aldor,1707,deathknight,unholy,100,58,42
Leomordf,doomhammer,1704,deathknight,unholy,424,219,205
Oj,darkspear,1704,deathknight,unholy,271,138,133
Мионеелол,goldrinn,1704,deathknight,unholy,96,45,51
Oßitø,ravencrest,1703,deathknight,unholy,127,70,57
Ктунец,blackscar,1703,deathknight,unholy,87,44,43
Mammacitaa,argent-dawn,1701,deathknight,unholy,95,52,43
Faznik,twisting-nether,1701,deathknight,unholy,303,152,151
Ràiven,blackmoore,1701,deathknight,unholy,65,31,34
Prebi,silvermoon,1700,deathknight,unholy,54,23,31
Tharassian,chamber-of-aspects,1699,deathknight,unholy,78,38,40
Enzÿ,drakthul,1698,deathknight,unholy,54,29,25
Hellguy,draenor,1698,deathknight,unholy,459,228,231
Zff,hyjal,1697,deathknight,unholy,108,66,42
Alti,blackmoore,1697,deathknight,unholy,148,80,68
Motvinden,stormscale,1697,deathknight,unholy,112,59,53
Ilovememes,terenas,1696,deathknight,unholy,89,58,31
Эриданс,gordunni,1696,deathknight,unholy,142,79,63
Apolyio,outland,1696,deathknight,unholy,242,123,119
Fraeya,sunstrider,1695,deathknight,unholy,213,107,106
Гронташ,howling-fjord,1692,deathknight,unholy,159,82,77
Oscman,silvermoon,1692,deathknight,unholy,195,97,98
Smörj,aggramar,1692,deathknight,unholy,130,63,67
Arizon,drakthul,1691,deathknight,unholy,98,40,58
Necrotic,blackrock,1690,deathknight,unholy,53,30,23
Deathlog,silvermoon,1690,deathknight,unholy,138,71,67
Impey,kazzak,1689,deathknight,unholy,30,18,12
Reidemorte,minahonda,1689,deathknight,unholy,140,81,59
Darkknights,archimonde,1687,deathknight,unholy,163,85,78
Lurkkiss,ravencrest,1687,deathknight,unholy,78,37,41
Линфео,galakrond,1686,deathknight,unholy,60,27,33
Leonis,arthas,1685,deathknight,unholy,84,41,43
Дарргг,ashenvale,1684,deathknight,unholy,148,79,69
Raizhen,ragnaros,1684,deathknight,unholy,60,31,29
Ahilus,bladefist,1683,deathknight,unholy,132,70,62
Ûñhølýðéåthj,tarren-mill,1683,deathknight,unholy,59,28,31
Альдафьод,howling-fjord,1682,deathknight,unholy,41,24,17
Wombo,dentarg,1682,deathknight,unholy,143,74,69
ßankoedno,stormscale,1681,deathknight,unholy,120,62,58
Råyzen,draenor,1679,deathknight,unholy,60,31,29
Karisteur,azuremyst,1678,deathknight,unholy,66,31,35
Äyrenn,draenor,1677,deathknight,unholy,125,68,57
Yusehz,kazzak,1677,deathknight,unholy,69,32,37
Lovroo,silvermoon,1677,deathknight,unholy,93,43,50
Sanuky,blackrock,1677,deathknight,unholy,42,18,24
Kharôn,stormscale,1676,deathknight,unholy,114,55,59
Vatø,tarren-mill,1676,deathknight,unholy,60,27,33
Doozz,draenor,1675,deathknight,unholy,193,87,106
Zehahaha,defias-brotherhood,1674,deathknight,unholy,119,51,68
Greymarker,kirin-tor,1673,deathknight,unholy,164,91,73
Джонаджеймсн,soulflayer,1673,deathknight,unholy,214,109,105
Ghostreign,tarren-mill,1673,deathknight,unholy,125,59,66
Økah,outland,1672,deathknight,unholy,106,50,56
Garasu,eredar,1672,deathknight,unholy,95,40,55
Femilista,dun-modr,1671,deathknight,unholy,42,23,19
Dasvidania,ragnaros,1670,deathknight,unholy,42,22,20
Unholyspîrît,outland,1669,deathknight,unholy,114,61,53
Ghaloob,draenor,1667,deathknight,unholy,96,49,47
Sakiko,thrall,1667,deathknight,unholy,54,26,28
Глэмнутый,howling-fjord,1664,deathknight,unholy,149,78,71
Слендер,howling-fjord,1664,deathknight,unholy,193,98,95
Drachnor,kazzak,1664,deathknight,unholy,89,43,46
Vidofnir,argent-dawn,1662,deathknight,unholy,84,46,38
Tenzøftw,archimonde,1662,deathknight,unholy,168,86,82
Blazeberg,blackrock,1661,deathknight,unholy,70,39,31
Моровой,blackscar,1661,deathknight,unholy,136,67,69
Nommad,archimonde,1657,deathknight,unholy,317,160,157
Seal,lightnings-blade,1657,deathknight,unholy,50,25,25
Вовчан,howling-fjord,1657,deathknight,unholy,222,105,117
Средозавр,howling-fjord,1655,deathknight,unholy,48,31,17
Kwc,kazzak,1655,deathknight,unholy,204,99,105
Babsyknight,wildhammer,1654,deathknight,unholy,312,157,155
Judin,kazzak,1651,deathknight,unholy,68,32,36
Sendurd,ragnaros,1651,deathknight,unholy,214,98,116
Сантамо,soulflayer,1650,deathknight,unholy,194,98,96
Panorboy,tarren-mill,1650,deathknight,unholy,54,23,31
Zoree,draenor,1647,deathknight,unholy,233,124,109
Руин,blackscar,1645,deathknight,unholy,142,77,65
Inmau,sanguino,1645,deathknight,unholy,54,25,29
Skulm,twisting-nether,1645,deathknight,unholy,72,30,42
Cheethdoom,ragnaros,1644,deathknight,unholy,70,37,33
Alessia,alonsus,1644,deathknight,unholy,90,46,44
Hordak,stormscale,1642,deathknight,unholy,123,56,67
Pawcio,argent-dawn,1640,deathknight,unholy,224,124,100
Gøretterog,ysondre,1640,deathknight,unholy,42,23,19
Feasant,outland,1639,deathknight,unholy,84,48,36
Spom,elune,1639,deathknight,unholy,48,21,27
Çruél,silvermoon,1638,deathknight,unholy,48,21,27
Xawias,ulduar,1637,deathknight,unholy,84,43,41
Deathgrab,twisting-nether,1637,deathknight,unholy,262,130,132
Dejkå,silvermoon,1637,deathknight,unholy,80,38,42
Изуалу,blackscar,1637,deathknight,unholy,54,24,30
Арцевус,gordunni,1636,deathknight,unholy,227,119,108
Derfitt,sanguino,1636,deathknight,unholy,141,72,69
Mojodango,outland,1634,deathknight,unholy,38,22,16
Yandeäth,chants-éternels,1634,deathknight,unholy,484,246,238
Skórm,burning-legion,1633,deathknight,unholy,42,21,21
Шуршаня,blackscar,1631,deathknight,unholy,110,51,59
Uvros,bloodhoof,1630,deathknight,unholy,48,23,25
Лапочки,gordunni,1628,deathknight,unholy,84,49,35
Gushik,twisting-nether,1628,deathknight,unholy,138,77,61
Wallenschøld,kazzak,1627,deathknight,unholy,66,30,36
Рамкар,howling-fjord,1626,deathknight,unholy,134,60,74
Aladonreith,zenedar,1626,deathknight,unholy,52,23,29
Deadlyorca,tarren-mill,1625,deathknight,unholy,42,18,24
Senkingodx,ravencrest,1624,deathknight,unholy,90,33,57
Blueironjr,kazzak,1623,deathknight,unholy,48,30,18
Сгеатог,gordunni,1623,deathknight,unholy,36,17,19
Ínví,aegwynn,1622,deathknight,unholy,211,113,98
Deathboost,archimonde,1622,deathknight,unholy,54,20,34
Apacsom,ragnaros,1621,deathknight,unholy,30,17,13
Quetza,twisting-nether,1621,deathknight,unholy,36,17,19
Giandam,draenor,1621,deathknight,unholy,76,31,45
Шинратенсеи,howling-fjord,1620,deathknight,unholy,95,58,37
Ластофас,gordunni,1620,deathknight,unholy,180,87,93
Armanelo,stormscale,1620,deathknight,unholy,71,33,38
Неондк,eversong,1619,deathknight,unholy,242,115,127
Ipanicfart,argent-dawn,1619,deathknight,unholy,36,17,19
Prekliatylad,burning-blade,1619,deathknight,unholy,83,39,44
Pängei,frostwolf,1618,deathknight,unholy,53,26,27
Rankor,grim-batol,1618,deathknight,unholy,132,62,70
Xenfos,tarren-mill,1618,deathknight,unholy,54,23,31
Pandahapci,ragnaros,1617,deathknight,unholy,54,23,31
Maxto,outland,1617,deathknight,unholy,48,20,28
Preddktwo,twisting-nether,1616,deathknight,unholy,24,17,7
Apoikia,argent-dawn,1616,deathknight,unholy,90,47,43
Goùlag,culte-de-la-rive-noire,1616,deathknight,unholy,145,67,78
Thairq,drakthul,1614,deathknight,unholy,72,44,28
Taylorswiftz,tarren-mill,1614,deathknight,unholy,36,17,19
Fringles,twisting-nether,1614,deathknight,unholy,36,17,19
Промештейн,gordunni,1613,deathknight,unholy,141,72,69
Lichbørn,ragnaros,1613,deathknight,unholy,132,65,67
Pellizquitas,sanguino,1612,deathknight,unholy,30,17,13
Cayliadk,tarren-mill,1612,deathknight,unholy,170,91,79
Nasxsy,blackmoore,1612,deathknight,unholy,78,38,40
Snowlegend,der-mithrilorden,1611,deathknight,unholy,66,36,30
Ðaserka,blackrock,1611,deathknight,unholy,39,19,20
Инлакеш,howling-fjord,1611,deathknight,unholy,57,25,32
Drogba,burning-blade,1610,deathknight,unholy,76,39,37
Elliipirelli,doomhammer,1609,deathknight,unholy,136,71,65
Hycecream,archimonde,1608,deathknight,unholy,120,51,69
Bijb,kragjin,1607,deathknight,unholy,48,17,31
Stinglelz,chogall,1606,deathknight,unholy,47,26,21
Вурдулакх,gordunni,1606,deathknight,unholy,212,109,103
Spøøk,defias-brotherhood,1606,deathknight,unholy,54,26,28
Вондум,howling-fjord,1606,deathknight,unholy,42,18,24
Deathcaller,dun-modr,1605,deathknight,unholy,86,44,42
Спавни,blackscar,1604,deathknight,unholy,235,119,116
Khalifamia,alonsus,1604,deathknight,unholy,66,32,34
Olriklol,dentarg,1603,deathknight,unholy,48,26,22
Sølîta,archimonde,1603,deathknight,unholy,89,47,42
Trialist,dun-modr,1602,deathknight,unholy,54,30,24
Bloodraynee,twisting-nether,1602,deathknight,unholy,114,58,56
Nurekindk,argent-dawn,1602,deathknight,unholy,179,89,90
Asarth,silvermoon,1602,deathknight,unholy,48,22,26
Alameda,nathrezim,1602,deathknight,unholy,54,23,31
Reann,argent-dawn,1601,deathknight,unholy,61,33,28
Ðiesel,stormscale,1601,deathknight,unholy,266,130,136
Mercdk,ravencrest,1601,deathknight,unholy,90,41,49
Jäätynyt,zenedar,1600,deathknight,unholy,738,364,374
Aceléss,drakthul,1600,deathknight,unholy,42,20,22
Тумм,howling-fjord,1598,deathknight,unholy,54,27,27
Judythegreat,silvermoon,1596,deathknight,unholy,309,160,149
Ghoulish,outland,1594,deathknight,unholy,209,102,107
Heyä,ysondre,1594,deathknight,unholy,66,29,37
Schweezlord,tarren-mill,1592,deathknight,unholy,30,17,13
Turboface,kazzak,1591,deathknight,unholy,124,68,56
Кокосоус,gordunni,1591,deathknight,unholy,89,41,48
Ashgôrath,defias-brotherhood,1591,deathknight,unholy,74,29,45
Cremefresh,ragnaros,1590,deathknight,unholy,45,24,21
Creatar,kazzak,1588,deathknight,unholy,93,50,43
Feministi,stormreaver,1588,deathknight,unholy,162,79,83
Slawtér,arathor,1587,deathknight,unholy,80,42,38
Моорта,soulflayer,1586,deathknight,unholy,397,206,191
Larrydk,tarren-mill,1585,deathknight,unholy,36,21,15
Swavsgothgf,ravencrest,1585,deathknight,unholy,30,17,13
Apoikos,argent-dawn,1584,deathknight,unholy,84,42,42
Lutcher,hellfire,1584,deathknight,unholy,56,28,28
Herumor,nerzhul,1582,deathknight,unholy,96,49,47
Bredox,ravencrest,1582,deathknight,unholy,63,27,36
Halez,antonidas,1581,deathknight,unholy,198,101,97
Yagoora,silvermoon,1581,deathknight,unholy,88,35,53
Linuzbunny,zenedar,1580,deathknight,unholy,30,18,12
Darkertimes,ragnaros,1580,deathknight,unholy,471,227,244
Ezlar,silvermoon,1579,deathknight,unholy,79,47,32
Aleejha,draenor,1578,deathknight,unholy,82,46,36
Jiodythyy,archimonde,1578,deathknight,unholy,66,28,38
Abomination,emeriss,1577,deathknight,unholy,334,160,174
Blízna,kazzak,1576,deathknight,unholy,250,126,124
Orktra,stormscale,1576,deathknight,unholy,72,36,36
Excaliuz,silvermoon,1575,deathknight,unholy,41,19,22
Торедх,howling-fjord,1575,deathknight,unholy,90,41,49
Винерас,soulflayer,1574,deathknight,unholy,159,79,80
Triffdich,blackrock,1574,deathknight,unholy,256,126,130
Deathvid,ravencrest,1573,deathknight,unholy,126,66,60
Ecormcpz,eredar,1573,deathknight,unholy,60,27,33
Abcdk,sargeras,1572,deathknight,unholy,68,39,29
Diabeticus,the-maelstrom,1572,deathknight,unholy,54,23,31
Inudworf,outland,1571,deathknight,unholy,81,41,40
Raziee,twisting-nether,1571,deathknight,unholy,125,60,65
Zektal,thrall,1571,deathknight,unholy,139,62,77
Gûuts,archimonde,1569,deathknight,unholy,354,189,165
Аркёт,howling-fjord,1566,deathknight,unholy,125,59,66
Lorvetis,malorne,1565,deathknight,unholy,104,56,48
Jollíe,tarren-mill,1565,deathknight,unholy,146,77,69
Apatheia,stormscale,1565,deathknight,unholy,86,41,45
Soulrime,garrosh,1565,deathknight,unholy,48,22,26
Sythuss,argent-dawn,1565,deathknight,unholy,72,30,42
Mongopogger,defias-brotherhood,1564,deathknight,unholy,113,66,47
Pangen,ravencrest,1564,deathknight,unholy,137,63,74
Körthazz,hyjal,1563,deathknight,unholy,55,27,28
Söttguetsi,blackrock,1560,deathknight,unholy,53,29,24
Apolloälf,blackrock,1560,deathknight,unholy,40,19,21
Nysaia,blackmoore,1559,deathknight,unholy,90,42,48
Скизм,howling-fjord,1557,deathknight,unholy,180,88,92
Frags,arathor,1555,deathknight,unholy,138,70,68
Хассандра,galakrond,1554,deathknight,unholy,117,58,59
Sugarcakedk,blackrock,1554,deathknight,unholy,155,74,81
Branchë,stormscale,1553,deathknight,unholy,305,151,154
Yamisukehiro,drakthul,1551,deathknight,unholy,60,28,32
Arkaris,blackmoore,1550,deathknight,unholy,86,52,34
Emphendk,twisting-nether,1550,deathknight,unholy,120,55,65
Рэндрей,gordunni,1549,deathknight,unholy,105,58,47
Høpes,chogall,1549,deathknight,unholy,54,26,28
Rebeast,blackhand,1549,deathknight,unholy,47,19,28
Енваки,gordunni,1548,deathknight,unholy,114,59,55
Мёрдерфэйсх,soulflayer,1547,deathknight,unholy,304,157,147
Gargalon,drakthul,1547,deathknight,unholy,102,52,50
Héroe,zuljin,1547,deathknight,unholy,84,32,52
Bølvar,zuljin,1546,deathknight,unholy,56,29,27
Rûnâr,proudmoore,1545,deathknight,unholy,45,28,17
Нарилуне,blackscar,1545,deathknight,unholy,667,338,329
Micaiah,dun-modr,1545,deathknight,unholy,84,39,45
Necrotickiss,frostwolf,1544,deathknight,unholy,44,23,21
Canesexxo,pozzo-delleternità,1543,deathknight,unholy,90,50,40
Derimathras,stormscale,1543,deathknight,unholy,36,20,16
Segrim,drakthul,1543,deathknight,unholy,191,100,91
Элекна,deepholm,1541,deathknight,unholy,48,24,24
Клиссанг,razuvious,1540,deathknight,unholy,72,26,46
Bokrak,norgannon,1539,deathknight,unholy,165,92,73
Asakim,tarren-mill,1538,deathknight,unholy,41,17,24
Валерамопс,soulflayer,1537,deathknight,unholy,41,19,22
Shabiri,twisting-nether,1536,deathknight,unholy,186,100,86
Дерайв,gordunni,1536,deathknight,unholy,138,68,70
Leyir,shendralar,1535,deathknight,unholy,54,29,25
Sxyd,silvermoon,1535,deathknight,unholy,155,70,85
Nenadvs,ravencrest,1535,deathknight,unholy,74,31,43
Руариди,gordunni,1534,deathknight,unholy,48,25,23
Хорссэ,soulflayer,1532,deathknight,unholy,91,48,43
Serelis,argent-dawn,1532,deathknight,unholy,66,31,35
Дрогдош,howling-fjord,1531,deathknight,unholy,72,38,34
Baltersa,blackhand,1531,deathknight,unholy,72,28,44
Noizt,ravencrest,1530,deathknight,unholy,48,20,28
Fýhr,silvermoon,1529,deathknight,unholy,144,78,66
Lockhead,stormscale,1529,deathknight,unholy,205,104,101
Израф,fordragon,1528,deathknight,unholy,50,21,29
Exanex,ragnaros,1527,deathknight,unholy,42,24,18
Диджейфрау,deathguard,1527,deathknight,unholy,30,16,14
Dzemoo,drakthul,1525,deathknight,unholy,83,43,40
Gorruk,malorne,1525,deathknight,unholy,217,112,105
Tölp,ravencrest,1524,deathknight,unholy,210,106,104
Dörfl,antonidas,1521,deathknight,unholy,87,42,45
Gripbroblem,nemesis,1521,deathknight,unholy,42,16,26
Ittei,ahnqiraj,1520,deathknight,unholy,30,22,8
Woddey,blackrock,1520,deathknight,unholy,72,39,33
Misazabanshi,blackrock,1519,deathknight,unholy,108,59,49
Gruzzaghkull,azuremyst,1519,deathknight,unholy,54,21,33
Deathcaller,zuljin,1517,deathknight,unholy,107,51,56
Alroc,blackrock,1516,deathknight,unholy,56,25,31
Crazyanimal,silvermoon,1514,deathknight,unholy,199,97,102
Jalapeñofan,tarren-mill,1513,deathknight,unholy,187,98,89
Ilius,kelthuzad,1513,deathknight,unholy,153,80,73
Ехтрим,howling-fjord,1512,deathknight,unholy,65,30,35
Manego,eredar,1511,deathknight,unholy,30,18,12
Zariia,twisting-nether,1511,deathknight,unholy,150,80,70
Unglück,die-aldor,1511,deathknight,unholy,168,87,81
Thecurator,ragnaros,1511,deathknight,unholy,123,60,63
Ilovebigass,ravencrest,1511,deathknight,unholy,72,34,38
Xirra,tarren-mill,1510,deathknight,unholy,263,136,127
Grendul,blackmoore,1510,deathknight,unholy,60,26,34
Saerus,kazzak,1508,deathknight,unholy,233,124,109
Dklékata,archimonde,1508,deathknight,unholy,141,69,72
Anathela,dalaran,1508,deathknight,unholy,85,40,45
Трибунальщик,gordunni,1508,deathknight,unholy,60,27,33
Bigblackgrip,hyjal,1508,deathknight,unholy,42,16,26
Barnalord,dentarg,1506,deathknight,unholy,54,27,27
Darhma,archimonde,1506,deathknight,unholy,104,47,57
Агереро,howling-fjord,1505,deathknight,unholy,88,46,42
Nîghtmáre,ravencrest,1505,deathknight,unholy,94,47,47
Ахелекус,blackscar,1504,deathknight,unholy,154,78,76
Reapocalypse,blackhand,1504,deathknight,unholy,411,206,205
Lavonobatas,kazzak,1503,deathknight,unholy,60,30,30
Deathcam,emerald-dream,1502,deathknight,unholy,95,45,50
Fatøumatata,archimonde,1502,deathknight,unholy,36,16,20
Шмуркич,gordunni,1501,deathknight,unholy,106,53,53
Amelia,ambossar,1500,deathknight,unholy,38,21,17
Unchaindk,outland,1500,deathknight,unholy,136,68,68
Bertonilo,burning-legion,1500,deathknight,unholy,84,39,45
Hemopathy,tarren-mill,1499,deathknight,unholy,30,16,14
Барагган,thermaplugg,1499,deathknight,unholy,144,73,71
Thánátós,hyjal,1499,deathknight,unholy,60,27,33
Gødofredo,dun-modr,1496,deathknight,unholy,177,93,84
Teljujad,sanguino,1496,deathknight,unholy,163,82,81
Анзорини,gordunni,1496,deathknight,unholy,84,31,53
Mávé,tarren-mill,1495,deathknight,unholy,69,32,37
Gharzhul,xavius,1493,deathknight,unholy,50,24,26
Борнтудай,borean-tundra,1492,deathknight,unholy,72,30,42
Кланки,soulflayer,1491,deathknight,unholy,142,71,71
Recoil,blackrock,1490,deathknight,unholy,26,17,9
Exoduss,dunemaul,1490,deathknight,unholy,141,72,69
Goblinslayer,zuljin,1489,deathknight,unholy,121,62,59
Metalmanethé,tarren-mill,1489,deathknight,unholy,284,140,144
Rizzlerdk,blackhand,1489,deathknight,unholy,114,49,65
Neorteriona,argent-dawn,1488,deathknight,unholy,171,94,77
Полонит,gordunni,1488,deathknight,unholy,125,61,64
Nuadar,outland,1488,deathknight,unholy,42,16,26
Анихиме,howling-fjord,1487,deathknight,unholy,98,51,47
Кадавров,gordunni,1486,deathknight,unholy,140,76,64
Dekayo,blackrock,1484,deathknight,unholy,68,34,34
Nolíferx,outland,1483,deathknight,unholy,96,50,46
Riceeater,kazzak,1483,deathknight,unholy,59,29,30
Veçh,turalyon,1483,deathknight,unholy,167,80,87
Катаринья,howling-fjord,1483,deathknight,unholy,59,26,33
Pëstîléñcè,ravencrest,1482,deathknight,unholy,39,27,12
Erodevil,kazzak,1482,deathknight,unholy,123,57,66
Дкшрёдингера,gordunni,1481,deathknight,unholy,126,63,63
Calina,frostwolf,1480,deathknight,unholy,72,26,46
Кристер,lich-king,1479,deathknight,unholy,66,30,36
Leipä,scarshield-legion,1478,deathknight,unholy,42,19,23
Vrark,forscherliga,1477,deathknight,unholy,34,19,15
Rektsohard,ravencrest,1477,deathknight,unholy,96,49,47
Вирзерагна,howling-fjord,1476,deathknight,unholy,126,71,55
Лекъса,gordunni,1476,deathknight,unholy,328,164,164
Протосеня,soulflayer,1476,deathknight,unholy,167,80,87
Necromedes,kazzak,1475,deathknight,unholy,82,46,36
Freezerker,ragnaros,1475,deathknight,unholy,60,29,31
Polimeh,draenor,1473,deathknight,unholy,84,45,39
Walkeni,defias-brotherhood,1473,deathknight,unholy,134,66,68
Notsyndra,nemesis,1473,deathknight,unholy,55,26,29
Deathkanta,antonidas,1472,deathknight,unholy,36,17,19
Ymirzo,outland,1471,deathknight,unholy,30,16,14
Knoxhult,kazzak,1471,deathknight,unholy,54,22,32
Nathriel,stormscale,1470,deathknight,unholy,66,38,28
Ardros,eredar,1470,deathknight,unholy,108,52,56
Dkbladet,ravencrest,1469,deathknight,unholy,174,91,83
Ihatenames,twisting-nether,1469,deathknight,unholy,125,60,65
Ультерис,deathguard,1468,deathknight,unholy,24,17,7
Sorostew,twisting-nether,1468,deathknight,unholy,86,45,41
Utyr,ragnaros,1468,deathknight,unholy,196,97,99
Arxelas,sylvanas,1467,deathknight,unholy,115,60,55
Moko,defias-brotherhood,1467,deathknight,unholy,54,25,29
Субботин,soulflayer,1466,deathknight,unholy,46,28,18
Zóur,rajaxx,1466,deathknight,unholy,119,66,53
Freakabiceps,draenor,1466,deathknight,unholy,84,39,45
Kérmít,tarren-mill,1465,deathknight,unholy,160,88,72
Unholy,ragnaros,1465,deathknight,unholy,70,36,34
Балаар,galakrond,1465,deathknight,unholy,98,49,49
Thanatus,aggra-português,1465,deathknight,unholy,48,23,25
Lifetakergr,sylvanas,1465,deathknight,unholy,40,16,24
Дискодансер,ashenvale,1463,deathknight,unholy,48,25,23
Емтвоюкиску,soulflayer,1462,deathknight,unholy,52,24,28
Turkknight,outland,1462,deathknight,unholy,36,16,20
Bärdk,forscherliga,1461,deathknight,unholy,95,47,48
Yousaindk,blackrock,1461,deathknight,unholy,66,30,36
Drãka,twisting-nether,1460,deathknight,unholy,88,49,39
Шифычдк,howling-fjord,1460,deathknight,unholy,60,27,33
Ylohnu,archimonde,1459,deathknight,unholy,57,27,30
Nospets,kazzak,1459,deathknight,unholy,54,25,29
Gethunts,drakthul,1457,deathknight,unholy,42,25,17
Holaroris,drakthul,1457,deathknight,unholy,54,31,23
Apraxia,ravencrest,1457,deathknight,unholy,38,16,22
Hêalz,ungoro,1456,deathknight,unholy,120,63,57
Bígzoran,kazzak,1456,deathknight,unholy,60,29,31
Hawkthuglife,dun-modr,1455,deathknight,unholy,143,69,74
Petardodupy,burning-legion,1454,deathknight,unholy,78,41,37
Сванхильда,grom,1454,deathknight,unholy,305,149,156
Yeamaon,ravencrest,1453,deathknight,unholy,48,17,31
Wtfisthisdmg,blackmoore,1452,deathknight,unholy,58,29,29
Skèltòn,rexxar,1451,deathknight,unholy,73,47,26
Megdeath,silvermoon,1451,deathknight,unholy,138,65,73
Hokdk,voljin,1451,deathknight,unholy,119,48,71
Ceranto,frostwolf,1450,deathknight,unholy,90,52,38
Nødæd,sanguino,1450,deathknight,unholy,142,69,73
Ceedrik,nemesis,1450,deathknight,unholy,34,16,18
Dharniman,sylvanas,1450,deathknight,unholy,52,23,29
Icep,archimonde,1449,deathknight,unholy,78,38,40
Sathmayla,silvermoon,1448,deathknight,unholy,53,32,21
Booneuh,kazzak,1448,deathknight,unholy,96,52,44
Ссагарисс,galakrond,1448,deathknight,unholy,42,16,26
Demrior,hellfire,1447,deathknight,unholy,66,27,39
Âlîce,culte-de-la-rive-noire,1446,deathknight,unholy,72,43,29
Fuzzyofc,draenor,1446,deathknight,unholy,102,42,60
Darksalezian,drakthul,1445,deathknight,unholy,113,60,53
Quantumshift,ravencrest,1444,deathknight,unholy,36,23,13
Majlus,outland,1444,deathknight,unholy,74,35,39
Rabbijacob,ysondre,1444,deathknight,unholy,209,94,115
Sîck,bladefist,1444,deathknight,unholy,78,29,49
Десхоб,soulflayer,1443,deathknight,unholy,181,76,105
Grubbins,kul-tiras,1442,deathknight,unholy,82,43,39
Homunculas,twisting-nether,1442,deathknight,unholy,82,37,45
Bonethugg,burning-legion,1440,deathknight,unholy,84,41,43
Insanïac,draenor,1440,deathknight,unholy,39,18,21
Morinosei,twisting-nether,1438,deathknight,unholy,125,69,56
Lothqgar,burning-legion,1438,deathknight,unholy,134,69,65
Tuggis,outland,1438,deathknight,unholy,134,64,70
Cleverb,silvermoon,1437,deathknight,unholy,89,43,46
Капустас,gordunni,1437,deathknight,unholy,108,50,58
Tilixdk,draenor,1437,deathknight,unholy,48,22,26
Касуляпвнз,gordunni,1436,deathknight,unholy,60,29,31
Dhampir,tarren-mill,1436,deathknight,unholy,73,31,42
Demonicaltar,dalaran,1436,deathknight,unholy,42,16,26
Mîîkkaa,blackhand,1435,deathknight,unholy,42,15,27
Mennal,the-maelstrom,1434,deathknight,unholy,61,35,26
Таможникс,soulflayer,1434,deathknight,unholy,83,45,38
Дедхо,soulflayer,1434,deathknight,unholy,62,28,34
Ridire,saurfang,1433,deathknight,unholy,69,38,31
Gegham,ravencrest,1433,deathknight,unholy,58,30,28
Chrispbacøn,ragnaros,1433,deathknight,unholy,40,19,21
Juicyjayho,stormscale,1433,deathknight,unholy,66,31,35
Ðeadghøul,silvermoon,1432,deathknight,unholy,48,24,24
Katatönias,archimonde,1432,deathknight,unholy,76,34,42
Deusmort,ravencrest,1432,deathknight,unholy,135,60,75
Elcapìtan,silvermoon,1431,deathknight,unholy,24,15,9
Ullefuz,silvermoon,1431,deathknight,unholy,99,52,47
Numnuts,alakir,1430,deathknight,unholy,42,21,21
Valanaari,argent-dawn,1430,deathknight,unholy,79,38,41
Форнителли,howling-fjord,1430,deathknight,unholy,120,54,66
Westdx,hyjal,1429,deathknight,unholy,78,41,37
Deadkilla,stormreaver,1429,deathknight,unholy,72,33,39
Dariusgrip,kazzak,1429,deathknight,unholy,36,15,21
Juliean,blackmoore,1428,deathknight,unholy,112,52,60
Empiu,blackhand,1427,deathknight,unholy,102,57,45
Blackterrør,hyjal,1427,deathknight,unholy,40,16,24
Goreshovel,stormscale,1426,deathknight,unholy,144,72,72
Дядьдим,soulflayer,1426,deathknight,unholy,99,49,50
Бреч,gordunni,1426,deathknight,unholy,81,34,47
Шейзо,soulflayer,1424,deathknight,unholy,39,22,17
Draforce,quelthalas,1424,deathknight,unholy,75,42,33
Assgripper,hyjal,1423,deathknight,unholy,71,41,30
Jöndas,drakthul,1422,deathknight,unholy,89,49,40
Späwn,ysondre,1422,deathknight,unholy,64,24,40
Микелон,gordunni,1421,deathknight,unholy,34,21,13
Elmyo,argent-dawn,1421,deathknight,unholy,54,24,30
Discochoppa,blackmoore,1421,deathknight,unholy,36,15,21
Wlcrealworld,ravencrest,1419,deathknight,unholy,56,30,26
Ohsevèn,ravencrest,1419,deathknight,unholy,71,38,33
Алсидис,gordunni,1419,deathknight,unholy,114,46,68
Logoz,dun-modr,1418,deathknight,unholy,36,18,18
Pavkata,outland,1417,deathknight,unholy,248,122,126
Kebabpizza,argent-dawn,1417,deathknight,unholy,109,53,56
Lastprophet,drakthul,1417,deathknight,unholy,70,25,45
Аирфрост,howling-fjord,1416,deathknight,unholy,54,25,29
Arxelas,stormscale,1416,deathknight,unholy,72,30,42
Styxdk,blackhand,1415,deathknight,unholy,30,15,15
Wolfyy,antonidas,1415,deathknight,unholy,78,36,42
Pestilerous,draenor,1415,deathknight,unholy,48,17,31
Kalenjii,burning-legion,1414,deathknight,unholy,70,33,37
Rotbone,drakthul,1413,deathknight,unholy,30,17,13
Darknemesis,nemesis,1413,deathknight,unholy,62,26,36
Сенкрул,gordunni,1412,deathknight,unholy,78,50,28
Сивкабурка,fordragon,1411,deathknight,unholy,78,35,43
Fenixflexin,ravencrest,1410,deathknight,unholy,48,15,33
Terren,ravencrest,1409,deathknight,unholy,52,29,23
Demonium,twisting-nether,1407,deathknight,unholy,69,26,43
Тряпьё,galakrond,1406,deathknight,unholy,41,23,18
Krinoe,dalaran,1406,deathknight,unholy,53,28,25
Taylorswiift,tarren-mill,1404,deathknight,unholy,29,15,14
Zandruq,twisting-nether,1404,deathknight,unholy,189,97,92
Chillstreak,twisting-nether,1404,deathknight,unholy,78,33,45
Flinsen,blackmoore,1403,deathknight,unholy,260,141,119
Grezak,defias-brotherhood,1403,deathknight,unholy,43,20,23
Eddrich,aegwynn,1402,deathknight,unholy,92,47,45
Semeris,twisting-nether,1401,deathknight,unholy,30,15,15
Iluzis,kazzak,1400,deathknight,unholy,60,30,30
Manovar,archimonde,1400,deathknight,unholy,377,183,194
Shewoman,stormreaver,1400,deathknight,unholy,42,17,25
Darkhallow,thrall,1399,deathknight,unholy,230,123,107
Zracul,nordrassil,1399,deathknight,unholy,141,74,67
Gerzys,drakthul,1398,deathknight,unholy,22,16,6
Calhoun,teldrassil,1398,deathknight,unholy,35,15,20
Sictir,stormscale,1397,deathknight,unholy,407,203,204
Soix,sanguino,1397,deathknight,unholy,66,30,36
Maradk,drakthul,1396,deathknight,unholy,305,150,155
Darkeron,dun-modr,1395,deathknight,unholy,56,31,25
Ganessha,sanguino,1395,deathknight,unholy,121,60,61
Kekebas,twisting-nether,1394,deathknight,unholy,96,54,42
Gaurk,aggra-português,1393,deathknight,unholy,94,51,43
Dizin,ravencrest,1393,deathknight,unholy,68,28,40
Анфалагон,gordunni,1392,deathknight,unholy,114,56,58
Civilredevil,ravencrest,1391,deathknight,unholy,42,18,24
Lilyxtulle,tarren-mill,1390,deathknight,unholy,298,153,145
Dzwiadke,burning-legion,1390,deathknight,unholy,154,72,82
Jihm,silvermoon,1388,deathknight,unholy,190,100,90
Estoico,ragnaros,1388,deathknight,unholy,107,52,55
Axram,ravencrest,1384,deathknight,unholy,108,50,58
Beherith,sunstrider,1383,deathknight,unholy,47,31,16
Akelæ,draenor,1383,deathknight,unholy,130,68,62
Epoch,azjolnerub,1383,deathknight,unholy,115,52,63
Bloodkatana,drakthul,1382,deathknight,unholy,90,40,50
Nellath,kazzak,1382,deathknight,unholy,125,53,72
Naimuakovaa,ravencrest,1380,deathknight,unholy,18,15,3
Nevmyrayka,silvermoon,1379,deathknight,unholy,63,35,28
Zarad,scarshield-legion,1379,deathknight,unholy,82,41,41
Gengàr,tarren-mill,1379,deathknight,unholy,30,15,15
Reezeer,stormscale,1379,deathknight,unholy,41,18,23
Luzifear,bloodscalp,1379,deathknight,unholy,66,24,42
Nauser,kazzak,1377,deathknight,unholy,101,47,54
Шарабум,howling-fjord,1377,deathknight,unholy,65,29,36
Xado,frostwolf,1376,deathknight,unholy,138,72,66
Омадесала,thermaplugg,1375,deathknight,unholy,63,30,33
Fizzdk,pozzo-delleternità,1375,deathknight,unholy,60,28,32
Puppétmastér,kazzak,1374,deathknight,unholy,96,47,49
Flawstmourne,kazzak,1374,deathknight,unholy,35,15,20
Frostplague,aegwynn,1374,deathknight,unholy,66,27,39
Vezthel,stormscale,1374,deathknight,unholy,103,42,61
Deathcleave,burning-legion,1373,deathknight,unholy,53,22,31
Sevatar,zuljin,1372,deathknight,unholy,24,16,8
Anaralien,ravencrest,1371,deathknight,unholy,188,87,101
Mayaya,malganis,1370,deathknight,unholy,52,28,24
Aesthaetik,draenor,1369,deathknight,unholy,70,36,34
Venexia,kazzak,1369,deathknight,unholy,64,31,33
Vrez,argent-dawn,1369,deathknight,unholy,42,16,26
Tyvra,blackhand,1369,deathknight,unholy,47,17,30
Wintersir,tarren-mill,1368,deathknight,unholy,59,31,28
Huekun,draenor,1366,deathknight,unholy,86,39,47
Defeated,thrall,1365,deathknight,unholy,285,141,144
Tobtób,antonidas,1365,deathknight,unholy,72,28,44
Astaret,tyrande,1363,deathknight,unholy,36,16,20
Zeghor,ragnaros,1363,deathknight,unholy,143,63,80
Энвилион,howling-fjord,1362,deathknight,unholy,191,91,100
Mìa,kragjin,1362,deathknight,unholy,109,49,60
Mellowqt,aegwynn,1358,deathknight,unholy,121,67,54
Deadroses,tarren-mill,1357,deathknight,unholy,162,86,76
Bàdtank,hyjal,1357,deathknight,unholy,121,64,57
Мурмадонище,soulflayer,1356,deathknight,unholy,50,29,21
Skøurge,silvermoon,1355,deathknight,unholy,293,145,148
Dorkmoal,blackmoore,1355,deathknight,unholy,114,55,59
Unholycard,argent-dawn,1353,deathknight,unholy,120,60,60
Ithis,zuljin,1351,deathknight,unholy,281,135,146
Xênôrr,archimonde,1350,deathknight,unholy,84,41,43
Bitdead,doomhammer,1349,deathknight,unholy,60,35,25
Sorcc,burning-legion,1349,deathknight,unholy,168,80,88
Mamanica,sanguino,1344,deathknight,unholy,48,23,25
Roaredrick,draenor,1343,deathknight,unholy,115,54,61
Twardobaba,burning-legion,1342,deathknight,unholy,54,27,27
Fosswire,stormscale,1342,deathknight,unholy,66,31,35
Julezer,malganis,1342,deathknight,unholy,30,14,16
Хейткрю,howling-fjord,1342,deathknight,unholy,48,21,27
Dunkàn,silvermoon,1341,deathknight,unholy,124,71,53
Diseasecow,tarren-mill,1341,deathknight,unholy,72,34,38
Chocopeanut,ravencrest,1339,deathknight,unholy,54,32,22
Анкара,ashenvale,1338,deathknight,unholy,145,71,74
Frostich,ragnaros,1338,deathknight,unholy,35,15,20
Lividity,blackhand,1337,deathknight,unholy,48,28,20
Prænklý,blackrock,1336,deathknight,unholy,90,44,46
Prethor,drakthul,1336,deathknight,unholy,36,15,21
Blorin,sylvanas,1335,deathknight,unholy,115,51,64
Блодскал,howling-fjord,1334,deathknight,unholy,111,52,59
Boreghar,drakthul,1333,deathknight,unholy,30,14,16
Raust,xavius,1333,deathknight,unholy,144,62,82
Arthrex,twisting-nether,1332,deathknight,unholy,54,29,25
Bloodbane,burning-blade,1332,deathknight,unholy,96,43,53
Хенстор,gordunni,1332,deathknight,unholy,101,44,57
Alamo,doomhammer,1331,deathknight,unholy,24,14,10
Варделон,gordunni,1331,deathknight,unholy,66,36,30
Çrtz,eredar,1330,deathknight,unholy,24,14,10
Scotty,ravencrest,1330,deathknight,unholy,30,14,16
Armax,stormscale,1329,deathknight,unholy,30,14,16
Чумазная,howling-fjord,1329,deathknight,unholy,36,14,22
Sonofalích,aerie-peak,1328,deathknight,unholy,73,37,36
Azrìal,agamaggan,1328,deathknight,unholy,95,47,48
Ravencraft,azjolnerub,1328,deathknight,unholy,30,14,16
Планус,booty-bay,1327,deathknight,unholy,39,24,15
Нетгкд,deathguard,1326,deathknight,unholy,71,34,37
Джайвана,soulflayer,1325,deathknight,unholy,391,198,193
Nekote,silvermoon,1325,deathknight,unholy,51,24,27
Ârtjom,aegwynn,1325,deathknight,unholy,105,49,56
Amdeath,kazzak,1324,deathknight,unholy,24,14,10
Crostrike,kazzak,1324,deathknight,unholy,41,23,18
Астартэс,deathguard,1322,deathknight,unholy,77,39,38
Persefal,nemesis,1322,deathknight,unholy,91,41,50
Nightcrawle,twisting-nether,1322,deathknight,unholy,41,18,23
Deathj,ravencrest,1321,deathknight,unholy,24,15,9
Потный,soulflayer,1321,deathknight,unholy,45,18,27
Teflonphobos,stormreaver,1320,deathknight,unholy,18,14,4
Bloodykushin,burning-legion,1320,deathknight,unholy,42,22,20
Deathuss,silvermoon,1320,deathknight,unholy,139,66,73
Drayvinn,twisting-nether,1319,deathknight,unholy,60,25,35
Ziuziu,twisting-nether,1318,deathknight,unholy,54,15,39
Deathlïght,nemesis,1317,deathknight,unholy,119,59,60
Jujudk,tarren-mill,1317,deathknight,unholy,207,100,107
Detrah,argent-dawn,1315,deathknight,unholy,52,27,25
Veyrøn,kazzak,1314,deathknight,unholy,96,49,47
Fineral,argent-dawn,1314,deathknight,unholy,68,33,35
Mcrune,ravencrest,1313,deathknight,unholy,84,37,47
Züg,draenor,1312,deathknight,unholy,125,58,67
Feugen,hyjal,1309,deathknight,unholy,54,28,26
Galayn,burning-legion,1309,deathknight,unholy,104,43,61
Nelzébal,kirin-tor,1309,deathknight,unholy,42,16,26
Riannoc,argent-dawn,1308,deathknight,unholy,30,17,13
Jodure,silvermoon,1308,deathknight,unholy,45,21,24
Ecoya,blackrock,1308,deathknight,unholy,89,40,49
Grubyr,burning-legion,1302,deathknight,unholy,78,38,40
Triqué,antonidas,1302,deathknight,unholy,54,25,29
Ahlat,blackmoore,1300,deathknight,unholy,113,65,48
Syncros,blackrock,1300,deathknight,unholy,42,19,23
Edochian,sanguino,1299,deathknight,unholy,32,16,16
Fishtruction,tarren-mill,1298,deathknight,unholy,414,211,203
Deathpaladin,blackmoore,1298,deathknight,unholy,36,15,21
Крикед,soulflayer,1297,deathknight,unholy,102,55,47
Дэбон,howling-fjord,1297,deathknight,unholy,156,74,82
Plagueherald,ravencrest,1296,deathknight,unholy,30,14,16
Izanagii,exodar,1296,deathknight,unholy,36,16,20
Sveinnhran,kazzak,1295,deathknight,unholy,303,147,156
Zeolingk,tarren-mill,1294,deathknight,unholy,86,34,52
Mêlian,blackmoore,1294,deathknight,unholy,36,14,22
Альмон,howling-fjord,1293,deathknight,unholy,72,34,38
Mediul,magtheridon,1292,deathknight,unholy,120,57,63
Roykoopa,hyjal,1291,deathknight,unholy,102,55,47
Zegaan,kazzak,1291,deathknight,unholy,132,61,71
Ничер,thermaplugg,1289,deathknight,unholy,24,14,10
Pjthedk,lightbringer,1289,deathknight,unholy,95,47,48
Kazildark,ravencrest,1288,deathknight,unholy,42,21,21
Еххел,soulflayer,1287,deathknight,unholy,60,30,30
Tyranus,quelthalas,1287,deathknight,unholy,216,101,115
Metalist,ravencrest,1286,deathknight,unholy,165,78,87
Fixmybones,frostmane,1286,deathknight,unholy,78,30,48
Zelamar,burning-legion,1286,deathknight,unholy,54,20,34
Msvine,kazzak,1285,deathknight,unholy,183,94,89
Финдекс,soulflayer,1285,deathknight,unholy,36,15,21
Morssal,outland,1284,deathknight,unholy,35,17,18
Зибак,soulflayer,1281,deathknight,unholy,99,46,53
Айос,ashenvale,1280,deathknight,unholy,78,37,41
Skalbjörn,arathor,1280,deathknight,unholy,63,29,34
Constantyn,blackrock,1280,deathknight,unholy,42,19,23
Endlesspain,burning-legion,1280,deathknight,unholy,58,24,34
Diatriss,argent-dawn,1279,deathknight,unholy,75,36,39
Брюшина,gordunni,1279,deathknight,unholy,90,36,54
Laobeef,twisting-nether,1278,deathknight,unholy,53,23,30
Elíta,draenor,1278,deathknight,unholy,42,18,24
Feekus,deathwing,1273,deathknight,unholy,54,32,22
Роземайер,ashenvale,1273,deathknight,unholy,132,63,69
Ryäñ,silvermoon,1272,deathknight,unholy,58,26,32
Mawdrym,twisting-nether,1272,deathknight,unholy,44,18,26
Атскийсатана,goldrinn,1271,deathknight,unholy,93,48,45
Авагон,howling-fjord,1271,deathknight,unholy,159,79,80
Obstwald,blackrock,1270,deathknight,unholy,215,110,105
Hðsh,ysondre,1270,deathknight,unholy,28,14,14
Reportmeplz,ragnaros,1270,deathknight,unholy,48,22,26
Necrozy,aggra-português,1269,deathknight,unholy,84,43,41
Katakurî,blackmoore,1269,deathknight,unholy,74,29,45
Dunklerlord,malfurion,1267,deathknight,unholy,48,20,28
Crudelias,aegwynn,1266,deathknight,unholy,42,22,20
Rimda,twisting-nether,1265,deathknight,unholy,26,14,12
Undtot,azshara,1264,deathknight,unholy,36,16,20
Ммиднайтт,blackscar,1264,deathknight,unholy,36,15,21
Rammsteïn,ravencrest,1264,deathknight,unholy,68,28,40
Heyabigail,wildhammer,1263,deathknight,unholy,139,63,76
Кмамехочу,howling-fjord,1262,deathknight,unholy,36,22,14
Drenodur,amanthul,1261,deathknight,unholy,24,14,10
Sound,shadowsong,1260,deathknight,unholy,124,59,65
Scareanger,argent-dawn,1259,deathknight,unholy,81,41,40
Tenofas,nemesis,1258,deathknight,unholy,33,16,17
Томиганн,grom,1257,deathknight,unholy,155,74,81
Kratagon,thrall,1257,deathknight,unholy,90,34,56
Plagueknight,ravencrest,1256,deathknight,unholy,90,37,53
Tesasd,silvermoon,1255,deathknight,unholy,58,26,32
Orcborg,zuljin,1254,deathknight,unholy,49,24,25
Goochtickler,kazzak,1247,deathknight,unholy,24,13,11
Kaletorn,ragnaros,1247,deathknight,unholy,106,53,53
Rimewraith,argent-dawn,1247,deathknight,unholy,104,50,54
Дуонза,blackscar,1244,deathknight,unholy,36,20,16
Алкеокол,soulflayer,1244,deathknight,unholy,63,28,35
Luciferon,zenedar,1244,deathknight,unholy,66,28,38
Halohuntress,outland,1243,deathknight,unholy,60,28,32
Патриаррх,gordunni,1240,deathknight,unholy,47,25,22
Zúrg,stormscale,1240,deathknight,unholy,30,14,16
Grithala,draenor,1239,deathknight,unholy,24,13,11
Kéréos,hyjal,1238,deathknight,unholy,24,13,11
Brogard,tarren-mill,1237,deathknight,unholy,30,16,14
Kalantii,draenor,1237,deathknight,unholy,53,24,29
Azcrown,azjolnerub,1235,deathknight,unholy,24,13,11
Khorag,lordaeron,1235,deathknight,unholy,30,13,17
Superere,hyjal,1234,deathknight,unholy,47,21,26
Ogomegee,ravencrest,1231,deathknight,unholy,28,15,13
Kazagoth,draenor,1230,deathknight,unholy,36,20,16
Funds,kazzak,1230,deathknight,unholy,30,13,17
Аданаэль,howling-fjord,1228,deathknight,unholy,47,21,26
Evelys,kazzak,1228,deathknight,unholy,70,31,39
Breakstuff,twisting-nether,1227,deathknight,unholy,61,29,32
Крус,blackscar,1227,deathknight,unholy,89,39,50
Близзбай,soulflayer,1227,deathknight,unholy,84,30,54
Falballâ,ysondre,1226,deathknight,unholy,54,26,28
Mãshi,hyjal,1225,deathknight,unholy,72,36,36
Negzul,blackmoore,1225,deathknight,unholy,109,50,59
Dmaarr,drakthul,1223,deathknight,unholy,50,23,27
Necrocancerr,twisting-nether,1220,deathknight,unholy,161,76,85
Nilodk,nemesis,1219,deathknight,unholy,445,222,223
Areyouvegan,quelthalas,1219,deathknight,unholy,35,14,21
Tarfu,kazzak,1218,deathknight,unholy,120,61,59
Vadamee,ravencrest,1218,deathknight,unholy,124,57,67
Bämbämpewpew,ravencrest,1218,deathknight,unholy,30,13,17
Thoir,ahnqiraj,1217,deathknight,unholy,24,13,11
Razzvy,darkspear,1217,deathknight,unholy,123,55,68
Jixcore,draenor,1217,deathknight,unholy,48,16,32
Sarkasm,malganis,1216,deathknight,unholy,102,48,54
Appdeath,azjolnerub,1214,deathknight,unholy,30,19,11
Kazagul,blackrock,1214,deathknight,unholy,45,22,23
Nøult,sanguino,1214,deathknight,unholy,30,13,17
Fentanil,elune,1213,deathknight,unholy,274,135,139
Gothenburger,darksorrow,1213,deathknight,unholy,84,41,43
Tanenoss,kazzak,1213,deathknight,unholy,54,21,33
Aradiel,archimonde,1210,deathknight,unholy,56,22,34
Thedx,blades-edge,1208,deathknight,unholy,52,20,32
Баривуль,howling-fjord,1207,deathknight,unholy,37,19,18
Деркхаус,soulflayer,1206,deathknight,unholy,30,18,12
Gravetitan,shattrath,1203,deathknight,unholy,178,89,89
Инкреасесх,blackscar,1202,deathknight,unholy,68,33,35
Бенечках,gordunni,1202,deathknight,unholy,62,25,37
Жупело,gordunni,1200,deathknight,unholy,60,33,27
Zpartan,ragnaros,1197,deathknight,unholy,66,25,41
Zelbørk,medivh,1194,deathknight,unholy,54,26,28
Funnboon,alleria,1193,deathknight,unholy,60,30,30
Fluffínator,kazzak,1190,deathknight,unholy,126,60,66
Dezzi,azuremyst,1189,deathknight,unholy,68,35,33
Vegz,archimonde,1187,deathknight,unholy,37,20,17
Deathmìnd,ravencrest,1186,deathknight,unholy,23,13,10
Asakurai,grim-batol,1184,deathknight,unholy,54,30,24
Vahllas,blackhand,1183,deathknight,unholy,54,19,35
Шэйп,fordragon,1181,deathknight,unholy,42,15,27
Øbito,sylvanas,1179,deathknight,unholy,36,14,22
Homoforsluts,silvermoon,1178,deathknight,unholy,24,15,9
Фиджибро,soulflayer,1175,deathknight,unholy,91,45,46
Deadpòól,twisting-nether,1173,deathknight,unholy,50,15,35
Lobotomia,burning-blade,1171,deathknight,unholy,97,45,52
Ezreo,neptulon,1167,deathknight,unholy,31,14,17
Eltorro,ravencrest,1165,deathknight,unholy,42,14,28
Mupak,drakthul,1164,deathknight,unholy,29,17,12
Sigarå,twisting-nether,1164,deathknight,unholy,60,26,34
Ennigmá,stormscale,1162,deathknight,unholy,36,21,15
Дэдушка,gordunni,1159,deathknight,unholy,23,13,10
Píz,ravencrest,1157,deathknight,unholy,32,13,19
Smalldk,silvermoon,1156,deathknight,unholy,36,18,18
Grisig,twisting-nether,1152,deathknight,unholy,100,56,44
Fyrkadk,aegwynn,1151,deathknight,unholy,24,12,12
Leiyo,arathor,1151,deathknight,unholy,36,14,22
Aest,blackhand,1150,deathknight,unholy,24,12,12
Chyppy,dalaran,1150,deathknight,unholy,36,15,21
Dklol,dun-morogh,1150,deathknight,unholy,36,14,22
Numnutz,alakir,1149,deathknight,unholy,25,13,12
Usbdock,stormscale,1149,deathknight,unholy,24,12,12
Hoar,blackrock,1148,deathknight,unholy,30,12,18
Màlthael,zuljin,1147,deathknight,unholy,30,12,18
Maxïmus,argent-dawn,1146,deathknight,unholy,42,12,30
Larvalîs,blackmoore,1145,deathknight,unholy,78,43,35
Nefertitï,kazzak,1145,deathknight,unholy,132,51,81
Adria,jaedenar,1143,deathknight,unholy,36,18,18
Euphorius,azuremyst,1142,deathknight,unholy,52,29,23
Badbrian,draenor,1141,deathknight,unholy,40,22,18
Maagbloeding,sylvanas,1138,deathknight,unholy,60,27,33
Qmy,outland,1138,deathknight,unholy,70,29,41
Thanagor,auchindoun,1138,deathknight,unholy,30,12,18
Abnormus,tarren-mill,1137,deathknight,unholy,114,52,62
Skeggjold,drakthul,1135,deathknight,unholy,30,14,16
Coldkase,ghostlands,1134,deathknight,unholy,18,12,6
Kailara,draenor,1133,deathknight,unholy,29,12,17
Niex,destromath,1133,deathknight,unholy,30,12,18
Jowân,blackmoore,1131,deathknight,unholy,24,13,11
Dêku,aegwynn,1130,deathknight,unholy,79,44,35
Beinlausi,dalaran,1130,deathknight,unholy,55,30,25
Sgtlit,outland,1130,deathknight,unholy,30,12,18
Артушадк,soulflayer,1127,deathknight,unholy,84,44,40
Волграл,howling-fjord,1125,deathknight,unholy,73,38,35
Hqxdd,twisting-nether,1123,deathknight,unholy,174,85,89
Cervä,kazzak,1120,deathknight,unholy,28,13,15
Rades,sanguino,1120,deathknight,unholy,36,15,21
Spometteqt,archimonde,1119,deathknight,unholy,23,12,11
Híruzen,blackrock,1115,deathknight,unholy,30,15,15
Vexinux,outland,1107,deathknight,unholy,45,15,30
Karalun,nagrand,1106,deathknight,unholy,120,62,58
Sénta,tarren-mill,1105,deathknight,unholy,53,21,32
Stepknìght,draenor,1104,deathknight,unholy,29,12,17
Жекабыкует,borean-tundra,1102,deathknight,unholy,44,17,27
Saromón,ravencrest,1101,deathknight,unholy,30,18,12
Zaouros,silvermoon,1101,deathknight,unholy,42,17,25
Auru,tarren-mill,1099,deathknight,unholy,143,69,74
Cykeljävel,stormreaver,1097,deathknight,unholy,35,12,23
Moartèa,blackhand,1095,deathknight,unholy,29,12,17
Охъламон,soulflayer,1094,deathknight,unholy,355,176,179
Xlmaster,aggra-português,1094,deathknight,unholy,28,12,16
Deathanos,kazzak,1093,deathknight,unholy,24,14,10
Frostmommy,argent-dawn,1092,deathknight,unholy,89,37,52
Bexly,defias-brotherhood,1091,deathknight,unholy,79,38,41
Schopenhauer,turalyon,1091,deathknight,unholy,75,35,40
Dalenn,kazzak,1089,deathknight,unholy,39,13,26
Zathron,blackmoore,1088,deathknight,unholy,96,46,50
Olm,guldan,1087,deathknight,unholy,84,42,42
Morvain,silvermoon,1087,deathknight,unholy,191,87,104
Teldä,archimonde,1086,deathknight,unholy,48,22,26
Younix,silvermoon,1086,deathknight,unholy,90,32,58
Kaldhan,nemesis,1085,deathknight,unholy,46,23,23
Squeeze,drakthul,1083,deathknight,unholy,60,22,38
Narrua,die-aldor,1082,deathknight,unholy,47,17,30
Heresjohny,stormrage,1073,deathknight,unholy,30,13,17
Highmelli,ambossar,1071,deathknight,unholy,84,30,54
Nestia,emerald-dream,1065,deathknight,unholy,118,54,64
Tyrannus,earthen-ring,1061,deathknight,unholy,46,25,21
Zdan,sylvanas,1060,deathknight,unholy,96,45,51
Kazay,madmortem,1059,deathknight,unholy,48,19,29
Critycal,draenor,1056,deathknight,unholy,18,11,7
Elendren,blackrock,1056,deathknight,unholy,24,11,13
Goshakutsen,ravencrest,1055,deathknight,unholy,18,11,7
Døddrukken,ragnaros,1055,deathknight,unholy,18,11,7
Stipemiocic,nemesis,1055,deathknight,unholy,24,11,13
Тидог,ashenvale,1055,deathknight,unholy,24,11,13
Orochimaruo,stormscale,1055,deathknight,unholy,42,17,25
Yötãrîn,dalaran,1054,deathknight,unholy,18,11,7
Atakan,nemesis,1054,deathknight,unholy,68,36,32
Darkqüeen,sanguino,1054,deathknight,unholy,54,20,34
Karvaturare,ravencrest,1054,deathknight,unholy,98,33,65
Ураан,gordunni,1053,deathknight,unholy,22,12,10
Synchronic,stormscale,1053,deathknight,unholy,24,11,13
Feelmyfuri,mazrigos,1053,deathknight,unholy,24,11,13
Painrune,nordrassil,1052,deathknight,unholy,24,11,13
Mustakäsi,ravencrest,1051,deathknight,unholy,27,12,15
Никорэнор,howling-fjord,1051,deathknight,unholy,36,11,25
Regniér,frostwolf,1050,deathknight,unholy,18,11,7
Adlatus,malganis,1049,deathknight,unholy,42,25,17
Hacknorris,aegwynn,1049,deathknight,unholy,33,17,16
Mailasse,dalaran,1049,deathknight,unholy,48,24,24
Mefhesto,tarren-mill,1049,deathknight,unholy,30,11,19
Нуурргл,howling-fjord,1046,deathknight,unholy,48,19,29
Авнас,fordragon,1045,deathknight,unholy,76,40,36
Auggee,ravencrest,1045,deathknight,unholy,24,11,13
Shakour,argent-dawn,1044,deathknight,unholy,18,11,7
Zyknight,silvermoon,1044,deathknight,unholy,30,11,19
Рэкставр,soulflayer,1043,deathknight,unholy,112,58,54
Дезентирия,soulflayer,1043,deathknight,unholy,27,11,16
Ilovegouàng,khaz-modan,1041,deathknight,unholy,36,15,21
Gigazord,ysondre,1039,deathknight,unholy,29,13,16
Eibon,drakthul,1037,deathknight,unholy,18,11,7
Порнпанда,gordunni,1037,deathknight,unholy,24,11,13
Rognvald,les-sentinelles,1036,deathknight,unholy,137,73,64
Valeriania,burning-legion,1035,deathknight,unholy,46,25,21
Draigó,thrall,1033,deathknight,unholy,36,16,20
Slâyèr,blackrock,1033,deathknight,unholy,114,50,64
Pamplemouse,burning-blade,1032,deathknight,unholy,125,59,66
Мокраявода,soulflayer,1030,deathknight,unholy,100,53,47
Gùra,sanguino,1028,deathknight,unholy,71,24,47
Jarhèad,grim-batol,1027,deathknight,unholy,71,33,38
Macdoom,throkferoth,1027,deathknight,unholy,44,14,30
Некронн,grom,1026,deathknight,unholy,300,152,148
Anùbïs,kaelthas,1026,deathknight,unholy,41,13,28
Ослаад,gordunni,1025,deathknight,unholy,24,13,11
Gowther,blackmoore,1024,deathknight,unholy,212,108,104
Ðeucaly,nemesis,1022,deathknight,unholy,23,11,12
Akuji,dragonmaw,1022,deathknight,unholy,36,14,22
Gothral,doomhammer,1020,deathknight,unholy,82,41,41
Kahp,tarren-mill,1019,deathknight,unholy,49,23,26
Icyplague,ravencrest,1018,deathknight,unholy,20,12,8
Малп,gordunni,1018,deathknight,unholy,42,24,18
Assasínator,tarren-mill,1017,deathknight,unholy,205,105,100
Luciferyan,twisting-nether,1017,deathknight,unholy,36,15,21
Трибублика,howling-fjord,1016,deathknight,unholy,30,11,19
Scorbion,kilrogg,1015,deathknight,unholy,24,11,13
Ereboss,eredar,1014,deathknight,unholy,36,17,19
Mÿv,archimonde,1010,deathknight,unholy,30,11,19
Keenda,kirin-tor,1009,deathknight,unholy,31,14,17
Jimundo,ravencrest,1005,deathknight,unholy,32,15,17
Cryistyx,draenor,1004,deathknight,unholy,20,12,8
Kachie,stormscale,1004,deathknight,unholy,23,11,12
Takåtry,archimonde,1004,deathknight,unholy,30,14,16
Braastad,sylvanas,994,deathknight,unholy,84,44,40
Kolman,drakthul,986,deathknight,unholy,24,16,8
Shadowevil,silvermoon,985,deathknight,unholy,21,12,9
Серинокс,howling-fjord,984,deathknight,unholy,27,12,15
Myeltior,kazzak,983,deathknight,unholy,28,11,17
Gathalion,the-maelstrom,980,deathknight,unholy,48,28,20
Арчибальд,soulflayer,975,deathknight,unholy,30,12,18
Kixx,bloodfeather,971,deathknight,unholy,94,38,56
Kenwae,silvermoon,970,deathknight,unholy,88,27,61
Anotherx,frostwolf,967,deathknight,unholy,24,11,13
Kirkster,terokkar,963,deathknight,unholy,51,22,29
Flytomoon,argent-dawn,962,deathknight,unholy,96,43,53
Kaliro,sylvanas,960,deathknight,unholy,18,10,8
Wórzzag,arygos,960,deathknight,unholy,18,10,8
Cervâ,twisting-nether,960,deathknight,unholy,24,10,14
Julezi,blackmoore,960,deathknight,unholy,30,10,20
Barnëylord,argent-dawn,959,deathknight,unholy,18,10,8
Ebonsword,kazzak,959,deathknight,unholy,18,10,8
Akronux,grim-batol,959,deathknight,unholy,36,18,18
Silvergreed,kazzak,959,deathknight,unholy,24,10,14
Виндрукс,soulflayer,958,deathknight,unholy,24,10,14
Xisaark,blackrock,958,deathknight,unholy,30,10,20
Valkion,nemesis,958,deathknight,unholy,30,10,20
Nightsong,tarren-mill,957,deathknight,unholy,18,10,8
Cyphîllyth,auchindoun,957,deathknight,unholy,18,10,8
Тоши,fordragon,957,deathknight,unholy,30,10,20
Smightydk,kazzak,956,deathknight,unholy,18,10,8
Kàrásu,eredar,956,deathknight,unholy,30,10,20
Корольбич,soulflayer,954,deathknight,unholy,24,10,14
Unzul,twisting-nether,953,deathknight,unholy,36,20,16
Джагат,gordunni,953,deathknight,unholy,48,24,24
Nickolass,skullcrusher,953,deathknight,unholy,48,22,26
Sarunâs,antonidas,953,deathknight,unholy,36,10,26
Khoragän,hyjal,948,deathknight,unholy,18,10,8
Ashlëy,kaelthas,948,deathknight,unholy,179,84,95
Neden,blackmoore,946,deathknight,unholy,89,45,44
Fpsrvg,minahonda,946,deathknight,unholy,83,37,46
Ahin,antonidas,940,deathknight,unholy,70,34,36
Aguroh,khaz-modan,937,deathknight,unholy,42,19,23
Etlam,antonidas,936,deathknight,unholy,35,14,21
Хуаролуксс,gordunni,935,deathknight,unholy,236,106,130
Mangemicro,archimonde,931,deathknight,unholy,22,11,11
Fidaii,sylvanas,924,deathknight,unholy,48,22,26
Jess,blackhand,923,deathknight,unholy,79,40,39
Keltòr,antonidas,920,deathknight,unholy,41,15,26
Kisenth,doomhammer,919,deathknight,unholy,72,37,35
Trigárdon,antonidas,914,deathknight,unholy,103,50,53
Marcianorock,dalaran,913,deathknight,unholy,24,10,14
Darkarnø,chants-éternels,904,deathknight,unholy,127,59,68
Квашонка,howling-fjord,898,deathknight,unholy,118,43,75
Hailandher,nemesis,896,deathknight,unholy,47,25,22
Erector,norgannon,895,deathknight,unholy,36,19,17
Rayliegh,silvermoon,891,deathknight,unholy,17,10,7
Deathorchide,pozzo-delleternità,891,deathknight,unholy,56,13,43
Basedzog,silvermoon,889,deathknight,unholy,20,10,10
Лордэнергон,gordunni,888,deathknight,unholy,16,10,6
Randomdkxd,ravencrest,880,deathknight,unholy,25,10,15
Хемелия,azuregos,880,deathknight,unholy,36,10,26
Fearax,terenas,876,deathknight,unholy,22,10,12
Lastdragon,dun-modr,876,deathknight,unholy,60,27,33
Restodrowd,tarren-mill,875,deathknight,unholy,93,44,49
Fabricios,blackrock,864,deathknight,unholy,12,9,3
Gáïà,blackmoore,864,deathknight,unholy,12,9,3
Punctilio,argent-dawn,864,deathknight,unholy,12,9,3
Duriel,stormscale,864,deathknight,unholy,18,9,9
Dakyforfun,ravencrest,864,deathknight,unholy,18,9,9
Terenes,darksorrow,864,deathknight,unholy,30,9,21
Mateusz,lightbringer,863,deathknight,unholy,12,9,3
Dromor,echsenkessel,863,deathknight,unholy,12,9,3
Kyusuke,blackhand,863,deathknight,unholy,18,9,9
Gosuhat,kazzak,863,deathknight,unholy,18,9,9
Toshiroo,draenor,863,deathknight,unholy,18,9,9
Prêstij,stormscale,863,deathknight,unholy,18,9,9
Oxxöw,draenor,863,deathknight,unholy,24,9,15
Dimania,the-maelstrom,863,deathknight,unholy,30,9,21
Vinczergripz,silvermoon,862,deathknight,unholy,12,9,3
Велиций,gordunni,862,deathknight,unholy,18,9,9
Blácklíght,silvermoon,862,deathknight,unholy,24,9,15
Kaeyz,blackmoore,861,deathknight,unholy,30,9,21
Dreamgirl,sylvanas,860,deathknight,unholy,30,14,16
Тзинч,soulflayer,859,deathknight,unholy,18,9,9
Payat,aegwynn,859,deathknight,unholy,18,9,9
Dzahnecro,archimonde,858,deathknight,unholy,18,9,9
Данарион,howling-fjord,858,deathknight,unholy,24,9,15
Pierun,dunemaul,857,deathknight,unholy,18,9,9
Aczheron,argent-dawn,857,deathknight,unholy,18,9,9
Zathy,twisting-nether,857,deathknight,unholy,18,9,9
Падшийрыцарь,gordunni,857,deathknight,unholy,24,9,15
Vielzudícht,blackmoore,856,deathknight,unholy,12,9,3
Riseofpovver,twisting-nether,856,deathknight,unholy,18,9,9
Aliostar,sylvanas,856,deathknight,unholy,20,9,11
Sulf,burning-legion,856,deathknight,unholy,24,9,15
Arâsk,blackmoore,856,deathknight,unholy,24,9,15
Бланки,deathweaver,855,deathknight,unholy,24,9,15
Oldu,haomarush,853,deathknight,unholy,117,56,61
Luxeridon,pozzo-delleternità,851,deathknight,unholy,18,9,9
Hukana,confrérie-du-thorium,850,deathknight,unholy,36,10,26
Zoomieh,bloodfeather,844,deathknight,unholy,18,9,9
Dànté,eitrigg,844,deathknight,unholy,46,22,24
Iscali,kazzak,843,deathknight,unholy,13,9,4
Sidious,auchindoun,826,deathknight,unholy,83,31,52
Volkovitch,archimonde,816,deathknight,unholy,27,9,18
Zot,twisting-nether,814,deathknight,unholy,18,10,8
Arrakìs,nemesis,811,deathknight,unholy,21,10,11
Xenomorphs,kazzak,808,deathknight,unholy,25,10,15
Narancha,haomarush,806,deathknight,unholy,30,10,20
Alielib,eredar,804,deathknight,unholy,82,29,53
Shackles,ravencrest,803,deathknight,unholy,17,9,8
Flúrrý,ravencrest,799,deathknight,unholy,17,9,8
Angalor,argent-dawn,798,deathknight,unholy,17,9,8
Thyrandre,khaz-modan,793,deathknight,unholy,106,41,65
Aldramil,gorgonnash,786,deathknight,unholy,30,12,18
Schiva,eredar,784,deathknight,unholy,28,9,19
Dìscus,nemesis,768,deathknight,unholy,12,8,4
Силдэус,galakrond,768,deathknight,unholy,12,8,4
Спамлюоковы,gordunni,768,deathknight,unholy,18,8,10
Wpízdu,aegwynn,768,deathknight,unholy,18,8,10
Amesz,tarren-mill,768,deathknight,unholy,18,8,10
Plaguecloud,kazzak,768,deathknight,unholy,24,8,16
Bubbledeath,tarren-mill,768,deathknight,unholy,24,8,16
Dreshtarg,draenor,768,deathknight,unholy,24,8,16
Zatrina,blackrock,768,deathknight,unholy,24,8,16
Quazy,draenor,768,deathknight,unholy,30,8,22
Mcbc,silvermoon,767,deathknight,unholy,12,8,4
Híld,hyjal,767,deathknight,unholy,12,8,4
Soulrender,kirin-tor,767,deathknight,unholy,12,8,4
Menstruelle,chants-éternels,767,deathknight,unholy,12,8,4
Valné,argent-dawn,767,deathknight,unholy,15,9,6
Ballum,frostmane,767,deathknight,unholy,72,33,39
Babs,sylvanas,767,deathknight,unholy,18,8,10
Hurubur,ravencrest,767,deathknight,unholy,18,8,10
Mauor,argent-dawn,767,deathknight,unholy,18,8,10
Tenzøjr,archimonde,767,deathknight,unholy,18,8,10
Ироним,gordunni,767,deathknight,unholy,18,8,10
Chains,sanguino,767,deathknight,unholy,18,8,10
Apocalypse,ravencrest,767,deathknight,unholy,18,8,10
Zaxrel,burning-legion,767,deathknight,unholy,21,8,13
Cyliandra,silvermoon,767,deathknight,unholy,27,9,18
Azathöth,elune,767,deathknight,unholy,24,8,16
Yøkai,ysondre,767,deathknight,unholy,42,8,34
Bloodflayer,argent-dawn,766,deathknight,unholy,16,9,7
Zombienatíon,silvermoon,766,deathknight,unholy,24,8,16
Shiryú,ravencrest,765,deathknight,unholy,30,8,22
Xiddy,quelthalas,764,deathknight,unholy,12,8,4
Zanretxd,outland,764,deathknight,unholy,20,8,12
Mjölnir,sanguino,764,deathknight,unholy,24,8,16
Семиран,gordunni,764,deathknight,unholy,30,8,22
Røt,twisting-nether,763,deathknight,unholy,18,8,10
Latindvergur,sylvanas,762,deathknight,unholy,18,8,10
Cødæx,blackrock,762,deathknight,unholy,24,8,16
Unsuspected,kazzak,758,deathknight,unholy,24,8,16
Fortinateur,suramar,757,deathknight,unholy,18,8,10
Arthursq,stormscale,753,deathknight,unholy,403,179,224
Milfgrabber,archimonde,751,deathknight,unholy,23,8,15
Bhishma,blades-edge,749,deathknight,unholy,12,8,4
Ricardiob,argent-dawn,748,deathknight,unholy,16,9,7
Kavour,tarren-mill,735,deathknight,unholy,14,9,5
Hyperflexz,blackrock,714,deathknight,unholy,23,9,14
Eli,dalaran,709,deathknight,unholy,29,8,21
Lulubadgirl,perenolde,704,deathknight,unholy,90,29,61
Vaalur,dalaran,672,deathknight,unholy,12,7,5
Moonpoxdk,nerathor,672,deathknight,unholy,12,7,5
Roundoné,kazzak,672,deathknight,unholy,12,7,5
Cortessá,rexxar,672,deathknight,unholy,12,7,5
Vorrén,tarren-mill,672,deathknight,unholy,12,7,5
Bericks,silvermoon,672,deathknight,unholy,12,7,5
Хухухуху,soulflayer,672,deathknight,unholy,12,7,5
Skylerblack,kazzak,672,deathknight,unholy,18,7,11
Deathfrqst,ysondre,672,deathknight,unholy,18,7,11
Deathstrikee,sylvanas,672,deathknight,unholy,18,7,11
Unholykebab,defias-brotherhood,672,deathknight,unholy,18,7,11
Wttdmg,kazzak,672,deathknight,unholy,18,7,11
Alinee,shadowsong,672,deathknight,unholy,18,7,11
Persês,blackmoore,672,deathknight,unholy,18,7,11
Moccababe,argent-dawn,672,deathknight,unholy,18,7,11
Clérora,argent-dawn,672,deathknight,unholy,18,7,11
Trashboat,outland,672,deathknight,unholy,18,7,11
Adlian,twisting-nether,672,deathknight,unholy,18,7,11
Кобихохо,gordunni,672,deathknight,unholy,18,7,11
Gadres,aegwynn,672,deathknight,unholy,18,7,11
Dextroyersx,sanguino,672,deathknight,unholy,18,7,11
Никнейм,gordunni,672,deathknight,unholy,18,7,11
Spliddy,ravencrest,672,deathknight,unholy,18,7,11
Phrek,outland,672,deathknight,unholy,18,7,11
Soulchaos,ravencrest,672,deathknight,unholy,18,7,11
Deadduchess,argent-dawn,672,deathknight,unholy,18,7,11
Keet,turalyon,672,deathknight,unholy,21,8,13
Elisaron,silvermoon,672,deathknight,unholy,24,7,17
Depleterus,blackrock,672,deathknight,unholy,24,7,17
Madseason,burning-legion,672,deathknight,unholy,30,7,23
Darkéi,outland,671,deathknight,unholy,12,7,5
Absoot,dun-morogh,671,deathknight,unholy,12,7,5
Ardulin,burning-legion,671,deathknight,unholy,12,7,5
Theamine,silvermoon,671,deathknight,unholy,12,7,5
Моргаррок,soulflayer,671,deathknight,unholy,12,7,5
Cmonbruvv,outland,671,deathknight,unholy,12,7,5
Lùrtzz,frostwolf,671,deathknight,unholy,12,7,5
Zariha,malfurion,671,deathknight,unholy,18,7,11
Сурендернау,blackscar,671,deathknight,unholy,18,7,11
Беларам,gordunni,671,deathknight,unholy,18,7,11
Creepzor,tarren-mill,671,deathknight,unholy,18,7,11
Lìlïth,kazzak,671,deathknight,unholy,18,7,11
Badnew,tarren-mill,671,deathknight,unholy,18,7,11
Healrstealr,antonidas,671,deathknight,unholy,18,7,11
Ráisy,outland,671,deathknight,unholy,24,7,17
Uridk,sanguino,670,deathknight,unholy,12,7,5
Думсдэйи,gordunni,670,deathknight,unholy,12,7,5
Amencore,kazzak,670,deathknight,unholy,14,7,7
Kranker,thrall,670,deathknight,unholy,18,7,11
Rubbad,draenor,670,deathknight,unholy,18,7,11
Darkboss,minahonda,670,deathknight,unholy,18,7,11
Deathclapp,twisting-nether,670,deathknight,unholy,18,7,11
Ertzuo,blackrock,670,deathknight,unholy,24,7,17
Furyáns,arathor,670,deathknight,unholy,30,7,23
Tréfoo,blackrock,668,deathknight,unholy,12,7,5
Asux,nazjatar,666,deathknight,unholy,30,7,23
Naerys,ysondre,662,deathknight,unholy,18,7,11
Müldgren,ysondre,658,deathknight,unholy,24,7,17
Alèx,hyjal,640,deathknight,unholy,28,7,21
Redzone,ravencrest,639,deathknight,unholy,23,7,16
Scalina,naxxramas,634,deathknight,unholy,17,7,10
Darkarthâs,ravencrest,624,deathknight,unholy,15,8,7
Haeydez,draenor,623,deathknight,unholy,17,7,10
Дкмонт,deathguard,623,deathknight,unholy,17,7,10
Gigadk,ragnaros,616,deathknight,unholy,19,8,11
Vargass,darksorrow,598,deathknight,unholy,14,7,7
Nirna,argent-dawn,587,deathknight,unholy,45,7,38
Krozzytwo,draenor,576,deathknight,unholy,12,6,6
Scorpiuzx,ravencrest,576,deathknight,unholy,12,6,6
Sfintter,uldum,576,deathknight,unholy,12,6,6
Янатащи,gordunni,576,deathknight,unholy,12,6,6
Doubledead,the-maelstrom,576,deathknight,unholy,12,6,6
Shaturi,antonidas,576,deathknight,unholy,12,6,6
Petergrippin,dragonblight,576,deathknight,unholy,12,6,6
Kurían,burning-legion,576,deathknight,unholy,12,6,6
Nephalêm,thrall,576,deathknight,unholy,12,6,6
Huxleeyys,draenor,576,deathknight,unholy,12,6,6
Tombkeeper,silvermoon,576,deathknight,unholy,12,6,6
Lemain,drakthul,576,deathknight,unholy,12,6,6
Джинтос,howling-fjord,576,deathknight,unholy,12,6,6
Quarkd,archimonde,576,deathknight,unholy,12,6,6
Ketnissq,blackrock,576,deathknight,unholy,12,6,6
Uqrdk,twisting-nether,576,deathknight,unholy,12,6,6
Swordkill,drakthul,576,deathknight,unholy,12,6,6
Nerinth,burning-legion,576,deathknight,unholy,12,6,6
Kane,destromath,576,deathknight,unholy,13,6,7
Critgødx,draenor,576,deathknight,unholy,13,6,7
Exult,twisting-nether,576,deathknight,unholy,18,6,12
Menethill,darkspear,576,deathknight,unholy,18,6,12
Morgianà,argent-dawn,576,deathknight,unholy,18,6,12
Itokawa,tarren-mill,576,deathknight,unholy,18,6,12
Eydren,doomhammer,576,deathknight,unholy,18,6,12
Iseetouch,draenor,576,deathknight,unholy,18,6,12
Sephirus,kazzak,576,deathknight,unholy,18,6,12
Pestikus,thrall,576,deathknight,unholy,18,6,12
Majkântês,drakthul,576,deathknight,unholy,24,6,18
Spaace,tarren-mill,576,deathknight,unholy,24,6,18
Tyranuse,kazzak,576,deathknight,unholy,24,6,18
Helixsdk,outland,576,deathknight,unholy,26,6,20
Dekatos,twisting-nether,575,deathknight,unholy,12,6,6
Kärringandré,silvermoon,575,deathknight,unholy,12,6,6
Ququ,twisting-nether,575,deathknight,unholy,12,6,6
Oldiseas,grim-batol,575,deathknight,unholy,12,6,6
Archdemonio,wildhammer,575,deathknight,unholy,12,6,6
Risakz,ysondre,575,deathknight,unholy,12,6,6
Zegò,silvermoon,575,deathknight,unholy,12,6,6
Асенвел,soulflayer,575,deathknight,unholy,12,6,6
Deathmaiden,outland,575,deathknight,unholy,12,6,6
Mosscraciun,kazzak,575,deathknight,unholy,12,6,6
Havi,thunderhorn,575,deathknight,unholy,12,6,6
Брейвз,gordunni,575,deathknight,unholy,18,6,12
Хлопайпопой,howling-fjord,575,deathknight,unholy,24,6,18
Namfuuh,blackrock,575,deathknight,unholy,24,6,18
Nephenty,der-rat-von-dalaran,574,deathknight,unholy,12,6,6
Thryndiel,ravencrest,574,deathknight,unholy,12,6,6
Ideath,executus,572,deathknight,unholy,12,6,6
Cervanteso,uldum,571,deathknight,unholy,12,6,6
Daquy,blackhand,570,deathknight,unholy,12,6,6
Minitehnicus,stormscale,558,deathknight,unholy,18,6,12
Darkangelina,aggra-português,553,deathknight,unholy,18,6,12
Приаадк,gordunni,543,deathknight,unholy,20,7,13
Darklotus,chamber-of-aspects,543,deathknight,unholy,22,6,16
ßabas,hyjal,542,deathknight,unholy,15,7,8
Каурдак,soulflayer,528,deathknight,unholy,21,6,15
Даркслэш,howling-fjord,522,deathknight,unholy,23,8,15
Náthrakh,argent-dawn,480,deathknight,unholy,6,5,1
Эваердк,gordunni,480,deathknight,unholy,6,5,1
Darthlenin,dentarg,480,deathknight,unholy,6,5,1
Roids,twisting-nether,480,deathknight,unholy,6,5,1
Gripshiftr,kazzak,480,deathknight,unholy,12,5,7
Dktyro,ravencrest,480,deathknight,unholy,12,5,7
Chocobanana,blackhand,480,deathknight,unholy,12,5,7
Kaenor,sporeggar,480,deathknight,unholy,12,5,7
Cbalife,ragnaros,480,deathknight,unholy,12,5,7
Дэспэр,gordunni,480,deathknight,unholy,12,5,7
Sipsip,tarren-mill,480,deathknight,unholy,12,5,7
Galsi,silvermoon,480,deathknight,unholy,12,5,7
Teshel,silvermoon,480,deathknight,unholy,12,5,7
Cipisza,drakthul,480,deathknight,unholy,12,5,7
Zhugzug,ragnaros,480,deathknight,unholy,12,5,7
Urkanis,hyjal,480,deathknight,unholy,12,5,7
Gigacow,outland,480,deathknight,unholy,12,5,7
Bëør,kirin-tor,480,deathknight,unholy,12,5,7
Hyomi,ravencrest,480,deathknight,unholy,12,5,7
Torbille,archimonde,480,deathknight,unholy,12,5,7
Kelebglin,silvermoon,480,deathknight,unholy,12,5,7
Seldrick,silvermoon,480,deathknight,unholy,12,5,7
Миракл,howling-fjord,480,deathknight,unholy,12,5,7
Salzalara,draenor,480,deathknight,unholy,12,5,7
Rêxaks,dun-modr,480,deathknight,unholy,12,5,7
Fenn,dentarg,480,deathknight,unholy,12,5,7
Unholybezerk,darkspear,480,deathknight,unholy,12,5,7
Dêeath,madmortem,480,deathknight,unholy,12,5,7
Christldeath,blackrock,480,deathknight,unholy,12,5,7
Nëcrøzys,archimonde,480,deathknight,unholy,12,5,7
Nietzschean,tarren-mill,480,deathknight,unholy,12,5,7
Blurek,lordaeron,480,deathknight,unholy,12,5,7
Nmedk,grim-batol,480,deathknight,unholy,21,6,15
Xad,blackrock,480,deathknight,unholy,18,5,13
Necroslap,blackhand,480,deathknight,unholy,18,5,13
Bytedk,aggra-português,480,deathknight,unholy,18,5,13
Frostbone,ravencrest,480,deathknight,unholy,18,5,13
Smurm,stormscale,480,deathknight,unholy,18,5,13
Omegasquall,nemesis,479,deathknight,unholy,6,5,1
Rafuki,stormscale,479,deathknight,unholy,12,6,6
Darioo,magtheridon,479,deathknight,unholy,12,5,7
Zilro,kazzak,479,deathknight,unholy,12,5,7
Мордаворот,gordunni,479,deathknight,unholy,12,5,7
Kratas,varimathras,479,deathknight,unholy,13,5,8
Kraken,aerie-peak,479,deathknight,unholy,18,5,13
Jonyo,silvermoon,479,deathknight,unholy,24,5,19
Toderus,forscherliga,477,deathknight,unholy,6,5,1
Droughun,drakthul,477,deathknight,unholy,21,6,15
Uncleadolph,draenor,464,deathknight,unholy,17,6,11
Superpotatoh,silvermoon,463,deathknight,unholy,17,5,12
Boyanmaga,stormscale,447,deathknight,unholy,16,5,11
Shadowgohst,dun-morogh,440,deathknight,unholy,14,6,8
Difestia,silvermoon,429,deathknight,unholy,11,5,6
Zaldraxus,stormscale,415,deathknight,unholy,16,5,11
Альянсобой,deathguard,414,deathknight,unholy,16,5,11
Runeburst,draenor,399,deathknight,unholy,13,5,8
Glacenoir,hyjal,384,deathknight,unholy,6,4,2
Cówboylayla,stormscale,384,deathknight,unholy,6,4,2
Budgetarthas,arthas,384,deathknight,unholy,6,4,2
Yggrauthr,argent-dawn,384,deathknight,unholy,6,4,2
Buldog,laughing-skull,384,deathknight,unholy,6,4,2
Redduck,silvermoon,384,deathknight,unholy,6,4,2
Kalhyst,archimonde,384,deathknight,unholy,6,4,2
Mängo,onyxia,384,deathknight,unholy,6,4,2
Радиосмерти,gordunni,384,deathknight,unholy,6,4,2
Zyôs,blackmoore,384,deathknight,unholy,6,4,2
Zhagroc,draenor,384,deathknight,unholy,6,4,2
Runeblade,shattered-hand,384,deathknight,unholy,6,4,2
Shlongripper,silvermoon,384,deathknight,unholy,6,4,2
Vendes,outland,384,deathknight,unholy,6,4,2
Tigros,burning-legion,384,deathknight,unholy,6,4,2
Тунелин,howling-fjord,384,deathknight,unholy,6,4,2
Velindara,argent-dawn,384,deathknight,unholy,6,4,2
Dragamanca,shendralar,384,deathknight,unholy,6,4,2
Kãzan,archimonde,384,deathknight,unholy,6,4,2
Cyrean,ravencrest,384,deathknight,unholy,6,4,2
Copium,hyjal,384,deathknight,unholy,6,4,2
Lichkunt,stormscale,384,deathknight,unholy,6,4,2
Haximusprime,kazzak,384,deathknight,unholy,6,4,2
Necrotopx,aegwynn,384,deathknight,unholy,6,4,2
Neph,sanguino,384,deathknight,unholy,6,4,2
Helmich,frostmane,384,deathknight,unholy,6,4,2
Ruppix,stormscale,384,deathknight,unholy,6,4,2
Yerssinia,sylvanas,384,deathknight,unholy,6,4,2
Söckli,mugthol,384,deathknight,unholy,6,4,2
Viseria,wrathbringer,384,deathknight,unholy,6,4,2
Notded,ragnaros,384,deathknight,unholy,8,4,4
Глээм,howling-fjord,384,deathknight,unholy,12,4,8
Filmsyz,ravencrest,384,deathknight,unholy,12,4,8
Skypowerxx,darkspear,384,deathknight,unholy,12,4,8
Taylorswifts,tarren-mill,384,deathknight,unholy,12,4,8
Kjötbiti,tarren-mill,384,deathknight,unholy,12,4,8
Лордтемар,howling-fjord,384,deathknight,unholy,12,4,8
Fait,blackrock,384,deathknight,unholy,12,4,8
Binknight,argent-dawn,384,deathknight,unholy,12,4,8
Szayestra,draenor,384,deathknight,unholy,12,4,8
Rouskkoff,hyjal,384,deathknight,unholy,12,4,8
Dëmise,ravencrest,384,deathknight,unholy,12,4,8
Trashdk,blackrock,384,deathknight,unholy,12,4,8
Razdig,dun-modr,384,deathknight,unholy,12,4,8
Raspad,tarren-mill,384,deathknight,unholy,12,4,8
Tixoz,archimonde,384,deathknight,unholy,12,4,8
Колхозник,howling-fjord,384,deathknight,unholy,12,4,8
Intrigo,blackmoore,384,deathknight,unholy,12,4,8
Sovietonions,marécage-de-zangar,384,deathknight,unholy,12,4,8
Servein,stormscale,384,deathknight,unholy,12,4,8
Sekkah,tarren-mill,384,deathknight,unholy,12,4,8
Bayur,antonidas,384,deathknight,unholy,12,4,8
Fatuglyrat,kazzak,384,deathknight,unholy,12,4,8
Sawada,terokkar,384,deathknight,unholy,12,4,8
Äbäddon,twisting-nether,384,deathknight,unholy,12,4,8
Morgued,ravencrest,384,deathknight,unholy,12,4,8
Mustapha,kazzak,384,deathknight,unholy,12,4,8
Dreadmind,blackrock,384,deathknight,unholy,12,4,8
Пикачухха,soulflayer,384,deathknight,unholy,12,4,8
Rædbull,ravencrest,384,deathknight,unholy,16,5,11
Jugglez,thrall,384,deathknight,unholy,17,4,13
Spratz,kazzak,384,deathknight,unholy,17,4,13
Brurf,ysondre,384,deathknight,unholy,18,4,14
Geilespferd,blackhand,384,deathknight,unholy,18,4,14
Hoggster,kazzak,384,deathknight,unholy,18,4,14
Blòópy,silvermoon,384,deathknight,unholy,18,4,14
Pottifar,tarren-mill,384,deathknight,unholy,18,4,14
Pändörä,uldum,384,deathknight,unholy,18,4,14
ßambøøzle,draenor,384,deathknight,unholy,25,5,20
Bargane,twilights-hammer,383,deathknight,unholy,6,4,2
Zoombie,draenor,383,deathknight,unholy,6,4,2
Unhory,argent-dawn,383,deathknight,unholy,9,5,4
Flippmo,argent-dawn,383,deathknight,unholy,9,5,4
Украшение,galakrond,383,deathknight,unholy,12,4,8
Karatedomi,blackmoore,383,deathknight,unholy,12,4,8
Эъя,howling-fjord,383,deathknight,unholy,12,4,8
Хворной,howling-fjord,383,deathknight,unholy,12,4,8
Antrinian,turalyon,383,deathknight,unholy,12,4,8
Andreaxx,drakthul,382,deathknight,unholy,6,4,2
Spunka,azjolnerub,381,deathknight,unholy,18,4,14
Àragørn,blackrock,379,deathknight,unholy,12,4,8
Варрлнишнс,soulflayer,367,deathknight,unholy,11,4,7
Millknight,norgannon,341,deathknight,unholy,15,6,9
Izagolt,dun-modr,336,deathknight,unholy,9,4,5
Fooji,stormscale,330,deathknight,unholy,19,5,14
Shining,blackrock,330,deathknight,unholy,25,6,19
Mercedees,blackhand,319,deathknight,unholy,8,4,4
Makisnk,archimonde,319,deathknight,unholy,8,4,4
Ikarack,twisting-nether,319,deathknight,unholy,8,4,4
Melleril,sylvanas,319,deathknight,unholy,14,4,10
Saryn,burning-steppes,304,deathknight,unholy,13,4,9
Darkeolos,twisting-nether,303,deathknight,unholy,7,4,3
Amentet,anetheron,288,deathknight,unholy,10,5,5
Blaspherian,stormscale,288,deathknight,unholy,6,3,3
Iceludwig,nemesis,288,deathknight,unholy,6,3,3
Ironák,malganis,288,deathknight,unholy,6,3,3
Soseiuchi,sargeras,288,deathknight,unholy,6,3,3
Argelthal,draenor,288,deathknight,unholy,6,3,3
Míscodé,twisting-nether,288,deathknight,unholy,6,3,3
Payd,blackhand,288,deathknight,unholy,6,3,3
Jénga,ghostlands,288,deathknight,unholy,6,3,3
Loorda,kazzak,288,deathknight,unholy,6,3,3
Израф,soulflayer,288,deathknight,unholy,6,3,3
Joyt,argent-dawn,288,deathknight,unholy,6,3,3
Deucalyqt,nemesis,288,deathknight,unholy,6,3,3
Ahzee,alleria,288,deathknight,unholy,6,3,3
Небишоп,howling-fjord,288,deathknight,unholy,6,3,3
Карвалан,eversong,288,deathknight,unholy,6,3,3
Seldreas,silvermoon,288,deathknight,unholy,6,3,3
Krookidk,archimonde,288,deathknight,unholy,6,3,3
Legixd,outland,288,deathknight,unholy,6,3,3
Luñatic,sylvanas,288,deathknight,unholy,6,3,3
Soloqueuedk,ravencrest,288,deathknight,unholy,6,3,3
Bigbaboon,stormreaver,288,deathknight,unholy,6,3,3
Løz,kazzak,288,deathknight,unholy,6,3,3
Hasbullagødx,blackrock,288,deathknight,unholy,6,3,3
Grabbinass,silvermoon,288,deathknight,unholy,6,3,3
Rävjakt,twisting-nether,288,deathknight,unholy,6,3,3
Deãth,archimonde,288,deathknight,unholy,6,3,3
Gbdk,xavius,288,deathknight,unholy,6,3,3
Kalenis,nemesis,288,deathknight,unholy,6,3,3
Zfeuda,azshara,288,deathknight,unholy,6,3,3
Nydräe,archimonde,288,deathknight,unholy,6,3,3
Budd,stormscale,288,deathknight,unholy,6,3,3
Darkrolexx,blackhand,288,deathknight,unholy,6,3,3
Hurz,archimonde,288,deathknight,unholy,6,3,3
Minidkshow,ravencrest,288,deathknight,unholy,6,3,3
Frezer,madmortem,288,deathknight,unholy,6,3,3
Mozir,thrall,288,deathknight,unholy,6,3,3
Badock,eredar,288,deathknight,unholy,6,3,3
Hugerr,azshara,288,deathknight,unholy,6,3,3
Horrorda,defias-brotherhood,288,deathknight,unholy,6,3,3
Oldmerle,blackmoore,288,deathknight,unholy,6,3,3
Azslan,skullcrusher,288,deathknight,unholy,6,3,3
Vip,argent-dawn,288,deathknight,unholy,6,3,3
Laz,shadowsong,288,deathknight,unholy,6,3,3
Galgalí,blackmoore,288,deathknight,unholy,6,3,3
Masakryczny,burning-legion,288,deathknight,unholy,6,3,3
Zêlëph,archimonde,288,deathknight,unholy,6,3,3
Ватачка,gordunni,288,deathknight,unholy,6,3,3
Shadies,drakthul,288,deathknight,unholy,6,3,3
Рончикк,gordunni,288,deathknight,unholy,6,3,3
Пашина,gordunni,288,deathknight,unholy,6,3,3
Tabano,onyxia,288,deathknight,unholy,6,3,3
Rilcaz,draenor,288,deathknight,unholy,6,3,3
Куррой,soulflayer,288,deathknight,unholy,6,3,3
Бьюрабов,gordunni,288,deathknight,unholy,6,3,3
Fõ,outland,288,deathknight,unholy,6,3,3
Bubblerumm,eonar,288,deathknight,unholy,6,3,3
Küseng,frostwolf,288,deathknight,unholy,6,3,3
Çhïñêséðk,defias-brotherhood,288,deathknight,unholy,6,3,3
Êyé,blackmoore,288,deathknight,unholy,6,3,3
Fredriksend,argent-dawn,288,deathknight,unholy,6,3,3
Mocca,aegwynn,288,deathknight,unholy,6,3,3
Grippyb,tarren-mill,288,deathknight,unholy,6,3,3
Sonervous,hyjal,288,deathknight,unholy,6,3,3
Anotherdkx,ravencrest,288,deathknight,unholy,6,3,3
Hêñtåìfänx,hyjal,288,deathknight,unholy,6,3,3
Chillfyre,argent-dawn,288,deathknight,unholy,8,3,5
Re,stormrage,288,deathknight,unholy,12,3,9
Drraugrinn,tarren-mill,288,deathknight,unholy,12,3,9
Sélyne,ysondre,288,deathknight,unholy,12,3,9
Mizrael,burning-blade,288,deathknight,unholy,12,3,9
Infamousmobb,archimonde,288,deathknight,unholy,12,3,9
Seay,malorne,288,deathknight,unholy,12,3,9
Oxcidium,archimonde,288,deathknight,unholy,12,3,9
Nooxi,sanguino,288,deathknight,unholy,12,3,9
Dagë,twisting-nether,288,deathknight,unholy,12,3,9
Lewro,drakthul,288,deathknight,unholy,12,3,9
Kptayn,culte-de-la-rive-noire,288,deathknight,unholy,12,3,9
Акерисса,gordunni,288,deathknight,unholy,12,3,9
Plaguebones,ravencrest,288,deathknight,unholy,12,3,9
Lair,shendralar,288,deathknight,unholy,12,3,9
Эвессом,goldrinn,288,deathknight,unholy,12,3,9
Морталес,azuregos,288,deathknight,unholy,12,3,9
Zixcommixx,hyjal,288,deathknight,unholy,12,3,9
Нитраль,deepholm,288,deathknight,unholy,12,3,9
Cryoknight,doomhammer,288,deathknight,unholy,12,3,9
Worldwiynd,ravencrest,288,deathknight,unholy,12,3,9
Whiskine,aggramar,288,deathknight,unholy,12,3,9
Ste,tarren-mill,288,deathknight,unholy,12,3,9
Gongroosh,blackrock,288,deathknight,unholy,12,3,9
Shinetop,silvermoon,288,deathknight,unholy,12,3,9
Úñçháíñéd,kazzak,288,deathknight,unholy,12,3,9
Benetleilax,bronzebeard,288,deathknight,unholy,12,3,9
Ecatholicus,silvermoon,288,deathknight,unholy,12,3,9
Letudra,outland,288,deathknight,unholy,12,3,9
Alakiah,khaz-modan,288,deathknight,unholy,12,3,9
Hexenköníg,frostmourne,288,deathknight,unholy,12,3,9
Ротвхалве,deathweaver,288,deathknight,unholy,18,3,15
Roobeert,defias-brotherhood,288,deathknight,unholy,18,3,15
Валериум,howling-fjord,288,deathknight,unholy,18,3,15
Zandul,terenas,287,deathknight,unholy,6,3,3
Grumthor,ambossar,287,deathknight,unholy,6,3,3
Badameco,twisting-nether,287,deathknight,unholy,6,3,3
Регроуз,ashenvale,287,deathknight,unholy,6,3,3
Spiritomb,eonar,287,deathknight,unholy,6,3,3
Каскадёрка,howling-fjord,287,deathknight,unholy,12,3,9
Mámmôn,malygos,287,deathknight,unholy,13,3,10
Xyasw,rashgarroth,286,deathknight,unholy,12,3,9
Abyad,dalaran,285,deathknight,unholy,12,3,9
Bestiaccia,nemesis,284,deathknight,unholy,12,3,9
Отвян,gordunni,256,deathknight,unholy,10,3,7
Ghary,blackhand,256,deathknight,unholy,10,3,7
Hateem,sylvanas,255,deathknight,unholy,11,3,8
Miruvar,tarren-mill,240,deathknight,unholy,9,3,6
Gogeta,zirkel-des-cenarius,239,deathknight,unholy,5,3,2
Dkreator,stormscale,234,deathknight,unholy,6,4,2
Charai,blackhand,234,deathknight,unholy,14,4,10
Xerone,turalyon,223,deathknight,unholy,8,3,5
Vîrus,kazzak,208,deathknight,unholy,13,3,10
Zeldêrx,tarren-mill,192,deathknight,unholy,4,3,1
Nexium,outland,192,deathknight,unholy,4,3,1
Shamytron,frostwolf,192,deathknight,unholy,6,3,3
Varogo,drakthul,192,deathknight,unholy,6,2,4
Frøzendeadz,blackhand,192,deathknight,unholy,6,2,4
Màzii,burning-legion,192,deathknight,unholy,6,2,4
Kacpèr,burning-legion,192,deathknight,unholy,6,2,4
Draghonis,argent-dawn,192,deathknight,unholy,6,2,4
Kyppz,gorgonnash,192,deathknight,unholy,6,2,4
Bladertz,tarren-mill,192,deathknight,unholy,6,2,4
Kromas,silvermoon,192,deathknight,unholy,6,2,4
Hasoyro,burning-legion,192,deathknight,unholy,6,2,4
Karnatron,draenor,192,deathknight,unholy,6,2,4
Гнилец,soulflayer,192,deathknight,unholy,6,2,4
Sjöstedt,twisting-nether,192,deathknight,unholy,6,2,4
Kaysto,blackrock,192,deathknight,unholy,6,2,4
Urukaye,silvermoon,192,deathknight,unholy,6,2,4
Bestkhalifä,ravencrest,192,deathknight,unholy,6,2,4
Suksiboksi,shattered-hand,192,deathknight,unholy,6,2,4
Ironded,pozzo-delleternità,192,deathknight,unholy,6,2,4
Jizzburga,blackhand,192,deathknight,unholy,6,2,4
Mcdreamy,grim-batol,192,deathknight,unholy,6,2,4
Nokti,ravencrest,192,deathknight,unholy,6,2,4
Seleniele,draenor,192,deathknight,unholy,6,2,4
Униорк,howling-fjord,192,deathknight,unholy,6,2,4
Fdkgotbuffed,tarren-mill,192,deathknight,unholy,6,2,4
Feldøøm,nemesis,192,deathknight,unholy,6,2,4
Firebladesa,ravencrest,192,deathknight,unholy,6,2,4
Brávéhéart,silvermoon,192,deathknight,unholy,6,2,4
Cursed,guldan,192,deathknight,unholy,6,2,4
Penumbris,silvermoon,192,deathknight,unholy,6,2,4
Xvlane,silvermoon,192,deathknight,unholy,6,2,4
Bårêlýgød,blackmoore,192,deathknight,unholy,6,2,4
Iziqroi,archimonde,192,deathknight,unholy,6,2,4
Homelándér,blackmoore,192,deathknight,unholy,6,2,4
Postura,kazzak,192,deathknight,unholy,6,2,4
Unholyysteel,silvermoon,192,deathknight,unholy,6,2,4
Szendeffy,ragnaros,192,deathknight,unholy,6,2,4
Kebbo,argent-dawn,192,deathknight,unholy,6,2,4
Имбазомбарь,howling-fjord,192,deathknight,unholy,6,2,4
Gustavofring,stormscale,192,deathknight,unholy,6,2,4
Woltorme,archimonde,192,deathknight,unholy,6,2,4
Акимур,gordunni,192,deathknight,unholy,6,2,4
Ozmak,draenor,192,deathknight,unholy,6,2,4
Pandagodx,archimonde,192,deathknight,unholy,6,2,4
Mangalitsa,twisting-nether,192,deathknight,unholy,6,2,4
Necrosiss,sunstrider,192,deathknight,unholy,6,2,4
Савамура,gordunni,192,deathknight,unholy,6,2,4
Буризан,blackscar,192,deathknight,unholy,6,2,4
Сидлэй,gordunni,192,deathknight,unholy,6,2,4
Ивитил,gordunni,192,deathknight,unholy,6,2,4
Dk,earthen-ring,192,deathknight,unholy,6,2,4
Nihilistyx,blackrock,192,deathknight,unholy,6,2,4
Lithics,blades-edge,192,deathknight,unholy,6,2,4
Kapitandk,sanguino,192,deathknight,unholy,6,2,4
Tinyfever,kazzak,192,deathknight,unholy,6,2,4
Горосов,gordunni,192,deathknight,unholy,6,2,4
Highblood,tarren-mill,192,deathknight,unholy,6,2,4
Lén,malygos,192,deathknight,unholy,6,2,4
Tirno,dun-modr,192,deathknight,unholy,6,2,4
Yoinkw,tarren-mill,192,deathknight,unholy,6,2,4
Yaxa,sylvanas,192,deathknight,unholy,6,2,4
Clipe,sanguino,192,deathknight,unholy,6,2,4
Engelinä,ysondre,192,deathknight,unholy,6,2,4
Norux,alonsus,192,deathknight,unholy,6,2,4
Xartukî,dun-modr,192,deathknight,unholy,6,2,4
Аэрит,howling-fjord,192,deathknight,unholy,6,2,4
Dilbil,tarren-mill,192,deathknight,unholy,6,2,4
Eigrin,argent-dawn,192,deathknight,unholy,6,2,4
Njor,twisting-nether,192,deathknight,unholy,6,2,4
Deathdayben,kazzak,192,deathknight,unholy,12,2,10
Холбункойл,gordunni,192,deathknight,unholy,12,2,10
Lumerix,drakthul,192,deathknight,unholy,12,2,10
Скромасакс,gordunni,192,deathknight,unholy,12,2,10
Victura,outland,192,deathknight,unholy,12,2,10
Azrail,alonsus,192,deathknight,unholy,12,2,10
Foíegras,stormscale,192,deathknight,unholy,12,2,10
Goldins,doomhammer,192,deathknight,unholy,12,2,10
Arthaslegend,magtheridon,192,deathknight,unholy,12,2,10
Niilø,antonidas,192,deathknight,unholy,12,2,10
Snøsamannen,ravencrest,192,deathknight,unholy,12,2,10
Carnificis,nefarian,192,deathknight,unholy,12,2,10
Гадиния,soulflayer,191,deathknight,unholy,4,3,1
Tygootjuh,nagrand,191,deathknight,unholy,6,2,4
Sangreloco,voljin,191,deathknight,unholy,6,2,4
Whitedead,destromath,191,deathknight,unholy,7,2,5
Strigoih,argent-dawn,190,deathknight,unholy,12,2,10
Gaisham,confrérie-du-thorium,190,deathknight,unholy,12,2,10
Ândi,alleria,190,deathknight,unholy,12,2,10
Xolaani,outland,159,deathknight,unholy,5,2,3
Gathec,kazzak,159,deathknight,unholy,5,2,3
Feätures,ragnaros,159,deathknight,unholy,5,2,3
Dødsmanna,twisting-nether,144,deathknight,unholy,9,2,7
Дралкс,gordunni,138,deathknight,unholy,10,3,7
Sämäël,outland,137,deathknight,unholy,8,3,5
Arthasson,ravencrest,137,deathknight,unholy,11,4,7
Auto,hyjal,128,deathknight,unholy,4,2,2
Árnèr,tyrande,96,deathknight,unholy,3,2,1
Justaniceguy,silvermoon,96,deathknight,unholy,3,2,1
Drfatnuts,kazzak,96,deathknight,unholy,6,1,5
Grimgôr,kazzak,96,deathknight,unholy,6,1,5
Melicia,anubarak,96,deathknight,unholy,6,1,5
Saurøn,chogall,96,deathknight,unholy,6,1,5
Искрос,gordunni,96,deathknight,unholy,6,1,5
Bobboswag,kazzak,96,deathknight,unholy,6,1,5
Scourgebane,kazzak,96,deathknight,unholy,6,1,5
Sìrmooalot,twisting-nether,96,deathknight,unholy,6,1,5
Инфлюминс,soulflayer,96,deathknight,unholy,6,1,5
Oghul,blackmoore,96,deathknight,unholy,6,1,5
Йоггсерун,gordunni,96,deathknight,unholy,6,1,5
Ôcb,marécage-de-zangar,96,deathknight,unholy,6,1,5
Deekee,kazzak,96,deathknight,unholy,6,1,5
Apokalipx,ragnaros,96,deathknight,unholy,6,1,5
Гроскот,howling-fjord,96,deathknight,unholy,6,1,5
Хеллхэйм,soulflayer,96,deathknight,unholy,6,1,5
Natanio,area-52,96,deathknight,unholy,6,1,5
Erbores,destromath,96,deathknight,unholy,6,1,5
Кернесса,blackscar,96,deathknight,unholy,6,1,5
Диманекротик,blackscar,96,deathknight,unholy,6,1,5
Orrengo,blackrock,96,deathknight,unholy,6,1,5
Гачимучий,soulflayer,96,deathknight,unholy,6,1,5
Glacuis,suramar,96,deathknight,unholy,6,1,5
Lieven,tarren-mill,96,deathknight,unholy,6,1,5
Ohris,silvermoon,96,deathknight,unholy,6,1,5
Skrati,das-syndikat,96,deathknight,unholy,6,1,5
Fefefasza,ragnaros,96,deathknight,unholy,6,1,5
Коилкоилкоил,blackscar,96,deathknight,unholy,6,1,5
Blackpeper,silvermoon,96,deathknight,unholy,6,1,5
Chøsen,sargeras,96,deathknight,unholy,6,1,5
Beliall,draenor,96,deathknight,unholy,6,1,5
Dumbclass,wildhammer,96,deathknight,unholy,6,1,5
Antexdk,drakthul,96,deathknight,unholy,6,1,5
Vlaakith,thunderhorn,96,deathknight,unholy,6,1,5
Ashgen,ravencrest,96,deathknight,unholy,6,1,5
Wavemaker,kazzak,96,deathknight,unholy,6,1,5
Axemastery,draenor,96,deathknight,unholy,6,1,5
Rongos,norgannon,96,deathknight,unholy,6,1,5
Tributus,perenolde,96,deathknight,unholy,6,1,5
Cowsoup,stormscale,96,deathknight,unholy,6,1,5
Eívór,garrosh,96,deathknight,unholy,6,1,5
Rakeschnake,teldrassil,96,deathknight,unholy,6,1,5
Ballie,tarren-mill,96,deathknight,unholy,6,1,5
Brotén,grim-batol,96,deathknight,unholy,6,1,5
Traurigstor,blackrock,96,deathknight,unholy,6,1,5
Plazu,draenor,96,deathknight,unholy,6,1,5
Nyzak,stormscale,96,deathknight,unholy,6,1,5
Arthasuk,dun-modr,96,deathknight,unholy,6,1,5
Gdubet,kazzak,96,deathknight,unholy,6,1,5
Dextèr,stormreaver,96,deathknight,unholy,6,1,5
Муунрок,howling-fjord,96,deathknight,unholy,6,1,5
Ravages,durotan,96,deathknight,unholy,6,1,5
Tsoupunisher,ravencrest,96,deathknight,unholy,6,1,5
Джеттар,howling-fjord,96,deathknight,unholy,6,1,5
Unholygunnds,ravencrest,96,deathknight,unholy,6,1,5
Twistednut,argent-dawn,96,deathknight,unholy,6,1,5
Cameltôe,frostwolf,96,deathknight,unholy,6,1,5
Yagashi,stormscale,96,deathknight,unholy,6,1,5
Seuchensturz,zirkel-des-cenarius,96,deathknight,unholy,6,1,5
Darkcøbra,culte-de-la-rive-noire,96,deathknight,unholy,6,1,5
Hemki,archimonde,96,deathknight,unholy,6,1,5
Itrailblazer,turalyon,96,deathknight,unholy,6,1,5
Lionello,stormscale,96,deathknight,unholy,6,1,5
Veleran,blackrock,96,deathknight,unholy,6,1,5
Såphirå,doomhammer,96,deathknight,unholy,6,1,5
Verssatus,archimonde,96,deathknight,unholy,6,1,5
Abusedk,archimonde,96,deathknight,unholy,6,1,5
Êroô,azjolnerub,96,deathknight,unholy,6,1,5
Madsgrip,tarren-mill,96,deathknight,unholy,6,1,5
Имерсий,gordunni,96,deathknight,unholy,6,1,5
Routasydän,outland,96,deathknight,unholy,6,1,5
Buzknight,twisting-nether,96,deathknight,unholy,12,1,11
Gosting,kirin-tor,96,deathknight,unholy,12,1,11
Brasith,outland,96,deathknight,unholy,12,1,11
Hathriel,blackmoore,96,deathknight,unholy,12,1,11
Gärrøsh,cthun,96,deathknight,unholy,12,1,11
Erezar,burning-legion,96,deathknight,unholy,12,1,11
Rhmoseli,twisting-nether,96,deathknight,unholy,12,1,11
Kauno,drakthul,96,deathknight,unholy,12,1,11
Peiie,ravencrest,96,deathknight,unholy,12,1,11
Cynthiia,sylvanas,96,deathknight,unholy,18,1,17
Gangman,kazzak,95,deathknight,unholy,9,3,6
Bäverpung,ragnaros,95,deathknight,unholy,6,1,5
Beurkbeurk,la-croisade-écarlate,95,deathknight,unholy,15,1,14
Bonthejovi,tarren-mill,79,deathknight,unholy,5,1,4
Шалелая,soulflayer,79,deathknight,unholy,5,1,4
Tørbåk,ysondre,79,deathknight,unholy,5,1,4
Custardo,grim-batol,63,deathknight,unholy,8,2,6
Kevsdk,arthas,48,deathknight,unholy,3,1,2
Talithakum,burning-legion,31,deathknight,unholy,2,1,1
Врейтфул,ashenvale,31,deathknight,unholy,2,1,1
Errøar,aegwynn,31,deathknight,unholy,2,1,1
Intrih,arathor,16,deathknight,unholy,7,1,6
Nellion,kazzak,2146,deathknight,frost,102,50,52
Skylerblack,kazzak,2139,deathknight,frost,113,72,41
Имерсий,gordunni,2104,deathknight,frost,72,43,29
Fdkgotbuffed,tarren-mill,2072,deathknight,frost,90,45,45
Leónid,kazzak,2071,deathknight,frost,75,38,37
Никнейм,gordunni,2066,deathknight,frost,239,121,118
Garrinchá,stormscale,2053,deathknight,frost,66,39,27
Anotherdkx,ravencrest,2002,deathknight,frost,66,39,27
Igetmount,draenor,2001,deathknight,frost,191,99,92
Arrestedx,aegwynn,1975,deathknight,frost,81,43,38
Diogenisis,arthas,1973,deathknight,frost,183,92,91
Viuff,kazzak,1932,deathknight,frost,48,25,23
Малтель,howling-fjord,1900,deathknight,frost,66,33,33
Murbastic,draenor,1897,deathknight,frost,344,171,173
Justaniceguy,silvermoon,1895,deathknight,frost,90,50,40
Даркслэш,howling-fjord,1859,deathknight,frost,75,42,33
Køley,draenor,1854,deathknight,frost,48,29,19
Bedstemoor,ravencrest,1849,deathknight,frost,47,28,19
Jeanice,blackhand,1848,deathknight,frost,133,68,65
Frostlux,archimonde,1837,deathknight,frost,799,397,402
Ayro,aegwynn,1824,deathknight,frost,112,60,52
Шадоудез,gordunni,1820,deathknight,frost,60,29,31
Zektal,thrall,1819,deathknight,frost,138,70,68
Moreau,eredar,1818,deathknight,frost,235,123,112
Maxto,outland,1812,deathknight,frost,54,32,22
Mellion,ragnaros,1811,deathknight,frost,35,23,12
Bíllÿ,kazzak,1811,deathknight,frost,71,32,39
Narali,argent-dawn,1811,deathknight,frost,78,34,44
Эриданс,gordunni,1806,deathknight,frost,48,32,16
Dktroll,blackmoore,1806,deathknight,frost,235,123,112
Vidofnir,argent-dawn,1804,deathknight,frost,128,74,54
Картафилиус,soulflayer,1804,deathknight,frost,66,28,38
Zdi,tarren-mill,1787,deathknight,frost,82,42,40
Verssatus,archimonde,1775,deathknight,frost,96,45,51
Drkok,blackmoore,1771,deathknight,frost,137,80,57
Leonis,arthas,1771,deathknight,frost,83,45,38
Lylíth,archimonde,1762,deathknight,frost,105,66,39
Ronsôn,terrordar,1756,deathknight,frost,36,21,15
Nèrfx,ragnaros,1755,deathknight,frost,48,26,22
Geunieve,ysondre,1745,deathknight,frost,130,58,72
Джонаджеймсн,soulflayer,1739,deathknight,frost,122,60,62
Oßitø,ravencrest,1738,deathknight,frost,70,39,31
Likewise,twisting-nether,1730,deathknight,frost,42,23,19
Mkom,ravencrest,1728,deathknight,frost,84,44,40
Re,stormrage,1718,deathknight,frost,54,28,26
Sonnedeath,tarren-mill,1718,deathknight,frost,100,50,50
Murky,kazzak,1712,deathknight,frost,143,74,69
Brawlerbabe,stormscale,1707,deathknight,frost,238,120,118
Kisyhrâ,aegwynn,1703,deathknight,frost,64,35,29
Synthwave,tarren-mill,1697,deathknight,frost,30,18,12
Zulthos,argent-dawn,1694,deathknight,frost,132,77,55
Nîghtmáre,ravencrest,1687,deathknight,frost,224,111,113
Aceléss,drakthul,1684,deathknight,frost,42,24,18
Frege,tarren-mill,1684,deathknight,frost,42,23,19
Duriel,stormscale,1681,deathknight,frost,276,142,134
Selena,blackmoore,1679,deathknight,frost,60,32,28
Furleyc,argent-dawn,1678,deathknight,frost,107,66,41
Erbugul,uldum,1670,deathknight,frost,251,128,123
Indrette,archimonde,1667,deathknight,frost,40,20,20
Mikagoddess,argent-dawn,1664,deathknight,frost,136,68,68
Arxelas,stormscale,1663,deathknight,frost,80,50,30
Veneera,emeriss,1662,deathknight,frost,30,20,10
Eynoway,blackmoore,1662,deathknight,frost,36,20,16
Rêxaks,dun-modr,1662,deathknight,frost,66,31,35
Frostymel,ravencrest,1654,deathknight,frost,168,86,82
Импостик,blackscar,1654,deathknight,frost,60,27,33
Leyc,argent-dawn,1646,deathknight,frost,86,47,39
Banishabomb,ragnaros,1643,deathknight,frost,90,46,44
Maryø,drakthul,1641,deathknight,frost,77,39,38
Neitoperho,frostmane,1641,deathknight,frost,63,28,35
Arxelas,sylvanas,1637,deathknight,frost,196,103,93
Энвилион,howling-fjord,1634,deathknight,frost,120,66,54
Neorteriona,argent-dawn,1632,deathknight,frost,239,129,110
Ниффер,deathguard,1627,deathknight,frost,34,18,16
Dktyro,ravencrest,1626,deathknight,frost,60,35,25
Xolaani,outland,1619,deathknight,frost,114,53,61
Frace,tyrande,1619,deathknight,frost,84,38,46
Frostfoxx,archimonde,1617,deathknight,frost,156,83,73
Кулькулегал,ashenvale,1617,deathknight,frost,84,44,40
Oldmerle,blackmoore,1617,deathknight,frost,45,23,22
Ärkhas,ragnaros,1616,deathknight,frost,53,29,24
Cyliandra,silvermoon,1615,deathknight,frost,48,27,21
Silvergreed,kazzak,1615,deathknight,frost,64,34,30
Frostzanlar,archimonde,1613,deathknight,frost,44,23,21
Дарргг,ashenvale,1612,deathknight,frost,167,79,88
Dakyforfun,ravencrest,1611,deathknight,frost,30,20,10
Raylenx,uldaman,1609,deathknight,frost,75,39,36
Fallenjaina,kazzak,1608,deathknight,frost,290,149,141
Apocallyptic,auchindoun,1606,deathknight,frost,121,71,50
Gorobijec,drakthul,1604,deathknight,frost,238,116,122
Chakko,ravencrest,1601,deathknight,frost,141,69,72
Espatula,ravencrest,1597,deathknight,frost,66,31,35
Винкис,gordunni,1594,deathknight,frost,194,103,91
Клиссанг,razuvious,1594,deathknight,frost,42,22,20
Decayz,thrall,1593,deathknight,frost,58,30,28
Rektsohard,ravencrest,1590,deathknight,frost,75,44,31
Deucàlyqt,nemesis,1589,deathknight,frost,64,28,36
Worlviuz,argent-dawn,1584,deathknight,frost,60,29,31
Dexterlul,blackmoore,1579,deathknight,frost,60,28,32
Спамлюоковы,gordunni,1577,deathknight,frost,29,18,11
Obliterate,frostmourne,1576,deathknight,frost,152,82,70
Nazgül,drakthul,1572,deathknight,frost,71,40,31
Diatriss,argent-dawn,1572,deathknight,frost,139,78,61
Tørbåk,ysondre,1572,deathknight,frost,48,21,27
Wuurzaag,twisting-nether,1571,deathknight,frost,42,21,21
Руянгрубиян,howling-fjord,1568,deathknight,frost,64,28,36
Анзорини,gordunni,1566,deathknight,frost,42,23,19
Kooklynn,aggra-português,1562,deathknight,frost,95,53,42
Halez,antonidas,1558,deathknight,frost,84,50,34
Deathvarg,argent-dawn,1558,deathknight,frost,90,41,49
Festerblight,grim-batol,1556,deathknight,frost,36,22,14
Jumbogrip,tarren-mill,1554,deathknight,frost,88,49,39
Vainie,argent-dawn,1549,deathknight,frost,63,40,23
Sipsip,tarren-mill,1548,deathknight,frost,201,106,95
Dzengiskhan,draenor,1546,deathknight,frost,198,103,95
Руин,blackscar,1545,deathknight,frost,65,35,30
Kailara,draenor,1544,deathknight,frost,209,107,102
Ithêrius,blackmoore,1544,deathknight,frost,47,24,23
Deucalyqt,nemesis,1538,deathknight,frost,66,31,35
Axram,ravencrest,1536,deathknight,frost,55,34,21
Prokszii,turalyon,1532,deathknight,frost,86,49,37
Krauss,argent-dawn,1531,deathknight,frost,66,30,36
Лордтемар,howling-fjord,1530,deathknight,frost,54,25,29
Darlyn,grim-batol,1529,deathknight,frost,48,31,17
Dripgrip,ravencrest,1529,deathknight,frost,77,36,41
Blendamed,outland,1529,deathknight,frost,60,25,35
Qus,twisting-nether,1528,deathknight,frost,59,27,32
Tenzøftw,archimonde,1527,deathknight,frost,31,17,14
Селес,ashenvale,1526,deathknight,frost,30,16,14
Anasûrimbor,tarren-mill,1526,deathknight,frost,36,18,18
Adär,kazzak,1512,deathknight,frost,84,42,42
Phrek,outland,1509,deathknight,frost,24,16,8
Leahthemad,sylvanas,1505,deathknight,frost,63,33,30
Thiccsnack,ragnaros,1505,deathknight,frost,41,21,20
Akril,tarren-mill,1505,deathknight,frost,114,58,56
Геннош,howling-fjord,1503,deathknight,frost,96,49,47
Morgued,ravencrest,1502,deathknight,frost,60,30,30
Fault,burning-legion,1500,deathknight,frost,30,16,14
Blácked,draenor,1500,deathknight,frost,138,73,65
Hatriox,outland,1494,deathknight,frost,207,109,98
Интерио,howling-fjord,1492,deathknight,frost,42,20,22
Balrot,burning-legion,1492,deathknight,frost,66,30,36
Cleverb,silvermoon,1491,deathknight,frost,42,20,22
Abadonn,archimonde,1489,deathknight,frost,66,28,38
Orcborg,zuljin,1485,deathknight,frost,127,72,55
Empar,nethersturm,1484,deathknight,frost,93,50,43
Униорк,howling-fjord,1475,deathknight,frost,36,20,16
Grendul,blackmoore,1475,deathknight,frost,84,44,40
Gauloupin,lightnings-blade,1473,deathknight,frost,105,50,55
Teldä,archimonde,1472,deathknight,frost,79,39,40
Флаттершайдк,booty-bay,1464,deathknight,frost,79,38,41
Gegham,ravencrest,1455,deathknight,frost,36,20,16
Вирко,eversong,1455,deathknight,frost,43,22,21
Kane,destromath,1442,deathknight,frost,36,18,18
Enizul,kazzak,1441,deathknight,frost,77,41,36
Солист,soulflayer,1439,deathknight,frost,163,89,74
Myzouth,silvermoon,1438,deathknight,frost,24,15,9
Madseason,burning-legion,1438,deathknight,frost,72,35,37
Amerant,kazzak,1433,deathknight,frost,60,28,32
Ullefuz,silvermoon,1432,deathknight,frost,128,63,65
Катаринья,howling-fjord,1432,deathknight,frost,140,67,73
Сенкрул,gordunni,1432,deathknight,frost,51,24,27
Средозавр,howling-fjord,1429,deathknight,frost,50,27,23
Leahthebad,sylvanas,1428,deathknight,frost,61,31,30
Меланндрис,gordunni,1427,deathknight,frost,63,40,23
Wildsword,sylvanas,1427,deathknight,frost,75,38,37
Cdp,ragnaros,1426,deathknight,frost,196,106,90
Nasxsy,blackmoore,1425,deathknight,frost,24,15,9
Wrathlich,tyrande,1425,deathknight,frost,130,62,68
Десигнатор,gordunni,1424,deathknight,frost,86,42,44
Sinabre,uldaman,1424,deathknight,frost,91,44,47
Belwina,silvermoon,1423,deathknight,frost,24,15,9
Gøtrek,archimonde,1423,deathknight,frost,84,40,44
Desolatiøn,ravencrest,1422,deathknight,frost,102,50,52
Бронерэй,gordunni,1421,deathknight,frost,24,15,9
Trashboat,outland,1419,deathknight,frost,42,21,21
Chillfyre,argent-dawn,1419,deathknight,frost,42,20,22
Winterberger,silvermoon,1415,deathknight,frost,35,16,19
Unholz,kazzak,1415,deathknight,frost,60,24,36
Stevensdk,darkspear,1414,deathknight,frost,69,33,36
Ðeucaly,nemesis,1411,deathknight,frost,96,47,49
Regniér,frostwolf,1411,deathknight,frost,380,184,196
Nymfo,tirion,1410,deathknight,frost,95,50,45
Bàbarus,dun-morogh,1407,deathknight,frost,66,42,24
Scørn,thrall,1401,deathknight,frost,234,117,117
Фростмаран,soulflayer,1401,deathknight,frost,120,58,62
Angalor,argent-dawn,1399,deathknight,frost,44,18,26
Arthasuk,dun-modr,1395,deathknight,frost,338,178,160
Истинна,grom,1394,deathknight,frost,36,20,16
Асаала,soulflayer,1393,deathknight,frost,33,21,12
Ккма,gordunni,1391,deathknight,frost,90,54,36
Rubbann,ravencrest,1391,deathknight,frost,30,15,15
Gorefiend,kazzak,1391,deathknight,frost,49,22,27
Skorice,dalaran,1389,deathknight,frost,48,19,29
Cedex,tarren-mill,1388,deathknight,frost,36,16,20
Düksito,dun-modr,1387,deathknight,frost,99,50,49
Jizzburga,blackhand,1387,deathknight,frost,128,60,68
Mocca,aegwynn,1385,deathknight,frost,58,25,33
Отвян,gordunni,1384,deathknight,frost,60,23,37
Spøøk,defias-brotherhood,1383,deathknight,frost,229,114,115
Вурдулакх,gordunni,1380,deathknight,frost,79,40,39
Dreadnight,sanguino,1380,deathknight,frost,56,26,30
Kãra,ysondre,1378,deathknight,frost,244,124,120
Reapocalypse,blackhand,1376,deathknight,frost,36,16,20
Arthaslegend,magtheridon,1376,deathknight,frost,84,35,49
Zhigan,ravencrest,1375,deathknight,frost,42,18,24
Iaccidens,stormscale,1374,deathknight,frost,222,112,110
Маклайкнайт,gordunni,1374,deathknight,frost,423,209,214
Dükss,dun-modr,1366,deathknight,frost,65,38,27
Keronaterol,blackhand,1363,deathknight,frost,84,46,38
Xyrosa,argent-dawn,1360,deathknight,frost,45,18,27
Primø,malganis,1357,deathknight,frost,34,17,17
Ihatelife,frostwolf,1353,deathknight,frost,202,101,101
Yeamaon,ravencrest,1353,deathknight,frost,79,38,41
Dextroyersx,sanguino,1348,deathknight,frost,71,36,35
Ubiystvo,kazzak,1338,deathknight,frost,120,63,57
Karax,draenor,1338,deathknight,frost,44,20,24
Darkdémn,eldrethalas,1336,deathknight,frost,48,20,28
Nifllheimr,outland,1335,deathknight,frost,48,24,24
Фэйлстрайк,azuregos,1334,deathknight,frost,41,20,21
Cayliadk,tarren-mill,1332,deathknight,frost,203,96,107
Кокосоус,gordunni,1331,deathknight,frost,46,17,29
Buldog,laughing-skull,1328,deathknight,frost,136,65,71
Касуляпвнз,gordunni,1326,deathknight,frost,77,41,36
Superere,hyjal,1326,deathknight,frost,156,83,73
Vincestaples,mannoroth,1326,deathknight,frost,88,44,44
Smellysock,tarren-mill,1324,deathknight,frost,41,23,18
Mâxî,hyjal,1323,deathknight,frost,48,18,30
Comehere,norgannon,1321,deathknight,frost,30,19,11
Tofin,dunemaul,1320,deathknight,frost,44,21,23
Sound,shadowsong,1319,deathknight,frost,84,38,46
Twardobaba,burning-legion,1318,deathknight,frost,86,45,41
Morbidx,ravencrest,1315,deathknight,frost,64,25,39
Wardrickxdd,ravencrest,1314,deathknight,frost,30,16,14
Døuffy,hyjal,1313,deathknight,frost,236,119,117
Kiraxen,draenor,1308,deathknight,frost,36,20,16
Xoqu,tarren-mill,1308,deathknight,frost,30,14,16
Mcrune,ravencrest,1306,deathknight,frost,50,23,27
Zoree,draenor,1306,deathknight,frost,54,19,35
Декеич,howling-fjord,1303,deathknight,frost,30,16,14
Deathknight,spinebreaker,1303,deathknight,frost,96,45,51
Wlcrealworld,ravencrest,1302,deathknight,frost,108,51,57
Deucalygodx,nemesis,1301,deathknight,frost,60,22,38
Thenrys,culte-de-la-rive-noire,1300,deathknight,frost,246,121,125
Orkishblack,tarren-mill,1298,deathknight,frost,47,25,22
Annecanos,ravencrest,1297,deathknight,frost,36,24,12
Âlîce,culte-de-la-rive-noire,1297,deathknight,frost,54,26,28
Папичдк,gordunni,1291,deathknight,frost,29,16,13
Vîrus,kazzak,1290,deathknight,frost,36,17,19
Wintersons,tarren-mill,1285,deathknight,frost,66,31,35
Odaijini,archimonde,1284,deathknight,frost,29,14,15
Soulrender,kirin-tor,1283,deathknight,frost,36,15,21
Barathéøn,les-sentinelles,1282,deathknight,frost,53,19,34
Moosbirne,blackhand,1279,deathknight,frost,60,28,32
Нифер,deathguard,1274,deathknight,frost,26,14,12
Sødax,sanguino,1274,deathknight,frost,36,14,22
Zúrg,stormscale,1273,deathknight,frost,96,54,42
Piri,defias-brotherhood,1272,deathknight,frost,94,46,48
Satyriasis,twisting-nether,1270,deathknight,frost,61,34,27
Torbrand,ravencrest,1270,deathknight,frost,57,29,28
Sindó,blackrock,1268,deathknight,frost,63,32,31
Ilovebigass,ravencrest,1267,deathknight,frost,30,14,16
Morgouse,kazzak,1262,deathknight,frost,209,102,107
Môrgøth,nemesis,1256,deathknight,frost,72,32,40
Tayuyu,sylvanas,1254,deathknight,frost,34,15,19
Mikese,silvermoon,1252,deathknight,frost,87,45,42
Reezeer,stormscale,1252,deathknight,frost,92,40,52
Nerinth,burning-legion,1251,deathknight,frost,43,15,28
Inaëlys,medivh,1250,deathknight,frost,73,39,34
Trogkhar,blackrock,1249,deathknight,frost,47,26,21
Elendren,blackrock,1247,deathknight,frost,24,13,11
Ваатерло,soulflayer,1246,deathknight,frost,66,28,38
Dämäger,proudmoore,1245,deathknight,frost,179,92,87
Sukadino,ragnaros,1245,deathknight,frost,79,40,39
Kàrásu,eredar,1245,deathknight,frost,36,14,22
Feelmyfuri,mazrigos,1243,deathknight,frost,30,13,17
Slexor,kargath,1241,deathknight,frost,42,18,24
Йохан,greymane,1240,deathknight,frost,40,15,25
Pandahapci,ragnaros,1239,deathknight,frost,24,13,11
Rakhash,antonidas,1238,deathknight,frost,72,42,30
Äbäddon,twisting-nether,1236,deathknight,frost,18,13,5
Mëzmêrïze,archimonde,1236,deathknight,frost,31,14,17
Bêllør,archimonde,1234,deathknight,frost,24,13,11
Varrazdk,blackrock,1232,deathknight,frost,36,13,23
Raihor,outland,1231,deathknight,frost,32,13,19
Merdraut,alakir,1228,deathknight,frost,46,25,21
Aracnys,dalaran,1227,deathknight,frost,42,17,25
Unchaindk,outland,1226,deathknight,frost,66,32,34
Exodiuss,dalaran,1225,deathknight,frost,58,30,28
Кроуфрост,gordunni,1220,deathknight,frost,120,57,63
Molgoth,outland,1218,deathknight,frost,46,16,30
Разлажение,gordunni,1216,deathknight,frost,78,41,37
Kaeyz,blackmoore,1216,deathknight,frost,30,13,17
Frostmommy,argent-dawn,1214,deathknight,frost,41,16,25
Darxiera,drakthul,1210,deathknight,frost,85,37,48
Zuggandk,tarren-mill,1209,deathknight,frost,48,26,22
Chaosbane,terokkar,1200,deathknight,frost,66,31,35
Tzunâ,blackmoore,1200,deathknight,frost,58,27,31
Nôsferatú,amanthul,1196,deathknight,frost,160,81,79
Dreodis,der-mithrilorden,1196,deathknight,frost,161,76,85
Krasny,hyjal,1185,deathknight,frost,156,81,75
Hî,malganis,1181,deathknight,frost,141,69,72
Íbossit,doomhammer,1180,deathknight,frost,28,17,11
Gageth,shadowsong,1180,deathknight,frost,45,15,30
Ziuziu,twisting-nether,1177,deathknight,frost,135,67,68
Vampire,ahnqiraj,1172,deathknight,frost,33,14,19
Predatormkdd,ravencrest,1171,deathknight,frost,41,26,15
Azrador,frostwolf,1171,deathknight,frost,202,95,107
Clàymax,kazzak,1171,deathknight,frost,51,21,30
Fróst,dun-modr,1170,deathknight,frost,73,41,32
Düks,dun-modr,1166,deathknight,frost,124,55,69
Archa,shendralar,1165,deathknight,frost,125,59,66
Collinná,aegwynn,1162,deathknight,frost,60,25,35
Zandruq,twisting-nether,1162,deathknight,frost,58,24,34
Rogerwaterz,twisting-nether,1159,deathknight,frost,43,24,19
Grumpykathi,blackmoore,1159,deathknight,frost,42,22,20
Рейндхардх,gordunni,1158,deathknight,frost,24,15,9
Darkride,shattrath,1153,deathknight,frost,43,22,21
Alastoras,nemesis,1152,deathknight,frost,43,23,20
Løz,kazzak,1151,deathknight,frost,24,12,12
Нитраль,deepholm,1150,deathknight,frost,18,12,6
Necrølyte,sylvanas,1149,deathknight,frost,18,12,6
Zanretxd,outland,1149,deathknight,frost,102,55,47
Belía,blackmoore,1146,deathknight,frost,62,27,35
Lueri,sanguino,1146,deathknight,frost,30,12,18
Ahnuk,aggra-português,1145,deathknight,frost,30,14,16
Stely,alonsus,1144,deathknight,frost,18,12,6
Darkchas,silvermoon,1144,deathknight,frost,24,12,12
Monkeydclaus,arathor,1144,deathknight,frost,96,47,49
Zioan,jaedenar,1143,deathknight,frost,117,63,54
Zerodude,silvermoon,1142,deathknight,frost,60,30,30
Goring,confrérie-du-thorium,1137,deathknight,frost,24,12,12
Rilledred,stormscale,1136,deathknight,frost,57,29,28
Stetch,darkspear,1135,deathknight,frost,36,12,24
Polimeh,draenor,1132,deathknight,frost,66,38,28
Mattesøs,drakthul,1130,deathknight,frost,36,13,23
Abnormus,tarren-mill,1129,deathknight,frost,143,72,71
Тайберзанн,grom,1127,deathknight,frost,30,12,18
Fixmybones,frostmane,1123,deathknight,frost,78,37,41
Ilopango,blackmoore,1123,deathknight,frost,47,17,30
Dkruffos,draenor,1115,deathknight,frost,66,27,39
Khelthalas,teldrassil,1114,deathknight,frost,37,26,11
Семиран,gordunni,1114,deathknight,frost,33,13,20
Triddion,sylvanas,1113,deathknight,frost,24,12,12
Ivik,the-maelstrom,1112,deathknight,frost,79,46,33
Nathriel,stormscale,1110,deathknight,frost,41,17,24
Akantras,blackmoore,1106,deathknight,frost,59,28,31
Woddey,blackrock,1101,deathknight,frost,60,29,31
Nelahh,the-maelstrom,1100,deathknight,frost,63,32,31
Sêmelia,blackrock,1095,deathknight,frost,33,15,18
Axilleas,magtheridon,1087,deathknight,frost,36,13,23
Posinkautta,silvermoon,1084,deathknight,frost,39,23,16
Regys,argent-dawn,1080,deathknight,frost,28,12,16
Вафельнаяфея,blackscar,1073,deathknight,frost,43,17,26
Zaouros,silvermoon,1070,deathknight,frost,48,12,36
Greiz,aggramar,1058,deathknight,frost,43,17,26
Elcapìtan,silvermoon,1054,deathknight,frost,18,11,7
Icebitten,argent-dawn,1053,deathknight,frost,27,18,9
Некробасс,deathguard,1052,deathknight,frost,24,11,13
Unaxito,sanguino,1052,deathknight,frost,24,11,13
Khagra,ravencrest,1051,deathknight,frost,24,11,13
Fallén,stormrage,1050,deathknight,frost,24,11,13
Loorda,kazzak,1047,deathknight,frost,24,11,13
Gravehammer,sylvanas,1044,deathknight,frost,40,23,17
Jugglez,thrall,1043,deathknight,frost,24,11,13
Feekus,deathwing,1039,deathknight,frost,18,11,7
Emielf,silvermoon,1039,deathknight,frost,32,13,19
Endavor,ragnaros,1037,deathknight,frost,42,20,22
Альянсобой,deathguard,1037,deathknight,frost,34,12,22
Arond,arygos,1035,deathknight,frost,30,12,18
Deathcardos,die-aldor,1035,deathknight,frost,60,23,37
Këus,hyjal,1033,deathknight,frost,24,17,7
Thrigoth,ravencrest,1033,deathknight,frost,48,18,30
Блодскал,howling-fjord,1031,deathknight,frost,30,11,19
Êbøla,sanguino,1030,deathknight,frost,102,40,62
Slâyèr,blackrock,1028,deathknight,frost,29,13,16
Мертвячино,deathguard,1026,deathknight,frost,18,12,6
Dødsgud,khaz-modan,1026,deathknight,frost,117,60,57
Gärrøsh,cthun,1026,deathknight,frost,30,11,19
Sunwrath,magtheridon,1025,deathknight,frost,63,31,32
Moiret,drakthul,1025,deathknight,frost,59,15,44
Krylow,draenor,1020,deathknight,frost,42,17,25
Sjöstedt,twisting-nether,1019,deathknight,frost,29,11,18
Холбункойл,gordunni,1017,deathknight,frost,72,29,43
Kalenjii,burning-legion,1006,deathknight,frost,23,11,12
Quantumshift,ravencrest,1004,deathknight,frost,17,11,6
Alameda,nathrezim,1004,deathknight,frost,34,15,19
Dursall,thrall,1003,deathknight,frost,320,160,160
Kixx,bloodfeather,1003,deathknight,frost,125,53,72
Zerdon,frostmane,1001,deathknight,frost,61,32,29
Nachtschwarz,amanthul,1001,deathknight,frost,33,16,17
Bari,the-venture-co,1001,deathknight,frost,158,68,90
Akmens,aggramar,998,deathknight,frost,36,17,19
Angôs,sanguino,995,deathknight,frost,144,70,74
Sooran,blackhand,994,deathknight,frost,24,16,8
Whooz,dun-morogh,977,deathknight,frost,47,11,36
Sawishere,sanguino,975,deathknight,frost,78,34,44
Lichquêen,zuluhed,970,deathknight,frost,36,16,20
Apacstanya,ragnaros,960,deathknight,frost,24,10,14
Flúrrý,kazzak,960,deathknight,frost,24,10,14
Shicheria,blackrock,959,deathknight,frost,18,10,8
Ñogg,kazzak,959,deathknight,frost,30,10,20
Zsozsodk,ragnaros,958,deathknight,frost,18,10,8
Residenta,dun-modr,958,deathknight,frost,30,10,20
Kerastrell,doomhammer,957,deathknight,frost,24,10,14
Asphyxias,alleria,957,deathknight,frost,24,10,14
Eívór,garrosh,957,deathknight,frost,24,10,14
Söttguetsi,blackrock,956,deathknight,frost,18,10,8
Hatcherb,sylvanas,953,deathknight,frost,30,16,14
Urzza,ysondre,953,deathknight,frost,30,10,20
Shadowsëek,hyjal,952,deathknight,frost,24,10,14
Ларкусдк,howling-fjord,952,deathknight,frost,30,10,20
Порция,greymane,948,deathknight,frost,113,58,55
Scorbion,kilrogg,947,deathknight,frost,33,16,17
Peachvajz,turalyon,942,deathknight,frost,189,97,92
Ballie,tarren-mill,939,deathknight,frost,30,10,20
Fullbusterr,hyjal,938,deathknight,frost,53,23,30
Bäy,archimonde,938,deathknight,frost,72,24,48
Хуаролуксс,gordunni,934,deathknight,frost,107,41,66
Aegwynnêr,blackmoore,932,deathknight,frost,51,28,23
Кунимэнгус,soulflayer,929,deathknight,frost,78,33,45
Assølid,arathor,928,deathknight,frost,51,22,29
Wtftauren,drakthul,910,deathknight,frost,36,17,19
Dípps,outland,908,deathknight,frost,24,11,13
Morvain,silvermoon,903,deathknight,frost,172,75,97
Liija,blackrock,900,deathknight,frost,35,12,23
Garandyr,hyjal,890,deathknight,frost,49,16,33
Dànté,eitrigg,889,deathknight,frost,48,24,24
Карвалан,eversong,886,deathknight,frost,42,21,21
Darklich,blackmoore,872,deathknight,frost,95,47,48
Assasínator,tarren-mill,872,deathknight,frost,49,24,25
Mauryr,drakthul,869,deathknight,frost,100,40,60
ßambøøzle,draenor,864,deathknight,frost,18,9,9
Некросморк,soulflayer,864,deathknight,frost,18,9,9
Nathaniall,drakthul,863,deathknight,frost,18,9,9
Oscman,silvermoon,863,deathknight,frost,18,9,9
Sephirus,kazzak,863,deathknight,frost,24,9,15
Борелис,soulflayer,862,deathknight,frost,18,9,9
Gringly,tarren-mill,862,deathknight,frost,18,9,9
Furby,taerar,861,deathknight,frost,24,9,15
Револьт,lich-king,857,deathknight,frost,12,9,3
Dkinta,colinas-pardas,857,deathknight,frost,18,9,9
Soulwalker,sylvanas,854,deathknight,frost,19,9,10
Deadkilla,stormreaver,851,deathknight,frost,18,9,9
Pavkata,outland,851,deathknight,frost,24,9,15
Mahfel,twisting-nether,850,deathknight,frost,48,23,25
Qooqooq,ravencrest,848,deathknight,frost,18,9,9
Izanagii,exodar,847,deathknight,frost,18,9,9
Bruttox,kazzak,847,deathknight,frost,24,9,15
Pandòrà,dun-modr,846,deathknight,frost,17,9,8
Guillemet,turalyon,830,deathknight,frost,16,10,6
Fentanil,elune,814,deathknight,frost,23,9,14
Ilaenu,ravencrest,810,deathknight,frost,26,10,16
Elbaqwan,the-shatar,801,deathknight,frost,54,24,30
Blinksg,frostmane,799,deathknight,frost,17,9,8
Aeneriah,tarren-mill,798,deathknight,frost,20,9,11
Fuzzyofc,draenor,796,deathknight,frost,17,9,8
Fareast,nerathor,783,deathknight,frost,114,52,62
Craftmaker,eonar,778,deathknight,frost,53,21,32
Letumnex,tarren-mill,768,deathknight,frost,12,8,4
Wpízdu,aegwynn,768,deathknight,frost,12,8,4
Tenzøjr,archimonde,768,deathknight,frost,12,8,4
Salaahadin,darkspear,768,deathknight,frost,18,8,10
Adderral,argent-dawn,767,deathknight,frost,12,8,4
Rainknight,twisting-nether,767,deathknight,frost,12,8,4
Ualar,silvermoon,767,deathknight,frost,18,8,10
Miruvar,tarren-mill,767,deathknight,frost,18,8,10
Jollíe,tarren-mill,767,deathknight,frost,24,8,16
Desulól,tarren-mill,766,deathknight,frost,15,9,6
Æew,kazzak,766,deathknight,frost,18,8,10
Flaii,hyjal,766,deathknight,frost,18,8,10
Zombíe,laughing-skull,765,deathknight,frost,12,8,4
Дрогдош,howling-fjord,765,deathknight,frost,24,8,16
Арнорос,lich-king,764,deathknight,frost,12,8,4
Goretex,pozzo-delleternità,763,deathknight,frost,18,8,10
Dkmonster,blackhand,763,deathknight,frost,24,8,16
Vladorus,draenor,762,deathknight,frost,16,9,7
Blurek,lordaeron,762,deathknight,frost,18,8,10
Xtream,blackmoore,762,deathknight,frost,18,8,10
Горгамель,howling-fjord,759,deathknight,frost,24,8,16
Bigspider,aggramar,759,deathknight,frost,36,8,28
Lichfils,chogall,745,deathknight,frost,27,8,19
Afadk,kazzak,744,deathknight,frost,150,61,89
Lenexia,ravencrest,743,deathknight,frost,18,8,10
Брейвз,gordunni,731,deathknight,frost,17,8,9
Gadres,aegwynn,687,deathknight,frost,25,8,17
Barothos,argent-dawn,672,deathknight,frost,12,7,5
Oweiowei,blackrock,672,deathknight,frost,12,7,5
Anydelia,blackmoore,672,deathknight,frost,12,7,5
Дедвбане,gordunni,672,deathknight,frost,14,7,7
Axalon,nordrassil,672,deathknight,frost,18,7,11
Doping,eredar,672,deathknight,frost,18,7,11
Darkarthás,aegwynn,672,deathknight,frost,18,7,11
Haximusprime,kazzak,671,deathknight,frost,12,7,5
Roobeert,defias-brotherhood,671,deathknight,frost,12,7,5
Iceludwig,nemesis,671,deathknight,frost,12,7,5
Cyphîllyth,auchindoun,671,deathknight,frost,12,7,5
Аирфрост,howling-fjord,671,deathknight,frost,18,7,11
Halohuntress,outland,671,deathknight,frost,18,7,11
Ischozâr,blackmoore,671,deathknight,frost,18,7,11
Holîx,kazzak,671,deathknight,frost,30,7,23
Karthor,teldrassil,670,deathknight,frost,12,7,5
Lycowrath,doomhammer,670,deathknight,frost,12,7,5
Kazanski,silvermoon,670,deathknight,frost,12,7,5
Uthn,outland,670,deathknight,frost,24,7,17
Blackjaxn,thrall,668,deathknight,frost,18,7,11
Merà,antonidas,668,deathknight,frost,24,7,17
Яшамару,borean-tundra,667,deathknight,frost,12,7,5
Menacê,ravencrest,662,deathknight,frost,18,7,11
Aczheron,argent-dawn,660,deathknight,frost,24,7,17
Antîlâ,antonidas,658,deathknight,frost,12,7,5
Савамура,gordunni,655,deathknight,frost,17,7,10
Dekagramcz,drakthul,653,deathknight,frost,27,7,20
Arthursq,stormscale,647,deathknight,frost,36,9,27
Jäätynyt,zenedar,639,deathknight,frost,17,7,10
Kleophatra,drakthul,637,deathknight,frost,11,7,4
Xeevdk,kazzak,623,deathknight,frost,21,7,14
Кромгонище,soulflayer,618,deathknight,frost,17,9,8
Ставраас,gordunni,605,deathknight,frost,20,7,13
Innerfrigus,tarren-mill,576,deathknight,frost,12,6,6
Volestral,emeriss,576,deathknight,frost,12,6,6
Планус,booty-bay,576,deathknight,frost,12,6,6
Orangatang,dalaran,576,deathknight,frost,12,6,6
Critycal,draenor,576,deathknight,frost,12,6,6
Garùn,sylvanas,576,deathknight,frost,12,6,6
Flúrry,ravencrest,576,deathknight,frost,12,6,6
Semeris,twisting-nether,576,deathknight,frost,12,6,6
Unhóly,tarren-mill,576,deathknight,frost,12,6,6
Azslan,skullcrusher,576,deathknight,frost,12,6,6
Xeliora,ragnaros,576,deathknight,frost,15,7,8
Westdx,hyjal,576,deathknight,frost,18,6,12
Oj,darkspear,576,deathknight,frost,18,6,12
Rompå,ravencrest,576,deathknight,frost,18,6,12
Leomordf,doomhammer,576,deathknight,frost,18,6,12
Parayysite,eredar,576,deathknight,frost,18,6,12
Deathmike,steamwheedle-cartel,576,deathknight,frost,18,6,12
Fatbutdead,malganis,575,deathknight,frost,12,6,6
Gotendk,draenor,575,deathknight,frost,12,6,6
Dunkàn,silvermoon,575,deathknight,frost,12,6,6
Coldstrike,sunstrider,575,deathknight,frost,12,6,6
Bloodbane,burning-blade,575,deathknight,frost,12,6,6
Marcellinus,hellfire,575,deathknight,frost,12,6,6
Moko,defias-brotherhood,575,deathknight,frost,12,6,6
Killerazog,rexxar,575,deathknight,frost,18,6,12
Tugarinzmey,tarren-mill,575,deathknight,frost,18,6,12
Xenake,kazzak,575,deathknight,frost,18,6,12
Grithala,draenor,574,deathknight,frost,12,6,6
Роземайер,ashenvale,574,deathknight,frost,12,6,6
Angrist,terokkar,573,deathknight,frost,12,6,6
Фламмивир,gordunni,572,deathknight,frost,12,6,6
Сааттана,soulflayer,570,deathknight,frost,12,6,6
Pestilerous,draenor,559,deathknight,frost,23,6,17
Tyranuse,kazzak,527,deathknight,frost,17,6,11
Deckbulle,blackhand,480,deathknight,frost,6,5,1
Grimmoth,argent-dawn,480,deathknight,frost,6,5,1
Thebangman,ravencrest,480,deathknight,frost,9,6,3
Khnïshou,silvermoon,480,deathknight,frost,12,5,7
Smardacus,silvermoon,480,deathknight,frost,12,5,7
Dödeek,twilights-hammer,480,deathknight,frost,12,5,7
Cptneverdie,stormscale,480,deathknight,frost,12,5,7
Keridíin,twisting-nether,480,deathknight,frost,12,5,7
Микелон,gordunni,480,deathknight,frost,12,5,7
Toshiroo,draenor,480,deathknight,frost,12,5,7
Ûñhølýðéåthj,tarren-mill,480,deathknight,frost,12,5,7
Alukai,blackrock,480,deathknight,frost,12,5,7
Nommad,archimonde,480,deathknight,frost,12,5,7
Alinee,shadowsong,480,deathknight,frost,12,5,7
Goochtickler,kazzak,480,deathknight,frost,12,5,7
Брюшина,gordunni,480,deathknight,frost,12,5,7
Necrozy,aggra-português,480,deathknight,frost,12,5,7
Runepride,argent-dawn,480,deathknight,frost,12,5,7
Hemopathy,tarren-mill,480,deathknight,frost,12,5,7
Дэвайна,gordunni,480,deathknight,frost,12,5,7
Persefal,nemesis,480,deathknight,frost,12,5,7
Dukoo,emerald-dream,480,deathknight,frost,12,5,7
Stteff,sylvanas,480,deathknight,frost,15,6,9
Windieselx,ragnaros,480,deathknight,frost,18,5,13
Nightglade,kilrogg,480,deathknight,frost,18,5,13
Freeks,die-aldor,480,deathknight,frost,18,5,13
Берсан,soulflayer,479,deathknight,frost,6,5,1
Xiddy,quelthalas,479,deathknight,frost,6,5,1
Jowân,blackmoore,479,deathknight,frost,12,5,7
Talge,defias-brotherhood,479,deathknight,frost,12,5,7
Hellcrosser,blackrock,479,deathknight,frost,12,5,7
Ricardiob,argent-dawn,479,deathknight,frost,12,5,7
Ostridz,grim-batol,479,deathknight,frost,12,5,7
Смердонос,grom,479,deathknight,frost,12,5,7
Чёбышек,gordunni,479,deathknight,frost,12,5,7
Сивкабурка,fordragon,479,deathknight,frost,12,5,7
Breakstuff,twisting-nether,479,deathknight,frost,18,5,13
Deadpòól,twisting-nether,479,deathknight,frost,18,5,13
Roids,twisting-nether,479,deathknight,frost,18,5,13
Appdeath,azjolnerub,478,deathknight,frost,12,5,7
Thundawrath,silvermoon,478,deathknight,frost,12,5,7
Scárebear,outland,478,deathknight,frost,18,5,13
Copium,hyjal,477,deathknight,frost,12,5,7
Fishtruction,tarren-mill,476,deathknight,frost,12,5,7
Eisentorte,nerathor,476,deathknight,frost,26,5,21
Kejpo,drakthul,473,deathknight,frost,12,5,7
Poaka,outland,471,deathknight,frost,18,5,13
Докторктан,eversong,468,deathknight,frost,18,5,13
Husarz,kazzak,447,deathknight,frost,11,5,6
Malahide,khadgar,447,deathknight,frost,17,5,12
Niunialesbo,draenor,416,deathknight,frost,10,5,5
Namzera,draenor,384,deathknight,frost,6,4,2
Reann,argent-dawn,384,deathknight,frost,6,4,2
Enzy,drakthul,384,deathknight,frost,6,4,2
Rexin,outland,384,deathknight,frost,6,4,2
Близзбай,soulflayer,384,deathknight,frost,6,4,2
Unholyysteel,silvermoon,384,deathknight,frost,6,4,2
Oldiseas,grim-batol,384,deathknight,frost,6,4,2
Lucyloverx,lightbringer,384,deathknight,frost,6,4,2
Kamisaber,eredar,384,deathknight,frost,6,4,2
Воргтень,borean-tundra,384,deathknight,frost,6,4,2
Lemmegetuuh,chogall,384,deathknight,frost,6,4,2
Seay,malorne,384,deathknight,frost,6,4,2
Servein,stormscale,384,deathknight,frost,6,4,2
Gozuryu,kazzak,384,deathknight,frost,6,4,2
Squicki,hyjal,384,deathknight,frost,6,4,2
Негинд,fordragon,384,deathknight,frost,15,5,10
Zeldahell,dalaran,384,deathknight,frost,12,4,8
Genêsìs,eredar,384,deathknight,frost,12,4,8
Doodcraft,tarren-mill,384,deathknight,frost,12,4,8
Hydross,archimonde,384,deathknight,frost,12,4,8
Rakeschnake,teldrassil,384,deathknight,frost,12,4,8
Victura,outland,384,deathknight,frost,12,4,8
Глэмнутый,howling-fjord,384,deathknight,frost,12,4,8
Primesnow,twisting-nether,384,deathknight,frost,12,4,8
Apraxia,ravencrest,384,deathknight,frost,12,4,8
Pawnzqtie,stormscale,384,deathknight,frost,12,4,8
Maxmo,twilights-hammer,384,deathknight,frost,12,4,8
Спиддоз,fordragon,384,deathknight,frost,12,4,8
Mohna,blackrock,384,deathknight,frost,12,4,8
Джайвана,soulflayer,384,deathknight,frost,12,4,8
Крозох,howling-fjord,384,deathknight,frost,12,4,8
Pappadeath,doomhammer,384,deathknight,frost,13,4,9
Hordak,stormscale,384,deathknight,frost,18,4,14
Veledrea,defias-brotherhood,384,deathknight,frost,24,4,20
Beherith,sunstrider,383,deathknight,frost,6,4,2
Tÿnak,der-mithrilorden,383,deathknight,frost,9,4,5
Breeze,xavius,383,deathknight,frost,12,4,8
Eckodk,aggra-português,383,deathknight,frost,12,4,8
Kivo,marécage-de-zangar,383,deathknight,frost,12,4,8
Ömerscofield,argent-dawn,383,deathknight,frost,12,4,8
Гадиния,soulflayer,383,deathknight,frost,12,4,8
Dkdiz,kazzak,383,deathknight,frost,12,4,8
Бранс,gordunni,383,deathknight,frost,12,4,8
Reyu,ambossar,383,deathknight,frost,16,4,12
Rades,sanguino,383,deathknight,frost,18,4,14
Belâam,archimonde,383,deathknight,frost,24,4,20
Группер,gordunni,382,deathknight,frost,6,4,2
Vicoperian,stormscale,382,deathknight,frost,12,4,8
Дневнои,howling-fjord,382,deathknight,frost,12,4,8
Itzdarklord,blackhand,379,deathknight,frost,12,4,8
Iikarus,eredar,376,deathknight,frost,18,4,14
Душанерзула,howling-fjord,330,deathknight,frost,18,6,12
Macskye,malfurion,320,deathknight,frost,10,4,6
Vín,silvermoon,319,deathknight,frost,10,4,6
Винерас,soulflayer,288,deathknight,frost,6,3,3
Джеттар,howling-fjord,288,deathknight,frost,6,3,3
Mirídiuss,silvermoon,288,deathknight,frost,6,3,3
Субботин,soulflayer,288,deathknight,frost,6,3,3
Skøurge,silvermoon,288,deathknight,frost,6,3,3
Sandør,conseil-des-ombres,288,deathknight,frost,6,3,3
Shamteastico,kazzak,288,deathknight,frost,6,3,3
Vainajala,die-aldor,288,deathknight,frost,6,3,3
Трибунальщик,gordunni,288,deathknight,frost,6,3,3
Dudik,sylvanas,288,deathknight,frost,6,3,3
Zathy,twisting-nether,288,deathknight,frost,6,3,3
Пламен,soulflayer,288,deathknight,frost,6,3,3
Skulm,twisting-nether,288,deathknight,frost,6,3,3
Isone,silvermoon,288,deathknight,frost,6,3,3
Modelo,twisting-nether,288,deathknight,frost,6,3,3
Petardodupy,burning-legion,288,deathknight,frost,6,3,3
Toblergnome,silvermoon,288,deathknight,frost,6,3,3
Tigros,burning-legion,288,deathknight,frost,6,3,3
Madsgrip,tarren-mill,288,deathknight,frost,6,3,3
Ideath,executus,288,deathknight,frost,6,3,3
Ghu,stormscale,288,deathknight,frost,6,3,3
Ithis,zuljin,288,deathknight,frost,6,3,3
Infeh,sanguino,288,deathknight,frost,6,3,3
Gelidamors,sylvanas,288,deathknight,frost,6,3,3
Nÿr,dalaran,288,deathknight,frost,6,3,3
Lair,shendralar,288,deathknight,frost,6,3,3
Гурий,ashenvale,288,deathknight,frost,6,3,3
Elliipirelli,doomhammer,288,deathknight,frost,6,3,3
Lukus,sanguino,288,deathknight,frost,6,3,3
Vexxed,magtheridon,288,deathknight,frost,6,3,3
Leijzen,azjolnerub,288,deathknight,frost,6,3,3
Шэйп,fordragon,288,deathknight,frost,6,3,3
Ogomegee,ravencrest,288,deathknight,frost,6,3,3
Kèén,kazzak,288,deathknight,frost,6,3,3
Hailay,ysondre,288,deathknight,frost,6,3,3
Jjayker,kazzak,288,deathknight,frost,6,3,3
Tómér,outland,288,deathknight,frost,6,3,3
Gaurk,aggra-português,288,deathknight,frost,6,3,3
Somaliandoge,outland,288,deathknight,frost,6,3,3
Xanthic,ravencrest,288,deathknight,frost,6,3,3
Vaanor,draenor,288,deathknight,frost,6,3,3
Дуонза,blackscar,288,deathknight,frost,6,3,3
Hellcrusher,kazzak,288,deathknight,frost,6,3,3
Huruguru,ravencrest,288,deathknight,frost,6,3,3
Jeanbenoit,archimonde,288,deathknight,frost,6,3,3
Castlevanía,ravencrest,288,deathknight,frost,6,3,3
Tÿttyka,hyjal,288,deathknight,frost,6,3,3
Bóby,ravencrest,288,deathknight,frost,6,3,3
Charlytango,archimonde,288,deathknight,frost,6,3,3
Neptunium,archimonde,288,deathknight,frost,6,3,3
Dêeath,madmortem,288,deathknight,frost,6,3,3
Mauor,argent-dawn,288,deathknight,frost,6,3,3
Anaralien,ravencrest,288,deathknight,frost,6,3,3
Whippy,ravencrest,288,deathknight,frost,6,3,3
Deathlïght,nemesis,288,deathknight,frost,11,5,6
Merdenhall,argent-dawn,288,deathknight,frost,7,3,4
Nexxel,blackhand,288,deathknight,frost,11,3,8
Powerlifting,los-errantes,288,deathknight,frost,12,3,9
Râke,teldrassil,288,deathknight,frost,12,3,9
Никсиомий,gordunni,288,deathknight,frost,12,3,9
Регроуз,ashenvale,288,deathknight,frost,12,3,9
Moohammood,argent-dawn,288,deathknight,frost,12,3,9
Edochian,sanguino,288,deathknight,frost,12,3,9
Ximopo,sanguino,288,deathknight,frost,12,3,9
Ротвхалве,deathweaver,288,deathknight,frost,12,3,9
Миреанда,eversong,288,deathknight,frost,12,3,9
Тенелла,gordunni,288,deathknight,frost,12,3,9
Gorruk,malorne,288,deathknight,frost,12,3,9
Prekliatylad,burning-blade,288,deathknight,frost,12,3,9
Yäägöö,tarren-mill,288,deathknight,frost,12,3,9
Milchimhaus,dun-morogh,288,deathknight,frost,12,3,9
Chifuyu,azjolnerub,288,deathknight,frost,12,3,9
Obstwald,blackrock,288,deathknight,frost,12,3,9
Scourgebane,kazzak,288,deathknight,frost,12,3,9
Thilior,silvermoon,288,deathknight,frost,12,3,9
Ezlar,silvermoon,288,deathknight,frost,12,3,9
Discochoppa,blackmoore,288,deathknight,frost,12,3,9
Thedk,voljin,288,deathknight,frost,12,3,9
Хайвейтухэлл,soulflayer,288,deathknight,frost,12,3,9
Корольбич,soulflayer,288,deathknight,frost,13,3,10
Brontolein,ungoro,288,deathknight,frost,14,3,11
Джинтос,howling-fjord,288,deathknight,frost,18,3,15
Brantiss,defias-brotherhood,287,deathknight,frost,6,3,3
Ilumëo,quelthalas,287,deathknight,frost,6,3,3
Balekouille,eldrethalas,287,deathknight,frost,6,3,3
Whitedead,destromath,286,deathknight,frost,6,3,3
Housemeyster,antonidas,286,deathknight,frost,12,3,9
Tiunping,silvermoon,286,deathknight,frost,12,3,9
Deadorcy,kazzak,285,deathknight,frost,9,4,5
Venthyrgwa,kazzak,284,deathknight,frost,7,5,2
Rubyblood,aggra-português,271,deathknight,frost,11,3,8
Bwonsámdí,twisting-nether,254,deathknight,frost,6,5,1
Blueironjr,kazzak,239,deathknight,frost,5,3,2
ßæst,archimonde,208,deathknight,frost,7,3,4
Saurøn,chogall,199,deathknight,frost,16,4,12
Dimania,the-maelstrom,192,deathknight,frost,4,3,1
Deadchad,draenor,192,deathknight,frost,9,3,6
Constantyn,blackrock,192,deathknight,frost,6,2,4
Mennal,the-maelstrom,192,deathknight,frost,6,2,4
Эвессом,goldrinn,192,deathknight,frost,6,2,4
Bytedk,aggra-português,192,deathknight,frost,6,2,4
Маккриманс,gordunni,192,deathknight,frost,6,2,4
Doubledead,the-maelstrom,192,deathknight,frost,6,2,4
Darksoulk,frostmane,192,deathknight,frost,6,2,4
Сванский,soulflayer,192,deathknight,frost,6,2,4
Notstacy,dragonblight,192,deathknight,frost,6,2,4
Farnbauer,ragnaros,192,deathknight,frost,6,2,4
Aradiel,archimonde,192,deathknight,frost,6,2,4
Archdemonio,wildhammer,192,deathknight,frost,6,2,4
Rømnie,la-croisade-écarlate,192,deathknight,frost,6,2,4
Vadamee,ravencrest,192,deathknight,frost,6,2,4
Pandahapcii,ragnaros,192,deathknight,frost,6,2,4
Бешенсство,soulflayer,192,deathknight,frost,6,2,4
Arjaden,doomhammer,192,deathknight,frost,6,2,4
Рэтсбэйнх,soulflayer,192,deathknight,frost,6,2,4
Frostplague,aegwynn,192,deathknight,frost,6,2,4
Necrotopx,aegwynn,192,deathknight,frost,6,2,4
Tyró,ravencrest,192,deathknight,frost,6,2,4
Seasonfive,arathor,192,deathknight,frost,6,2,4
Металистикс,howling-fjord,192,deathknight,frost,6,2,4
Zackryder,ravenholdt,192,deathknight,frost,6,2,4
Ilovegouàng,khaz-modan,192,deathknight,frost,6,2,4
Ðeathceptiøn,dun-modr,192,deathknight,frost,6,2,4
Larum,burning-legion,192,deathknight,frost,6,2,4
Getdked,grim-batol,192,deathknight,frost,6,2,4
Ikarack,twisting-nether,192,deathknight,frost,6,2,4
Chillstreak,twisting-nether,192,deathknight,frost,6,2,4
Babsyknight,wildhammer,192,deathknight,frost,6,2,4
Marcianorock,dalaran,192,deathknight,frost,6,2,4
Dklol,dun-morogh,192,deathknight,frost,6,2,4
Tobtób,antonidas,192,deathknight,frost,6,2,4
Tüddelich,antonidas,192,deathknight,frost,6,2,4
Dysnomiya,antonidas,192,deathknight,frost,6,2,4
Силдэус,galakrond,192,deathknight,frost,6,2,4
Ratge,hyjal,192,deathknight,frost,6,2,4
Negzul,blackmoore,192,deathknight,frost,6,2,4
Nathoel,zuljin,192,deathknight,frost,6,2,4
Lemonhazebg,stormscale,192,deathknight,frost,6,2,4
Karaliuss,draenor,192,deathknight,frost,6,2,4
Olexeshh,blackhand,192,deathknight,frost,6,2,4
Necrossis,stormscale,192,deathknight,frost,6,2,4
Капустас,gordunni,192,deathknight,frost,6,2,4
Julezi,blackmoore,192,deathknight,frost,6,2,4
Ashguol,twisting-nether,192,deathknight,frost,6,2,4
Royalcrown,stormscale,192,deathknight,frost,6,2,4
Sugarcakedk,blackrock,192,deathknight,frost,6,2,4
Nergål,sanguino,192,deathknight,frost,6,2,4
Doozz,draenor,192,deathknight,frost,6,2,4
Ghaloob,draenor,192,deathknight,frost,6,2,4
Wantobewarri,blackhand,192,deathknight,frost,6,2,4
Expiredsauce,silvermoon,192,deathknight,frost,6,2,4
Brewknight,silvermoon,192,deathknight,frost,6,2,4
Toffy,anetheron,192,deathknight,frost,6,2,4
Deathuss,silvermoon,192,deathknight,frost,6,2,4
Excaliuz,silvermoon,192,deathknight,frost,6,2,4
Highblood,tarren-mill,192,deathknight,frost,6,2,4
Abomination,emeriss,192,deathknight,frost,6,2,4
Nietzschean,tarren-mill,192,deathknight,frost,6,2,4
Deathdayben,kazzak,192,deathknight,frost,6,2,4
Arthrosis,tarren-mill,192,deathknight,frost,6,2,4
Dreadmind,blackrock,192,deathknight,frost,6,2,4
Likell,argent-dawn,192,deathknight,frost,6,2,4
Vaffe,tarren-mill,192,deathknight,frost,6,2,4
Lillekas,outland,192,deathknight,frost,12,2,10
Menethill,darkspear,192,deathknight,frost,12,2,10
Erilisa,malorne,192,deathknight,frost,12,2,10
Narrua,die-aldor,192,deathknight,frost,12,2,10
Kenseisan,kazzak,192,deathknight,frost,12,2,10
Dklékata,archimonde,192,deathknight,frost,12,2,10
Deadlygnome,silvermoon,192,deathknight,frost,12,2,10
Бахлыщ,soulflayer,192,deathknight,frost,12,2,10
Adreak,defias-brotherhood,192,deathknight,frost,12,2,10
Tüsa,exodar,192,deathknight,frost,18,2,16
Moograine,anachronos,191,deathknight,frost,6,2,4
Pachecodk,aggra-português,191,deathknight,frost,6,2,4
Ренкус,grom,191,deathknight,frost,6,2,4
Lithirion,ysondre,191,deathknight,frost,12,2,10
Пума,eversong,187,deathknight,frost,24,2,22
Bloodywife,die-ewige-wacht,159,deathknight,frost,5,2,3
Endlesspain,burning-legion,138,deathknight,frost,8,3,5
Xøry,blackrock,138,deathknight,frost,10,3,7
Maradk,drakthul,127,deathknight,frost,8,2,6
Spunka,azjolnerub,96,deathknight,frost,9,2,7
Todevcha,draenor,96,deathknight,frost,6,1,5
Veleran,blackrock,96,deathknight,frost,6,1,5
Wântted,archimonde,96,deathknight,frost,6,1,5
Dïkcite,archimonde,96,deathknight,frost,6,1,5
Jenkk,drakthul,96,deathknight,frost,6,1,5
Hurz,archimonde,96,deathknight,frost,6,1,5
Greatgrips,argent-dawn,96,deathknight,frost,6,1,5
Идзанаги,blackscar,96,deathknight,frost,6,1,5
Mârlák,blackhand,96,deathknight,frost,6,1,5
Sarunâs,antonidas,96,deathknight,frost,6,1,5
Filmsyz,ravencrest,96,deathknight,frost,6,1,5
Zagoôo,outland,96,deathknight,frost,6,1,5
Thryndiel,ravencrest,96,deathknight,frost,6,1,5
Ódar,silvermoon,96,deathknight,frost,6,1,5
Mizrael,burning-blade,96,deathknight,frost,6,1,5
Noizt,ravencrest,96,deathknight,frost,6,1,5
Syncros,blackrock,96,deathknight,frost,6,1,5
Yoroh,magtheridon,96,deathknight,frost,6,1,5
Thínkk,ysondre,96,deathknight,frost,6,1,5
Mptak,kazzak,96,deathknight,frost,6,1,5
Triqué,antonidas,96,deathknight,frost,6,1,5
Thyrandre,khaz-modan,96,deathknight,frost,6,1,5
Jacksc,aggramar,96,deathknight,frost,6,1,5
Pierun,dunemaul,96,deathknight,frost,6,1,5
Bwonsamdiez,kazzak,96,deathknight,frost,6,1,5
Sokkara,silvermoon,96,deathknight,frost,6,1,5
Rognvald,les-sentinelles,96,deathknight,frost,6,1,5
Lîçhkîng,kazzak,96,deathknight,frost,6,1,5
Rudysek,dunemaul,96,deathknight,frost,6,1,5
ßlink,dun-modr,96,deathknight,frost,6,1,5
Гнидостный,howling-fjord,96,deathknight,frost,6,1,5
Qingen,earthen-ring,96,deathknight,frost,6,1,5
Вирзерагна,howling-fjord,96,deathknight,frost,6,1,5
Urukaye,silvermoon,96,deathknight,frost,6,1,5
Skalbjörn,arathor,96,deathknight,frost,6,1,5
Brurf,ysondre,96,deathknight,frost,6,1,5
Rodimus,arathor,96,deathknight,frost,6,1,5
Kptayn,culte-de-la-rive-noire,96,deathknight,frost,6,1,5
Pokkel,silvermoon,96,deathknight,frost,6,1,5
Feddk,stormscale,96,deathknight,frost,6,1,5
Armanelo,stormscale,96,deathknight,frost,6,1,5
Gigadk,ragnaros,96,deathknight,frost,6,1,5
Iseetouch,draenor,96,deathknight,frost,6,1,5
Gotbaked,outland,96,deathknight,frost,6,1,5
Zpartan,ragnaros,96,deathknight,frost,6,1,5
Umadßroh,sanguino,96,deathknight,frost,6,1,5
Lilliith,sanguino,96,deathknight,frost,6,1,5
Thirtyfour,aegwynn,96,deathknight,frost,6,1,5
Conqueròr,tarren-mill,96,deathknight,frost,6,1,5
Escaflowno,outland,96,deathknight,frost,6,1,5
Lusankyaa,argent-dawn,96,deathknight,frost,6,1,5
Буризан,blackscar,96,deathknight,frost,6,1,5
Дкшрёдингера,gordunni,96,deathknight,frost,6,1,5
Veçh,turalyon,96,deathknight,frost,6,1,5
Slimez,magtheridon,96,deathknight,frost,6,1,5
Промештейн,gordunni,96,deathknight,frost,9,1,8
Хенстор,gordunni,96,deathknight,frost,12,1,11
Лятеха,gordunni,96,deathknight,frost,12,1,11
Asmodian,uldaman,96,deathknight,frost,12,1,11
Shaturi,antonidas,96,deathknight,frost,12,1,11
Burebistà,eonar,96,deathknight,frost,12,1,11
Müldgren,ysondre,96,deathknight,frost,12,1,11
Nirna,argent-dawn,96,deathknight,frost,24,1,23
Arzuriel,arygos,95,deathknight,frost,6,1,5
Infamousmobb,archimonde,79,deathknight,frost,5,1,4
Zýnês,thrall,79,deathknight,frost,5,1,4
Tamatus,ulduar,79,deathknight,frost,11,1,10
Lathspelli,zenedar,64,deathknight,frost,4,1,3
Grubyr,burning-legion,31,deathknight,frost,2,1,1
Dripcatchér,ravencrest,2387,demonhunter,havoc,200,114,86
Íllìðåñgøðx,twisting-nether,2353,demonhunter,havoc,370,192,178
Glìmpsêgøðx,twisting-nether,2344,demonhunter,havoc,350,188,162
Norgan,die-aldor,2339,demonhunter,havoc,153,85,68
Norgàn,die-aldor,2307,demonhunter,havoc,161,89,72
Mips,ghostlands,2306,demonhunter,havoc,144,78,66
Siuli,minahonda,2277,demonhunter,havoc,221,115,106
Razzagall,elune,2258,demonhunter,havoc,83,45,38
Elswavé,kazzak,2231,demonhunter,havoc,168,95,73
Guësswho,twisting-nether,2201,demonhunter,havoc,117,60,57
Zslebaans,dun-modr,2173,demonhunter,havoc,266,134,132
Antrix,ravencrest,2164,demonhunter,havoc,94,48,46
Milanto,antonidas,2160,demonhunter,havoc,177,94,83
Ðesz,sanguino,2153,demonhunter,havoc,95,52,43
Itsdampbaby,kazzak,2151,demonhunter,havoc,121,63,58
Majînßûü,ravencrest,2147,demonhunter,havoc,77,42,35
Rùkîbazùkï,ravencrest,2146,demonhunter,havoc,83,51,32
Ráiku,ravencrest,2141,demonhunter,havoc,90,47,43
Brolafsen,ravencrest,2131,demonhunter,havoc,126,66,60
Ewynadh,die-aldor,2127,demonhunter,havoc,241,124,117
Enysia,twisting-nether,2127,demonhunter,havoc,122,62,60
Bxdh,argent-dawn,2126,demonhunter,havoc,168,87,81
Lelaniae,blackhand,2126,demonhunter,havoc,107,55,52
Natosyywaor,dun-modr,2124,demonhunter,havoc,77,40,37
Jinwoo,area-52,2124,demonhunter,havoc,149,76,73
Hellwynne,archimonde,2117,demonhunter,havoc,134,78,56
Cuddlypeanut,argent-dawn,2115,demonhunter,havoc,291,147,144
Zuklio,ysondre,2108,demonhunter,havoc,235,117,118
Истребитель,blackscar,2103,demonhunter,havoc,378,210,168
Моигваза,soulflayer,2103,demonhunter,havoc,103,51,52
Лфгхиро,soulflayer,2101,demonhunter,havoc,65,37,28
Antrixa,ravencrest,2086,demonhunter,havoc,98,49,49
Battlebruh,ghostlands,2076,demonhunter,havoc,134,66,68
Badtime,malganis,2074,demonhunter,havoc,236,124,112
Мортрэд,gordunni,2069,demonhunter,havoc,173,96,77
Konydh,outland,2067,demonhunter,havoc,446,232,214
Neunelfturbo,ravencrest,2063,demonhunter,havoc,83,53,30
Drmanaburn,ravencrest,2062,demonhunter,havoc,82,45,37
Ozu,blackrock,2061,demonhunter,havoc,149,79,70
Boostbydh,archimonde,2059,demonhunter,havoc,279,143,136
Évø,silvermoon,2044,demonhunter,havoc,153,74,79
Apfelbaum,die-aldor,2038,demonhunter,havoc,84,58,26
Qk,ghostlands,2034,demonhunter,havoc,144,71,73
Dantert,zuljin,2032,demonhunter,havoc,102,57,45
Zhadrom,ragnaros,2028,demonhunter,havoc,101,51,50
Mavorz,blackhand,2026,demonhunter,havoc,60,38,22
Demonalpha,stormscale,2018,demonhunter,havoc,61,34,27
Nèvér,silvermoon,2014,demonhunter,havoc,143,74,69
Heatx,ysondre,2012,demonhunter,havoc,216,115,101
Melan,sanguino,2012,demonhunter,havoc,186,89,97
Nèvér,kazzak,2011,demonhunter,havoc,133,78,55
Lòsêr,ravencrest,2009,demonhunter,havoc,120,61,59
Ezrnkone,stormscale,2006,demonhunter,havoc,89,54,35
Supay,rexxar,2004,demonhunter,havoc,82,47,35
Badtimes,malganis,1998,demonhunter,havoc,307,159,148
Лфгнехиро,soulflayer,1997,demonhunter,havoc,24,21,3
Диджейвжух,gordunni,1996,demonhunter,havoc,143,72,71
Smydi,blackmoore,1991,demonhunter,havoc,112,82,30
Finwe,outland,1988,demonhunter,havoc,87,50,37
Veon,ravencrest,1988,demonhunter,havoc,281,136,145
Avye,tichondrius,1984,demonhunter,havoc,108,54,54
Yúki,blackrock,1983,demonhunter,havoc,102,51,51
Felthunder,twisting-nether,1979,demonhunter,havoc,78,43,35
Майвэйх,soulflayer,1977,demonhunter,havoc,327,165,162
Sofun,stormscale,1976,demonhunter,havoc,626,315,311
Ûro,dun-modr,1970,demonhunter,havoc,204,103,101
Bämbøué,hyjal,1970,demonhunter,havoc,113,56,57
Deehâ,eredar,1968,demonhunter,havoc,150,86,64
Jimfromsales,argent-dawn,1968,demonhunter,havoc,66,34,32
Çrymemøre,dun-modr,1967,demonhunter,havoc,185,100,85
Betterevoker,outland,1966,demonhunter,havoc,294,154,140
Battlebruuh,ghostlands,1964,demonhunter,havoc,72,31,41
Gíftig,ravencrest,1963,demonhunter,havoc,276,142,134
Ohseri,defias-brotherhood,1962,demonhunter,havoc,245,120,125
Burchulica,sylvanas,1959,demonhunter,havoc,72,42,30
Ледимиледи,lich-king,1959,demonhunter,havoc,89,39,50
Майотх,gordunni,1958,demonhunter,havoc,349,178,171
Írony,draenor,1958,demonhunter,havoc,198,97,101
Neiìf,blackhand,1958,demonhunter,havoc,72,31,41
Miscóde,twisting-nether,1952,demonhunter,havoc,120,68,52
Anabbele,kazzak,1946,demonhunter,havoc,153,80,73
Aiean,ravencrest,1945,demonhunter,havoc,342,170,172
Depure,blackrock,1945,demonhunter,havoc,135,64,71
Wàýztøpgx,ravencrest,1941,demonhunter,havoc,160,73,87
Scubaman,tarren-mill,1940,demonhunter,havoc,198,101,97
Krm,dun-modr,1937,demonhunter,havoc,118,63,55
Wibez,twisting-nether,1937,demonhunter,havoc,214,114,100
Chïbrøne,archimonde,1937,demonhunter,havoc,84,38,46
Empúsa,stormscale,1936,demonhunter,havoc,164,90,74
Gushìñgwøuñð,blackmoore,1935,demonhunter,havoc,89,46,43
Læsy,antonidas,1932,demonhunter,havoc,175,87,88
Schrewneil,twisting-nether,1931,demonhunter,havoc,137,64,73
Cerad,ragnaros,1929,demonhunter,havoc,36,28,8
Tórstenstøck,ravencrest,1928,demonhunter,havoc,71,48,23
Хэллшок,eversong,1927,demonhunter,havoc,155,80,75
Satånist,outland,1926,demonhunter,havoc,420,217,203
Máédhros,ravencrest,1926,demonhunter,havoc,94,48,46
Ææçëñ,ravencrest,1923,demonhunter,havoc,136,70,66
Cydh,auchindoun,1922,demonhunter,havoc,132,66,66
Рензокукеен,gordunni,1921,demonhunter,havoc,127,62,65
Barbarinjo,silvermoon,1920,demonhunter,havoc,88,52,36
Realtrance,sanguino,1920,demonhunter,havoc,62,35,27
Carritoscrm,outland,1920,demonhunter,havoc,90,40,50
Pipeandy,kazzak,1919,demonhunter,havoc,125,66,59
Viced,kazzak,1919,demonhunter,havoc,124,61,63
Нэйтиси,soulflayer,1918,demonhunter,havoc,86,46,40
Ïfï,archimonde,1918,demonhunter,havoc,177,94,83
Leýara,blackmoore,1915,demonhunter,havoc,117,68,49
Yerla,burning-legion,1914,demonhunter,havoc,146,69,77
Véin,stormscale,1914,demonhunter,havoc,101,43,58
Wibergdh,kazzak,1911,demonhunter,havoc,78,42,36
Pulsefuzzy,burning-legion,1908,demonhunter,havoc,71,39,32
Ricedh,blackhand,1908,demonhunter,havoc,96,47,49
Åáäàáåàáäàáå,dun-modr,1906,demonhunter,havoc,122,61,61
Revérse,stormscale,1903,demonhunter,havoc,48,24,24
Shattre,silvermoon,1901,demonhunter,havoc,281,142,139
Icekissl,hyjal,1901,demonhunter,havoc,58,29,29
Pogdh,silvermoon,1900,demonhunter,havoc,105,60,45
Ourius,blackmoore,1900,demonhunter,havoc,66,36,30
Солфдх,fordragon,1900,demonhunter,havoc,120,57,63
Cyfel,auchindoun,1899,demonhunter,havoc,71,36,35
Юзлескласс,gordunni,1896,demonhunter,havoc,60,32,28
Delanoss,blackmoore,1896,demonhunter,havoc,181,95,86
Christysmack,tarren-mill,1896,demonhunter,havoc,300,151,149
Kardyö,archimonde,1896,demonhunter,havoc,142,70,72
Perna,ghostlands,1895,demonhunter,havoc,128,64,64
Çøððøøððøøðð,blackmoore,1893,demonhunter,havoc,486,246,240
Gøat,nemesis,1892,demonhunter,havoc,283,152,131
Mojothejojo,ravencrest,1891,demonhunter,havoc,130,72,58
Yamehd,stormreaver,1890,demonhunter,havoc,90,49,41
Soulstacker,outland,1888,demonhunter,havoc,110,56,54
Perojeina,draenor,1885,demonhunter,havoc,41,22,19
Dizbi,argent-dawn,1884,demonhunter,havoc,153,90,63
Shyynedh,grim-batol,1883,demonhunter,havoc,191,101,90
Illíllìllî,twisting-nether,1883,demonhunter,havoc,72,35,37
Periphere,eredar,1882,demonhunter,havoc,120,60,60
Chxpo,twisting-nether,1881,demonhunter,havoc,113,61,52
Carboen,tarren-mill,1881,demonhunter,havoc,150,80,70
Damatche,outland,1880,demonhunter,havoc,178,88,90
Monkeyddog,blackrock,1879,demonhunter,havoc,63,28,35
Skywålker,stormscale,1878,demonhunter,havoc,123,62,61
Boxssabanned,archimonde,1878,demonhunter,havoc,155,76,79
Brunhity,twisting-nether,1878,demonhunter,havoc,59,28,31
Brx,balnazzar,1876,demonhunter,havoc,60,31,29
Jisoô,tarren-mill,1874,demonhunter,havoc,55,27,28
Bogren,sylvanas,1873,demonhunter,havoc,253,125,128
Jumpmeister,ragnaros,1872,demonhunter,havoc,60,35,25
Màuul,ravencrest,1870,demonhunter,havoc,223,111,112
Geauxinue,archimonde,1870,demonhunter,havoc,106,52,54
Бабкамопед,howling-fjord,1869,demonhunter,havoc,299,155,144
Bigmóm,stormscale,1869,demonhunter,havoc,210,102,108
Chàk,marécage-de-zangar,1869,demonhunter,havoc,179,86,93
Zkrdh,kazzak,1866,demonhunter,havoc,94,45,49
Tozpak,sylvanas,1866,demonhunter,havoc,82,38,44
Раудвейф,gordunni,1865,demonhunter,havoc,30,20,10
Minifranger,archimonde,1865,demonhunter,havoc,357,183,174
Androwdings,dalaran,1863,demonhunter,havoc,63,35,28
Mazöku,ravencrest,1863,demonhunter,havoc,182,98,84
Donkeydh,tarren-mill,1862,demonhunter,havoc,66,41,25
Alythes,stormscale,1862,demonhunter,havoc,420,222,198
Mittÿ,tarren-mill,1862,demonhunter,havoc,137,66,71
Jincksdh,kazzak,1861,demonhunter,havoc,61,29,32
Dpsspec,draenor,1861,demonhunter,havoc,126,59,67
Sturmimon,arthas,1861,demonhunter,havoc,102,46,56
Блэйденрифтс,soulflayer,1859,demonhunter,havoc,88,48,40
Yukiz,ravencrest,1858,demonhunter,havoc,203,100,103
Firstwolf,twisting-nether,1856,demonhunter,havoc,89,42,47
Unseenshadow,ragnaros,1856,demonhunter,havoc,183,86,97
Asukakazama,twisting-nether,1856,demonhunter,havoc,75,33,42
Billyhassan,kazzak,1855,demonhunter,havoc,102,62,40
Jeannedäsh,archimonde,1854,demonhunter,havoc,115,58,57
Mädchen,blackhand,1854,demonhunter,havoc,48,23,25
Onlyfangodx,antonidas,1853,demonhunter,havoc,42,22,20
Neverdance,ravencrest,1853,demonhunter,havoc,78,32,46
Mønkeyx,kazzak,1849,demonhunter,havoc,66,39,27
Biànca,outland,1847,demonhunter,havoc,86,44,42
Нереалочка,blackscar,1847,demonhunter,havoc,48,24,24
Dëëpdh,archimonde,1845,demonhunter,havoc,77,36,41
Eyecandy,scarshield-legion,1843,demonhunter,havoc,292,148,144
Grimjow,arthas,1843,demonhunter,havoc,73,34,39
Гранкрю,blackscar,1841,demonhunter,havoc,108,61,47
Snubbeldemon,outland,1841,demonhunter,havoc,59,29,30
Evilidan,hyjal,1840,demonhunter,havoc,60,27,33
Rxor,eredar,1838,demonhunter,havoc,120,66,54
Vexanic,chamber-of-aspects,1838,demonhunter,havoc,99,53,46
Zakaji,blackmoore,1837,demonhunter,havoc,112,65,47
Fotmdehatwo,blackrock,1837,demonhunter,havoc,61,32,29
Ilovelilith,zuljin,1837,demonhunter,havoc,129,67,62
Whøo,stormscale,1835,demonhunter,havoc,26,24,2
Ðoksy,archimonde,1835,demonhunter,havoc,78,40,38
Lasaka,stormscale,1833,demonhunter,havoc,155,95,60
Haldin,kazzak,1833,demonhunter,havoc,128,70,58
Erzàuwu,silvermoon,1833,demonhunter,havoc,71,31,40
Koiskdh,tarren-mill,1831,demonhunter,havoc,84,50,34
Zeroques,frostmane,1831,demonhunter,havoc,66,33,33
Сасун,galakrond,1831,demonhunter,havoc,69,32,37
Ranked,drakthul,1830,demonhunter,havoc,203,98,105
Demoncyka,twisting-nether,1830,demonhunter,havoc,76,34,42
Charteryo,eredar,1829,demonhunter,havoc,60,35,25
Lassudan,stormreaver,1827,demonhunter,havoc,146,70,76
Sayph,hyjal,1826,demonhunter,havoc,54,30,24
Mordaer,twisting-nether,1826,demonhunter,havoc,204,103,101
Eréthrus,ravencrest,1826,demonhunter,havoc,73,35,38
Сибу,soulflayer,1825,demonhunter,havoc,48,21,27
Yarakobama,blackrock,1824,demonhunter,havoc,156,79,77
Maytherel,blackhand,1824,demonhunter,havoc,370,181,189
Anerana,malganis,1824,demonhunter,havoc,172,82,90
Eyasluna,twisting-nether,1824,demonhunter,havoc,124,59,65
Mürh,nordrassil,1824,demonhunter,havoc,54,25,29
Barneeéy,tarren-mill,1823,demonhunter,havoc,113,62,51
Bearrockx,alleria,1823,demonhunter,havoc,70,32,38
Qqski,kazzak,1822,demonhunter,havoc,54,31,23
Dasein,tarren-mill,1822,demonhunter,havoc,114,57,57
Brainlessdmg,ragnaros,1821,demonhunter,havoc,48,28,20
Necorinex,silvermoon,1821,demonhunter,havoc,54,30,24
Notlars,chamber-of-aspects,1821,demonhunter,havoc,77,42,35
Uldren,defias-brotherhood,1821,demonhunter,havoc,200,102,98
Dhhduhd,blackrock,1821,demonhunter,havoc,107,54,53
Эрнерион,soulflayer,1821,demonhunter,havoc,78,38,40
Azaeras,argent-dawn,1820,demonhunter,havoc,48,28,20
Quazr,outland,1820,demonhunter,havoc,368,205,163
Barny,skullcrusher,1820,demonhunter,havoc,347,179,168
Клопобойка,gordunni,1820,demonhunter,havoc,121,62,59
Элизар,howling-fjord,1820,demonhunter,havoc,150,76,74
Onof,hyjal,1820,demonhunter,havoc,96,43,53
Breezzdh,twisting-nether,1819,demonhunter,havoc,99,53,46
Мэйзиквин,howling-fjord,1819,demonhunter,havoc,321,165,156
Reckqt,eredar,1819,demonhunter,havoc,54,26,28
Bojestvena,twisting-nether,1818,demonhunter,havoc,294,146,148
Luwayne,blackmoore,1818,demonhunter,havoc,47,21,26
Corvox,argent-dawn,1818,demonhunter,havoc,75,32,43
Brawngodx,draenor,1817,demonhunter,havoc,109,69,40
Dreamslash,tarren-mill,1817,demonhunter,havoc,52,29,23
Elipireli,doomhammer,1817,demonhunter,havoc,84,40,44
Nørðìç,nordrassil,1816,demonhunter,havoc,42,25,17
Broglaive,sylvanas,1816,demonhunter,havoc,120,66,54
Velysaría,guldan,1816,demonhunter,havoc,172,94,78
Кайренсс,howling-fjord,1816,demonhunter,havoc,48,21,27
Dhgoddess,kazzak,1815,demonhunter,havoc,48,25,23
Âkazza,archimonde,1814,demonhunter,havoc,50,26,24
Voicechat,tarren-mill,1812,demonhunter,havoc,42,26,16
Найтшифт,blackscar,1811,demonhunter,havoc,46,29,17
Djratatouill,kazzak,1810,demonhunter,havoc,42,27,15
Kinstak,sanguino,1810,demonhunter,havoc,72,39,33
Khrtdh,silvermoon,1810,demonhunter,havoc,48,26,22
Slaanaesh,kazzak,1809,demonhunter,havoc,90,44,46
Хменчик,soulflayer,1809,demonhunter,havoc,97,47,50
Lemondehunta,twisting-nether,1808,demonhunter,havoc,60,33,27
Mandariâ,blackmoore,1808,demonhunter,havoc,60,32,28
Sàskiàn,draenor,1808,demonhunter,havoc,102,50,52
Iryut,onyxia,1808,demonhunter,havoc,137,67,70
Hopéless,aggra-português,1807,demonhunter,havoc,82,42,40
Камуи,gordunni,1807,demonhunter,havoc,201,101,100
Xarôth,eredar,1807,demonhunter,havoc,78,37,41
Ambudh,kazzak,1806,demonhunter,havoc,53,30,23
Felom,garona,1806,demonhunter,havoc,138,75,63
Дантеллиан,gordunni,1806,demonhunter,havoc,216,117,99
Кейтпрнстарс,howling-fjord,1806,demonhunter,havoc,206,111,95
Allosa,argent-dawn,1805,demonhunter,havoc,96,51,45
Broilerx,balnazzar,1805,demonhunter,havoc,110,56,54
Kïng,frostmane,1804,demonhunter,havoc,186,108,78
Jórúnn,twisting-nether,1804,demonhunter,havoc,95,53,42
Zireáel,stormscale,1804,demonhunter,havoc,74,40,34
Nerronaxd,silvermoon,1804,demonhunter,havoc,171,91,80
Annaboliik,ravencrest,1804,demonhunter,havoc,60,28,32
Illidarisi,auchindoun,1803,demonhunter,havoc,102,58,44
Kividari,dun-modr,1803,demonhunter,havoc,101,50,51
Myuøu,hyjal,1803,demonhunter,havoc,53,25,28
Jawohunt,rexxar,1803,demonhunter,havoc,108,49,59
Mür,nordrassil,1803,demonhunter,havoc,89,40,49
Anubias,ravencrest,1802,demonhunter,havoc,132,65,67
Phesxdh,sylvanas,1801,demonhunter,havoc,122,77,45
Kindablind,aggramar,1800,demonhunter,havoc,125,61,64
Bloodwatcher,twisting-nether,1800,demonhunter,havoc,65,30,35
Jco,kazzak,1800,demonhunter,havoc,50,23,27
Wyna,aggra-português,1799,demonhunter,havoc,261,132,129
Maevê,frostmourne,1798,demonhunter,havoc,67,32,35
Khétí,tarren-mill,1796,demonhunter,havoc,113,58,55
Fullsënd,ragnaros,1796,demonhunter,havoc,309,158,151
Oldforwow,outland,1796,demonhunter,havoc,228,116,112
Maurî,tarren-mill,1796,demonhunter,havoc,55,25,30
Уполномочен,howling-fjord,1794,demonhunter,havoc,60,32,28
Daemonax,ragnaros,1794,demonhunter,havoc,116,58,58
Dadøw,dun-modr,1794,demonhunter,havoc,90,42,48
Dbolmami,twisting-nether,1793,demonhunter,havoc,43,29,14
Camtoe,ravencrest,1793,demonhunter,havoc,264,144,120
Coolpizzaguy,twisting-nether,1793,demonhunter,havoc,90,42,48
Azzïnoth,sargeras,1792,demonhunter,havoc,126,69,57
Rvnx,archimonde,1792,demonhunter,havoc,388,204,184
Fiveyearques,sylvanas,1792,demonhunter,havoc,111,51,60
Fiduci,archimonde,1792,demonhunter,havoc,42,19,23
Dânÿ,elune,1791,demonhunter,havoc,129,65,64
Джастх,howling-fjord,1791,demonhunter,havoc,64,32,32
Ethína,kazzak,1791,demonhunter,havoc,78,38,40
Smoothbraiin,ravencrest,1790,demonhunter,havoc,149,80,69
Riñ,twisting-nether,1790,demonhunter,havoc,193,94,99
Soysoyum,argent-dawn,1789,demonhunter,havoc,72,38,34
Schøck,blackhand,1787,demonhunter,havoc,66,42,24
Kostiq,kazzak,1787,demonhunter,havoc,59,30,29
Stràt,ysondre,1787,demonhunter,havoc,143,66,77
Amatèrasú,kazzak,1784,demonhunter,havoc,58,29,29
Purpleturtle,blackrock,1783,demonhunter,havoc,78,38,40
Аркантт,soulflayer,1782,demonhunter,havoc,273,130,143
Nyalah,eredar,1781,demonhunter,havoc,60,32,28
Folygale,outland,1781,demonhunter,havoc,54,25,29
Kâsúxôxô,ravencrest,1780,demonhunter,havoc,46,27,19
Amnésysx,ysondre,1780,demonhunter,havoc,131,63,68
Trashcarlitô,eredar,1779,demonhunter,havoc,92,50,42
Dooj,sylvanas,1779,demonhunter,havoc,42,21,21
Ferihokurva,outland,1778,demonhunter,havoc,99,53,46
Гивюрхартми,gordunni,1778,demonhunter,havoc,125,59,66
Walkmyshoes,twisting-nether,1777,demonhunter,havoc,126,59,67
Врежимеэтти,soulflayer,1776,demonhunter,havoc,70,37,33
Merelini,twisting-nether,1775,demonhunter,havoc,46,25,21
Keiral,stormscale,1775,demonhunter,havoc,42,19,23
Cláw,ravencrest,1774,demonhunter,havoc,102,50,52
Sghemon,pozzo-delleternità,1774,demonhunter,havoc,54,26,28
Radamantyz,drakthul,1774,demonhunter,havoc,42,20,22
Íamprepared,tarren-mill,1774,demonhunter,havoc,60,26,34
Yarrøck,silvermoon,1773,demonhunter,havoc,207,104,103
Ячмо,gordunni,1773,demonhunter,havoc,64,32,32
Demonzøku,ravencrest,1773,demonhunter,havoc,54,27,27
Weback,ravencrest,1773,demonhunter,havoc,90,42,48
Сосочков,soulflayer,1772,demonhunter,havoc,353,180,173
Accurate,sanguino,1771,demonhunter,havoc,84,42,42
Snøwdh,outland,1769,demonhunter,havoc,63,37,26
Демонблэйдс,gordunni,1769,demonhunter,havoc,106,53,53
Nstea,cthun,1769,demonhunter,havoc,60,26,34
Simshady,stormscale,1768,demonhunter,havoc,163,90,73
Shtahuntna,tarren-mill,1768,demonhunter,havoc,545,290,255
Smâshêd,stormscale,1766,demonhunter,havoc,209,115,94
Demonmatheo,stormscale,1764,demonhunter,havoc,62,34,28
Гвинович,blackscar,1764,demonhunter,havoc,142,71,71
Cuirnoir,ravencrest,1763,demonhunter,havoc,72,37,35
Stickidan,malganis,1763,demonhunter,havoc,96,46,50
Blæm,archimonde,1762,demonhunter,havoc,75,40,35
Aroxos,draenor,1762,demonhunter,havoc,118,61,57
Тяннейм,deathguard,1761,demonhunter,havoc,121,67,54
Belákor,twisting-nether,1761,demonhunter,havoc,325,166,159
Charleyzard,argent-dawn,1760,demonhunter,havoc,130,73,57
Kezumå,tarren-mill,1760,demonhunter,havoc,126,65,61
Razex,kazzak,1760,demonhunter,havoc,192,99,93
Sgit,doomhammer,1760,demonhunter,havoc,154,67,87
Cumbayá,draenor,1759,demonhunter,havoc,36,22,14
Hunee,kazzak,1759,demonhunter,havoc,129,72,57
Opmuch,eonar,1759,demonhunter,havoc,192,103,89
Ted,frostwolf,1759,demonhunter,havoc,78,36,42
Oniramqt,aegwynn,1758,demonhunter,havoc,102,45,57
Подэхилла,galakrond,1756,demonhunter,havoc,142,75,67
Мэртольятти,soulflayer,1756,demonhunter,havoc,354,183,171
Trickstero,ragnaros,1755,demonhunter,havoc,188,96,92
Fotmøngø,argent-dawn,1754,demonhunter,havoc,53,28,25
Rïmðh,haomarush,1754,demonhunter,havoc,53,28,25
Зарах,gordunni,1754,demonhunter,havoc,138,71,67
Shanaplow,hyjal,1754,demonhunter,havoc,90,42,48
Авилолз,gordunni,1752,demonhunter,havoc,54,28,26
Maskinegoðx,tarren-mill,1752,demonhunter,havoc,78,37,41
Primolover,outland,1751,demonhunter,havoc,66,33,33
Nøbodyx,tarren-mill,1751,demonhunter,havoc,228,109,119
Carablue,hyjal,1750,demonhunter,havoc,48,26,22
Ymmothep,draenor,1750,demonhunter,havoc,495,263,232
Calloww,kazzak,1750,demonhunter,havoc,37,19,18
Dämonbumm,blackmoore,1750,demonhunter,havoc,93,44,49
Balberith,twisting-nether,1749,demonhunter,havoc,143,76,67
Pay,twisting-nether,1749,demonhunter,havoc,87,39,48
Zy,ahnqiraj,1748,demonhunter,havoc,41,23,18
Zedxx,kazzak,1748,demonhunter,havoc,153,76,77
Itadora,antonidas,1748,demonhunter,havoc,155,76,79
Sailen,blackmoore,1748,demonhunter,havoc,59,28,31
Happýk,kazzak,1747,demonhunter,havoc,30,20,10
Xotourlife,stormscale,1744,demonhunter,havoc,36,22,14
Lagseven,ravencrest,1744,demonhunter,havoc,63,31,32
Миелион,gordunni,1744,demonhunter,havoc,125,56,69
Chotzbrocke,blackhand,1743,demonhunter,havoc,42,23,19
Mongoose,drakthul,1743,demonhunter,havoc,190,94,96
Brawndow,draenor,1743,demonhunter,havoc,424,207,217
Автокикер,soulflayer,1742,demonhunter,havoc,66,36,30
Shirra,shadowsong,1742,demonhunter,havoc,131,67,64
Gnarpump,emeriss,1742,demonhunter,havoc,90,44,46
Illislan,darksorrow,1741,demonhunter,havoc,383,189,194
Illidiangød,sanguino,1740,demonhunter,havoc,60,34,26
Культсмерти,howling-fjord,1740,demonhunter,havoc,132,59,73
Jotaros,ravencrest,1739,demonhunter,havoc,48,20,28
Солевыеглефы,gordunni,1738,demonhunter,havoc,74,44,30
Jaquees,stormscale,1738,demonhunter,havoc,102,55,47
Skippydemon,nozdormu,1737,demonhunter,havoc,78,35,43
Makwah,kazzak,1737,demonhunter,havoc,48,20,28
Vizh,aegwynn,1736,demonhunter,havoc,90,41,49
Possomhd,kazzak,1734,demonhunter,havoc,201,109,92
Фавлав,ashenvale,1734,demonhunter,havoc,56,29,27
Blacklidan,blackrock,1733,demonhunter,havoc,73,36,37
Dêyza,archimonde,1733,demonhunter,havoc,58,26,32
Lilfly,twisting-nether,1732,demonhunter,havoc,66,34,32
Rasenhunt,blackmoore,1732,demonhunter,havoc,137,67,70
Malignantx,ragnaros,1731,demonhunter,havoc,223,109,114
Йактон,soulflayer,1731,demonhunter,havoc,42,20,22
Zernoid,kazzak,1730,demonhunter,havoc,42,26,16
Бистлайк,soulflayer,1730,demonhunter,havoc,66,38,28
Felpsita,kazzak,1730,demonhunter,havoc,121,61,60
Kázuyá,blackrock,1730,demonhunter,havoc,42,21,21
Usaïnbolts,archimonde,1730,demonhunter,havoc,66,31,35
Ewlyna,stormscale,1730,demonhunter,havoc,48,22,26
Narlà,silvermoon,1729,demonhunter,havoc,36,27,9
Anwenox,argent-dawn,1729,demonhunter,havoc,36,23,13
Дезлее,gordunni,1729,demonhunter,havoc,199,101,98
Turbomenak,drakthul,1728,demonhunter,havoc,54,34,20
Altsta,draenor,1728,demonhunter,havoc,129,67,62
Kryux,blackrock,1727,demonhunter,havoc,51,29,22
Zamassu,kazzak,1727,demonhunter,havoc,66,37,29
Азместь,howling-fjord,1727,demonhunter,havoc,42,20,22
Shadowjambo,twisting-nether,1725,demonhunter,havoc,81,45,36
Shyuk,sanguino,1725,demonhunter,havoc,66,35,31
Âyro,ravencrest,1724,demonhunter,havoc,102,59,43
Zerinitý,outland,1724,demonhunter,havoc,90,47,43
Blizó,tarren-mill,1724,demonhunter,havoc,36,18,18
Funkiller,stormscale,1724,demonhunter,havoc,91,45,46
Hextechz,stormscale,1723,demonhunter,havoc,117,68,49
Enjøybrah,nemesis,1723,demonhunter,havoc,157,85,72
Airelidari,tyrande,1723,demonhunter,havoc,215,106,109
Immørtaldh,tarren-mill,1723,demonhunter,havoc,48,23,25
Aarondh,ravencrest,1722,demonhunter,havoc,52,32,20
Nuxzhell,tarren-mill,1722,demonhunter,havoc,488,244,244
Felski,outland,1722,demonhunter,havoc,97,47,50
Anzz,kazzak,1721,demonhunter,havoc,96,50,46
Demondusk,silvermoon,1721,demonhunter,havoc,96,47,49
Gilletteabdi,argent-dawn,1721,demonhunter,havoc,295,139,156
Shadyblady,nemesis,1720,demonhunter,havoc,340,170,170
Ayyo,agamaggan,1720,demonhunter,havoc,51,22,29
Despèradø,archimonde,1719,demonhunter,havoc,194,105,89
Heimnar,frostmane,1719,demonhunter,havoc,42,22,20
Lòsâng,sanguino,1718,demonhunter,havoc,276,137,139
Håssan,ravencrest,1717,demonhunter,havoc,48,27,21
Teinzy,stormscale,1717,demonhunter,havoc,48,25,23
Shabalda,dun-morogh,1717,demonhunter,havoc,118,59,59
Lhya,tarren-mill,1716,demonhunter,havoc,119,64,55
Imslapping,draenor,1714,demonhunter,havoc,126,68,58
Felen,zuljin,1714,demonhunter,havoc,167,82,85
Hcsgötze,dalaran,1713,demonhunter,havoc,132,75,57
Bestro,tarren-mill,1713,demonhunter,havoc,140,70,70
Kuromiya,nemesis,1712,demonhunter,havoc,42,27,15
Indral,argent-dawn,1712,demonhunter,havoc,131,71,60
Бананчикус,gordunni,1712,demonhunter,havoc,172,88,84
Teletubby,blackrock,1712,demonhunter,havoc,42,18,24
Aethinos,sylvanas,1711,demonhunter,havoc,66,39,27
Nyalaah,eredar,1710,demonhunter,havoc,48,26,22
Xenits,kazzak,1710,demonhunter,havoc,106,53,53
Demxx,blackrock,1710,demonhunter,havoc,71,35,36
Ittas,archimonde,1709,demonhunter,havoc,30,18,12
Demonkata,twisting-nether,1709,demonhunter,havoc,128,71,57
Fizzpep,eredar,1709,demonhunter,havoc,70,36,34
Paiz,grim-batol,1709,demonhunter,havoc,51,26,25
Yorxdh,eredar,1708,demonhunter,havoc,51,31,20
Лизарин,gordunni,1708,demonhunter,havoc,101,46,55
Dhqoo,blackrock,1708,demonhunter,havoc,66,27,39
Demonade,ravencrest,1707,demonhunter,havoc,173,97,76
Teladar,outland,1707,demonhunter,havoc,74,40,34
Ilidrax,hyjal,1707,demonhunter,havoc,60,32,28
Турбосвинья,gordunni,1707,demonhunter,havoc,321,167,154
Alundil,ravencrest,1707,demonhunter,havoc,114,58,56
Yousaindh,blackrock,1707,demonhunter,havoc,125,59,66
Márcin,burning-legion,1706,demonhunter,havoc,176,87,89
Lanadelbae,teldrassil,1705,demonhunter,havoc,228,117,111
Garfie,ravencrest,1705,demonhunter,havoc,36,18,18
Rabæ,blackhand,1705,demonhunter,havoc,126,62,64
Эссенденс,gordunni,1705,demonhunter,havoc,64,31,33
Yaboyferv,tarren-mill,1705,demonhunter,havoc,48,19,29
Kamoridh,blackhand,1704,demonhunter,havoc,84,48,36
Batik,blackmoore,1704,demonhunter,havoc,346,171,175
Deathe,kilrogg,1703,demonhunter,havoc,101,53,48
Neralith,ravencrest,1703,demonhunter,havoc,119,62,57
Солстрэйл,gordunni,1703,demonhunter,havoc,155,79,76
Kebabidin,kazzak,1703,demonhunter,havoc,103,43,60
Kolísenn,drakthul,1702,demonhunter,havoc,168,88,80
Donipwnz,blackrock,1702,demonhunter,havoc,107,46,61
Aeko,silvermoon,1701,demonhunter,havoc,96,46,50
Vaiprix,ragnaros,1699,demonhunter,havoc,117,53,64
Krmâ,blackrock,1699,demonhunter,havoc,97,40,57
Кавайтити,howling-fjord,1697,demonhunter,havoc,154,83,71
Prepared,kaelthas,1697,demonhunter,havoc,93,46,47
Tanjero,stormscale,1696,demonhunter,havoc,53,36,17
Omegapump,ravencrest,1696,demonhunter,havoc,60,30,30
Dominik,the-maelstrom,1695,demonhunter,havoc,188,107,81
Guáca,draenor,1695,demonhunter,havoc,201,105,96
Blish,blackhand,1695,demonhunter,havoc,42,19,23
Sepdy,draenor,1694,demonhunter,havoc,158,84,74
Скинр,soulflayer,1694,demonhunter,havoc,102,54,48
Hornyhexy,stormscale,1694,demonhunter,havoc,332,174,158
Ifeeldirty,draenor,1693,demonhunter,havoc,57,32,25
Muyoni,eredar,1693,demonhunter,havoc,54,24,30
Bokajr,ragnaros,1692,demonhunter,havoc,82,43,39
Vorbis,twisting-nether,1692,demonhunter,havoc,253,130,123
Tyssra,argent-dawn,1692,demonhunter,havoc,335,161,174
Velvetrain,ravencrest,1692,demonhunter,havoc,48,21,27
Bizl,arygos,1691,demonhunter,havoc,36,23,13
Itàchì,kazzak,1691,demonhunter,havoc,60,38,22
Найтбладия,gordunni,1691,demonhunter,havoc,139,72,67
Faufilé,garona,1691,demonhunter,havoc,245,122,123
Róxor,twisting-nether,1691,demonhunter,havoc,123,58,65
Jnfd,outland,1691,demonhunter,havoc,56,24,32
Elenôy,antonidas,1689,demonhunter,havoc,48,26,22
Dhhuu,kazzak,1689,demonhunter,havoc,58,30,28
Ðemøñsåy,blackrock,1689,demonhunter,havoc,372,185,187
Shotraklul,zuljin,1689,demonhunter,havoc,143,61,82
Séphrióth,frostwolf,1686,demonhunter,havoc,134,73,61
Mårcxb,blackhand,1686,demonhunter,havoc,89,47,42
Геммула,howling-fjord,1686,demonhunter,havoc,266,136,130
Demobob,tarren-mill,1686,demonhunter,havoc,48,23,25
Hagana,tirion,1686,demonhunter,havoc,54,24,30
Batx,ravencrest,1686,demonhunter,havoc,64,28,36
Vênedri,eredar,1685,demonhunter,havoc,87,53,34
Höllymedx,blackmoore,1685,demonhunter,havoc,66,33,33
Турботашш,soulflayer,1685,demonhunter,havoc,162,79,83
Slutkitten,ravencrest,1684,demonhunter,havoc,48,21,27
Rerien,blackmoore,1682,demonhunter,havoc,95,52,43
Zevsa,ravencrest,1682,demonhunter,havoc,103,56,47
Fruchtzwerg,tarren-mill,1682,demonhunter,havoc,143,76,67
Edh,dalaran,1682,demonhunter,havoc,149,75,74
Dxæn,archimonde,1682,demonhunter,havoc,95,47,48
Emurid,les-sentinelles,1682,demonhunter,havoc,54,26,28
Míàkhãlîfâýð,stormscale,1682,demonhunter,havoc,62,26,36
Øoröra,hyjal,1681,demonhunter,havoc,112,67,45
Tdh,sanguino,1681,demonhunter,havoc,42,23,19
Финдита,ashenvale,1680,demonhunter,havoc,41,21,20
Øhka,outland,1680,demonhunter,havoc,102,51,51
Fatimá,stormscale,1678,demonhunter,havoc,33,22,11
Maøu,hyjal,1678,demonhunter,havoc,41,24,17
Atrikagodx,kazzak,1678,demonhunter,havoc,54,30,24
Zintu,draenor,1678,demonhunter,havoc,180,93,87
Skuz,archimonde,1677,demonhunter,havoc,36,20,16
Susanoø,eredar,1677,demonhunter,havoc,219,117,102
Hialdoo,bladefist,1677,demonhunter,havoc,84,41,43
Mâdzylîa,archimonde,1677,demonhunter,havoc,81,39,42
Mîlîm,silvermoon,1677,demonhunter,havoc,78,34,44
Geneset,nozdormu,1676,demonhunter,havoc,72,34,38
Trenfluencer,silvermoon,1675,demonhunter,havoc,115,71,44
Soizis,drakthul,1673,demonhunter,havoc,72,37,35
Twopumpchump,twisting-nether,1673,demonhunter,havoc,98,48,50
Stân,tarren-mill,1672,demonhunter,havoc,82,48,34
Malabala,grim-batol,1672,demonhunter,havoc,59,32,27
Hialdoo,sylvanas,1672,demonhunter,havoc,72,32,40
Illidankxx,sylvanas,1671,demonhunter,havoc,97,56,41
Kanabiztwo,outland,1671,demonhunter,havoc,414,214,200
Luunz,argent-dawn,1671,demonhunter,havoc,303,149,154
Øctågøñ,blackrock,1670,demonhunter,havoc,246,125,121
Rhinozerg,kazzak,1670,demonhunter,havoc,45,22,23
Richielou,outland,1670,demonhunter,havoc,54,25,29
Demondulle,kazzak,1670,demonhunter,havoc,66,25,41
Ììîîííììîîíí,tarren-mill,1669,demonhunter,havoc,78,44,34
Shadoss,ravencrest,1668,demonhunter,havoc,210,108,102
Pêrfêctnôw,blackmoore,1668,demonhunter,havoc,68,30,38
Yarudh,blackrock,1667,demonhunter,havoc,152,80,72
Тугеймовер,grom,1667,demonhunter,havoc,173,91,82
Brzzlbrzzl,malganis,1666,demonhunter,havoc,196,106,90
Eurobeat,dun-modr,1666,demonhunter,havoc,227,117,110
Demongodxx,twisting-nether,1666,demonhunter,havoc,78,39,39
Spicysteve,tarren-mill,1665,demonhunter,havoc,123,77,46
Alcóhon,ravencrest,1665,demonhunter,havoc,47,23,24
Sturmovik,ravencrest,1664,demonhunter,havoc,54,33,21
Êlva,alleria,1664,demonhunter,havoc,92,49,43
Thedudex,dunemaul,1664,demonhunter,havoc,80,41,39
Destinado,aggra-português,1663,demonhunter,havoc,66,38,28
Râindra,twisting-nether,1663,demonhunter,havoc,198,104,94
Isito,draenor,1663,demonhunter,havoc,130,68,62
Hofisis,kazzak,1663,demonhunter,havoc,60,31,29
Crappyftw,ravencrest,1663,demonhunter,havoc,690,356,334
Djdeathsweep,blackrock,1662,demonhunter,havoc,54,27,27
Thingawoop,tarren-mill,1662,demonhunter,havoc,97,48,49
Nepthýs,blackhand,1662,demonhunter,havoc,93,43,50
Ræko,sanguino,1661,demonhunter,havoc,144,75,69
Evildeeb,kazzak,1660,demonhunter,havoc,66,35,31
Ðêmønìnsìðê,blackmoore,1659,demonhunter,havoc,48,27,21
Nagatobimaru,tarren-mill,1659,demonhunter,havoc,109,55,54
Anayihh,dun-modr,1659,demonhunter,havoc,83,38,45
Zoyle,blackrock,1659,demonhunter,havoc,60,26,34
Lilydrop,varimathras,1659,demonhunter,havoc,51,20,31
Cheetòs,blackmoore,1658,demonhunter,havoc,75,40,35
Мишаметапамп,grom,1658,demonhunter,havoc,44,23,21
Nøvillain,blackrock,1657,demonhunter,havoc,102,59,43
Инферналка,howling-fjord,1656,demonhunter,havoc,166,89,77
Aylakesh,draenor,1655,demonhunter,havoc,53,30,23
Nisirae,argent-dawn,1655,demonhunter,havoc,174,98,76
Eibemme,alleria,1655,demonhunter,havoc,40,21,19
Vengeful,alonsus,1655,demonhunter,havoc,41,20,21
Vayshi,turalyon,1655,demonhunter,havoc,54,26,28
Èfiie,culte-de-la-rive-noire,1655,demonhunter,havoc,95,45,50
Picpouc,archimonde,1655,demonhunter,havoc,60,27,33
Felwinter,ravencrest,1654,demonhunter,havoc,234,114,120
Faytundh,kult-der-verdammten,1654,demonhunter,havoc,72,33,39
Turkoïs,silvermoon,1653,demonhunter,havoc,33,18,15
Tylleröwittu,grim-batol,1653,demonhunter,havoc,118,63,55
Skîllwhat,aegwynn,1653,demonhunter,havoc,67,35,32
Эллий,blackscar,1652,demonhunter,havoc,72,33,39
Zahadius,silvermoon,1651,demonhunter,havoc,59,37,22
Элунн,soulflayer,1650,demonhunter,havoc,42,22,20
Dldb,dentarg,1649,demonhunter,havoc,48,32,16
Deocleo,draenor,1649,demonhunter,havoc,43,24,19
Blankdh,outland,1649,demonhunter,havoc,49,27,22
Аллидариан,howling-fjord,1649,demonhunter,havoc,41,20,21
Tamtheone,silvermoon,1648,demonhunter,havoc,126,67,59
Ehrin,lightbringer,1648,demonhunter,havoc,170,80,90
Filthyape,ravencrest,1648,demonhunter,havoc,78,35,43
Ноубрейндыха,gordunni,1647,demonhunter,havoc,614,313,301
Амбату,howling-fjord,1646,demonhunter,havoc,56,38,18
Davidastt,drakthul,1646,demonhunter,havoc,125,61,64
Gigasloth,outland,1645,demonhunter,havoc,48,32,16
Scarath,eredar,1645,demonhunter,havoc,66,30,36
Aofaye,aegwynn,1645,demonhunter,havoc,77,29,48
Doomcake,emeriss,1644,demonhunter,havoc,66,37,29
Ekaõs,les-sentinelles,1644,demonhunter,havoc,53,28,25
Рейз,howling-fjord,1644,demonhunter,havoc,144,70,74
Трукейт,gordunni,1643,demonhunter,havoc,74,44,30
Spiriteru,archimonde,1643,demonhunter,havoc,54,29,25
Дэн,blackscar,1643,demonhunter,havoc,154,73,81
Drphillidan,tarren-mill,1643,demonhunter,havoc,126,59,67
Dontmashme,cthun,1643,demonhunter,havoc,54,25,29
Hauntedseoul,grim-batol,1642,demonhunter,havoc,162,95,67
Killia,lothar,1642,demonhunter,havoc,42,24,18
Nillrogthedh,stormscale,1641,demonhunter,havoc,265,147,118
Solarae,silvermoon,1641,demonhunter,havoc,166,89,77
Bestboytoy,ravencrest,1641,demonhunter,havoc,59,30,29
Депрессивдед,gordunni,1641,demonhunter,havoc,72,35,37
Sekørm,ragnaros,1641,demonhunter,havoc,54,23,31
Ðârksìðê,stormscale,1640,demonhunter,havoc,96,53,43
Elsynn,dalaran,1640,demonhunter,havoc,132,62,70
Sonreye,kazzak,1640,demonhunter,havoc,53,22,31
Ranzerg,tarren-mill,1639,demonhunter,havoc,60,38,22
Persio,sanguino,1639,demonhunter,havoc,135,73,62
Khray,archimonde,1639,demonhunter,havoc,48,25,23
Ziover,zuljin,1639,demonhunter,havoc,42,21,21
Rejstan,drakthul,1639,demonhunter,havoc,53,26,27
Meleidar,kazzak,1639,demonhunter,havoc,42,20,22
Муими,soulflayer,1639,demonhunter,havoc,84,37,47
Draxie,turalyon,1638,demonhunter,havoc,143,75,68
Flys,doomhammer,1638,demonhunter,havoc,200,103,97
Exoqt,blackhand,1638,demonhunter,havoc,166,80,86
Asmonsmash,twisting-nether,1638,demonhunter,havoc,64,30,34
Gwoodza,archimonde,1638,demonhunter,havoc,66,27,39
Wojtall,silvermoon,1637,demonhunter,havoc,558,286,272
Lawus,blackhand,1637,demonhunter,havoc,54,26,28
Папичгодх,borean-tundra,1637,demonhunter,havoc,87,36,51
Aylinx,blackrock,1636,demonhunter,havoc,60,29,31
Thorair,ravenholdt,1635,demonhunter,havoc,132,67,65
Like,shattrath,1635,demonhunter,havoc,38,19,19
Riptos,blackhand,1635,demonhunter,havoc,46,22,24
Mollamaija,defias-brotherhood,1635,demonhunter,havoc,85,36,49
Coniras,dun-morogh,1634,demonhunter,havoc,102,55,47
Azraethx,ravencrest,1633,demonhunter,havoc,66,38,28
Ðêmønìç,area-52,1633,demonhunter,havoc,72,41,31
Flyingwhale,terokkar,1633,demonhunter,havoc,105,50,55
Смутсайбот,howling-fjord,1633,demonhunter,havoc,48,22,26
Moojdh,malganis,1632,demonhunter,havoc,96,57,39
Smashdaddý,tarren-mill,1632,demonhunter,havoc,60,30,30
Nyxxeria,drakthul,1632,demonhunter,havoc,85,42,43
Salvadx,zuljin,1632,demonhunter,havoc,51,23,28
Integer,tarren-mill,1631,demonhunter,havoc,196,99,97
Kãzïn,archimonde,1631,demonhunter,havoc,83,41,42
Вориузз,soulflayer,1630,demonhunter,havoc,30,17,13
Pizjar,ravencrest,1630,demonhunter,havoc,54,28,26
Maodh,veknilash,1630,demonhunter,havoc,60,27,33
Anero,draenor,1630,demonhunter,havoc,85,37,48
Havocer,burning-legion,1629,demonhunter,havoc,165,86,79
ßroken,ragnaros,1629,demonhunter,havoc,48,22,26
Крикетчсв,soulflayer,1628,demonhunter,havoc,72,41,31
Evil,uldum,1628,demonhunter,havoc,179,94,85
Блъя,gordunni,1628,demonhunter,havoc,42,21,21
Padalecki,blackmoore,1628,demonhunter,havoc,47,21,26
Felbannedguy,twisting-nether,1627,demonhunter,havoc,42,23,19
Azaleia,archimonde,1627,demonhunter,havoc,228,116,112
Lyanadh,blackhand,1627,demonhunter,havoc,46,23,23
Оригамушка,gordunni,1627,demonhunter,havoc,48,23,25
Nopredh,blackrock,1627,demonhunter,havoc,133,62,71
Гадх,gordunni,1627,demonhunter,havoc,80,36,44
Крикадский,howling-fjord,1626,demonhunter,havoc,90,54,36
Huntoverkill,hyjal,1626,demonhunter,havoc,84,46,38
Sandem,blackrock,1626,demonhunter,havoc,90,47,43
Fuseton,kazzak,1626,demonhunter,havoc,42,20,22
Dhamp,kazzak,1625,demonhunter,havoc,30,17,13
Bosskuw,kazzak,1625,demonhunter,havoc,30,17,13
Sfguild,kazzak,1625,demonhunter,havoc,75,42,33
Kakashî,darksorrow,1625,demonhunter,havoc,42,22,20
Клитозавр,gordunni,1625,demonhunter,havoc,42,20,22
Lindzor,frostmane,1624,demonhunter,havoc,53,35,18
Bruxdh,colinas-pardas,1624,demonhunter,havoc,40,21,19
Нсэнс,soulflayer,1624,demonhunter,havoc,88,46,42
Onecho,ragnaros,1623,demonhunter,havoc,30,18,12
Mowiemow,argent-dawn,1623,demonhunter,havoc,35,18,17
Koomaliha,outland,1623,demonhunter,havoc,85,42,43
Soysoyum,draenor,1623,demonhunter,havoc,85,41,44
Tiktokfrida,twisting-nether,1623,demonhunter,havoc,36,17,19
Urukguy,silvermoon,1622,demonhunter,havoc,66,37,29
Бельторо,soulflayer,1622,demonhunter,havoc,123,68,55
Incanator,tarren-mill,1622,demonhunter,havoc,178,93,85
Mentalìst,blackmoore,1622,demonhunter,havoc,171,89,82
Enfy,twisting-nether,1622,demonhunter,havoc,154,75,79
Ravael,archimonde,1622,demonhunter,havoc,54,26,28
Naïtipa,arathi,1622,demonhunter,havoc,78,37,41
Akkixy,die-aldor,1621,demonhunter,havoc,53,30,23
Shiefwiggum,aegwynn,1620,demonhunter,havoc,60,34,26
Länika,drakthul,1620,demonhunter,havoc,42,23,19
Darkwing,silvermoon,1619,demonhunter,havoc,91,54,37
Dragontwist,sylvanas,1619,demonhunter,havoc,42,22,20
Фэсс,soulflayer,1619,demonhunter,havoc,149,77,72
Felsbane,argent-dawn,1618,demonhunter,havoc,39,25,14
Midoaa,nerathor,1618,demonhunter,havoc,42,22,20
Albdh,kazzak,1618,demonhunter,havoc,42,20,22
Keanujeeves,dentarg,1617,demonhunter,havoc,114,68,46
Cantseêyou,blackmoore,1617,demonhunter,havoc,177,98,79
Kanata,kazzak,1617,demonhunter,havoc,116,58,58
Abuelodosaka,dun-modr,1616,demonhunter,havoc,36,20,16
Пибзянка,howling-fjord,1616,demonhunter,havoc,36,20,16
Хирако,booty-bay,1616,demonhunter,havoc,66,35,31
Lghdtv,ravencrest,1616,demonhunter,havoc,144,74,70
Drâparn,sylvanas,1616,demonhunter,havoc,36,17,19
Izzidan,magtheridon,1616,demonhunter,havoc,45,21,24
Morgothe,ysondre,1616,demonhunter,havoc,56,25,31
Крикетгодх,howling-fjord,1615,demonhunter,havoc,39,24,15
Abendro,twisting-nether,1615,demonhunter,havoc,140,78,62
Xalgalor,silvermoon,1615,demonhunter,havoc,84,46,38
Telarris,twisting-nether,1615,demonhunter,havoc,462,246,216
Bohchín,zuljin,1615,demonhunter,havoc,318,167,151
Muckan,tarren-mill,1615,demonhunter,havoc,48,25,23
Ðanizâ,aegwynn,1615,demonhunter,havoc,81,42,39
Анавеллка,howling-fjord,1615,demonhunter,havoc,54,28,26
Wirsing,azshara,1615,demonhunter,havoc,191,98,93
Sikke,draenor,1615,demonhunter,havoc,42,21,21
Киттигоплей,soulflayer,1615,demonhunter,havoc,114,55,59
Shaely,arthas,1615,demonhunter,havoc,36,17,19
Leesplays,ravencrest,1614,demonhunter,havoc,60,36,24
Sîre,ravencrest,1614,demonhunter,havoc,30,17,13
Junkai,echsenkessel,1613,demonhunter,havoc,69,38,31
Кельдарк,soulflayer,1613,demonhunter,havoc,288,146,142
Stazó,drakthul,1613,demonhunter,havoc,161,79,82
Benihimee,twisting-nether,1613,demonhunter,havoc,84,40,44
Влажныйдемон,soulflayer,1612,demonhunter,havoc,30,25,5
Kéftëmé,ravencrest,1612,demonhunter,havoc,84,43,41
Çôæ,twisting-nether,1612,demonhunter,havoc,362,176,186
Talisnar,nemesis,1612,demonhunter,havoc,294,141,153
Netherim,twisting-nether,1612,demonhunter,havoc,134,58,76
Sickfck,ravencrest,1611,demonhunter,havoc,117,69,48
Narkiza,tarren-mill,1611,demonhunter,havoc,30,17,13
Великаямыша,blackscar,1611,demonhunter,havoc,86,48,38
Maupau,ravencrest,1610,demonhunter,havoc,105,59,46
Азелира,gordunni,1610,demonhunter,havoc,84,47,37
Kéøn,ravencrest,1610,demonhunter,havoc,108,58,50
Firebringer,silvermoon,1610,demonhunter,havoc,48,25,23
Gündüzgezen,silvermoon,1610,demonhunter,havoc,59,30,29
Demonichanta,azjolnerub,1610,demonhunter,havoc,304,153,151
Dedemøn,ysondre,1610,demonhunter,havoc,69,32,37
Zadian,twisting-nether,1610,demonhunter,havoc,70,32,38
Ultîma,hyjal,1610,demonhunter,havoc,54,21,33
Чуювонь,soulflayer,1609,demonhunter,havoc,78,44,34
Ðèaðlýsins,kazzak,1609,demonhunter,havoc,102,56,46
Дайкиаомине,soulflayer,1609,demonhunter,havoc,36,19,17
Loucee,blackhand,1609,demonhunter,havoc,96,49,47
Snitchezz,blackmoore,1608,demonhunter,havoc,162,88,74
Akalàkarcher,hyjal,1608,demonhunter,havoc,130,67,63
Heidihauge,silvermoon,1608,demonhunter,havoc,78,35,43
Fishmicksh,twisting-nether,1607,demonhunter,havoc,36,22,14
Enthia,antonidas,1607,demonhunter,havoc,119,65,54
Coffeecount,twisting-nether,1607,demonhunter,havoc,148,76,72
Pibzya,ravencrest,1607,demonhunter,havoc,85,43,42
Jynizu,silvermoon,1606,demonhunter,havoc,72,47,25
Kîallz,hyjal,1606,demonhunter,havoc,30,17,13
Kïallz,hyjal,1606,demonhunter,havoc,523,266,257
Metaisnice,nozdormu,1606,demonhunter,havoc,51,25,26
Chåk,marécage-de-zangar,1606,demonhunter,havoc,48,23,25
Майкелелекек,gordunni,1606,demonhunter,havoc,36,17,19
Völkswagen,dun-modr,1605,demonhunter,havoc,30,17,13
Thawgdh,silvermoon,1605,demonhunter,havoc,83,46,37
ßerdíná,tarren-mill,1605,demonhunter,havoc,60,31,29
Wintalker,nemesis,1605,demonhunter,havoc,99,51,48
Darrkdemon,kazzak,1605,demonhunter,havoc,445,229,216
Demonjagge,tarren-mill,1604,demonhunter,havoc,36,24,12
Escaboyx,stormscale,1604,demonhunter,havoc,41,27,14
Hatemaker,burning-legion,1604,demonhunter,havoc,158,85,73
Gonextbg,tarren-mill,1604,demonhunter,havoc,187,100,87
Shayanäa,les-clairvoyants,1604,demonhunter,havoc,66,35,31
Kinderbueno,the-maelstrom,1604,demonhunter,havoc,42,19,23
Nixzon,thrall,1604,demonhunter,havoc,78,31,47
Самаэльф,blackscar,1603,demonhunter,havoc,72,42,30
Ayö,draenor,1603,demonhunter,havoc,169,95,74
Trashclass,draenor,1603,demonhunter,havoc,34,18,16
Illiada,spinebreaker,1603,demonhunter,havoc,54,28,26
Weez,kilrogg,1603,demonhunter,havoc,266,128,138
Lolliance,talnivarr,1603,demonhunter,havoc,48,23,25
Demonkingx,twisting-nether,1603,demonhunter,havoc,58,24,34
Jamzydemon,kazzak,1602,demonhunter,havoc,24,17,7
Вскрыша,soulflayer,1602,demonhunter,havoc,36,20,16
Freylis,burning-legion,1602,demonhunter,havoc,62,31,31
Chosabreka,zuljin,1602,demonhunter,havoc,36,17,19
Синнэрлити,soulflayer,1602,demonhunter,havoc,54,25,29
Ðevl,blackmoore,1602,demonhunter,havoc,48,22,26
Cayssaelle,argent-dawn,1601,demonhunter,havoc,66,34,32
Ïîï,archimonde,1601,demonhunter,havoc,243,108,135
Demonsqueezy,nemesis,1600,demonhunter,havoc,111,68,43
Flaybalbooll,ragnaros,1600,demonhunter,havoc,406,214,192
Ícéìnmývèins,stormscale,1600,demonhunter,havoc,45,20,25
Torporu,tarren-mill,1599,demonhunter,havoc,60,34,26
Fazero,silvermoon,1599,demonhunter,havoc,139,67,72
Darrkmoff,sylvanas,1598,demonhunter,havoc,162,91,71
Sweetpety,tarren-mill,1598,demonhunter,havoc,159,84,75
Táti,blackrock,1598,demonhunter,havoc,42,19,23
Cappaowx,ravencrest,1597,demonhunter,havoc,30,21,9
Thorno,argent-dawn,1597,demonhunter,havoc,60,22,38
Knmdemon,draenor,1596,demonhunter,havoc,36,21,15
Antidevil,kazzak,1596,demonhunter,havoc,129,73,56
Âspen,archimonde,1596,demonhunter,havoc,209,110,99
Stickihunt,malganis,1596,demonhunter,havoc,42,18,24
Dinastye,archimonde,1595,demonhunter,havoc,186,97,89
Matally,khaz-modan,1595,demonhunter,havoc,60,30,30
Tatenzex,stormscale,1594,demonhunter,havoc,51,32,19
Saisahan,archimonde,1594,demonhunter,havoc,125,70,55
Glayvie,kazzak,1593,demonhunter,havoc,69,32,37
Blackfrostic,stormscale,1592,demonhunter,havoc,73,39,34
Bhairav,silvermoon,1591,demonhunter,havoc,36,21,15
Kekburagól,kazzak,1591,demonhunter,havoc,69,30,39
Speedførce,antonidas,1590,demonhunter,havoc,138,63,75
Ybou,archimonde,1590,demonhunter,havoc,66,24,42
Dhvyx,hyjal,1589,demonhunter,havoc,160,72,88
Gixota,silvermoon,1588,demonhunter,havoc,30,17,13
Jumboo,tarren-mill,1588,demonhunter,havoc,106,54,52
Ботология,gordunni,1588,demonhunter,havoc,108,51,57
Nowhereturun,stormscale,1587,demonhunter,havoc,60,31,29
Bignugs,ravencrest,1587,demonhunter,havoc,48,19,29
Xenca,ravencrest,1586,demonhunter,havoc,172,95,77
Реогансина,galakrond,1586,demonhunter,havoc,68,32,36
Badreal,sylvanas,1586,demonhunter,havoc,143,64,79
Kloo,hyjal,1585,demonhunter,havoc,59,34,25
Terrminator,darksorrow,1585,demonhunter,havoc,102,56,46
Eliàna,twisting-nether,1585,demonhunter,havoc,82,38,44
Venatica,twisting-nether,1584,demonhunter,havoc,120,67,53
Kyuzo,sanguino,1584,demonhunter,havoc,51,28,23
Umbraslash,argent-dawn,1584,demonhunter,havoc,107,57,50
Dialøl,twisting-nether,1584,demonhunter,havoc,39,19,20
Kins,dun-modr,1584,demonhunter,havoc,101,46,55
Knùbbz,ravencrest,1583,demonhunter,havoc,114,59,55
Mìkélol,stormscale,1583,demonhunter,havoc,48,19,29
Onizukadh,archimonde,1581,demonhunter,havoc,54,20,34
Olddemon,ravencrest,1580,demonhunter,havoc,116,72,44
Ðisgraze,argent-dawn,1580,demonhunter,havoc,309,157,152
Mazeeken,kazzak,1580,demonhunter,havoc,126,56,70
Sabe,ravencrest,1579,demonhunter,havoc,71,46,25
Tetedechaise,archimonde,1579,demonhunter,havoc,36,20,16
Släshes,kazzak,1579,demonhunter,havoc,104,50,54
Rezer,stormscale,1579,demonhunter,havoc,134,61,73
Badess,malfurion,1579,demonhunter,havoc,42,18,24
Gullveîg,archimonde,1578,demonhunter,havoc,137,75,62
Ydrael,terokkar,1578,demonhunter,havoc,60,32,28
Хингарский,deathguard,1578,demonhunter,havoc,104,55,49
Шизванаденс,gordunni,1578,demonhunter,havoc,89,44,45
Gandzsä,ragnaros,1578,demonhunter,havoc,156,76,80
Rybn,eredar,1578,demonhunter,havoc,105,46,59
Marrie,area-52,1576,demonhunter,havoc,36,21,15
Bhaz,tichondrius,1576,demonhunter,havoc,66,36,30
Devildust,ravencrest,1576,demonhunter,havoc,54,18,36
Aenirá,tarren-mill,1575,demonhunter,havoc,124,63,61
Деирдевил,blackscar,1574,demonhunter,havoc,66,34,32
Demonicano,draenor,1574,demonhunter,havoc,295,145,150
Dhive,blackrock,1574,demonhunter,havoc,48,23,25
Цезарий,gordunni,1573,demonhunter,havoc,261,133,128
Spheria,outland,1573,demonhunter,havoc,273,131,142
Demonpegasus,draenor,1573,demonhunter,havoc,101,45,56
Lodjay,hyjal,1572,demonhunter,havoc,70,35,35
Xocotl,blackmoore,1572,demonhunter,havoc,60,25,35
Mottenmann,tarren-mill,1570,demonhunter,havoc,53,32,21
Mezo,outland,1570,demonhunter,havoc,33,18,15
Shentarie,kazzak,1569,demonhunter,havoc,72,40,32
Aedilles,ravencrest,1569,demonhunter,havoc,96,53,43
Дикаяособа,howling-fjord,1569,demonhunter,havoc,141,77,64
Fumbiidhx,thrall,1569,demonhunter,havoc,117,63,54
Alervius,blackrock,1569,demonhunter,havoc,42,21,21
Judditdhx,draenor,1569,demonhunter,havoc,36,18,18
Verybigdps,aegwynn,1569,demonhunter,havoc,54,24,30
Сихая,howling-fjord,1568,demonhunter,havoc,42,24,18
Ayky,outland,1568,demonhunter,havoc,75,40,35
Jokidh,zuljin,1568,demonhunter,havoc,54,27,27
Asporos,pozzo-delleternità,1568,demonhunter,havoc,79,36,43
Ignasei,archimonde,1568,demonhunter,havoc,81,36,45
Дрэгонборн,howling-fjord,1567,demonhunter,havoc,116,60,56
Paindemon,outland,1567,demonhunter,havoc,91,46,45
Felspîrît,outland,1565,demonhunter,havoc,48,33,15
Minadng,silvermoon,1565,demonhunter,havoc,36,20,16
Sonnefel,tarren-mill,1565,demonhunter,havoc,107,55,52
Remn,archimonde,1565,demonhunter,havoc,54,22,32
Jugøbænned,blackrock,1564,demonhunter,havoc,42,27,15
Liladan,sylvanas,1564,demonhunter,havoc,30,17,13
ßerdína,tarren-mill,1564,demonhunter,havoc,182,89,93
Phudi,tarren-mill,1563,demonhunter,havoc,286,145,141
Nuitrayer,hyjal,1560,demonhunter,havoc,68,44,24
Аянамирейко,blackscar,1560,demonhunter,havoc,78,49,29
Demogon,thrall,1559,demonhunter,havoc,69,34,35
Deponiajkm,dun-modr,1559,demonhunter,havoc,42,18,24
Лучшедк,gordunni,1559,demonhunter,havoc,118,50,68
Аитерия,gordunni,1558,demonhunter,havoc,48,31,17
Onebuttonxd,ravencrest,1558,demonhunter,havoc,105,58,47
Baball,kazzak,1558,demonhunter,havoc,157,86,71
Kabomse,eredar,1557,demonhunter,havoc,34,19,15
Авалиас,gordunni,1557,demonhunter,havoc,76,41,35
Gïzmó,tarren-mill,1557,demonhunter,havoc,95,47,48
Ricmorphis,grim-batol,1557,demonhunter,havoc,65,28,37
Elvenfrey,kazzak,1556,demonhunter,havoc,112,54,58
Alied,burning-blade,1556,demonhunter,havoc,107,51,56
Themen,ragnaros,1555,demonhunter,havoc,54,34,20
Palangebahar,tarren-mill,1555,demonhunter,havoc,72,36,36
Akkita,ravencrest,1554,demonhunter,havoc,131,67,64
Aelìa,ysondre,1554,demonhunter,havoc,91,40,51
Thkingragnar,sanguino,1553,demonhunter,havoc,36,23,13
Cptncucumber,blackmoore,1553,demonhunter,havoc,258,127,131
Suitcåséguy,ravencrest,1553,demonhunter,havoc,48,18,30
Illidrax,outland,1553,demonhunter,havoc,48,18,30
Ekhlipz,ysondre,1553,demonhunter,havoc,54,18,36
Cynmatic,kargath,1552,demonhunter,havoc,80,40,40
Glímpse,ravencrest,1552,demonhunter,havoc,78,39,39
Dhzor,twisting-nether,1552,demonhunter,havoc,64,32,32
Zayláh,ravencrest,1552,demonhunter,havoc,135,64,71
Nidorino,aegwynn,1552,demonhunter,havoc,42,18,24
Shylea,ravencrest,1551,demonhunter,havoc,126,66,60
Aranéus,archimonde,1551,demonhunter,havoc,82,42,40
Nolitara,exodar,1551,demonhunter,havoc,98,47,51
Ashcan,tarren-mill,1550,demonhunter,havoc,121,62,59
Dvex,stormscale,1550,demonhunter,havoc,36,18,18
Brodor,alakir,1550,demonhunter,havoc,72,33,39
Jolyh,nemesis,1549,demonhunter,havoc,107,56,51
Дэйзиджонсон,soulflayer,1549,demonhunter,havoc,59,30,29
Sebyk,doomhammer,1548,demonhunter,havoc,89,48,41
Mamio,chogall,1548,demonhunter,havoc,94,50,44
Neomicha,blackmoore,1548,demonhunter,havoc,238,122,116
Самадиэль,soulflayer,1548,demonhunter,havoc,124,63,61
Mooty,drekthar,1548,demonhunter,havoc,36,18,18
Saleny,blackrock,1548,demonhunter,havoc,87,40,47
Pinkberry,outland,1548,demonhunter,havoc,48,22,26
Inflection,ravencrest,1548,demonhunter,havoc,72,29,43
Crylater,twisting-nether,1547,demonhunter,havoc,57,31,26
Chaosstrike,twisting-nether,1547,demonhunter,havoc,66,30,36
Baddxd,ragnaros,1547,demonhunter,havoc,80,34,46
Ibeem,dentarg,1546,demonhunter,havoc,105,66,39
Szexypopsi,ragnaros,1546,demonhunter,havoc,95,51,44
Akaria,blackrock,1545,demonhunter,havoc,141,82,59
Mikezilla,drakthul,1544,demonhunter,havoc,69,36,33
Kätarïnas,confrérie-du-thorium,1544,demonhunter,havoc,36,18,18
Дашажмимету,blackscar,1544,demonhunter,havoc,44,21,23
Ragel,grim-batol,1544,demonhunter,havoc,65,28,37
Топдекдх,howling-fjord,1544,demonhunter,havoc,137,58,79
Däshgødx,stormscale,1543,demonhunter,havoc,54,31,23
Art,tarren-mill,1543,demonhunter,havoc,77,44,33
Olessias,cthun,1542,demonhunter,havoc,30,18,12
Error,ravencrest,1542,demonhunter,havoc,64,34,30
Unkqt,dalaran,1542,demonhunter,havoc,72,35,37
Danfurtunica,draenor,1542,demonhunter,havoc,108,50,58
Valarauk,ravencrest,1541,demonhunter,havoc,261,141,120
Эльгастон,howling-fjord,1541,demonhunter,havoc,159,80,79
Bichmicher,earthen-ring,1541,demonhunter,havoc,60,23,37
Schejtan,blackmoore,1539,demonhunter,havoc,120,64,56
Razrsolo,tarren-mill,1539,demonhunter,havoc,183,92,91
Xpllen,shadowsong,1539,demonhunter,havoc,44,21,23
Demonmancer,ravencrest,1537,demonhunter,havoc,318,161,157
Mcfitty,stormscale,1537,demonhunter,havoc,90,44,46
Никкэс,gordunni,1536,demonhunter,havoc,96,55,41
Roaf,twisting-nether,1536,demonhunter,havoc,99,48,51
Xekaul,tarren-mill,1536,demonhunter,havoc,379,182,197
Demonakis,twisting-nether,1536,demonhunter,havoc,113,49,64
Inolia,argent-dawn,1536,demonhunter,havoc,70,28,42
Ávto,stormscale,1535,demonhunter,havoc,95,64,31
Johncoffèy,ragnaros,1535,demonhunter,havoc,24,16,8
Winxclub,ravencrest,1535,demonhunter,havoc,113,62,51
Ryuwar,dun-modr,1535,demonhunter,havoc,141,72,69
Гневлуны,lich-king,1535,demonhunter,havoc,121,60,61
Sèptember,draenor,1535,demonhunter,havoc,83,38,45
Molntuss,ravencrest,1535,demonhunter,havoc,134,59,75
Nèmésîs,gorgonnash,1535,demonhunter,havoc,74,32,42
Qweqweasd,outland,1534,demonhunter,havoc,30,16,14
Méruème,hyjal,1534,demonhunter,havoc,43,22,21
Sutures,ravencrest,1534,demonhunter,havoc,43,21,22
Ckboo,kazzak,1533,demonhunter,havoc,65,33,32
Hyprdh,blackrock,1533,demonhunter,havoc,34,17,17
Lastactiondh,dun-morogh,1531,demonhunter,havoc,72,44,28
Хенноо,howling-fjord,1531,demonhunter,havoc,36,17,19
Snibsxdh,silvermoon,1531,demonhunter,havoc,60,27,33
Kanabiz,outland,1530,demonhunter,havoc,358,186,172
Elønaria,antonidas,1529,demonhunter,havoc,30,17,13
Mylandea,die-aldor,1529,demonhunter,havoc,54,29,25
Õmen,ravencrest,1529,demonhunter,havoc,38,18,20
Полутемный,howling-fjord,1528,demonhunter,havoc,98,51,47
Рэгес,howling-fjord,1527,demonhunter,havoc,60,32,28
Чанпэн,soulflayer,1526,demonhunter,havoc,163,85,78
Niklâûs,ysondre,1525,demonhunter,havoc,48,33,15
Lennöx,silvermoon,1525,demonhunter,havoc,67,38,29
Alareey,antonidas,1525,demonhunter,havoc,285,139,146
Rúllio,rexxar,1525,demonhunter,havoc,54,22,32
Däny,zuljin,1525,demonhunter,havoc,54,22,32
Drilloz,ravencrest,1524,demonhunter,havoc,30,18,12
Shivarræ,stormreaver,1524,demonhunter,havoc,60,31,29
Kranta,blackmoore,1524,demonhunter,havoc,58,26,32
Геннитиро,deathguard,1523,demonhunter,havoc,34,20,14
Yeedhlol,blackmoore,1523,demonhunter,havoc,30,16,14
Luckertwo,tarren-mill,1523,demonhunter,havoc,362,191,171
Pvpabuser,ravencrest,1521,demonhunter,havoc,140,79,61
Zelidh,korgall,1521,demonhunter,havoc,30,16,14
Èstefany,stormscale,1521,demonhunter,havoc,180,91,89
Sanfia,twisting-nether,1521,demonhunter,havoc,36,17,19
Vaimustus,outland,1521,demonhunter,havoc,59,23,36
Спииртт,blackscar,1521,demonhunter,havoc,78,29,49
Zulthealbino,tarren-mill,1520,demonhunter,havoc,68,40,28
Spacedance,silvermoon,1520,demonhunter,havoc,32,17,15
Kayzel,argent-dawn,1519,demonhunter,havoc,379,190,189
Mêgumi,kirin-tor,1519,demonhunter,havoc,348,174,174
Rylqt,blackmoore,1519,demonhunter,havoc,145,68,77
Mëy,thrall,1519,demonhunter,havoc,65,28,37
Asylèm,draenor,1518,demonhunter,havoc,89,45,44
Norac,silvermoon,1518,demonhunter,havoc,78,39,39
Кррюкс,gordunni,1517,demonhunter,havoc,55,29,26
Taÿkyn,archimonde,1517,demonhunter,havoc,78,39,39
Deqthstrïke,ysondre,1516,demonhunter,havoc,29,17,12
Obitum,burning-legion,1516,demonhunter,havoc,206,112,94
Qtt,arthas,1516,demonhunter,havoc,42,19,23
Felledelfine,kazzak,1515,demonhunter,havoc,66,30,36
Zwizch,draenor,1515,demonhunter,havoc,82,37,45
Exceltor,sanguino,1515,demonhunter,havoc,72,28,44
Dhsheesh,draenor,1514,demonhunter,havoc,48,25,23
Shaihulud,sanguino,1514,demonhunter,havoc,455,233,222
Ардатйякши,borean-tundra,1514,demonhunter,havoc,110,47,63
Nørkos,ysondre,1513,demonhunter,havoc,34,20,14
Фумиан,soulflayer,1513,demonhunter,havoc,100,48,52
Atlizzdh,twisting-nether,1513,demonhunter,havoc,54,25,29
Mephilax,stormscale,1512,demonhunter,havoc,30,17,13
Цэрри,soulflayer,1512,demonhunter,havoc,83,42,41
Ruíko,dun-morogh,1511,demonhunter,havoc,89,45,44
Âyoôrts,archimonde,1509,demonhunter,havoc,59,31,28
Iphanaa,frostmane,1509,demonhunter,havoc,128,64,64
Mephîsto,sylvanas,1508,demonhunter,havoc,210,108,102
Ceyye,blackrock,1507,demonhunter,havoc,54,26,28
Драксх,gordunni,1507,demonhunter,havoc,95,44,51
Mâlefiz,blackmoore,1507,demonhunter,havoc,48,22,26
Azaeel,blackhand,1507,demonhunter,havoc,42,17,25
Tenawees,blackmoore,1506,demonhunter,havoc,66,37,29
Lilitlovesme,blackmoore,1506,demonhunter,havoc,42,23,19
Exact,throkferoth,1506,demonhunter,havoc,119,60,59
Theaisbae,twisting-nether,1506,demonhunter,havoc,54,25,29
Loria,tyrande,1505,demonhunter,havoc,36,20,16
Camilysu,perenolde,1505,demonhunter,havoc,71,33,38
Änyä,ravencrest,1504,demonhunter,havoc,40,21,19
Malami,burning-legion,1503,demonhunter,havoc,36,20,16
Shäck,archimonde,1503,demonhunter,havoc,179,93,86
Sidekiq,silvermoon,1503,demonhunter,havoc,58,29,29
Duffin,doomhammer,1503,demonhunter,havoc,207,102,105
Bùlkbogan,kazzak,1502,demonhunter,havoc,36,19,17
Onlyw,ravencrest,1501,demonhunter,havoc,35,27,8
Lanaël,kaelthas,1501,demonhunter,havoc,36,20,16
Íllìðåñgøðx,antonidas,1500,demonhunter,havoc,118,57,61
Demonetized,blackrock,1500,demonhunter,havoc,36,17,19
Kreoshimaru,archimonde,1499,demonhunter,havoc,30,20,10
Версомния,gordunni,1498,demonhunter,havoc,66,32,34
Insaneomg,blackmoore,1497,demonhunter,havoc,40,16,24
Astartë,stormscale,1496,demonhunter,havoc,78,42,36
Naltharian,drakthul,1496,demonhunter,havoc,71,33,38
Demonicrage,burning-legion,1495,demonhunter,havoc,32,18,14
Conte,darksorrow,1495,demonhunter,havoc,40,22,18
Amionisiken,amanthul,1495,demonhunter,havoc,308,161,147
Агрочика,borean-tundra,1495,demonhunter,havoc,60,28,32
Shironeko,ysondre,1495,demonhunter,havoc,58,27,31
Hanuta,alleria,1495,demonhunter,havoc,48,22,26
Kiirtach,dun-modr,1494,demonhunter,havoc,27,18,9
Blizdliksk,outland,1494,demonhunter,havoc,54,30,24
Parmesano,tyrande,1493,demonhunter,havoc,96,56,40
Sofie,aerie-peak,1493,demonhunter,havoc,54,31,23
Fellespont,hellscream,1493,demonhunter,havoc,93,40,53
Ashiharademo,twilights-hammer,1492,demonhunter,havoc,167,86,81
Drakhiel,hyjal,1491,demonhunter,havoc,36,16,20
Fckmlf,outland,1490,demonhunter,havoc,132,68,64
Lovesong,the-shatar,1490,demonhunter,havoc,183,94,89
Эинхерия,soulflayer,1490,demonhunter,havoc,105,49,56
Myztiko,hellscream,1489,demonhunter,havoc,206,105,101
Exoduss,ravencrest,1489,demonhunter,havoc,87,42,45
Échô,tarren-mill,1489,demonhunter,havoc,40,18,22
Gouteça,la-croisade-écarlate,1489,demonhunter,havoc,42,16,26
Skyborn,tarren-mill,1488,demonhunter,havoc,99,55,44
Xetalar,burning-legion,1488,demonhunter,havoc,204,109,95
Enhtailo,draenor,1488,demonhunter,havoc,42,21,21
Läderjoel,ravencrest,1488,demonhunter,havoc,71,34,37
Noitradh,zuljin,1487,demonhunter,havoc,48,27,21
Alithy,kazzak,1487,demonhunter,havoc,162,90,72
Malakbel,nemesis,1487,demonhunter,havoc,378,190,188
Xyrs,draenor,1487,demonhunter,havoc,42,21,21
Shylaría,blackhand,1487,demonhunter,havoc,78,35,43
Кайриель,gordunni,1486,demonhunter,havoc,48,29,19
Booka,bladefist,1486,demonhunter,havoc,30,16,14
Guccibaby,silvermoon,1486,demonhunter,havoc,108,53,55
Древиал,gordunni,1485,demonhunter,havoc,62,35,27
Покахонта,soulflayer,1484,demonhunter,havoc,100,54,46
Imsickleavme,draenor,1484,demonhunter,havoc,124,62,62
Коньх,goldrinn,1484,demonhunter,havoc,156,76,80
Felguard,darksorrow,1484,demonhunter,havoc,131,62,69
Wârz,aegwynn,1484,demonhunter,havoc,49,23,26
Штормдоттэр,howling-fjord,1483,demonhunter,havoc,65,33,32
Tmluu,nazjatar,1483,demonhunter,havoc,43,21,22
Apokalypsra,blackmoore,1482,demonhunter,havoc,145,73,72
Oonn,outland,1482,demonhunter,havoc,45,21,24
Axxad,ragnaros,1482,demonhunter,havoc,95,42,53
Morskivuk,draenor,1481,demonhunter,havoc,44,26,18
Carnii,ambossar,1481,demonhunter,havoc,54,25,29
Misli,stormscale,1480,demonhunter,havoc,54,29,25
Trinchensdh,blackhand,1480,demonhunter,havoc,74,37,37
Нуунас,soulflayer,1480,demonhunter,havoc,249,123,126
Føresight,blackmoore,1480,demonhunter,havoc,59,28,31
Tachala,khaz-modan,1479,demonhunter,havoc,57,24,33
Ülquiorrä,kazzak,1478,demonhunter,havoc,59,38,21
Icelucard,argent-dawn,1478,demonhunter,havoc,129,69,60
Sakumi,azshara,1478,demonhunter,havoc,249,120,129
Oggidanbuu,tarren-mill,1478,demonhunter,havoc,49,22,27
Toonsdh,kazzak,1477,demonhunter,havoc,127,71,56
Осхимс,deathguard,1477,demonhunter,havoc,275,151,124
Ларэгар,azuregos,1477,demonhunter,havoc,106,51,55
Tapio,burning-legion,1477,demonhunter,havoc,103,48,55
Экселия,howling-fjord,1476,demonhunter,havoc,119,64,55
Teladrias,ravencrest,1476,demonhunter,havoc,46,24,22
Boozlike,tarren-mill,1476,demonhunter,havoc,126,62,64
Przemson,mazrigos,1475,demonhunter,havoc,170,82,88
Lolbalanced,burning-legion,1475,demonhunter,havoc,83,40,43
Merizane,antonidas,1474,demonhunter,havoc,127,65,62
Dyamo,sylvanas,1474,demonhunter,havoc,652,322,330
Safedaddy,silvermoon,1474,demonhunter,havoc,51,23,28
Siio,antonidas,1473,demonhunter,havoc,147,81,66
Itheos,kazzak,1473,demonhunter,havoc,258,133,125
Luzifer,ambossar,1473,demonhunter,havoc,503,259,244
Netrisha,ravencrest,1473,demonhunter,havoc,84,35,49
Thehûnt,outland,1472,demonhunter,havoc,101,55,46
Songur,blackhand,1471,demonhunter,havoc,36,17,19
Cielis,outland,1471,demonhunter,havoc,42,19,23
Treehunter,ravencrest,1470,demonhunter,havoc,30,16,14
Piloudh,dalaran,1469,demonhunter,havoc,56,27,29
Mihaliana,argent-dawn,1468,demonhunter,havoc,69,39,30
Dibo,blackmoore,1468,demonhunter,havoc,147,73,74
Хуракаши,howling-fjord,1468,demonhunter,havoc,39,19,20
Azmodían,silvermoon,1468,demonhunter,havoc,77,36,41
Zitx,ravencrest,1467,demonhunter,havoc,138,71,67
Khalestya,shendralar,1467,demonhunter,havoc,532,270,262
Elfmonger,ravencrest,1466,demonhunter,havoc,42,23,19
Féèlthèpåiñ,burning-legion,1466,demonhunter,havoc,66,30,36
Innocuouss,twisting-nether,1466,demonhunter,havoc,66,24,42
Kanéki,sylvanas,1465,demonhunter,havoc,47,33,14
Lydaro,malganis,1465,demonhunter,havoc,54,32,22
Сложныйдх,howling-fjord,1465,demonhunter,havoc,111,59,52
Шалдарон,howling-fjord,1465,demonhunter,havoc,58,30,28
Demonicdingo,lightnings-blade,1465,demonhunter,havoc,128,59,69
Palaurx,kazzak,1464,demonhunter,havoc,59,31,28
Hotshoxx,blackmoore,1464,demonhunter,havoc,54,22,32
Tursal,dun-morogh,1463,demonhunter,havoc,63,35,28
Saytana,ysondre,1463,demonhunter,havoc,83,41,42
Moonhorns,deathwing,1463,demonhunter,havoc,66,31,35
Zavoc,the-maelstrom,1462,demonhunter,havoc,51,28,23
Garoteromani,draenor,1462,demonhunter,havoc,201,104,97
Glitchx,silvermoon,1462,demonhunter,havoc,123,60,63
Kiwicrash,tarren-mill,1462,demonhunter,havoc,66,32,34
Împd,ravencrest,1462,demonhunter,havoc,108,52,56
Yvrig,eredar,1461,demonhunter,havoc,103,55,48
Метаденсер,gordunni,1461,demonhunter,havoc,36,17,19
Morow,die-ewige-wacht,1460,demonhunter,havoc,24,16,8
Frevee,outland,1460,demonhunter,havoc,143,78,65
Geashy,blackrock,1460,demonhunter,havoc,82,44,38
Jedbrazander,ragnaros,1460,demonhunter,havoc,54,25,29
Rawrus,blackmoore,1459,demonhunter,havoc,30,18,12
Бичерезх,soulflayer,1459,demonhunter,havoc,73,43,30
Pettitebang,ravencrest,1459,demonhunter,havoc,94,52,42
Mëwë,hyjal,1459,demonhunter,havoc,78,43,35
Kvye,archimonde,1459,demonhunter,havoc,30,16,14
Blîndmaster,ravencrest,1459,demonhunter,havoc,130,65,65
Emmunka,drakthul,1459,demonhunter,havoc,47,23,24
Métakagoule,ysondre,1459,demonhunter,havoc,93,45,48
Kenzaii,aegwynn,1459,demonhunter,havoc,66,29,37
Styxdh,blackhand,1458,demonhunter,havoc,30,16,14
Jyzu,festung-der-stürme,1458,demonhunter,havoc,102,52,50
Хорбелий,deathguard,1458,demonhunter,havoc,219,110,109
Aminféryadi,twisting-nether,1458,demonhunter,havoc,250,125,125
Этмер,soulflayer,1458,demonhunter,havoc,90,45,45
Kolrex,ragnaros,1458,demonhunter,havoc,77,37,40
Feluron,silvermoon,1457,demonhunter,havoc,30,24,6
Glerog,ragnaros,1457,demonhunter,havoc,60,33,27
Остроухйй,blackscar,1457,demonhunter,havoc,78,37,41
Actuallytrol,argent-dawn,1457,demonhunter,havoc,59,27,32
Satanmanna,twisting-nether,1457,demonhunter,havoc,108,49,59
Toddsnuggles,thrall,1456,demonhunter,havoc,60,37,23
Pyleá,malganis,1456,demonhunter,havoc,52,24,28
Balsza,burning-legion,1455,demonhunter,havoc,107,57,50
Alury,blackrock,1455,demonhunter,havoc,126,67,59
Croüp,draenor,1455,demonhunter,havoc,123,59,64
Eliyz,dalaran,1455,demonhunter,havoc,71,29,42
Felun,turalyon,1453,demonhunter,havoc,96,59,37
Ratho,ragnaros,1453,demonhunter,havoc,59,35,24
Kyru,frostwhisper,1453,demonhunter,havoc,111,63,48
Malzehar,tarren-mill,1453,demonhunter,havoc,45,24,21
Nneverx,bladefist,1453,demonhunter,havoc,30,16,14
Шахдан,howling-fjord,1453,demonhunter,havoc,185,91,94
Sesrix,silvermoon,1452,demonhunter,havoc,125,71,54
Chrístíe,sanguino,1452,demonhunter,havoc,58,23,35
Vvdh,ravencrest,1451,demonhunter,havoc,40,23,17
Dirtydoggy,dun-modr,1451,demonhunter,havoc,126,59,67
Ðhgøðx,outland,1449,demonhunter,havoc,54,30,24
Anklàr,blackrock,1449,demonhunter,havoc,60,30,30
Tenx,auchindoun,1449,demonhunter,havoc,36,16,20
Terrorblader,malygos,1449,demonhunter,havoc,45,19,26
Zumei,stormreaver,1448,demonhunter,havoc,110,57,53
Wolfsøng,tarren-mill,1448,demonhunter,havoc,144,71,73
Munamasa,archimonde,1446,demonhunter,havoc,63,32,31
Koralentprix,twisting-nether,1446,demonhunter,havoc,68,33,35
Эридали,gordunni,1445,demonhunter,havoc,135,72,63
Nyach,kazzak,1445,demonhunter,havoc,132,70,62
Talamacus,outland,1445,demonhunter,havoc,96,48,48
Omegasyx,dun-modr,1445,demonhunter,havoc,91,45,46
Cptxo,tarren-mill,1445,demonhunter,havoc,167,80,87
Шэдоуштормх,soulflayer,1444,demonhunter,havoc,112,62,50
Szopóvadász,ragnaros,1444,demonhunter,havoc,48,20,28
Типокрутойдх,howling-fjord,1443,demonhunter,havoc,24,19,5
Adraelia,archimonde,1443,demonhunter,havoc,119,66,53
Pówèr,ravencrest,1443,demonhunter,havoc,102,56,46
Vexblade,silvermoon,1443,demonhunter,havoc,290,154,136
Afuwarrior,doomhammer,1443,demonhunter,havoc,118,62,56
Ryänåir,ravencrest,1443,demonhunter,havoc,109,53,56
Zuljain,tarren-mill,1443,demonhunter,havoc,38,17,21
Korrupt,draenor,1443,demonhunter,havoc,36,16,20
Силдеус,galakrond,1442,demonhunter,havoc,96,55,41
Malveross,argent-dawn,1442,demonhunter,havoc,53,29,24
Arconta,blackmoore,1441,demonhunter,havoc,56,26,30
Ázârìûs,draenor,1440,demonhunter,havoc,48,22,26
Iamwicked,silvermoon,1439,demonhunter,havoc,24,15,9
Demøniac,ravencrest,1438,demonhunter,havoc,202,104,98
Грязюка,howling-fjord,1438,demonhunter,havoc,36,15,21
Opsidaisi,tarren-mill,1438,demonhunter,havoc,42,16,26
Arnokia,kazzak,1437,demonhunter,havoc,168,82,86
Nerudas,blackhand,1436,demonhunter,havoc,42,24,18
Грешный,gordunni,1436,demonhunter,havoc,30,16,14
Bamßi,ragnaros,1436,demonhunter,havoc,36,16,20
Fiepsy,alexstrasza,1435,demonhunter,havoc,50,26,24
Bippsy,zuljin,1434,demonhunter,havoc,79,44,35
Jïsoo,blackhand,1434,demonhunter,havoc,46,22,24
Wrakdh,archimonde,1433,demonhunter,havoc,74,46,28
Isp,kazzak,1433,demonhunter,havoc,96,49,47
Tôryon,archimonde,1433,demonhunter,havoc,54,27,27
Shõ,twisting-nether,1433,demonhunter,havoc,42,15,27
Vèga,thrall,1432,demonhunter,havoc,27,16,11
Kélida,dun-modr,1432,demonhunter,havoc,78,33,45
Calcïum,archimonde,1432,demonhunter,havoc,150,63,87
Ashrena,ysondre,1431,demonhunter,havoc,48,32,16
Деструкцыя,howling-fjord,1431,demonhunter,havoc,69,37,32
Albunico,draenor,1431,demonhunter,havoc,147,77,70
Дэйнни,blackscar,1431,demonhunter,havoc,75,37,38
Кирсена,gordunni,1431,demonhunter,havoc,137,66,71
Sionar,kazzak,1430,demonhunter,havoc,54,31,23
Kaylaz,eredar,1430,demonhunter,havoc,75,41,34
Daemis,dun-modr,1430,demonhunter,havoc,59,31,28
Quavanity,sylvanas,1430,demonhunter,havoc,41,17,24
Nvampire,draenor,1429,demonhunter,havoc,24,17,7
Kellogan,ragnaros,1429,demonhunter,havoc,30,17,13
Coca,stormreaver,1429,demonhunter,havoc,84,46,38
Felcaller,sylvanas,1429,demonhunter,havoc,87,46,41
Tòd,silvermoon,1429,demonhunter,havoc,140,69,71
Djaskmazi,archimonde,1428,demonhunter,havoc,42,15,27
Mareen,pozzo-delleternità,1427,demonhunter,havoc,60,31,29
Øbsessiøn,kazzak,1427,demonhunter,havoc,131,65,66
Gagfordaddy,ravencrest,1427,demonhunter,havoc,36,15,21
Zopekztropek,burning-legion,1426,demonhunter,havoc,78,45,33
Иллиферрат,blackscar,1426,demonhunter,havoc,394,199,195
Stellarvore,nemesis,1426,demonhunter,havoc,215,105,110
Impatìence,tarren-mill,1426,demonhunter,havoc,54,24,30
Kîrîto,nethersturm,1426,demonhunter,havoc,47,16,31
Hyggéè,sanguino,1424,demonhunter,havoc,78,42,36
Exodlia,silvermoon,1424,demonhunter,havoc,60,31,29
Fruttidimare,frostwolf,1424,demonhunter,havoc,165,85,80
Slaanesh,xavius,1423,demonhunter,havoc,45,27,18
Dawnsbreaker,twisting-nether,1423,demonhunter,havoc,54,23,31
Satti,sargeras,1423,demonhunter,havoc,36,15,21
Scarebearz,outland,1422,demonhunter,havoc,276,151,125
Ämi,blackmoore,1422,demonhunter,havoc,142,71,71
Chaosfist,blackrock,1421,demonhunter,havoc,79,41,38
Tayo,dun-modr,1421,demonhunter,havoc,71,35,36
Laholdrops,chants-éternels,1421,demonhunter,havoc,35,17,18
Emerelle,die-aldor,1421,demonhunter,havoc,227,108,119
Miràá,frostwolf,1420,demonhunter,havoc,36,15,21
Лолбичьпро,blackscar,1419,demonhunter,havoc,83,49,34
Алькирена,howling-fjord,1419,demonhunter,havoc,84,45,39
Syonis,archimonde,1419,demonhunter,havoc,73,39,34
Cheethless,ragnaros,1419,demonhunter,havoc,72,38,34
Ziltush,archimonde,1419,demonhunter,havoc,191,94,97
Yeéydh,tarren-mill,1419,demonhunter,havoc,64,29,35
Karakas,drakthul,1418,demonhunter,havoc,54,29,25
Spankoproof,kazzak,1418,demonhunter,havoc,30,16,14
Threathunt,outland,1418,demonhunter,havoc,50,23,27
Aphulucky,kazzak,1418,demonhunter,havoc,48,21,27
Zlett,draenor,1418,demonhunter,havoc,46,19,27
Biü,tarren-mill,1418,demonhunter,havoc,42,16,26
Сочняга,gordunni,1417,demonhunter,havoc,42,15,27
Demogen,sylvanas,1415,demonhunter,havoc,234,123,111
Flowen,stormreaver,1415,demonhunter,havoc,66,34,32
Razziyel,ragnaros,1415,demonhunter,havoc,65,33,32
Mìrkø,nemesis,1415,demonhunter,havoc,58,29,29
Tricksxx,tarren-mill,1415,demonhunter,havoc,30,15,15
Мужна,grom,1415,demonhunter,havoc,106,52,54
Такетомии,gordunni,1415,demonhunter,havoc,58,25,33
Storetal,ravencrest,1414,demonhunter,havoc,36,23,13
Cassitä,chogall,1414,demonhunter,havoc,102,56,46
Ragingbladex,kazzak,1414,demonhunter,havoc,85,46,39
Убийца,soulflayer,1414,demonhunter,havoc,82,42,40
Komei,stormscale,1414,demonhunter,havoc,36,17,19
Дахану,soulflayer,1414,demonhunter,havoc,106,47,59
Hatemrankone,outland,1413,demonhunter,havoc,63,30,33
Adalya,stormrage,1412,demonhunter,havoc,116,53,63
Funclass,blackrock,1411,demonhunter,havoc,24,15,9
Havocnslash,ragnaros,1411,demonhunter,havoc,42,23,19
Келадор,soulflayer,1411,demonhunter,havoc,155,74,81
Straizo,malganis,1411,demonhunter,havoc,38,18,20
Вирбль,gordunni,1411,demonhunter,havoc,95,39,56
Blóópy,silvermoon,1410,demonhunter,havoc,73,39,34
Megrella,stormscale,1409,demonhunter,havoc,210,104,106
Hairyjapgirl,silvermoon,1408,demonhunter,havoc,88,50,38
Sua,outland,1408,demonhunter,havoc,166,87,79
Smoochygodx,antonidas,1408,demonhunter,havoc,180,94,86
Yäkku,drakthul,1408,demonhunter,havoc,148,71,77
Рагнос,goldrinn,1408,demonhunter,havoc,48,16,32
Jennyßright,sargeras,1407,demonhunter,havoc,24,15,9
Maddjakni,draenor,1406,demonhunter,havoc,38,22,16
Killeedan,darksorrow,1406,demonhunter,havoc,48,22,26
Beörn,stormscale,1405,demonhunter,havoc,77,31,46
Philona,die-aldor,1404,demonhunter,havoc,186,96,90
Харольд,deepholm,1404,demonhunter,havoc,107,54,53
Xîr,silvermoon,1404,demonhunter,havoc,30,15,15
Divnapani,drakthul,1404,demonhunter,havoc,36,17,19
Choclatballs,stormscale,1404,demonhunter,havoc,125,59,66
Beraxulus,aegwynn,1404,demonhunter,havoc,52,24,28
Ulthil,confrérie-du-thorium,1403,demonhunter,havoc,25,15,10
Monkeypox,twisting-nether,1402,demonhunter,havoc,196,95,101
Sayee,drakthul,1401,demonhunter,havoc,36,23,13
Orenrg,dun-modr,1401,demonhunter,havoc,88,53,35
Watchmepoop,stormscale,1401,demonhunter,havoc,51,30,21
Vaynahi,grim-batol,1401,demonhunter,havoc,72,36,36
Gwx,draenor,1401,demonhunter,havoc,170,83,87
Morphiyy,tarren-mill,1400,demonhunter,havoc,54,28,26
Thugrøse,blackrock,1400,demonhunter,havoc,201,101,100
Natzú,ravencrest,1400,demonhunter,havoc,54,23,31
Archadric,ravencrest,1399,demonhunter,havoc,59,30,29
Varedisa,kazzak,1399,demonhunter,havoc,140,69,71
Tyhaxx,ravencrest,1399,demonhunter,havoc,102,48,54
Hupon,drakthul,1398,demonhunter,havoc,69,38,31
Wìxx,blackrock,1398,demonhunter,havoc,41,17,24
Тириола,howling-fjord,1397,demonhunter,havoc,76,41,35
Kékw,stormscale,1397,demonhunter,havoc,273,141,132
Skyzon,ravencrest,1396,demonhunter,havoc,35,19,16
Нейроуз,howling-fjord,1396,demonhunter,havoc,166,90,76
Grimberg,tarren-mill,1396,demonhunter,havoc,150,75,75
Demonbean,stormscale,1396,demonhunter,havoc,52,23,29
Дартарин,gordunni,1395,demonhunter,havoc,62,34,28
Singelx,outland,1394,demonhunter,havoc,24,15,9
Sadzari,burning-legion,1394,demonhunter,havoc,30,15,15
Aååááååââåâå,arygos,1394,demonhunter,havoc,30,15,15
Immune,aegwynn,1394,demonhunter,havoc,36,17,19
Morvash,nemesis,1393,demonhunter,havoc,114,59,55
Artï,ravencrest,1392,demonhunter,havoc,34,20,14
Pichkachu,sylvanas,1392,demonhunter,havoc,66,35,31
Нокаруру,gordunni,1392,demonhunter,havoc,78,38,40
Nanana,doomhammer,1392,demonhunter,havoc,198,95,103
Culywurly,silvermoon,1392,demonhunter,havoc,66,30,36
Dharuel,cthun,1392,demonhunter,havoc,60,25,35
Miyabí,drakthul,1392,demonhunter,havoc,105,43,62
Testôdh,blackrock,1392,demonhunter,havoc,52,18,34
Extraxtreme,ravencrest,1391,demonhunter,havoc,30,20,10
Реверсед,howling-fjord,1391,demonhunter,havoc,63,30,33
Brisingamen,outland,1390,demonhunter,havoc,94,45,49
Kamaz,twisting-nether,1387,demonhunter,havoc,87,45,42
Jazhz,dalaran,1386,demonhunter,havoc,66,31,35
Dayo,archimonde,1386,demonhunter,havoc,108,49,59
Ihløøx,minahonda,1385,demonhunter,havoc,110,54,56
Янатапки,howling-fjord,1384,demonhunter,havoc,24,15,9
Slyblades,tarren-mill,1384,demonhunter,havoc,180,90,90
Shadowweaver,earthen-ring,1381,demonhunter,havoc,30,17,13
Glavesong,burning-legion,1381,demonhunter,havoc,75,38,37
Гарражж,howling-fjord,1381,demonhunter,havoc,41,20,21
Thalamis,kazzak,1381,demonhunter,havoc,142,68,74
Imlegalblind,ragnaros,1380,demonhunter,havoc,106,48,58
Тушино,lich-king,1379,demonhunter,havoc,36,23,13
Овецловец,deathguard,1379,demonhunter,havoc,42,23,19
Avnanof,draenor,1379,demonhunter,havoc,30,15,15
Testorex,kazzak,1379,demonhunter,havoc,47,21,26
Sarissa,dun-modr,1378,demonhunter,havoc,58,36,22
Súrinox,blackrock,1377,demonhunter,havoc,92,53,39
Jesana,argent-dawn,1377,demonhunter,havoc,157,78,79
Moonbeàm,kazzak,1377,demonhunter,havoc,79,35,44
Undefeatable,stormrage,1376,demonhunter,havoc,30,17,13
Lexuirca,tarren-mill,1376,demonhunter,havoc,60,31,29
Kírstén,draenor,1375,demonhunter,havoc,29,15,14
Venge,la-croisade-écarlate,1375,demonhunter,havoc,69,34,35
Åelita,burning-legion,1375,demonhunter,havoc,74,36,38
Æä,draenor,1375,demonhunter,havoc,89,40,49
Штормкор,soulflayer,1374,demonhunter,havoc,53,23,30
Ultrashlozy,ravencrest,1373,demonhunter,havoc,45,23,22
Fotmfgt,eredar,1373,demonhunter,havoc,42,19,23
Zamp,deathwing,1373,demonhunter,havoc,51,23,28
Anstict,kazzak,1371,demonhunter,havoc,48,22,26
Kâtsulol,ysondre,1371,demonhunter,havoc,36,15,21
Seedor,archimonde,1370,demonhunter,havoc,116,58,58
Zayl,defias-brotherhood,1370,demonhunter,havoc,130,60,70
Bloodconte,darksorrow,1369,demonhunter,havoc,28,17,11
Baileeh,blackmoore,1369,demonhunter,havoc,42,23,19
Scotcheggs,argent-dawn,1369,demonhunter,havoc,191,97,94
Strikeforce,burning-legion,1369,demonhunter,havoc,72,31,41
Kouloukas,ragnaros,1369,demonhunter,havoc,42,17,25
Miragirl,stormscale,1368,demonhunter,havoc,74,35,39
Fulger,ghostlands,1368,demonhunter,havoc,78,34,44
Adapterinput,auchindoun,1367,demonhunter,havoc,132,69,63
Seyran,silvermoon,1367,demonhunter,havoc,30,15,15
Yugsiturath,drakthul,1367,demonhunter,havoc,122,59,63
Poutanaola,twisting-nether,1365,demonhunter,havoc,30,15,15
Naxuitawowa,quelthalas,1365,demonhunter,havoc,48,22,26
Иланари,gordunni,1364,demonhunter,havoc,65,39,26
Saiyanblue,tarren-mill,1364,demonhunter,havoc,32,18,14
Хайзи,gordunni,1364,demonhunter,havoc,54,29,25
Mbappé,archimonde,1364,demonhunter,havoc,47,18,29
Fùth,ysondre,1363,demonhunter,havoc,88,40,48
Kerog,blackmoore,1362,demonhunter,havoc,71,29,42
Илизарнный,gordunni,1362,demonhunter,havoc,42,17,25
Jyrpä,stormscale,1361,demonhunter,havoc,77,42,35
Zephyrê,blackrock,1361,demonhunter,havoc,164,83,81
Heiltgalen,grim-batol,1361,demonhunter,havoc,38,19,19
Natazia,eredar,1360,demonhunter,havoc,105,56,49
Liondrix,sanguino,1360,demonhunter,havoc,93,49,44
Trenoth,drakthul,1359,demonhunter,havoc,24,18,6
Баттлрэп,soulflayer,1359,demonhunter,havoc,104,47,57
Daiten,outland,1358,demonhunter,havoc,71,35,36
Methyza,thrall,1356,demonhunter,havoc,51,31,20
Kaizzy,twisting-nether,1356,demonhunter,havoc,179,95,84
Nadok,tarren-mill,1356,demonhunter,havoc,48,24,24
Beerseewälk,ragnaros,1356,demonhunter,havoc,88,41,47
Дэрзлорд,fordragon,1355,demonhunter,havoc,29,15,14
Héy,turalyon,1355,demonhunter,havoc,48,23,25
Savagee,ragnaros,1355,demonhunter,havoc,128,59,69
Persiana,dun-modr,1354,demonhunter,havoc,84,36,48
Aryuna,frostwolf,1353,demonhunter,havoc,39,24,15
Djaris,ghostlands,1352,demonhunter,havoc,24,16,8
Ðraudræm,ravencrest,1352,demonhunter,havoc,149,73,76
Fleshes,draenor,1350,demonhunter,havoc,57,28,29
Garretos,senjin,1349,demonhunter,havoc,49,29,20
Lockmylips,kazzak,1348,demonhunter,havoc,110,52,58
Valkorion,chamber-of-aspects,1348,demonhunter,havoc,63,28,35
Sokal,dun-modr,1348,demonhunter,havoc,110,48,62
Soo,aerie-peak,1347,demonhunter,havoc,53,32,21
Ikari,neptulon,1347,demonhunter,havoc,98,53,45
Devilord,sanguino,1347,demonhunter,havoc,30,16,14
Stringsz,ragnaros,1346,demonhunter,havoc,202,115,87
Maltok,ysondre,1346,demonhunter,havoc,101,55,46
Wauway,ragnaros,1344,demonhunter,havoc,54,27,27
Ðezs,dun-modr,1343,demonhunter,havoc,24,14,10
Reckqqt,eredar,1343,demonhunter,havoc,24,14,10
Eydipha,blackmoore,1342,demonhunter,havoc,24,14,10
Brolafsen,tarren-mill,1342,demonhunter,havoc,24,14,10
Watnntietnn,burning-blade,1342,demonhunter,havoc,126,61,65
Koger,twisting-nether,1342,demonhunter,havoc,30,14,16
Pidkova,tarren-mill,1342,demonhunter,havoc,80,36,44
Kibiri,rajaxx,1341,demonhunter,havoc,36,14,22
Дхашуля,gordunni,1340,demonhunter,havoc,30,18,12
Даблкорк,soulflayer,1340,demonhunter,havoc,125,70,55
Illídana,azjolnerub,1340,demonhunter,havoc,62,32,30
Манарифт,blackscar,1340,demonhunter,havoc,30,14,16
Piedonzo,nemesis,1340,demonhunter,havoc,36,14,22
Daemonai,neptulon,1339,demonhunter,havoc,120,61,59
Newgens,kazzak,1339,demonhunter,havoc,30,14,16
Lifel,nemesis,1339,demonhunter,havoc,56,26,30
Rehagen,ysondre,1339,demonhunter,havoc,36,14,22
Trekxx,ragnaros,1337,demonhunter,havoc,138,72,66
Daekon,ahnqiraj,1337,demonhunter,havoc,72,29,43
Dhogge,emerald-dream,1337,demonhunter,havoc,36,14,22
Ðeadínside,kazzak,1336,demonhunter,havoc,24,14,10
Kaitlyyn,norgannon,1335,demonhunter,havoc,60,28,32
Kainenn,silvermoon,1335,demonhunter,havoc,60,26,34
Hawoc,chamber-of-aspects,1334,demonhunter,havoc,42,26,16
Quakes,pozzo-delleternità,1334,demonhunter,havoc,84,47,37
Thulânn,twisting-nether,1334,demonhunter,havoc,30,14,16
Onlytwokeys,dun-modr,1333,demonhunter,havoc,102,51,51
Gamaö,khaz-modan,1333,demonhunter,havoc,59,26,33
Sinninse,blackmoore,1332,demonhunter,havoc,48,27,21
Бропинг,soulflayer,1332,demonhunter,havoc,338,174,164
Sharhan,sylvanas,1332,demonhunter,havoc,127,65,62
Ziplar,tarren-mill,1332,demonhunter,havoc,113,55,58
Armás,stormscale,1332,demonhunter,havoc,36,14,22
Lexim,khaz-modan,1331,demonhunter,havoc,72,40,32
Nezruslfive,dun-modr,1331,demonhunter,havoc,60,29,31
Amylia,perenolde,1331,demonhunter,havoc,58,27,31
Irenzy,twisting-nether,1331,demonhunter,havoc,36,14,22
Kurvamrusna,kazzak,1330,demonhunter,havoc,24,14,10
Мейьибейьи,howling-fjord,1330,demonhunter,havoc,30,15,15
Äzräël,dun-modr,1330,demonhunter,havoc,138,62,76
Грингекс,gordunni,1330,demonhunter,havoc,36,16,20
Notcrashy,eredar,1329,demonhunter,havoc,35,22,13
Checakore,argent-dawn,1329,demonhunter,havoc,66,34,32
Полетела,gordunni,1329,demonhunter,havoc,84,43,41
Tkr,zuljin,1329,demonhunter,havoc,126,63,63
Níghtwing,wildhammer,1329,demonhunter,havoc,83,39,44
Demozzer,ravencrest,1328,demonhunter,havoc,73,41,32
Батявздане,soulflayer,1328,demonhunter,havoc,58,32,26
Синяша,howling-fjord,1327,demonhunter,havoc,78,38,40
Nxtpls,silvermoon,1327,demonhunter,havoc,99,48,51
Calainis,twisting-nether,1326,demonhunter,havoc,88,46,42
Сильверган,soulflayer,1326,demonhunter,havoc,323,166,157
Dzidch,silvermoon,1326,demonhunter,havoc,72,36,36
Lilithxz,blackmoore,1326,demonhunter,havoc,36,16,20
Mjuliet,stormscale,1326,demonhunter,havoc,77,28,49
Ghiocelulog,draenor,1325,demonhunter,havoc,103,52,51
Soca,ysondre,1325,demonhunter,havoc,72,33,39
Kintschy,ragnaros,1325,demonhunter,havoc,48,21,27
Жемчужинка,eversong,1324,demonhunter,havoc,117,59,58
Егордемон,soulflayer,1323,demonhunter,havoc,46,25,21
Эндимэн,soulflayer,1323,demonhunter,havoc,157,85,72
Кейсимег,soulflayer,1323,demonhunter,havoc,357,177,180
Iaml,ravencrest,1323,demonhunter,havoc,67,32,35
Ibnia,azjolnerub,1323,demonhunter,havoc,32,14,18
Muharaar,ravencrest,1322,demonhunter,havoc,28,16,12
Slinks,silvermoon,1322,demonhunter,havoc,119,61,58
Destructs,sylvanas,1321,demonhunter,havoc,67,33,34
Daeneryz,drakthul,1321,demonhunter,havoc,55,23,32
Кельселай,soulflayer,1321,demonhunter,havoc,42,16,26
Grumpylicorn,archimonde,1320,demonhunter,havoc,30,14,16
Стрепа,grom,1319,demonhunter,havoc,159,89,70
Threebuttøns,ravencrest,1319,demonhunter,havoc,36,14,22
Ragnirok,deathwing,1318,demonhunter,havoc,138,66,72
Illyriel,antonidas,1318,demonhunter,havoc,106,48,58
Kídazi,draenor,1318,demonhunter,havoc,47,20,27
Matumbojumbo,outland,1317,demonhunter,havoc,135,66,69
Kebiz,ragnaros,1316,demonhunter,havoc,41,22,19
Zimmerdin,blackmoore,1316,demonhunter,havoc,33,15,18
Dadbodxd,stormscale,1315,demonhunter,havoc,42,22,20
Øæø,turalyon,1315,demonhunter,havoc,30,14,16
Posterboy,tarren-mill,1314,demonhunter,havoc,67,34,33
Mâdîta,todeswache,1313,demonhunter,havoc,30,16,14
Bestdemon,tarren-mill,1313,demonhunter,havoc,57,29,28
Obey,exodar,1312,demonhunter,havoc,47,22,25
Hatred,argent-dawn,1312,demonhunter,havoc,42,18,24
Jayhan,chamber-of-aspects,1311,demonhunter,havoc,68,37,31
Darksink,kazzak,1311,demonhunter,havoc,72,39,33
Райкан,soulflayer,1311,demonhunter,havoc,54,23,31
Шмальнуть,gordunni,1311,demonhunter,havoc,81,34,47
Aeshalla,blackmoore,1311,demonhunter,havoc,36,14,22
Vampirishi,frostwolf,1310,demonhunter,havoc,32,19,13
Дисофи,soulflayer,1310,demonhunter,havoc,96,45,51
Nightglaives,twisting-nether,1309,demonhunter,havoc,30,18,12
Valendriel,archimonde,1309,demonhunter,havoc,117,60,57
Maryjane,nordrassil,1307,demonhunter,havoc,96,57,39
Slowcuzclick,stormscale,1307,demonhunter,havoc,85,44,41
Lîllîv,wrathbringer,1307,demonhunter,havoc,71,34,37
Порядокх,soulflayer,1306,demonhunter,havoc,36,21,15
Kalr,silvermoon,1306,demonhunter,havoc,85,45,40
Тарапынька,gordunni,1305,demonhunter,havoc,158,83,75
Thëos,argent-dawn,1305,demonhunter,havoc,132,66,66
Damenhunter,malganis,1305,demonhunter,havoc,42,18,24
Illidarya,dunemaul,1305,demonhunter,havoc,48,20,28
Batghoul,laughing-skull,1304,demonhunter,havoc,29,16,13
Bicskas,ragnaros,1304,demonhunter,havoc,60,26,34
Headlessdh,ragnaros,1302,demonhunter,havoc,132,63,69
Каралас,soulflayer,1301,demonhunter,havoc,36,21,15
Demonpun,the-venture-co,1301,demonhunter,havoc,76,40,36
Shreddern,ragnaros,1300,demonhunter,havoc,91,45,46
Isila,alakir,1300,demonhunter,havoc,304,143,161
Lucthedané,ravencrest,1300,demonhunter,havoc,36,14,22
Felni,lightbringer,1299,demonhunter,havoc,66,38,28
Picotea,argent-dawn,1298,demonhunter,havoc,30,20,10
Sephiris,argent-dawn,1298,demonhunter,havoc,37,23,14
Gurvan,kazzak,1298,demonhunter,havoc,108,55,53
Nestrae,drakthul,1298,demonhunter,havoc,36,16,20
Konoth,kirin-tor,1296,demonhunter,havoc,123,65,58
Sîvîct,uldum,1294,demonhunter,havoc,32,18,14
Riema,bloodscalp,1294,demonhunter,havoc,58,31,27
Охотникн,howling-fjord,1293,demonhunter,havoc,72,30,42
Athoribos,silvermoon,1292,demonhunter,havoc,114,64,50
Kalî,forscherliga,1292,demonhunter,havoc,60,33,27
Unreally,tarren-mill,1292,demonhunter,havoc,39,15,24
Byakugaan,drakthul,1289,demonhunter,havoc,84,45,39
Venøøm,eldrethalas,1289,demonhunter,havoc,144,75,69
Bluespe,twisting-nether,1289,demonhunter,havoc,132,67,65
Jahannam,ysondre,1288,demonhunter,havoc,96,47,49
Nîksa,aegwynn,1288,demonhunter,havoc,66,29,37
Joeybadass,aegwynn,1288,demonhunter,havoc,42,18,24
Аликана,blackscar,1288,demonhunter,havoc,48,19,29
Száraz,ragnaros,1288,demonhunter,havoc,54,19,35
Roadruner,kazzak,1286,demonhunter,havoc,42,20,22
Gruusha,kazzak,1286,demonhunter,havoc,47,22,25
Féileacán,kazzak,1286,demonhunter,havoc,48,20,28
Marmelademad,twisting-nether,1285,demonhunter,havoc,24,14,10
Makri,outland,1285,demonhunter,havoc,198,105,93
Medievils,silvermoon,1285,demonhunter,havoc,230,109,121
Луксория,soulflayer,1285,demonhunter,havoc,82,38,44
Jëtman,ravencrest,1284,demonhunter,havoc,62,37,25
Sarrabulho,magtheridon,1284,demonhunter,havoc,72,32,40
Кевалат,gordunni,1283,demonhunter,havoc,42,26,16
Sangita,tarren-mill,1283,demonhunter,havoc,105,56,49
Реалистик,deathweaver,1282,demonhunter,havoc,133,62,71
Billidan,eredar,1282,demonhunter,havoc,54,25,29
Gnaget,the-maelstrom,1282,demonhunter,havoc,42,18,24
Æroa,antonidas,1281,demonhunter,havoc,56,30,26
Wårbÿ,ravencrest,1281,demonhunter,havoc,36,15,21
Actarüs,hyjal,1281,demonhunter,havoc,48,16,32
Ozeey,draenor,1280,demonhunter,havoc,29,14,15
Зографос,fordragon,1276,demonhunter,havoc,29,16,13
Ebache,darksorrow,1276,demonhunter,havoc,106,50,56
Saehila,kirin-tor,1276,demonhunter,havoc,149,70,79
Demonguard,draenor,1275,demonhunter,havoc,195,99,96
Calthmon,shattrath,1275,demonhunter,havoc,49,21,28
Clexa,thrall,1275,demonhunter,havoc,36,15,21
Shinydari,kazzak,1275,demonhunter,havoc,36,14,22
Ðmn,silvermoon,1275,demonhunter,havoc,62,23,39
Ascanius,nemesis,1274,demonhunter,havoc,169,95,74
Даудаев,gordunni,1274,demonhunter,havoc,78,42,36
Fikyx,draenor,1274,demonhunter,havoc,152,77,75
Dârhma,archimonde,1273,demonhunter,havoc,77,44,33
Нксин,howling-fjord,1273,demonhunter,havoc,42,21,21
Nuflin,eredar,1273,demonhunter,havoc,60,26,34
Apsodemon,twisting-nether,1272,demonhunter,havoc,22,15,7
Shishiro,alakir,1272,demonhunter,havoc,78,41,37
Øutsider,blackmoore,1272,demonhunter,havoc,143,71,72
Zuldekdh,sanguino,1272,demonhunter,havoc,30,14,16
Nasghul,drakthul,1272,demonhunter,havoc,84,39,45
Adroenz,twisting-nether,1272,demonhunter,havoc,54,23,31
Pleskdh,malganis,1272,demonhunter,havoc,54,23,31
Aleydan,shattered-hand,1271,demonhunter,havoc,66,31,35
Tzigonline,silvermoon,1271,demonhunter,havoc,41,17,24
Talwen,guldan,1269,demonhunter,havoc,30,19,11
Yamiagitosan,burning-legion,1269,demonhunter,havoc,77,39,38
Nephylon,draenor,1268,demonhunter,havoc,30,15,15
Symbul,blackrock,1268,demonhunter,havoc,115,56,59
Ilyerias,twisting-nether,1267,demonhunter,havoc,131,57,74
Trøbblete,ragnaros,1266,demonhunter,havoc,30,16,14
Жаркийсекс,soulflayer,1266,demonhunter,havoc,60,23,37
Schonevrouw,aszune,1265,demonhunter,havoc,66,38,28
Minutte,twisting-nether,1265,demonhunter,havoc,48,27,21
Неффкодх,howling-fjord,1265,demonhunter,havoc,133,58,75
Дримриэль,gordunni,1264,demonhunter,havoc,37,16,21
Grimrippa,the-maelstrom,1264,demonhunter,havoc,41,17,24
Luceafaru,draenor,1264,demonhunter,havoc,42,14,28
Goatcorpse,blackmoore,1263,demonhunter,havoc,66,33,33
Ìllídán,ravencrest,1261,demonhunter,havoc,140,73,67
Nÿnx,archimonde,1261,demonhunter,havoc,53,25,28
Erenyeagerr,kazzak,1260,demonhunter,havoc,52,31,21
Coltender,drakthul,1260,demonhunter,havoc,91,42,49
Felleaf,ragnaros,1260,demonhunter,havoc,70,28,42
Kratton,silvermoon,1259,demonhunter,havoc,62,29,33
Zejza,ragnaros,1257,demonhunter,havoc,85,41,44
Hirbs,silvermoon,1257,demonhunter,havoc,78,35,43
Yorkaj,kazzak,1257,demonhunter,havoc,126,52,74
Милинайт,eversong,1256,demonhunter,havoc,30,17,13
Chapzi,ragnaros,1256,demonhunter,havoc,51,26,25
Gurthalak,alakir,1256,demonhunter,havoc,59,30,29
Harha,stormscale,1256,demonhunter,havoc,99,48,51
Eviljunior,blackhand,1256,demonhunter,havoc,84,37,47
Sindweller,arathi,1256,demonhunter,havoc,40,16,24
Bessus,aggra-português,1254,demonhunter,havoc,82,43,39
Waviel,burning-legion,1254,demonhunter,havoc,59,27,32
Vaterdenke,defias-brotherhood,1253,demonhunter,havoc,30,19,11
Viridisignis,silvermoon,1252,demonhunter,havoc,269,140,129
Zøóm,tarren-mill,1250,demonhunter,havoc,24,14,10
Azâdi,blackhand,1250,demonhunter,havoc,48,26,22
Medom,stormreaver,1250,demonhunter,havoc,60,31,29
Bosque,ragnaros,1249,demonhunter,havoc,66,33,33
Abhimanyu,ravencrest,1249,demonhunter,havoc,108,48,60
Ludakrava,outland,1248,demonhunter,havoc,138,66,72
Эфемерид,howling-fjord,1248,demonhunter,havoc,48,22,26
Maat,anetheron,1248,demonhunter,havoc,43,18,25
Sweåfy,outland,1247,demonhunter,havoc,18,13,5
Fíendy,ravencrest,1247,demonhunter,havoc,24,13,11
Ironjòe,eredar,1247,demonhunter,havoc,30,14,16
Shinsen,archimonde,1247,demonhunter,havoc,36,16,20
Mentallybòóm,tarren-mill,1247,demonhunter,havoc,30,13,17
Fróstdh,ravencrest,1247,demonhunter,havoc,30,13,17
Bläckdëvïl,uldum,1246,demonhunter,havoc,58,33,25
Lögan,uldum,1246,demonhunter,havoc,60,34,26
Louloulou,aegwynn,1246,demonhunter,havoc,215,110,105
Shytan,tarren-mill,1246,demonhunter,havoc,110,50,60
Daweeo,the-maelstrom,1245,demonhunter,havoc,30,17,13
Valen,die-aldor,1245,demonhunter,havoc,88,40,48
Lethalidan,darksorrow,1244,demonhunter,havoc,24,13,11
Fyell,antonidas,1244,demonhunter,havoc,24,13,11
Meridah,twisting-nether,1244,demonhunter,havoc,30,13,17
Ømêgäðmggóðx,blackrock,1244,demonhunter,havoc,30,13,17
Kimberleh,doomhammer,1243,demonhunter,havoc,24,13,11
Ilídos,blackmoore,1243,demonhunter,havoc,92,39,53
Tharysan,sanguino,1242,demonhunter,havoc,84,46,38
Imvnrcvr,dalaran,1242,demonhunter,havoc,24,13,11
Maddhxo,drakthul,1242,demonhunter,havoc,24,13,11
Spamaname,outland,1242,demonhunter,havoc,48,24,24
Falanar,ysondre,1242,demonhunter,havoc,30,13,17
Becknárn,sylvanas,1242,demonhunter,havoc,30,13,17
Imperio,tarren-mill,1242,demonhunter,havoc,36,13,23
Iíïììïiíïìïï,blackmoore,1241,demonhunter,havoc,18,13,5
Lyzzra,blackmoore,1241,demonhunter,havoc,30,13,17
Vulcaan,ravencrest,1241,demonhunter,havoc,30,13,17
Dhanny,blackmoore,1240,demonhunter,havoc,24,13,11
Verrottung,blackhand,1240,demonhunter,havoc,24,13,11
Ðarckjojo,hyjal,1240,demonhunter,havoc,94,44,50
Hakakuri,ravencrest,1240,demonhunter,havoc,30,14,16
Drushii,shattrath,1240,demonhunter,havoc,30,13,17
Asmedios,twisting-nether,1239,demonhunter,havoc,734,367,367
Leäf,drakthul,1239,demonhunter,havoc,36,18,18
Илджес,gordunni,1239,demonhunter,havoc,42,13,29
Momochi,silvermoon,1238,demonhunter,havoc,50,24,26
Illidanio,xavius,1238,demonhunter,havoc,76,33,43
Galuna,deathwing,1238,demonhunter,havoc,31,13,18
Lùcîfer,hellfire,1237,demonhunter,havoc,108,53,55
Siljima,tarren-mill,1237,demonhunter,havoc,36,13,23
Nekkëtsu,archimonde,1235,demonhunter,havoc,24,13,11
Aloii,kazzak,1235,demonhunter,havoc,48,24,24
Niniach,burning-legion,1235,demonhunter,havoc,30,13,17
Zackiq,ravencrest,1234,demonhunter,havoc,24,13,11
Solrosfrön,stormscale,1234,demonhunter,havoc,28,14,14
Сумърак,grom,1234,demonhunter,havoc,212,102,110
Bashara,minahonda,1234,demonhunter,havoc,40,18,22
Fâng,archimonde,1234,demonhunter,havoc,36,13,23
Wasilij,ravencrest,1233,demonhunter,havoc,24,13,11
Qvn,sylvanas,1233,demonhunter,havoc,24,13,11
Demonjay,stormscale,1233,demonhunter,havoc,28,14,14
Mirajen,dun-modr,1233,demonhunter,havoc,36,17,19
Zhartax,dun-modr,1233,demonhunter,havoc,30,13,17
Titanslayyer,azjolnerub,1233,demonhunter,havoc,30,13,17
Даргсайд,gordunni,1232,demonhunter,havoc,305,147,158
Azkerash,draenor,1232,demonhunter,havoc,94,43,51
Drahîna,khaz-modan,1232,demonhunter,havoc,38,16,22
Orochimaruu,kargath,1232,demonhunter,havoc,111,43,68
Клиффорд,gordunni,1231,demonhunter,havoc,18,13,5
Juha,bronze-dragonflight,1231,demonhunter,havoc,69,38,31
Anödyth,kirin-tor,1231,demonhunter,havoc,57,25,32
Skarvy,bronze-dragonflight,1230,demonhunter,havoc,24,13,11
Demonk,nemesis,1230,demonhunter,havoc,181,91,90
Maeb,cthun,1230,demonhunter,havoc,72,30,42
Mamazboy,lightnings-blade,1229,demonhunter,havoc,35,20,15
Ïöï,tarren-mill,1229,demonhunter,havoc,24,13,11
Lengadanger,durotan,1229,demonhunter,havoc,36,13,23
Nëmesi,ravencrest,1228,demonhunter,havoc,27,15,12
Bazzer,aegwynn,1228,demonhunter,havoc,110,56,54
Fôns,sanguino,1227,demonhunter,havoc,18,13,5
Inasyndre,argent-dawn,1226,demonhunter,havoc,30,13,17
Carizmma,ravencrest,1226,demonhunter,havoc,102,41,61
Katheros,garrosh,1224,demonhunter,havoc,72,41,31
Hannipham,silvermoon,1224,demonhunter,havoc,47,25,22
Manavoid,outland,1223,demonhunter,havoc,30,15,15
Brazahart,silvermoon,1223,demonhunter,havoc,102,44,58
Thilanea,emeriss,1222,demonhunter,havoc,36,22,14
Roostidh,shattered-hand,1222,demonhunter,havoc,96,54,42
Nikkidesaint,twisting-nether,1220,demonhunter,havoc,24,14,10
Defjax,argent-dawn,1220,demonhunter,havoc,24,13,11
Devilmonkey,ambossar,1219,demonhunter,havoc,93,35,58
Danedemlia,magtheridon,1218,demonhunter,havoc,79,38,41
Badgyalriri,hyjal,1218,demonhunter,havoc,33,15,18
Dmgchris,sylvanas,1218,demonhunter,havoc,36,13,23
Rtz,malfurion,1217,demonhunter,havoc,36,19,17
Tokoloshë,ragnaros,1217,demonhunter,havoc,108,56,52
Crueldo,silvermoon,1217,demonhunter,havoc,54,22,32
Demonzeus,sylvanas,1216,demonhunter,havoc,91,48,43
Alfaa,outland,1216,demonhunter,havoc,62,30,32
Tabsen,sanguino,1215,demonhunter,havoc,29,13,16
Ferndejar,draenor,1215,demonhunter,havoc,40,14,26
Estheris,sylvanas,1214,demonhunter,havoc,75,42,33
Demonpotatô,draenor,1214,demonhunter,havoc,78,41,37
Vänöx,dun-modr,1214,demonhunter,havoc,56,24,32
Tyvas,hyjal,1214,demonhunter,havoc,59,25,34
Petefile,kazzak,1213,demonhunter,havoc,128,68,60
Noxxi,gorgonnash,1213,demonhunter,havoc,31,15,16
Этимму,gordunni,1213,demonhunter,havoc,212,100,112
Betråyêr,draenor,1213,demonhunter,havoc,38,15,23
Xendrina,blackrock,1213,demonhunter,havoc,36,14,22
Иллидал,greymane,1212,demonhunter,havoc,36,18,18
Chancelvie,outland,1211,demonhunter,havoc,123,54,69
Kladius,skullcrusher,1210,demonhunter,havoc,48,24,24
Cameclc,hyjal,1209,demonhunter,havoc,28,13,15
Schahmiran,kargath,1208,demonhunter,havoc,96,45,51
Дронкрылатый,soulflayer,1207,demonhunter,havoc,107,55,52
Áléc,outland,1206,demonhunter,havoc,36,18,18
Demonsfury,ravencrest,1206,demonhunter,havoc,42,13,29
Marmotaa,ragnaros,1205,demonhunter,havoc,159,77,82
Dadicek,drakthul,1204,demonhunter,havoc,30,20,10
Csav,ragnaros,1204,demonhunter,havoc,42,19,23
Jimdh,quelthalas,1204,demonhunter,havoc,66,22,44
Déstructiva,blackhand,1203,demonhunter,havoc,78,33,45
Kumoko,burning-legion,1203,demonhunter,havoc,39,16,23
Azn,twisting-nether,1203,demonhunter,havoc,62,25,37
Deadclass,tarren-mill,1202,demonhunter,havoc,24,13,11
Эридэм,gordunni,1202,demonhunter,havoc,30,14,16
Bøøgý,silvermoon,1202,demonhunter,havoc,54,24,30
Tyranax,kirin-tor,1201,demonhunter,havoc,36,15,21
Délyria,blackhand,1200,demonhunter,havoc,162,82,80
Флеркенкот,galakrond,1197,demonhunter,havoc,377,198,179
Aûrelian,kragjin,1197,demonhunter,havoc,45,20,25
Сангвиннус,howling-fjord,1196,demonhunter,havoc,99,51,48
Vozol,stormscale,1195,demonhunter,havoc,30,20,10
Hellarious,ragnaros,1195,demonhunter,havoc,72,30,42
Demondik,aggramar,1195,demonhunter,havoc,52,20,32
Nalleya,draenor,1195,demonhunter,havoc,42,14,28
Sholon,kiljaeden,1194,demonhunter,havoc,24,14,10
Талона,fordragon,1191,demonhunter,havoc,60,33,27
Claere,blackhand,1191,demonhunter,havoc,129,66,63
Spideymon,ragnaros,1191,demonhunter,havoc,56,21,35
Makkivar,terenas,1190,demonhunter,havoc,64,33,31
Lastdemon,dun-modr,1189,demonhunter,havoc,44,24,20
Куню,gordunni,1189,demonhunter,havoc,36,17,19
Джигурдинец,gordunni,1188,demonhunter,havoc,36,21,15
Paranoiac,defias-brotherhood,1187,demonhunter,havoc,29,13,16
Buttslapper,silvermoon,1187,demonhunter,havoc,38,14,24
Khamzath,blackhand,1186,demonhunter,havoc,72,36,36
Manga,aegwynn,1186,demonhunter,havoc,96,40,56
Vallaas,argent-dawn,1185,demonhunter,havoc,41,17,24
Тэлэсык,gordunni,1185,demonhunter,havoc,69,28,41
Liisza,blackhand,1184,demonhunter,havoc,22,15,7
Gotwings,sunstrider,1183,demonhunter,havoc,22,13,9
Demonligos,draenor,1183,demonhunter,havoc,72,36,36
Pumaswede,auchindoun,1183,demonhunter,havoc,35,13,22
Акамамба,gordunni,1182,demonhunter,havoc,35,14,21
Wen,outland,1182,demonhunter,havoc,33,13,20
Artexxen,kazzak,1182,demonhunter,havoc,42,14,28
Plagues,quelthalas,1181,demonhunter,havoc,32,17,15
Dionyz,magtheridon,1180,demonhunter,havoc,30,18,12
Demonronin,the-maelstrom,1180,demonhunter,havoc,91,46,45
Ohshietwadap,twisting-nether,1180,demonhunter,havoc,34,13,21
Bloodilidari,ragnaros,1180,demonhunter,havoc,36,13,23
Heàvic,outland,1179,demonhunter,havoc,69,37,32
Годиксгёрл,gordunni,1178,demonhunter,havoc,92,47,45
Kalimbä,suramar,1178,demonhunter,havoc,72,35,37
Nvm,wrathbringer,1178,demonhunter,havoc,79,38,41
Squatrix,archimonde,1177,demonhunter,havoc,30,16,14
Xellnaga,twisting-nether,1176,demonhunter,havoc,52,23,29
Aoeshu,wildhammer,1175,demonhunter,havoc,23,13,10
Finsterfix,blackrock,1175,demonhunter,havoc,59,26,33
Êvê,blackmoore,1174,demonhunter,havoc,52,25,27
Lozakum,draenor,1174,demonhunter,havoc,126,58,68
Шикзаль,deathguard,1173,demonhunter,havoc,84,33,51
Kaletoq,ragnaros,1172,demonhunter,havoc,34,20,14
Aidae,sylvanas,1172,demonhunter,havoc,90,37,53
Lovzuu,draenor,1171,demonhunter,havoc,24,17,7
Дитяхаоса,howling-fjord,1170,demonhunter,havoc,97,42,55
Brolycoly,stormscale,1169,demonhunter,havoc,34,13,21
Demonwithin,nerathor,1167,demonhunter,havoc,39,15,24
Cmi,tarren-mill,1167,demonhunter,havoc,34,13,21
Teoma,hyjal,1166,demonhunter,havoc,233,121,112
Metadel,outland,1166,demonhunter,havoc,383,197,186
Kiriall,blackmoore,1166,demonhunter,havoc,78,36,42
Winchesterxx,sanguino,1165,demonhunter,havoc,102,52,50
Oxydh,ravencrest,1165,demonhunter,havoc,28,13,15
Doccholiday,doomhammer,1164,demonhunter,havoc,71,33,38
Шоеррей,gordunni,1164,demonhunter,havoc,38,17,21
Diabloman,stormscale,1164,demonhunter,havoc,42,18,24
Tizefik,stormscale,1163,demonhunter,havoc,57,28,29
Velgetox,blackrock,1163,demonhunter,havoc,51,24,27
Morthorr,grim-batol,1163,demonhunter,havoc,37,17,20
Lailâh,blackmoore,1162,demonhunter,havoc,30,14,16
Sickman,burning-legion,1162,demonhunter,havoc,48,16,32
Lagordin,aggramar,1161,demonhunter,havoc,18,14,4
Dämokröte,ambossar,1161,demonhunter,havoc,110,57,53
Dombra,kult-der-verdammten,1160,demonhunter,havoc,35,22,13
Hawek,madmortem,1160,demonhunter,havoc,76,41,35
Самуройд,gordunni,1159,demonhunter,havoc,104,47,57
Tallain,drakthul,1158,demonhunter,havoc,45,19,26
Letidyr,ravencrest,1158,demonhunter,havoc,54,17,37
Нохелет,deepholm,1157,demonhunter,havoc,531,273,258
Chrititia,blackmoore,1155,demonhunter,havoc,53,24,29
Wréckful,ravencrest,1155,demonhunter,havoc,48,17,31
Nanocsika,twisting-nether,1154,demonhunter,havoc,250,122,128
Itsukix,stormscale,1153,demonhunter,havoc,36,21,15
Kalachiquezz,kazzak,1152,demonhunter,havoc,18,12,6
Demønlady,blackmoore,1152,demonhunter,havoc,26,13,13
Аоешный,howling-fjord,1152,demonhunter,havoc,24,12,12
Nairra,blackmoore,1152,demonhunter,havoc,30,13,17
Neonishh,twisting-nether,1152,demonhunter,havoc,30,12,18
Ápölö,zuljin,1152,demonhunter,havoc,48,15,33
Kímínøséí,kazzak,1151,demonhunter,havoc,18,12,6
Джэба,gordunni,1150,demonhunter,havoc,18,12,6
Qiera,grim-batol,1150,demonhunter,havoc,24,12,12
Raïley,archimonde,1150,demonhunter,havoc,30,12,18
Demonkal,twisting-nether,1150,demonhunter,havoc,36,12,24
Aygael,archimonde,1150,demonhunter,havoc,48,12,36
Evul,blackmoore,1149,demonhunter,havoc,18,12,6
Seleverkauft,antonidas,1149,demonhunter,havoc,18,12,6
Hashoks,draenor,1149,demonhunter,havoc,51,29,22
Bigboychaos,twisting-nether,1149,demonhunter,havoc,36,19,17
Notapistol,outland,1149,demonhunter,havoc,24,12,12
Rasmekul,defias-brotherhood,1149,demonhunter,havoc,24,12,12
Dhlee,ravencrest,1149,demonhunter,havoc,24,12,12
Glowfall,draenor,1149,demonhunter,havoc,45,22,23
Shizá,burning-legion,1149,demonhunter,havoc,92,41,51
Allen,dragonblight,1149,demonhunter,havoc,30,12,18
Мицлейн,gordunni,1149,demonhunter,havoc,85,31,54
Allalina,draenor,1148,demonhunter,havoc,96,51,45
Эйфирон,blackscar,1148,demonhunter,havoc,125,66,59
Slinks,ragnaros,1148,demonhunter,havoc,275,127,148
Íhithard,drakthul,1147,demonhunter,havoc,24,12,12
Mouz,thrall,1147,demonhunter,havoc,24,12,12
Mèlfurion,hyjal,1147,demonhunter,havoc,97,42,55
Bayerd,burning-legion,1146,demonhunter,havoc,24,12,12
Ravae,burning-legion,1146,demonhunter,havoc,30,12,18
Milkeyes,ravencrest,1145,demonhunter,havoc,112,60,52
Aruzar,twisting-nether,1145,demonhunter,havoc,36,14,22
Artwar,stormscale,1145,demonhunter,havoc,42,16,26
Тиктокденсер,gordunni,1144,demonhunter,havoc,24,12,12
Lilor,aegwynn,1143,demonhunter,havoc,18,12,6
Puppygf,ravencrest,1143,demonhunter,havoc,18,12,6
Joniod,stormreaver,1143,demonhunter,havoc,24,12,12
Jânnekê,blackmoore,1143,demonhunter,havoc,36,15,21
Xellidan,dun-modr,1142,demonhunter,havoc,30,14,16
Gyrospita,dun-morogh,1142,demonhunter,havoc,30,12,18
Idxbl,kazzak,1141,demonhunter,havoc,54,14,40
Embruixada,sanguino,1140,demonhunter,havoc,239,122,117
Yuka,earthen-ring,1140,demonhunter,havoc,42,20,22
Dreggath,doomhammer,1139,demonhunter,havoc,59,29,30
Betrayeð,tarren-mill,1139,demonhunter,havoc,30,12,18
Prepared,teldrassil,1138,demonhunter,havoc,24,15,9
Nelairia,tarren-mill,1138,demonhunter,havoc,41,24,17
Тонниданза,howling-fjord,1138,demonhunter,havoc,384,187,197
Аэм,deathweaver,1137,demonhunter,havoc,52,23,29
Илайора,galakrond,1137,demonhunter,havoc,79,34,45
Txullidan,twisting-nether,1136,demonhunter,havoc,92,46,46
Mau,blackmoore,1136,demonhunter,havoc,30,12,18
Merelîn,eredar,1135,demonhunter,havoc,47,23,24
Grazilo,outland,1135,demonhunter,havoc,68,31,37
Сеомагистр,gordunni,1135,demonhunter,havoc,124,52,72
Biatrix,stormscale,1134,demonhunter,havoc,24,14,10
Typhoonxq,tarren-mill,1134,demonhunter,havoc,53,29,24
Yousif,stormscale,1134,demonhunter,havoc,155,78,77
Basiliskus,argent-dawn,1134,demonhunter,havoc,30,12,18
Fläsktorped,stormscale,1132,demonhunter,havoc,31,14,17
Xtrong,agamaggan,1131,demonhunter,havoc,27,14,13
Iaozh,culte-de-la-rive-noire,1130,demonhunter,havoc,54,23,31
Нотреди,howling-fjord,1129,demonhunter,havoc,156,85,71
Фирулия,goldrinn,1129,demonhunter,havoc,214,113,101
Tasi,dun-morogh,1128,demonhunter,havoc,70,33,37
Giboo,emerald-dream,1127,demonhunter,havoc,18,12,6
Хэвдан,gordunni,1126,demonhunter,havoc,18,12,6
Accursius,blackmoore,1126,demonhunter,havoc,92,54,38
Crydemo,darkspear,1122,demonhunter,havoc,54,26,28
Dontrunaway,tarren-mill,1121,demonhunter,havoc,18,12,6
Mojois,ravenholdt,1119,demonhunter,havoc,168,86,82
Shiqqi,blackhand,1118,demonhunter,havoc,60,31,29
Líllíth,forscherliga,1118,demonhunter,havoc,66,30,36
Nori,malganis,1118,demonhunter,havoc,29,12,17
Vaenil,hyjal,1118,demonhunter,havoc,41,14,27
Оксиликвит,soulflayer,1118,demonhunter,havoc,52,16,36
Mcsmackface,hellfire,1117,demonhunter,havoc,69,26,43
Subelsiu,alakir,1116,demonhunter,havoc,247,126,121
Илнари,soulflayer,1116,demonhunter,havoc,29,12,17
Zyasea,blackmoore,1116,demonhunter,havoc,107,41,66
Обходчик,soulflayer,1115,demonhunter,havoc,60,32,28
Kundán,antonidas,1113,demonhunter,havoc,60,31,29
Unnachgiebig,antonidas,1113,demonhunter,havoc,24,12,12
Aamonath,tarren-mill,1112,demonhunter,havoc,66,37,29
Zarkhyl,malygos,1112,demonhunter,havoc,65,32,33
Neepz,ravencrest,1112,demonhunter,havoc,66,30,36
Youjosenki,magtheridon,1111,demonhunter,havoc,23,15,8
Yiùna,hyjal,1110,demonhunter,havoc,119,60,59
Zengor,twilights-hammer,1109,demonhunter,havoc,28,14,14
Мотек,howling-fjord,1109,demonhunter,havoc,120,57,63
Séphora,confrérie-du-thorium,1108,demonhunter,havoc,24,14,10
Tatsukiyuzu,hyjal,1107,demonhunter,havoc,54,35,19
Karxarias,silvermoon,1107,demonhunter,havoc,42,22,20
Hellboii,kilrogg,1104,demonhunter,havoc,70,42,28
Sükiküki,alexstrasza,1104,demonhunter,havoc,78,29,49
Nylaria,dethecus,1102,demonhunter,havoc,24,13,11
Napastak,blackrock,1100,demonhunter,havoc,47,17,30
Eranduur,draenor,1099,demonhunter,havoc,36,18,18
Дайленрия,eversong,1097,demonhunter,havoc,54,27,27
Wingedfelcat,argent-dawn,1095,demonhunter,havoc,23,12,11
Luciferio,quelthalas,1095,demonhunter,havoc,75,29,46
Ilidas,frostwolf,1094,demonhunter,havoc,42,23,19
Giace,drakthul,1094,demonhunter,havoc,96,39,57
Аллилания,fordragon,1092,demonhunter,havoc,50,32,18
Téthis,uldaman,1092,demonhunter,havoc,102,44,58
Maßik,terokkar,1091,demonhunter,havoc,50,26,24
Joltheen,silvermoon,1090,demonhunter,havoc,29,12,17
Ailis,drakthul,1089,demonhunter,havoc,38,13,25
Арат,ashenvale,1088,demonhunter,havoc,96,46,50
Моуровани,eversong,1088,demonhunter,havoc,60,28,32
Azzinoth,outland,1088,demonhunter,havoc,106,42,64
Айвэнгос,thermaplugg,1086,demonhunter,havoc,91,48,43
Hamssterek,magtheridon,1085,demonhunter,havoc,30,14,16
Cerza,sanguino,1085,demonhunter,havoc,48,16,32
Anandria,blutkessel,1084,demonhunter,havoc,83,46,37
Музакант,gordunni,1084,demonhunter,havoc,101,54,47
Azazelkw,ragnaros,1084,demonhunter,havoc,66,34,32
Thegamesucks,ravencrest,1084,demonhunter,havoc,214,104,110
Sombessat,tarren-mill,1084,demonhunter,havoc,95,46,49
Огнод,gordunni,1083,demonhunter,havoc,90,49,41
Marsterkush,malygos,1083,demonhunter,havoc,49,23,26
Гёнке,gordunni,1083,demonhunter,havoc,34,13,21
Grove,cthun,1081,demonhunter,havoc,25,15,10
Sintoraz,amanthul,1080,demonhunter,havoc,61,37,24
Bezdna,stormrage,1080,demonhunter,havoc,27,12,15
Niika,archimonde,1080,demonhunter,havoc,90,37,53
Easywaay,kazzak,1079,demonhunter,havoc,136,63,73
Mäxo,frostwolf,1079,demonhunter,havoc,32,12,20
Noire,zuljin,1079,demonhunter,havoc,35,12,23
Poliex,khaz-modan,1078,demonhunter,havoc,36,18,18
Sgravo,nemesis,1076,demonhunter,havoc,30,18,12
Veldragor,blackhand,1076,demonhunter,havoc,30,14,16
Darkustos,blackrock,1076,demonhunter,havoc,44,20,24
Zolvanith,tarren-mill,1076,demonhunter,havoc,66,25,41
Shinyshuckle,stormscale,1076,demonhunter,havoc,35,13,22
Välhöll,kirin-tor,1076,demonhunter,havoc,65,23,42
Predatrix,khaz-modan,1074,demonhunter,havoc,26,12,14
Twistyy,drakthul,1070,demonhunter,havoc,78,43,35
Leloine,trollbane,1069,demonhunter,havoc,133,67,66
Giusifreddo,zuljin,1068,demonhunter,havoc,67,28,39
Blackdémon,blackrock,1067,demonhunter,havoc,102,39,63
Scurenzio,outland,1065,demonhunter,havoc,42,24,18
Ôlowain,blackmoore,1065,demonhunter,havoc,30,12,18
Каталейна,howling-fjord,1065,demonhunter,havoc,62,19,43
Alioshad,ravencrest,1064,demonhunter,havoc,76,36,40
Ertel,burning-legion,1064,demonhunter,havoc,65,29,36
Cirino,defias-brotherhood,1063,demonhunter,havoc,108,52,56
Hvc,twisting-nether,1062,demonhunter,havoc,77,32,45
Слепойалкаш,blackscar,1062,demonhunter,havoc,32,13,19
Noctilucent,executus,1061,demonhunter,havoc,90,49,41
Hernandez,sanguino,1060,demonhunter,havoc,36,18,18
Увиден,eversong,1060,demonhunter,havoc,170,84,86
Prismio,ysondre,1059,demonhunter,havoc,21,12,9
Vio,jaedenar,1057,demonhunter,havoc,120,64,56
Alkann,chogall,1057,demonhunter,havoc,47,24,23
Happykx,draenor,1056,demonhunter,havoc,12,11,1
Haýuken,kazzak,1056,demonhunter,havoc,48,22,26
Анхардх,gordunni,1056,demonhunter,havoc,24,11,13
Hûora,stormscale,1055,demonhunter,havoc,18,11,7
Virkgodx,bloodscalp,1055,demonhunter,havoc,18,11,7
Babipanggang,kazzak,1055,demonhunter,havoc,18,11,7
Joggeqt,stormreaver,1055,demonhunter,havoc,19,11,8
Caria,twisting-nether,1055,demonhunter,havoc,48,27,21
Arylinn,tarren-mill,1055,demonhunter,havoc,23,11,12
Draqula,ravencrest,1055,demonhunter,havoc,24,11,13
Roxxis,mazrigos,1055,demonhunter,havoc,24,11,13
Tarrgaryen,twisting-nether,1055,demonhunter,havoc,42,16,26
Evlos,hyjal,1055,demonhunter,havoc,30,11,19
Vrekur,sanguino,1055,demonhunter,havoc,36,11,25
Eyegamis,ravencrest,1054,demonhunter,havoc,18,11,7
Løum,blackrock,1054,demonhunter,havoc,18,11,7
Atômik,drakthul,1054,demonhunter,havoc,24,11,13
Përry,archimonde,1054,demonhunter,havoc,24,11,13
Demonicat,twisting-nether,1054,demonhunter,havoc,30,11,19
Цион,soulflayer,1053,demonhunter,havoc,47,22,25
Darktérror,silvermoon,1053,demonhunter,havoc,30,11,19
Marluxx,stormscale,1053,demonhunter,havoc,42,13,29
Никельдон,howling-fjord,1052,demonhunter,havoc,54,33,21
Watermelonqt,tarren-mill,1052,demonhunter,havoc,24,11,13
Valorina,stormrage,1052,demonhunter,havoc,24,11,13
Шавермье,gordunni,1052,demonhunter,havoc,36,11,25
Bud,lightnings-blade,1051,demonhunter,havoc,18,11,7
Aldeshabrake,antonidas,1051,demonhunter,havoc,24,11,13
Squan,blackmoore,1050,demonhunter,havoc,20,12,8
Sorowas,tichondrius,1050,demonhunter,havoc,61,34,27
Blisdon,argent-dawn,1050,demonhunter,havoc,163,79,84
Халбренд,gordunni,1050,demonhunter,havoc,24,11,13
Вуджория,gordunni,1050,demonhunter,havoc,27,12,15
Sercemdwarf,silvermoon,1049,demonhunter,havoc,18,11,7
Vìdhar,tarren-mill,1049,demonhunter,havoc,24,11,13
Akhyra,ysondre,1049,demonhunter,havoc,24,11,13
Maddificator,silvermoon,1048,demonhunter,havoc,32,22,10
Neony,blackmoore,1048,demonhunter,havoc,23,12,11
Ilidailine,kazzak,1047,demonhunter,havoc,27,12,15
Plec,alakir,1047,demonhunter,havoc,76,31,45
Nerfy,silvermoon,1046,demonhunter,havoc,18,11,7
Glaiverush,alakir,1046,demonhunter,havoc,36,19,17
Lïazï,throkferoth,1046,demonhunter,havoc,24,11,13
Bunzi,sylvanas,1045,demonhunter,havoc,18,11,7
Valdrake,burning-legion,1045,demonhunter,havoc,19,11,8
Siscia,outland,1042,demonhunter,havoc,74,40,34
Карнавалыч,gordunni,1041,demonhunter,havoc,224,103,121
Хитсхан,soulflayer,1041,demonhunter,havoc,60,26,34
Гурцкой,soulflayer,1041,demonhunter,havoc,51,16,35
Dântés,silvermoon,1040,demonhunter,havoc,60,23,37
Besnik,stormscale,1039,demonhunter,havoc,86,38,48
Balathor,quelthalas,1038,demonhunter,havoc,18,11,7
Estarloco,blackmoore,1038,demonhunter,havoc,36,19,17
Selénhe,silvermoon,1038,demonhunter,havoc,24,11,13
Gigipletosu,ravencrest,1037,demonhunter,havoc,66,26,40
Rebelion,dun-modr,1037,demonhunter,havoc,61,19,42
Shnshon,kazzak,1036,demonhunter,havoc,18,12,6
Lightkick,archimonde,1035,demonhunter,havoc,60,35,25
Бигбэбров,gordunni,1035,demonhunter,havoc,42,19,23
Elmindundi,shendralar,1033,demonhunter,havoc,44,17,27
Électrâs,archimonde,1032,demonhunter,havoc,50,21,29
Stixxs,archimonde,1030,demonhunter,havoc,26,15,11
Abalim,nemesis,1030,demonhunter,havoc,30,11,19
Zahif,kazzak,1030,demonhunter,havoc,42,15,27
Crimsoncloud,burning-legion,1030,demonhunter,havoc,36,11,25
Munja,hyjal,1028,demonhunter,havoc,284,138,146
Mdåll,chogall,1028,demonhunter,havoc,56,23,33
Dollar,daggerspine,1028,demonhunter,havoc,96,34,62
Thorskinius,ravencrest,1027,demonhunter,havoc,62,28,34
Starlightkid,kazzak,1027,demonhunter,havoc,30,13,17
Vanereel,thrall,1026,demonhunter,havoc,23,14,9
Silan,kiljaeden,1026,demonhunter,havoc,46,26,20
Uthinare,silvermoon,1026,demonhunter,havoc,110,47,63
Aggerpain,draenor,1026,demonhunter,havoc,68,24,44
Greensøul,los-errantes,1025,demonhunter,havoc,84,39,45
Тэниан,gordunni,1025,demonhunter,havoc,162,67,95
Julmia,dragonblight,1025,demonhunter,havoc,47,12,35
Dèathless,pozzo-delleternità,1024,demonhunter,havoc,52,21,31
Coaxial,twisting-nether,1024,demonhunter,havoc,68,25,43
Cobayashi,der-mithrilorden,1023,demonhunter,havoc,38,21,17
Djsasan,kazzak,1022,demonhunter,havoc,18,11,7
Дэйкан,borean-tundra,1022,demonhunter,havoc,33,18,15
Самфор,soulflayer,1022,demonhunter,havoc,85,41,44
Thelanora,zirkel-des-cenarius,1022,demonhunter,havoc,82,37,45
Killidance,outland,1021,demonhunter,havoc,67,27,40
Vixandrion,twisting-nether,1020,demonhunter,havoc,24,13,11
Гарнаш,howling-fjord,1020,demonhunter,havoc,89,46,43
Herax,drakthul,1019,demonhunter,havoc,29,15,14
Stonebanker,turalyon,1019,demonhunter,havoc,35,18,17
Ðíablo,amanthul,1019,demonhunter,havoc,26,11,15
Ragefighterr,ragnaros,1018,demonhunter,havoc,42,21,21
Takeshy,alleria,1016,demonhunter,havoc,60,31,29
Ladj,blackmoore,1014,demonhunter,havoc,48,24,24
Butcherr,ulduar,1013,demonhunter,havoc,72,36,36
Цейн,azuregos,1012,demonhunter,havoc,79,36,43
Entzuu,hyjal,1012,demonhunter,havoc,28,11,17
Äcnologia,khaz-modan,1009,demonhunter,havoc,34,15,19
Srul,eredar,1009,demonhunter,havoc,66,28,38
Mommasboi,twisting-nether,1009,demonhunter,havoc,30,11,19
Gabquist,argent-dawn,1008,demonhunter,havoc,53,26,27
Синтвеив,soulflayer,1007,demonhunter,havoc,17,11,6
Tooltip,outland,1006,demonhunter,havoc,36,14,22
Demontripo,silvermoon,1005,demonhunter,havoc,81,43,38
Delfee,twisting-nether,1005,demonhunter,havoc,54,25,29
Yayayaa,kazzak,1000,demonhunter,havoc,23,13,10
Гневныймомон,soulflayer,1000,demonhunter,havoc,79,38,41
Vaco,la-croisade-écarlate,996,demonhunter,havoc,30,13,17
Annelf,ragnaros,994,demonhunter,havoc,30,11,19
Ànavar,twisting-nether,991,demonhunter,havoc,47,21,26
Funb,ragnaros,990,demonhunter,havoc,20,11,9
Carater,uldum,989,demonhunter,havoc,52,26,26
Superset,twisting-nether,989,demonhunter,havoc,22,11,11
Yuná,stormscale,989,demonhunter,havoc,28,11,17
Demonzeus,archimonde,985,demonhunter,havoc,25,12,13
Andij,frostwolf,981,demonhunter,havoc,77,36,41
Itzmir,nethersturm,980,demonhunter,havoc,22,11,11
Jimlast,eredar,980,demonhunter,havoc,22,11,11
Shirakava,quelthalas,978,demonhunter,havoc,215,98,117
Herzbann,madmortem,976,demonhunter,havoc,36,16,20
Rijsel,dalaran,975,demonhunter,havoc,36,22,14
Sinthetyx,quelthalas,974,demonhunter,havoc,48,27,21
Tinchev,kazzak,973,demonhunter,havoc,30,11,19
Sìnbad,khaz-modan,970,demonhunter,havoc,60,34,26
Ayido,xavius,970,demonhunter,havoc,52,21,31
Mortblede,outland,968,demonhunter,havoc,123,57,66
Люцифэйль,gordunni,966,demonhunter,havoc,55,23,32
Ríasgremory,los-errantes,965,demonhunter,havoc,27,15,12
Dutchmadman,aerie-peak,964,demonhunter,havoc,140,71,69
Pijvijie,shattrath,961,demonhunter,havoc,55,18,37
Дианист,gordunni,960,demonhunter,havoc,16,11,5
Fantabolous,ragnaros,960,demonhunter,havoc,18,10,8
Karpandero,stormreaver,960,demonhunter,havoc,18,10,8
Keýrañe,ragnaros,960,demonhunter,havoc,18,10,8
Iíïììïiíïìïï,alakir,960,demonhunter,havoc,24,10,14
Zxcjklcasdlk,sylvanas,960,demonhunter,havoc,24,10,14
Krvckhead,hyjal,960,demonhunter,havoc,24,10,14
Ghetzlel,draenor,960,demonhunter,havoc,24,10,14
Rîasgremoryy,twisting-nether,960,demonhunter,havoc,30,10,20
Mýg,ravencrest,960,demonhunter,havoc,30,10,20
Karaxd,stormscale,960,demonhunter,havoc,30,10,20
Gæxemus,draenor,959,demonhunter,havoc,12,10,2
Darkshadow,turalyon,959,demonhunter,havoc,18,10,8
Deadmaus,stormscale,959,demonhunter,havoc,18,10,8
Катякрылышки,gordunni,959,demonhunter,havoc,18,10,8
Lucianloco,dun-morogh,959,demonhunter,havoc,18,10,8
Zmemroo,magtheridon,959,demonhunter,havoc,18,10,8
Heanondh,dentarg,959,demonhunter,havoc,18,10,8
Дантавул,gordunni,959,demonhunter,havoc,105,50,55
Qbaz,twisting-nether,959,demonhunter,havoc,24,10,14
Yumhip,dun-modr,959,demonhunter,havoc,24,10,14
Darnke,silvermoon,959,demonhunter,havoc,30,10,20
Iamayaqt,nemesis,959,demonhunter,havoc,30,10,20
Тяжелыйбасс,gordunni,958,demonhunter,havoc,18,10,8
Elenôy,malganis,958,demonhunter,havoc,18,10,8
Desdh,blackmoore,958,demonhunter,havoc,24,10,14
Nocluë,shattered-halls,958,demonhunter,havoc,30,10,20
Dominantorka,outland,957,demonhunter,havoc,24,10,14
Bobdh,twisting-nether,957,demonhunter,havoc,35,10,25
Madator,eredar,956,demonhunter,havoc,12,10,2
Zhynia,blackmoore,956,demonhunter,havoc,18,10,8
Fredhy,tarren-mill,956,demonhunter,havoc,18,10,8
Løkil,blackrock,956,demonhunter,havoc,24,10,14
Вапатикяу,gordunni,956,demonhunter,havoc,30,10,20
Diagonol,ragnaros,955,demonhunter,havoc,18,10,8
Tire,draenor,955,demonhunter,havoc,18,10,8
Freddh,blackrock,955,demonhunter,havoc,24,10,14
Illidián,chamber-of-aspects,955,demonhunter,havoc,30,10,20
Shaaton,ysondre,955,demonhunter,havoc,30,10,20
Okoral,dun-modr,954,demonhunter,havoc,24,10,14
Blíndgódx,ravencrest,954,demonhunter,havoc,28,11,17
Argnils,tarren-mill,953,demonhunter,havoc,12,10,2
Ravier,baelgun,953,demonhunter,havoc,75,39,36
Mhieltior,frostmane,953,demonhunter,havoc,24,10,14
Dajjal,eredar,953,demonhunter,havoc,24,10,14
Yamaarashi,earthen-ring,953,demonhunter,havoc,24,10,14
Akaniiaa,blackmoore,953,demonhunter,havoc,24,10,14
Pelko,sanguino,953,demonhunter,havoc,30,10,20
Dimonhunta,tarren-mill,953,demonhunter,havoc,36,10,26
Hallowdip,drakthul,952,demonhunter,havoc,18,10,8
Greedsmoke,kazzak,952,demonhunter,havoc,18,10,8
Enlightens,aegwynn,951,demonhunter,havoc,24,10,14
Sinorack,sargeras,951,demonhunter,havoc,24,10,14
Демод,soulflayer,950,demonhunter,havoc,24,13,11
Alandrisz,argent-dawn,949,demonhunter,havoc,30,10,20
Olaghkhan,minahonda,948,demonhunter,havoc,27,14,13
Selfdestruct,tarren-mill,948,demonhunter,havoc,24,10,14
Krankzz,ravencrest,946,demonhunter,havoc,30,10,20
Askaroth,blackmoore,946,demonhunter,havoc,54,14,40
Demonglide,moonglade,945,demonhunter,havoc,18,10,8
Максаналл,soulflayer,944,demonhunter,havoc,18,10,8
Hackstück,blackrock,943,demonhunter,havoc,28,14,14
Deathmàrk,stormscale,943,demonhunter,havoc,23,10,13
Jörgböhme,blackhand,942,demonhunter,havoc,24,10,14
Naem,blackrock,942,demonhunter,havoc,24,10,14
Nithraim,kazzak,940,demonhunter,havoc,44,15,29
Демолейшер,eversong,937,demonhunter,havoc,24,10,14
Shàdoww,hyjal,937,demonhunter,havoc,36,10,26
Pismanik,drakthul,936,demonhunter,havoc,36,19,17
Skylinex,dentarg,934,demonhunter,havoc,96,49,47
Byah,kazzak,933,demonhunter,havoc,146,65,81
Yanosses,la-croisade-écarlate,931,demonhunter,havoc,24,15,9
Shadowkick,archimonde,931,demonhunter,havoc,285,137,148
Zaeros,archimonde,929,demonhunter,havoc,18,10,8
Nuriia,arthas,927,demonhunter,havoc,84,44,40
Winnztlol,chamber-of-aspects,927,demonhunter,havoc,36,17,19
Zermut,culte-de-la-rive-noire,925,demonhunter,havoc,17,10,7
Darknightx,grim-batol,924,demonhunter,havoc,70,31,39
Aggrr,blackmoore,923,demonhunter,havoc,26,11,15
Nehmarath,doomhammer,923,demonhunter,havoc,42,11,31
Braserol,archimonde,922,demonhunter,havoc,50,19,31
Ёмайл,soulflayer,921,demonhunter,havoc,30,14,16
Losthunter,turalyon,920,demonhunter,havoc,75,31,44
Séleister,khaz-modan,917,demonhunter,havoc,53,23,30
Aelita,twisting-nether,916,demonhunter,havoc,132,68,64
Demonhyan,chants-éternels,916,demonhunter,havoc,97,45,52
Jamule,dun-morogh,916,demonhunter,havoc,54,25,29
Meliòdas,draenor,916,demonhunter,havoc,53,17,36
Devendora,antonidas,915,demonhunter,havoc,65,30,35
Taliaa,drakthul,911,demonhunter,havoc,21,10,11
Магнисс,fordragon,909,demonhunter,havoc,26,14,12
Манапарда,howling-fjord,909,demonhunter,havoc,35,10,25
Liquidtrip,kazzak,907,demonhunter,havoc,101,54,47
Guziel,kazzak,906,demonhunter,havoc,15,10,5
Hicgidik,outland,905,demonhunter,havoc,24,11,13
Nöah,burning-steppes,905,demonhunter,havoc,33,11,22
Luìnìl,khaz-modan,904,demonhunter,havoc,27,10,17
Fredoo,sylvanas,903,demonhunter,havoc,21,11,10
Lufy,rexxar,896,demonhunter,havoc,60,26,34
Kroepoeks,mazrigos,894,demonhunter,havoc,30,16,14
Zsari,ravencrest,894,demonhunter,havoc,20,10,10
Aradh,hyjal,892,demonhunter,havoc,22,10,12
Innostigma,dalaran,892,demonhunter,havoc,26,10,16
Anarcky,ravencrest,890,demonhunter,havoc,25,11,14
Lillinète,archimonde,890,demonhunter,havoc,42,11,31
Rockymarcia,archimonde,888,demonhunter,havoc,36,17,19
Finstergraf,blackmoore,887,demonhunter,havoc,78,40,38
Lorcanmar,draenor,887,demonhunter,havoc,99,44,55
Cometofloki,outland,880,demonhunter,havoc,36,17,19
Blutox,antonidas,875,demonhunter,havoc,37,18,19
Dàrkinette,archimonde,875,demonhunter,havoc,48,22,26
Deadskill,alexstrasza,874,demonhunter,havoc,96,44,52
Legionek,burning-blade,866,demonhunter,havoc,20,11,9
Ejder,anubarak,865,demonhunter,havoc,78,31,47
Tzs,blackrock,864,demonhunter,havoc,12,9,3
Styhawk,zuljin,864,demonhunter,havoc,18,10,8
Tillidani,outland,864,demonhunter,havoc,18,9,9
Snäx,aggra-português,864,demonhunter,havoc,18,9,9
Pogchamp,argent-dawn,864,demonhunter,havoc,18,9,9
Toschadh,blackmoore,864,demonhunter,havoc,18,9,9
Эридари,blackscar,864,demonhunter,havoc,18,9,9
Zophý,ragnaros,864,demonhunter,havoc,18,9,9
Saene,ravencrest,864,demonhunter,havoc,18,9,9
Demønjægarex,stormscale,864,demonhunter,havoc,18,9,9
Critneyféárs,blackrock,864,demonhunter,havoc,18,9,9
Lrdhavemercy,kiljaeden,864,demonhunter,havoc,18,9,9
Giftìg,ravencrest,864,demonhunter,havoc,18,9,9
Bruxdh,dun-modr,864,demonhunter,havoc,18,9,9
Illidany,eredar,864,demonhunter,havoc,24,9,15
Ayimprepared,ragnaros,864,demonhunter,havoc,24,9,15
Sjox,dalaran,864,demonhunter,havoc,84,25,59
Aîmwârê,ravencrest,863,demonhunter,havoc,12,9,3
Sunestaa,kazzak,863,demonhunter,havoc,12,9,3
Drunkendemon,frostwolf,863,demonhunter,havoc,12,9,3
Деленна,azuregos,863,demonhunter,havoc,15,10,5
Lezzo,tarren-mill,863,demonhunter,havoc,18,9,9
Hogidan,hellscream,863,demonhunter,havoc,18,9,9
Hymennette,hyjal,863,demonhunter,havoc,18,9,9
Sykzdh,hyjal,863,demonhunter,havoc,18,9,9
Ronstoppable,ravencrest,863,demonhunter,havoc,18,9,9
Chaoticballz,tarren-mill,863,demonhunter,havoc,18,9,9
Пампу,howling-fjord,863,demonhunter,havoc,18,9,9
Azuriana,teldrassil,863,demonhunter,havoc,18,9,9
Illidaia,ravencrest,863,demonhunter,havoc,18,9,9
Djdhh,draenor,863,demonhunter,havoc,20,9,11
Pokálen,drakthul,863,demonhunter,havoc,24,9,15
Mettdaemon,ravencrest,863,demonhunter,havoc,24,9,15
Slizer,draenor,863,demonhunter,havoc,24,9,15
Tricki,kelthuzad,863,demonhunter,havoc,24,9,15
Susamaro,blackrock,862,demonhunter,havoc,15,10,5
Lundí,tarren-mill,862,demonhunter,havoc,18,9,9
Oleasdra,dragonmaw,862,demonhunter,havoc,18,9,9
Nadili,destromath,862,demonhunter,havoc,18,9,9
Zappikdh,silvermoon,862,demonhunter,havoc,18,9,9
Grifht,zuljin,862,demonhunter,havoc,18,9,9
Demonstorpix,drakthul,862,demonhunter,havoc,24,9,15
Крикетх,soulflayer,862,demonhunter,havoc,24,9,15
Tzklkn,sylvanas,861,demonhunter,havoc,12,9,3
Эска,razuvious,861,demonhunter,havoc,18,9,9
Selcan,archimonde,861,demonhunter,havoc,18,9,9
Mightyslayar,kazzak,861,demonhunter,havoc,18,9,9
Montesíno,drakthul,861,demonhunter,havoc,24,9,15
Яестьдима,howling-fjord,861,demonhunter,havoc,30,9,21
Loße,ragnaros,860,demonhunter,havoc,12,9,3
Cerebro,dunemaul,860,demonhunter,havoc,53,27,26
Nameerr,ragnaros,860,demonhunter,havoc,18,9,9
Felglaiver,outland,860,demonhunter,havoc,18,9,9
Wrathill,draenor,860,demonhunter,havoc,24,9,15
Switzar,kazzak,860,demonhunter,havoc,24,9,15
Doobregeesy,burning-legion,859,demonhunter,havoc,21,10,11
Calicó,draenor,859,demonhunter,havoc,24,9,15
Deathblades,twisting-nether,859,demonhunter,havoc,24,9,15
Approxis,archimonde,858,demonhunter,havoc,18,9,9
Styggve,ragnaros,858,demonhunter,havoc,24,9,15
Бусурманец,gordunni,858,demonhunter,havoc,27,10,17
Thärius,silvermoon,857,demonhunter,havoc,18,9,9
Enithy,twisting-nether,857,demonhunter,havoc,18,9,9
Keiti,drakthul,856,demonhunter,havoc,36,9,27
Æsenaw,argent-dawn,855,demonhunter,havoc,18,9,9
Bhuta,aerie-peak,855,demonhunter,havoc,18,9,9
Deathsnote,marécage-de-zangar,854,demonhunter,havoc,24,9,15
Dionée,silvermoon,853,demonhunter,havoc,42,21,21
Mobpsycho,draenor,852,demonhunter,havoc,12,9,3
Hummér,ravencrest,850,demonhunter,havoc,18,9,9
Axyo,doomhammer,849,demonhunter,havoc,30,9,21
Winchestera,silvermoon,849,demonhunter,havoc,36,9,27
Jemoer,twisting-nether,847,demonhunter,havoc,45,22,23
Heemaglobin,ravencrest,843,demonhunter,havoc,42,18,24
Noorrd,hyjal,842,demonhunter,havoc,30,11,19
Razzum,blackhand,841,demonhunter,havoc,50,14,36
Sil,khazgoroth,838,demonhunter,havoc,30,11,19
Backflipgødx,uldaman,832,demonhunter,havoc,22,9,13
Elldarion,blackhand,832,demonhunter,havoc,29,9,20
Brasa,pozzo-delleternità,831,demonhunter,havoc,16,9,7
Toio,nemesis,831,demonhunter,havoc,24,9,15
Judderzz,bronze-dragonflight,830,demonhunter,havoc,42,19,23
Nystiyel,hyjal,828,demonhunter,havoc,26,10,16
Ysanix,drakthul,825,demonhunter,havoc,18,9,9
Selvagg,archimonde,823,demonhunter,havoc,30,9,21
Кислотна,borean-tundra,819,demonhunter,havoc,37,16,21
Afkah,chants-éternels,815,demonhunter,havoc,12,9,3
Hunterston,twisting-nether,813,demonhunter,havoc,77,42,35
Daimon,pozzo-delleternità,813,demonhunter,havoc,21,10,11
Тиранд,gordunni,810,demonhunter,havoc,27,9,18
Critlerman,blackmoore,807,demonhunter,havoc,18,11,7
Darkleaf,sporeggar,807,demonhunter,havoc,42,12,30
Lazeruraz,argent-dawn,799,demonhunter,havoc,16,9,7
Аззил,soulflayer,799,demonhunter,havoc,16,9,7
Illidaniellé,tarren-mill,799,demonhunter,havoc,17,9,8
Wukasin,kazzak,798,demonhunter,havoc,18,9,9
Deadhuntor,daggerspine,795,demonhunter,havoc,17,9,8
Hollowflame,ravencrest,793,demonhunter,havoc,29,12,17
Merilidan,blackrock,791,demonhunter,havoc,20,9,11
Sinjinzoo,blackrock,789,demonhunter,havoc,14,9,5
Eous,nordrassil,782,demonhunter,havoc,19,9,10
Кусьзакиску,soulflayer,781,demonhunter,havoc,22,9,13
Viodemon,blackrock,768,demonhunter,havoc,12,8,4
Диефекта,gordunni,768,demonhunter,havoc,12,8,4
Mesini,darksorrow,768,demonhunter,havoc,12,8,4
Smallnik,tarren-mill,768,demonhunter,havoc,12,8,4
Adexi,twisting-nether,768,demonhunter,havoc,12,8,4
Lurtexjr,antonidas,768,demonhunter,havoc,12,8,4
Mongraal,tichondrius,768,demonhunter,havoc,12,8,4
Traumadh,tarren-mill,768,demonhunter,havoc,12,8,4
Wèx,tarren-mill,768,demonhunter,havoc,12,8,4
Eysndh,blackrock,768,demonhunter,havoc,12,8,4
Stinkymonkey,pozzo-delleternità,768,demonhunter,havoc,18,8,10
Fîrstwolf,silvermoon,768,demonhunter,havoc,18,8,10
Nthday,draenor,768,demonhunter,havoc,18,8,10
Sydeon,burning-legion,768,demonhunter,havoc,18,8,10
Dhaosh,nemesis,768,demonhunter,havoc,18,8,10
Konesimp,kazzak,768,demonhunter,havoc,18,8,10
Mvqdh,stormscale,768,demonhunter,havoc,18,8,10
Leväna,sanguino,768,demonhunter,havoc,18,8,10
Praisethelrd,blackrock,768,demonhunter,havoc,18,8,10
Thestrength,twisting-nether,768,demonhunter,havoc,18,8,10
Jellyjoker,malganis,768,demonhunter,havoc,18,8,10
Tbxdh,blackrock,768,demonhunter,havoc,18,8,10
Mythisa,blackrock,768,demonhunter,havoc,21,9,12
Dzieciak,burning-legion,768,demonhunter,havoc,22,9,13
Ataddcay,outland,768,demonhunter,havoc,84,29,55
Rõb,magtheridon,768,demonhunter,havoc,24,8,16
Demoan,outland,768,demonhunter,havoc,24,8,16
Cptgmiasbria,eredar,768,demonhunter,havoc,30,8,22
Earfâlass,twisting-nether,768,demonhunter,havoc,30,8,22
Smaùg,archimonde,767,demonhunter,havoc,12,8,4
Ninetzqp,tarren-mill,767,demonhunter,havoc,12,8,4
Callì,blackrock,767,demonhunter,havoc,12,8,4
Sepulvar,blackmoore,767,demonhunter,havoc,13,8,5
Ðynnamo,dentarg,767,demonhunter,havoc,15,9,6
Glevenuschii,blackmoore,767,demonhunter,havoc,18,9,9
Kithan,zuljin,767,demonhunter,havoc,18,8,10
Mortyb,kazzak,767,demonhunter,havoc,18,8,10
Tøñÿfûsìllí,hyjal,767,demonhunter,havoc,18,8,10
Tyradell,darksorrow,767,demonhunter,havoc,18,8,10
Caronte,los-errantes,767,demonhunter,havoc,18,8,10
Вафлистикус,ashenvale,767,demonhunter,havoc,18,8,10
Zmasteez,ahnqiraj,767,demonhunter,havoc,18,8,10
Demonpimpf,blackrock,767,demonhunter,havoc,18,8,10
Lirigizel,hellscream,767,demonhunter,havoc,18,8,10
Mayaken,ravencrest,767,demonhunter,havoc,18,8,10
Shax,hellscream,767,demonhunter,havoc,18,8,10
Рикельме,gordunni,767,demonhunter,havoc,18,8,10
Evandel,silvermoon,767,demonhunter,havoc,18,8,10
Zedies,argent-dawn,767,demonhunter,havoc,18,8,10
Lesamaritain,ysondre,767,demonhunter,havoc,18,8,10
Jayjây,outland,767,demonhunter,havoc,18,8,10
Kittenz,outland,767,demonhunter,havoc,18,8,10
Calendith,arathor,767,demonhunter,havoc,21,9,12
Salamihexler,dun-morogh,767,demonhunter,havoc,23,8,15
Dìus,blackmoore,767,demonhunter,havoc,24,8,16
Klerikerin,blackmoore,766,demonhunter,havoc,12,8,4
Rfosop,chants-éternels,766,demonhunter,havoc,12,8,4
Skrelarent,argent-dawn,766,demonhunter,havoc,12,8,4
Хандза,gordunni,766,demonhunter,havoc,18,8,10
Varthag,antonidas,766,demonhunter,havoc,18,8,10
Nairu,doomhammer,766,demonhunter,havoc,18,8,10
Thrina,blackmoore,766,demonhunter,havoc,18,8,10
Klinnaa,elune,766,demonhunter,havoc,18,8,10
Neiden,deathwing,766,demonhunter,havoc,24,8,16
Iceboni,hyjal,766,demonhunter,havoc,24,8,16
Calami,pozzo-delleternità,766,demonhunter,havoc,24,8,16
Apfelkuchen,eredar,765,demonhunter,havoc,12,8,4
Granitaa,archimonde,765,demonhunter,havoc,12,8,4
Akäly,hyjal,765,demonhunter,havoc,19,9,10
Sildanah,hyjal,765,demonhunter,havoc,18,8,10
Karakaartaal,silvermoon,765,demonhunter,havoc,18,8,10
Jimpanik,ravencrest,765,demonhunter,havoc,18,8,10
Aelzeran,stormscale,765,demonhunter,havoc,24,8,16
Zumbly,silvermoon,765,demonhunter,havoc,24,8,16
Mortalsin,tarren-mill,764,demonhunter,havoc,12,8,4
Flamme,amanthul,764,demonhunter,havoc,98,45,53
Blackrdemon,azjolnerub,763,demonhunter,havoc,12,8,4
Cindras,turalyon,763,demonhunter,havoc,18,8,10
Saìras,blackhand,763,demonhunter,havoc,18,8,10
Covidian,kilrogg,762,demonhunter,havoc,12,8,4
Funálfa,sylvanas,762,demonhunter,havoc,12,8,4
Ridweng,ravenholdt,762,demonhunter,havoc,13,8,5
Zydemon,silvermoon,762,demonhunter,havoc,18,8,10
Unsainted,blackhand,762,demonhunter,havoc,24,8,16
Amaterasù,alleria,761,demonhunter,havoc,18,8,10
Норилайнн,gordunni,761,demonhunter,havoc,24,8,16
Sinrii,archimonde,760,demonhunter,havoc,16,9,7
Stàmàzza,nemesis,760,demonhunter,havoc,18,8,10
Hairebutter,kult-der-verdammten,760,demonhunter,havoc,30,8,22
Azazël,turalyon,759,demonhunter,havoc,27,9,18
Mandemz,nagrand,759,demonhunter,havoc,24,8,16
Chaordic,turalyon,758,demonhunter,havoc,24,8,16
Tuffêli,turalyon,756,demonhunter,havoc,24,8,16
Lailat,alexstrasza,752,demonhunter,havoc,16,9,7
Seaburn,bronzebeard,751,demonhunter,havoc,229,99,130
Deamo,stormscale,750,demonhunter,havoc,23,8,15
Zealdancer,veknilash,734,demonhunter,havoc,17,8,9
Opvoksterxx,sylvanas,733,demonhunter,havoc,22,8,14
Fllyp,stormscale,731,demonhunter,havoc,17,8,9
Daedris,tarren-mill,727,demonhunter,havoc,23,8,15
Неверластх,gordunni,720,demonhunter,havoc,21,8,13
Hashwidow,archimonde,719,demonhunter,havoc,15,8,7
Makiu,archimonde,717,demonhunter,havoc,21,8,13
Alfazar,pozzo-delleternità,708,demonhunter,havoc,98,31,67
Liondam,pozzo-delleternità,707,demonhunter,havoc,42,13,29
Laylay,vashj,706,demonhunter,havoc,78,26,52
Rozikosi,magtheridon,703,demonhunter,havoc,14,8,6
Caøtix,blackrock,702,demonhunter,havoc,19,9,10
Stormshred,stormscale,700,demonhunter,havoc,27,8,19
Yeyote,dun-modr,695,demonhunter,havoc,15,10,5
Itzrazor,ravencrest,683,demonhunter,havoc,25,8,17
Prouser,turalyon,678,demonhunter,havoc,27,9,18
Mobyl,stormscale,672,demonhunter,havoc,12,7,5
Gorinda,twisting-nether,672,demonhunter,havoc,12,7,5
Fumroned,twisting-nether,672,demonhunter,havoc,12,7,5
Pepenger,kazzak,672,demonhunter,havoc,12,7,5
Damnituther,kazzak,672,demonhunter,havoc,12,7,5
Dreamreaperx,ravencrest,672,demonhunter,havoc,12,7,5
Vidagín,blackmoore,672,demonhunter,havoc,12,7,5
Brutodh,stormscale,672,demonhunter,havoc,12,7,5
Psynotic,kazzak,672,demonhunter,havoc,12,7,5
Клаес,howling-fjord,672,demonhunter,havoc,12,7,5
Sfigmenos,sylvanas,672,demonhunter,havoc,12,7,5
Lornashøre,blackmoore,672,demonhunter,havoc,12,7,5
Chaosknight,outland,672,demonhunter,havoc,12,7,5
Vazaí,ravencrest,672,demonhunter,havoc,12,7,5
Rageglaive,ragnaros,672,demonhunter,havoc,12,7,5
Lemiisa,burning-blade,672,demonhunter,havoc,12,7,5
Vlexsuave,stormscale,672,demonhunter,havoc,12,7,5
Víllaiin,tarren-mill,672,demonhunter,havoc,12,7,5
Varkósa,sylvanas,672,demonhunter,havoc,12,7,5
Izior,drakthul,672,demonhunter,havoc,12,7,5
Rainmaker,xavius,672,demonhunter,havoc,12,7,5
Lëtho,colinas-pardas,672,demonhunter,havoc,12,7,5
Remiyo,eredar,672,demonhunter,havoc,12,7,5
Esadeáth,ravencrest,672,demonhunter,havoc,12,7,5
Bwipøo,alakir,672,demonhunter,havoc,12,7,5
Setthanol,burning-legion,672,demonhunter,havoc,12,7,5
Crispychick,stormscale,672,demonhunter,havoc,12,7,5
Stonedaf,ravencrest,672,demonhunter,havoc,12,7,5
Ilidansdaddy,twisting-nether,672,demonhunter,havoc,12,7,5
Bøneshades,hyjal,672,demonhunter,havoc,12,7,5
Amovea,draenor,672,demonhunter,havoc,15,8,7
Kayzer,hyjal,672,demonhunter,havoc,16,8,8
Itsfinee,outland,672,demonhunter,havoc,14,7,7
Abigorien,blackmoore,672,demonhunter,havoc,18,7,11
Foltek,silvermoon,672,demonhunter,havoc,18,7,11
Størmrage,sanguino,672,demonhunter,havoc,18,7,11
Reachfight,lothar,672,demonhunter,havoc,18,7,11
Alàstora,twisting-nether,672,demonhunter,havoc,18,7,11
Grazax,lightnings-blade,672,demonhunter,havoc,18,7,11
Veryfunhaha,ravencrest,672,demonhunter,havoc,18,7,11
Келидаррия,soulflayer,672,demonhunter,havoc,18,7,11
Ashivari,argent-dawn,672,demonhunter,havoc,18,7,11
Granite,blackrock,672,demonhunter,havoc,18,7,11
Maximuspizza,tarren-mill,672,demonhunter,havoc,18,7,11
Kruthor,taerar,672,demonhunter,havoc,18,7,11
Hatabaa,argent-dawn,672,demonhunter,havoc,18,7,11
Этотрагедия,howling-fjord,672,demonhunter,havoc,18,7,11
Wrathia,rexxar,672,demonhunter,havoc,18,7,11
Gorilla,korgall,672,demonhunter,havoc,18,7,11
Jurihan,blackhand,672,demonhunter,havoc,18,7,11
Dhgoddess,ravencrest,672,demonhunter,havoc,18,7,11
Шликшлик,blackscar,672,demonhunter,havoc,18,7,11
Ostosbigego,ravencrest,672,demonhunter,havoc,18,7,11
Enami,kazzak,672,demonhunter,havoc,18,7,11
Kiô,drakthul,672,demonhunter,havoc,21,8,13
Monkeytwelve,eredar,672,demonhunter,havoc,19,7,12
Hârambe,stormscale,672,demonhunter,havoc,24,8,16
Illidorie,twisting-nether,672,demonhunter,havoc,24,7,17
Paîmon,hyjal,672,demonhunter,havoc,24,7,17
Jokas,archimonde,672,demonhunter,havoc,24,7,17
Darkdh,sanguino,672,demonhunter,havoc,24,7,17
Demonbreak,nemesis,672,demonhunter,havoc,30,7,23
Gifix,nemesis,671,demonhunter,havoc,12,7,5
Nxmpys,sanguino,671,demonhunter,havoc,12,7,5
Kap,kazzak,671,demonhunter,havoc,12,7,5
Haragazu,blackrock,671,demonhunter,havoc,12,7,5
Randydhunt,draenor,671,demonhunter,havoc,12,7,5
Ddvh,drakthul,671,demonhunter,havoc,12,7,5
Aladír,malygos,671,demonhunter,havoc,12,7,5
Zenga,kazzak,671,demonhunter,havoc,12,7,5
Marcellaa,ravencrest,671,demonhunter,havoc,12,7,5
Phaël,ravencrest,671,demonhunter,havoc,12,7,5
Youngboost,blackrock,671,demonhunter,havoc,12,7,5
Meji,ravencrest,671,demonhunter,havoc,12,7,5
Rabischu,echsenkessel,671,demonhunter,havoc,15,8,7
Illidarios,blackhand,671,demonhunter,havoc,18,7,11
Venkz,archimonde,671,demonhunter,havoc,18,7,11
Тирандил,grom,671,demonhunter,havoc,18,7,11
Abrahêll,dun-modr,671,demonhunter,havoc,18,7,11
Zarkaniz,draenor,671,demonhunter,havoc,18,7,11
Moireananke,frostwolf,671,demonhunter,havoc,18,7,11
Norebb,sanguino,671,demonhunter,havoc,18,7,11
Gearuzaki,ghostlands,671,demonhunter,havoc,18,7,11
Takeshí,burning-legion,671,demonhunter,havoc,18,7,11
Corelly,ragnaros,671,demonhunter,havoc,18,7,11
Illidaclem,archimonde,671,demonhunter,havoc,18,7,11
Critheria,wildhammer,671,demonhunter,havoc,18,7,11
Irenth,burning-legion,671,demonhunter,havoc,19,7,12
Pravda,terokkar,671,demonhunter,havoc,20,7,13
Donstyle,anachronos,671,demonhunter,havoc,22,7,15
Камбечная,soulflayer,671,demonhunter,havoc,24,7,17
Moððe,defias-brotherhood,671,demonhunter,havoc,24,7,17
Talyrîs,aegwynn,671,demonhunter,havoc,24,7,17
Älger,archimonde,670,demonhunter,havoc,12,7,5
Asgorth,eredar,670,demonhunter,havoc,12,7,5
Lahan,twisting-nether,670,demonhunter,havoc,12,7,5
Xtrmhunter,hyjal,670,demonhunter,havoc,18,7,11
Avus,burning-legion,670,demonhunter,havoc,18,7,11
Ungeist,blackrock,670,demonhunter,havoc,18,7,11
Hyunkél,kirin-tor,670,demonhunter,havoc,18,7,11
Atronäx,dun-modr,670,demonhunter,havoc,18,7,11
Tarók,ragnaros,670,demonhunter,havoc,18,7,11
Raenir,twisting-nether,670,demonhunter,havoc,19,7,12
Léeroy,blackmoore,670,demonhunter,havoc,30,7,23
Fellstone,kazzak,670,demonhunter,havoc,30,7,23
Rahteri,hellfire,669,demonhunter,havoc,12,7,5
Nmeule,turalyon,669,demonhunter,havoc,12,7,5
Kíssemurra,azjolnerub,669,demonhunter,havoc,18,7,11
Akina,krasus,669,demonhunter,havoc,18,7,11
Мориганс,soulflayer,669,demonhunter,havoc,18,7,11
Necrotyle,twisting-nether,669,demonhunter,havoc,21,8,13
Ïllidän,sinstralis,668,demonhunter,havoc,12,7,5
Rooster,malganis,668,demonhunter,havoc,18,7,11
Gangrazorg,garona,667,demonhunter,havoc,18,7,11
Дядяэл,fordragon,667,demonhunter,havoc,24,7,17
Farlopon,dun-modr,667,demonhunter,havoc,36,7,29
Mormefiél,twisting-nether,666,demonhunter,havoc,12,7,5
Fugma,defias-brotherhood,666,demonhunter,havoc,12,7,5
Baeblade,ragnaros,666,demonhunter,havoc,12,7,5
Seeshark,thrall,665,demonhunter,havoc,16,8,8
Coryalac,archimonde,665,demonhunter,havoc,18,7,11
Pmiguel,aggra-português,665,demonhunter,havoc,24,7,17
Ztef,outland,665,demonhunter,havoc,30,7,23
Demonyz,hyjal,664,demonhunter,havoc,18,7,11
Rúpél,thrall,664,demonhunter,havoc,24,7,17
Мелликсин,gordunni,664,demonhunter,havoc,30,7,23
Illidancz,thunderhorn,662,demonhunter,havoc,19,8,11
Solian,ravencrest,661,demonhunter,havoc,12,7,5
Asalina,hyjal,661,demonhunter,havoc,19,8,11
Demoncancer,kazzak,657,demonhunter,havoc,12,7,5
Nazzan,destromath,657,demonhunter,havoc,12,7,5
Eranasht,madmortem,655,demonhunter,havoc,24,7,17
Anishara,die-nachtwache,653,demonhunter,havoc,19,8,11
Caesares,azjolnerub,653,demonhunter,havoc,24,7,17
Kaleyah,gorgonnash,651,demonhunter,havoc,18,7,11
Попкасиська,eversong,651,demonhunter,havoc,65,22,43
Deadali,stormscale,649,demonhunter,havoc,18,7,11
Saintos,drakthul,645,demonhunter,havoc,18,7,11
Smîrky,silvermoon,640,demonhunter,havoc,22,7,15
Tavarion,thrall,639,demonhunter,havoc,14,8,6
Demongorgon,arathor,639,demonhunter,havoc,26,8,18
Летучий,howling-fjord,638,demonhunter,havoc,14,8,6
Lexxdh,blackmoore,637,demonhunter,havoc,14,8,6
Nofelings,twisting-nether,634,demonhunter,havoc,34,8,26
Vesria,stormrage,627,demonhunter,havoc,16,8,8
Snelle,outland,624,demonhunter,havoc,15,7,8
Valandyl,ysondre,623,demonhunter,havoc,11,7,4
Подкрадунзай,soulflayer,621,demonhunter,havoc,12,9,3
Áthos,stormscale,621,demonhunter,havoc,13,8,5
Юзалесщит,soulflayer,618,demonhunter,havoc,21,8,13
Makhabunda,terokkar,618,demonhunter,havoc,28,8,20
Illidrak,sylvanas,617,demonhunter,havoc,21,8,13
Shiroyashae,twisting-nether,613,demonhunter,havoc,15,8,7
Hyperflex,blackrock,608,demonhunter,havoc,16,7,9
Phalekxox,ravencrest,607,demonhunter,havoc,11,7,4
Лсди,gordunni,607,demonhunter,havoc,14,7,7
Линдорм,deathguard,603,demonhunter,havoc,14,7,7
Sorgnarol,dalaran,602,demonhunter,havoc,22,8,14
Samurase,kazzak,597,demonhunter,havoc,20,7,13
Nahlendris,darkmoon-faire,596,demonhunter,havoc,16,7,9
Thesasuke,tarren-mill,590,demonhunter,havoc,11,7,4
Povamateur,rexxar,576,demonhunter,havoc,6,6,0
Mímð,ravencrest,576,demonhunter,havoc,6,6,0
Alasune,twisting-nether,576,demonhunter,havoc,6,6,0
Chicorycofee,archimonde,576,demonhunter,havoc,9,7,2
Demoqt,ragnaros,576,demonhunter,havoc,10,7,3
Peacedopice,drakthul,576,demonhunter,havoc,12,6,6
Malethrienna,argent-dawn,576,demonhunter,havoc,12,6,6
Zeyrax,ragnaros,576,demonhunter,havoc,12,6,6
Harrah,archimonde,576,demonhunter,havoc,12,6,6
Clapping,blackhand,576,demonhunter,havoc,12,6,6
Nélathas,twisting-nether,576,demonhunter,havoc,12,6,6
Noovedh,ravencrest,576,demonhunter,havoc,12,6,6
Shinrpz,archimonde,576,demonhunter,havoc,12,6,6
Onkwang,twisting-nether,576,demonhunter,havoc,12,6,6
Friidaadh,lightbringer,576,demonhunter,havoc,12,6,6
Denouncez,defias-brotherhood,576,demonhunter,havoc,12,6,6
Nitrobeevz,blackmoore,576,demonhunter,havoc,12,6,6
Bep,defias-brotherhood,576,demonhunter,havoc,12,6,6
Cagirnat,tarren-mill,576,demonhunter,havoc,12,6,6
Kazeha,tarren-mill,576,demonhunter,havoc,12,6,6
Ксен,howling-fjord,576,demonhunter,havoc,12,6,6
Dàrknight,azjolnerub,576,demonhunter,havoc,12,6,6
Adírael,cthun,576,demonhunter,havoc,12,6,6
Gzmo,tarren-mill,576,demonhunter,havoc,12,6,6
Thoridin,draenor,576,demonhunter,havoc,12,6,6
Dakydh,ravencrest,576,demonhunter,havoc,12,6,6
Zsídakabra,ragnaros,576,demonhunter,havoc,12,6,6
Emowhiteboi,draenor,576,demonhunter,havoc,12,6,6
Daiax,ravencrest,576,demonhunter,havoc,12,6,6
Сурек,howling-fjord,576,demonhunter,havoc,12,6,6
Jollychimp,blackrock,576,demonhunter,havoc,12,6,6
Reppz,blackmoore,576,demonhunter,havoc,12,6,6
Credenzx,frostmane,576,demonhunter,havoc,12,6,6
Imdrevil,ravencrest,576,demonhunter,havoc,12,6,6
Alrashidi,ravencrest,576,demonhunter,havoc,12,6,6
Brajjo,frostmane,576,demonhunter,havoc,12,6,6
Felrunner,grim-batol,576,demonhunter,havoc,12,6,6
Soulmortal,draenor,576,demonhunter,havoc,12,6,6
Avadåra,stormscale,576,demonhunter,havoc,12,6,6
Amnesiax,der-rat-von-dalaran,576,demonhunter,havoc,12,6,6
Liädriss,tarren-mill,576,demonhunter,havoc,12,6,6
Swearix,twisting-nether,576,demonhunter,havoc,12,6,6
Jaace,silvermoon,576,demonhunter,havoc,12,6,6
Нулевыйчел,gordunni,576,demonhunter,havoc,12,6,6
Брилаброви,soulflayer,576,demonhunter,havoc,12,6,6
Miyxcu,aegwynn,576,demonhunter,havoc,12,6,6
Elsibal,dunemaul,576,demonhunter,havoc,12,6,6
Grimner,silvermoon,576,demonhunter,havoc,12,6,6
Mendøøza,hyjal,576,demonhunter,havoc,12,6,6
Bradzdh,outland,576,demonhunter,havoc,12,6,6
Illidangr,sylvanas,576,demonhunter,havoc,12,6,6
Lurtéx,kazzak,576,demonhunter,havoc,12,6,6
Sickdoci,kazzak,576,demonhunter,havoc,12,6,6
Ferrero,guldan,576,demonhunter,havoc,12,6,6
Mitzii,nazjatar,576,demonhunter,havoc,12,6,6
Mårvænn,hyjal,576,demonhunter,havoc,12,6,6
Smashine,silvermoon,576,demonhunter,havoc,12,6,6
Tëvnic,kazzak,576,demonhunter,havoc,12,6,6
Bigbrain,festung-der-stürme,576,demonhunter,havoc,12,6,6
Shreeð,blackmoore,576,demonhunter,havoc,16,7,9
Dèsdemøna,nemesis,576,demonhunter,havoc,18,6,12
Gendó,twisting-nether,576,demonhunter,havoc,18,6,12
Rurt,sanguino,576,demonhunter,havoc,18,6,12
Shyoxdh,twisting-nether,576,demonhunter,havoc,18,6,12
Pinx,archimonde,576,demonhunter,havoc,18,6,12
Alandiel,twisting-nether,576,demonhunter,havoc,18,6,12
Blueformeld,draenor,576,demonhunter,havoc,18,6,12
Zomaso,kazzak,576,demonhunter,havoc,18,6,12
Tthic,shadowsong,576,demonhunter,havoc,18,6,12
Dlarkyl,drakthul,576,demonhunter,havoc,18,6,12
Bitex,archimonde,576,demonhunter,havoc,18,6,12
Chíwas,outland,576,demonhunter,havoc,18,6,12
Devourr,ravencrest,576,demonhunter,havoc,18,6,12
Sorrøwblade,drakthul,576,demonhunter,havoc,18,6,12
Кальнмиир,soulflayer,576,demonhunter,havoc,18,6,12
Zaÿn,antonidas,576,demonhunter,havoc,18,6,12
Mythnimue,tarren-mill,576,demonhunter,havoc,18,6,12
Vg,blackhand,576,demonhunter,havoc,18,6,12
Lilpeepfan,hyjal,576,demonhunter,havoc,18,6,12
Nøøßønline,hyjal,576,demonhunter,havoc,18,6,12
Awawaaw,tarren-mill,576,demonhunter,havoc,18,6,12
Kukulkanx,tarren-mill,576,demonhunter,havoc,18,6,12
Филеровщик,deathguard,576,demonhunter,havoc,18,6,12
Jäck,draenor,576,demonhunter,havoc,21,6,15
Thewalker,argent-dawn,576,demonhunter,havoc,24,6,18
Кранище,howling-fjord,576,demonhunter,havoc,24,6,18
Pèpsì,kazzak,576,demonhunter,havoc,24,6,18
Vrazjababa,dragonmaw,576,demonhunter,havoc,24,6,18
Redgi,tarren-mill,576,demonhunter,havoc,24,6,18
Каоссдх,gordunni,576,demonhunter,havoc,24,6,18
Стараятварь,thermaplugg,576,demonhunter,havoc,24,6,18
Shizuuli,outland,576,demonhunter,havoc,30,6,24
Patologia,burning-legion,575,demonhunter,havoc,9,7,2
Nassou,hyjal,575,demonhunter,havoc,12,6,6
Urdeathwish,draenor,575,demonhunter,havoc,12,6,6
Davdavdh,tarren-mill,575,demonhunter,havoc,12,6,6
Instinctivee,sylvanas,575,demonhunter,havoc,12,6,6
Sûnfury,draenor,575,demonhunter,havoc,12,6,6
Mendøza,hyjal,575,demonhunter,havoc,12,6,6
Kramixx,thrall,575,demonhunter,havoc,12,6,6
Saftad,outland,575,demonhunter,havoc,12,6,6
Firebladeza,ravencrest,575,demonhunter,havoc,12,6,6
Valshatt,sanguino,575,demonhunter,havoc,12,6,6
Plafos,sanguino,575,demonhunter,havoc,12,6,6
Nolords,twisting-nether,575,demonhunter,havoc,12,6,6
Tôrxy,antonidas,575,demonhunter,havoc,12,6,6
Arløw,archimonde,575,demonhunter,havoc,16,7,9
Synistera,trollbane,575,demonhunter,havoc,18,6,12
Drypwnya,azshara,575,demonhunter,havoc,18,6,12
Talrundir,argent-dawn,575,demonhunter,havoc,18,6,12
Yundmida,antonidas,575,demonhunter,havoc,18,6,12
Milleniumx,aegwynn,575,demonhunter,havoc,18,6,12
Candylicks,kazzak,575,demonhunter,havoc,18,6,12
Joezus,draenor,575,demonhunter,havoc,18,6,12
Darkshadez,ravencrest,575,demonhunter,havoc,18,6,12
Trép,draenor,575,demonhunter,havoc,18,6,12
Зедю,howling-fjord,575,demonhunter,havoc,18,6,12
Generaaloo,ragnaros,575,demonhunter,havoc,18,6,12
Tixe,thrall,575,demonhunter,havoc,24,6,18
Бтдыш,azuregos,575,demonhunter,havoc,24,6,18
Grinchdemon,nagrand,574,demonhunter,havoc,12,6,6
Altacer,defias-brotherhood,574,demonhunter,havoc,18,6,12
Lenuna,frostmourne,574,demonhunter,havoc,18,6,12
Klave,argent-dawn,573,demonhunter,havoc,18,6,12
Elindoria,dalaran,572,demonhunter,havoc,12,6,6
Dæmonhønter,draenor,572,demonhunter,havoc,26,6,20
Arxaxe,sanguino,571,demonhunter,havoc,12,6,6
Káyn,sanguino,570,demonhunter,havoc,12,6,6
Bahmut,argent-dawn,569,demonhunter,havoc,12,6,6
Ðéstrøz,draenor,564,demonhunter,havoc,23,10,13
Darkraiser,blackmoore,544,demonhunter,havoc,16,7,9
Дартемъянка,gordunni,543,demonhunter,havoc,11,6,5
Yldaryiss,les-sentinelles,542,demonhunter,havoc,17,6,11
Ayylmfao,sanguino,541,demonhunter,havoc,11,6,5
Tiucciah,kirin-tor,539,demonhunter,havoc,11,6,5
Foxylama,stormscale,528,demonhunter,havoc,15,7,8
Panejo,drakthul,528,demonhunter,havoc,15,6,9
Manybuttons,tarren-mill,522,demonhunter,havoc,16,7,9
Алистреель,gordunni,521,demonhunter,havoc,13,7,6
Джэкмэн,soulflayer,520,demonhunter,havoc,29,8,21
Kaev,ravencrest,512,demonhunter,havoc,22,6,16
Zethraxxur,outland,511,demonhunter,havoc,11,6,5
Gnjurac,outland,511,demonhunter,havoc,14,6,8
Høw,ravencrest,511,demonhunter,havoc,14,6,8
Asperity,antonidas,511,demonhunter,havoc,18,6,12
Oskarz,ravencrest,507,demonhunter,havoc,20,6,14
Veaxina,der-rat-von-dalaran,494,demonhunter,havoc,11,8,3
ßatman,eredar,480,demonhunter,havoc,6,5,1
Harpyia,azshara,480,demonhunter,havoc,6,5,1
Avavidh,blackmoore,480,demonhunter,havoc,6,5,1
Nanába,draenor,480,demonhunter,havoc,6,5,1
Ybo,tarren-mill,480,demonhunter,havoc,6,5,1
Lîlìllíðårî,the-maelstrom,480,demonhunter,havoc,6,5,1
Monion,defias-brotherhood,480,demonhunter,havoc,6,5,1
Mouga,hyjal,480,demonhunter,havoc,6,5,1
Katkott,kazzak,480,demonhunter,havoc,6,5,1
Yunkimon,ysondre,480,demonhunter,havoc,6,5,1
Shazima,sylvanas,480,demonhunter,havoc,6,5,1
Sinarel,die-aldor,480,demonhunter,havoc,6,5,1
Ismelldemons,silvermoon,480,demonhunter,havoc,6,5,1
Gansh,draenor,480,demonhunter,havoc,6,5,1
Kekina,die-aldor,480,demonhunter,havoc,6,5,1
Theomarz,nemesis,480,demonhunter,havoc,6,5,1
Morrion,blackmoore,480,demonhunter,havoc,6,5,1
Sossifotm,silvermoon,480,demonhunter,havoc,6,5,1
Wyzedh,blackrock,480,demonhunter,havoc,6,5,1
Miscodedh,ravencrest,480,demonhunter,havoc,9,6,3
Reikuel,nemesis,480,demonhunter,havoc,12,5,7
Nagh,archimonde,480,demonhunter,havoc,12,5,7
Dzikalocha,burning-legion,480,demonhunter,havoc,12,5,7
Jahtomise,hyjal,480,demonhunter,havoc,12,5,7
Spitface,aegwynn,480,demonhunter,havoc,12,5,7
Depopbilbow,hyjal,480,demonhunter,havoc,12,5,7
Khenetai,silvermoon,480,demonhunter,havoc,12,5,7
Takad,twisting-nether,480,demonhunter,havoc,12,5,7
Диртхамен,blackscar,480,demonhunter,havoc,12,5,7
Kyvi,blackrock,480,demonhunter,havoc,12,5,7
Fefestyle,silvermoon,480,demonhunter,havoc,12,5,7
Zunada,ragnaros,480,demonhunter,havoc,12,5,7
Максимлолпро,howling-fjord,480,demonhunter,havoc,12,5,7
Spiiky,kazzak,480,demonhunter,havoc,12,5,7
Âstræa,antonidas,480,demonhunter,havoc,12,5,7
Hørnyßæ,drakthul,480,demonhunter,havoc,12,5,7
Пупчански,howling-fjord,480,demonhunter,havoc,12,5,7
Bigbootáy,silvermoon,480,demonhunter,havoc,12,5,7
Mileenacross,turalyon,480,demonhunter,havoc,12,5,7
Véspé,naxxramas,480,demonhunter,havoc,12,5,7
Dirael,dalaran,480,demonhunter,havoc,12,5,7
Rihal,stormscale,480,demonhunter,havoc,12,5,7
Thelyan,ravencrest,480,demonhunter,havoc,12,5,7
Tastyblades,blackmoore,480,demonhunter,havoc,12,5,7
Dogdeeps,silvermoon,480,demonhunter,havoc,12,5,7
Éla,stormscale,480,demonhunter,havoc,12,5,7
Malvax,tarren-mill,480,demonhunter,havoc,12,5,7
Vyers,argent-dawn,480,demonhunter,havoc,12,5,7
Winarchiksex,tarren-mill,480,demonhunter,havoc,12,5,7
Иаред,gordunni,480,demonhunter,havoc,12,5,7
Glìmpsêgøðx,antonidas,480,demonhunter,havoc,12,5,7
Ukumeqt,kazzak,480,demonhunter,havoc,12,5,7
Неондх,eversong,480,demonhunter,havoc,12,5,7
Icurogue,kazzak,480,demonhunter,havoc,12,5,7
Gunaknoch,outland,480,demonhunter,havoc,12,5,7
Tomkis,ravencrest,480,demonhunter,havoc,12,5,7
Алекзей,gordunni,480,demonhunter,havoc,12,5,7
Topg,bladefist,480,demonhunter,havoc,12,5,7
Noether,blackrock,480,demonhunter,havoc,12,5,7
Lårxx,draenor,480,demonhunter,havoc,12,5,7
Дракомуфлон,gordunni,480,demonhunter,havoc,12,5,7
Беатриз,soulflayer,480,demonhunter,havoc,12,5,7
Hajeva,ravencrest,480,demonhunter,havoc,12,5,7
Odda,los-errantes,480,demonhunter,havoc,12,5,7
Blind,kazzak,480,demonhunter,havoc,12,5,7
Tatoos,bronze-dragonflight,480,demonhunter,havoc,12,5,7
Deccal,blackmoore,480,demonhunter,havoc,12,5,7
Kindred,anachronos,480,demonhunter,havoc,12,5,7
Милифесена,gordunni,480,demonhunter,havoc,12,5,7
Резако,soulflayer,480,demonhunter,havoc,12,5,7
Superchocowo,sanguino,480,demonhunter,havoc,12,5,7
Qiufan,eredar,480,demonhunter,havoc,12,5,7
Блэйэмих,gordunni,480,demonhunter,havoc,12,5,7
Конглея,gordunni,480,demonhunter,havoc,18,5,13
Bengleng,draenor,480,demonhunter,havoc,18,5,13
Ascindra,kazzak,480,demonhunter,havoc,18,5,13
Alleyezønme,outland,480,demonhunter,havoc,18,5,13
Dübler,gorgonnash,480,demonhunter,havoc,18,5,13
Kritflake,blackrock,480,demonhunter,havoc,18,5,13
Natarásh,blackmoore,480,demonhunter,havoc,18,5,13
Wajoglaive,blackhand,480,demonhunter,havoc,18,5,13
Crushidemon,draenor,480,demonhunter,havoc,18,5,13
Nefastia,pozzo-delleternità,480,demonhunter,havoc,18,5,13
Gailiugas,kazzak,480,demonhunter,havoc,18,5,13
Aelina,area-52,480,demonhunter,havoc,18,5,13
Разагеш,gordunni,480,demonhunter,havoc,18,5,13
Felbae,emeriss,480,demonhunter,havoc,18,5,13
Xeiiv,lothar,480,demonhunter,havoc,18,5,13
Laclé,archimonde,480,demonhunter,havoc,24,5,19
Kalodir,malygos,479,demonhunter,havoc,6,5,1
Divia,anubarak,479,demonhunter,havoc,12,5,7
Bchj,ysondre,479,demonhunter,havoc,12,5,7
Demontevz,outland,479,demonhunter,havoc,12,5,7
Мйрасаа,gordunni,479,demonhunter,havoc,12,5,7
Dedaronnes,hyjal,479,demonhunter,havoc,12,5,7
Jonasdh,antonidas,479,demonhunter,havoc,12,5,7
Nazgulla,grim-batol,479,demonhunter,havoc,12,5,7
Bloodysong,kazzak,479,demonhunter,havoc,12,5,7
Demonicus,tarren-mill,479,demonhunter,havoc,12,5,7
Ionhet,dun-modr,479,demonhunter,havoc,12,5,7
Ирилан,deepholm,479,demonhunter,havoc,12,5,7
Gryphory,ravencrest,479,demonhunter,havoc,12,5,7
Escoo,blackmoore,479,demonhunter,havoc,12,5,7
Макай,deathguard,479,demonhunter,havoc,12,5,7
Séo,draenor,479,demonhunter,havoc,12,5,7
Nagareth,uldum,479,demonhunter,havoc,12,5,7
Chàuvequipeu,dalaran,479,demonhunter,havoc,12,5,7
Shekny,sanguino,479,demonhunter,havoc,12,5,7
Mulda,dun-morogh,479,demonhunter,havoc,12,5,7
Wïzzp,magtheridon,479,demonhunter,havoc,18,5,13
Shonal,defias-brotherhood,479,demonhunter,havoc,18,5,13
Arasy,los-errantes,479,demonhunter,havoc,18,5,13
Asperatus,dalaran,479,demonhunter,havoc,18,5,13
Джидэра,gordunni,478,demonhunter,havoc,6,5,1
Deasdh,tarren-mill,478,demonhunter,havoc,12,5,7
Скудайвер,gordunni,478,demonhunter,havoc,12,5,7
Greyfel,blackhand,478,demonhunter,havoc,20,7,13
Dhakaan,silvermoon,477,demonhunter,havoc,6,5,1
Kairidemon,eredar,477,demonhunter,havoc,12,5,7
Язамясо,gordunni,477,demonhunter,havoc,18,5,13
Thefightergz,terokkar,477,demonhunter,havoc,18,5,13
Гачирабыня,lich-king,477,demonhunter,havoc,30,5,25
Vincbengt,tarren-mill,476,demonhunter,havoc,12,5,7
Satanayl,stormscale,475,demonhunter,havoc,15,5,10
Illikan,stormscale,474,demonhunter,havoc,12,5,7
Hellforce,nemesis,474,demonhunter,havoc,12,5,7
Etraidor,turalyon,473,demonhunter,havoc,12,5,7
Mayyhem,blackrock,472,demonhunter,havoc,17,7,10
Dakrey,blackmoore,467,demonhunter,havoc,18,5,13
Morathie,kazzak,462,demonhunter,havoc,11,5,6
Luferite,burning-blade,455,demonhunter,havoc,27,7,20
Bertori,dun-modr,447,demonhunter,havoc,12,6,6
Shaundead,drakthul,447,demonhunter,havoc,11,5,6
Huntingmilfs,ravencrest,447,demonhunter,havoc,11,5,6
Habara,dun-modr,447,demonhunter,havoc,11,5,6
Káhúsz,ragnaros,447,demonhunter,havoc,17,5,12
Amatèrasu,burning-legion,435,demonhunter,havoc,38,8,30
Иллианэль,howling-fjord,432,demonhunter,havoc,9,5,4
Icantfitmyna,draenor,432,demonhunter,havoc,15,5,10
Xaro,quelthalas,431,demonhunter,havoc,11,5,6
Martøsdh,uldum,426,demonhunter,havoc,12,6,6
Ailisdmgbotx,drakthul,426,demonhunter,havoc,15,7,8
Rufihuntdemo,blackmoore,426,demonhunter,havoc,14,6,8
Rostiza,blackrock,425,demonhunter,havoc,21,6,15
Axeldardh,draenor,415,demonhunter,havoc,11,6,5
Zyfu,antonidas,415,demonhunter,havoc,11,5,6
Lumpp,drakthul,415,demonhunter,havoc,14,5,9
Drstn,blackmoore,415,demonhunter,havoc,16,5,11
Lesora,alleria,400,demonhunter,havoc,13,5,8
Arliden,azshara,384,demonhunter,havoc,6,4,2
Raydhd,tarren-mill,384,demonhunter,havoc,6,4,2
Iken,ragnaros,384,demonhunter,havoc,6,4,2
Gézieliæ,archimonde,384,demonhunter,havoc,6,4,2
Deriidan,garrosh,384,demonhunter,havoc,6,4,2
Varonx,drakthul,384,demonhunter,havoc,6,4,2
Frombegin,lordaeron,384,demonhunter,havoc,6,4,2
Blizodh,tarren-mill,384,demonhunter,havoc,6,4,2
Бестворлдд,howling-fjord,384,demonhunter,havoc,6,4,2
Memedhbtw,outland,384,demonhunter,havoc,6,4,2
Kriszidan,arathor,384,demonhunter,havoc,6,4,2
Плэкс,howling-fjord,384,demonhunter,havoc,6,4,2
Srryimretard,dun-modr,384,demonhunter,havoc,6,4,2
Zíkár,kazzak,384,demonhunter,havoc,6,4,2
Талисзора,gordunni,384,demonhunter,havoc,6,4,2
Jyraxs,archimonde,384,demonhunter,havoc,6,4,2
Shïca,sanguino,384,demonhunter,havoc,6,4,2
Epicelf,hyjal,384,demonhunter,havoc,6,4,2
Zukii,blackrock,384,demonhunter,havoc,6,4,2
Bartoshek,auchindoun,384,demonhunter,havoc,6,4,2
Intøxixxixx,stormscale,384,demonhunter,havoc,6,4,2
Garra,chants-éternels,384,demonhunter,havoc,6,4,2
Séismic,outland,384,demonhunter,havoc,6,4,2
Çhïñêséðëmøñ,draenor,384,demonhunter,havoc,6,4,2
Bblock,silvermoon,384,demonhunter,havoc,6,4,2
Atti,the-maelstrom,384,demonhunter,havoc,6,4,2
Carre,aggramar,384,demonhunter,havoc,6,4,2
Timitär,mazrigos,384,demonhunter,havoc,6,4,2
Betrayerboi,blackmoore,384,demonhunter,havoc,6,4,2
Niellarsc,ravencrest,384,demonhunter,havoc,6,4,2
Demoncalle,the-maelstrom,384,demonhunter,havoc,6,4,2
Pvefuljrqt,draenor,384,demonhunter,havoc,6,4,2
Kimura,the-maelstrom,384,demonhunter,havoc,6,4,2
Caramelmou,chogall,384,demonhunter,havoc,6,4,2
Маланаар,gordunni,384,demonhunter,havoc,6,4,2
Mymindead,ravencrest,384,demonhunter,havoc,6,4,2
Exerzaria,twisting-nether,384,demonhunter,havoc,6,4,2
Digi,twisting-nether,384,demonhunter,havoc,6,4,2
Nelathas,twisting-nether,384,demonhunter,havoc,6,4,2
Docos,genjuros,384,demonhunter,havoc,6,4,2
Theend,das-konsortium,384,demonhunter,havoc,6,4,2
Rocksn,blackmoore,384,demonhunter,havoc,6,4,2
Daemonmatt,outland,384,demonhunter,havoc,6,4,2
Waahpah,ravencrest,384,demonhunter,havoc,6,4,2
Drölfchicken,frostwolf,384,demonhunter,havoc,6,4,2
Wuzzabi,darksorrow,384,demonhunter,havoc,6,4,2
Финкинга,gordunni,384,demonhunter,havoc,6,4,2
Варгаст,blackscar,384,demonhunter,havoc,6,4,2
Shavidan,antonidas,384,demonhunter,havoc,6,4,2
Darmash,ambossar,384,demonhunter,havoc,9,5,4
Jak,dalvengyr,384,demonhunter,havoc,9,5,4
Imprøve,ravencrest,384,demonhunter,havoc,9,5,4
Freakerzoid,kazzak,384,demonhunter,havoc,11,4,7
Yaha,ysondre,384,demonhunter,havoc,15,5,10
Gigawashed,ravencrest,384,demonhunter,havoc,12,4,8
Rivy,magtheridon,384,demonhunter,havoc,12,4,8
Mythrixian,draenor,384,demonhunter,havoc,12,4,8
Venøm,chromaggus,384,demonhunter,havoc,12,4,8
Ysirã,hyjal,384,demonhunter,havoc,12,4,8
Эвернесса,soulflayer,384,demonhunter,havoc,12,4,8
Mäcklepyah,tarren-mill,384,demonhunter,havoc,12,4,8
Чесденьгамии,soulflayer,384,demonhunter,havoc,12,4,8
Leeloø,twisting-nether,384,demonhunter,havoc,12,4,8
Leylas,nagrand,384,demonhunter,havoc,12,4,8
Toxicbaboon,nemesis,384,demonhunter,havoc,12,4,8
Crisperis,drakthul,384,demonhunter,havoc,12,4,8
Ågøny,outland,384,demonhunter,havoc,12,4,8
Dannyp,ravencrest,384,demonhunter,havoc,12,4,8
Fellektra,draenor,384,demonhunter,havoc,12,4,8
Лупидолх,soulflayer,384,demonhunter,havoc,12,4,8
Пвпфея,soulflayer,384,demonhunter,havoc,12,4,8
Chávi,twisting-nether,384,demonhunter,havoc,12,4,8
Headbanger,twisting-nether,384,demonhunter,havoc,12,4,8
Cutforshred,zenedar,384,demonhunter,havoc,12,4,8
Floridaboy,ravencrest,384,demonhunter,havoc,12,4,8
Mempaan,magtheridon,384,demonhunter,havoc,12,4,8
Blüëräin,draenor,384,demonhunter,havoc,12,4,8
Алмантиус,gordunni,384,demonhunter,havoc,12,4,8
Frostidh,ysondre,384,demonhunter,havoc,12,4,8
Nobrainerz,twisting-nether,384,demonhunter,havoc,12,4,8
Berserk,steamwheedle-cartel,384,demonhunter,havoc,12,4,8
Drædløcks,ysondre,384,demonhunter,havoc,12,4,8
Slashyz,argent-dawn,384,demonhunter,havoc,12,4,8
Factcox,magtheridon,384,demonhunter,havoc,12,4,8
Sevira,tarren-mill,384,demonhunter,havoc,12,4,8
Kinami,hyjal,384,demonhunter,havoc,12,4,8
Demønaz,sanguino,384,demonhunter,havoc,12,4,8
Lopphaufen,onyxia,384,demonhunter,havoc,12,4,8
Valravnen,ravencrest,384,demonhunter,havoc,12,4,8
Shakso,tarren-mill,384,demonhunter,havoc,12,4,8
Xilor,neptulon,384,demonhunter,havoc,12,4,8
Deathbydeaf,terenas,384,demonhunter,havoc,12,4,8
Мисъёсмит,soulflayer,384,demonhunter,havoc,12,4,8
Одзангейра,blackscar,384,demonhunter,havoc,12,4,8
Huntingmaven,blackrock,384,demonhunter,havoc,12,4,8
Хокану,gordunni,384,demonhunter,havoc,12,4,8
Saikamango,blackhand,384,demonhunter,havoc,12,4,8
Betterdk,twilights-hammer,384,demonhunter,havoc,12,4,8
Balzhor,blackhand,384,demonhunter,havoc,12,4,8
Neulgød,zuljin,384,demonhunter,havoc,12,4,8
Skylebeam,blackrock,384,demonhunter,havoc,12,4,8
Felabatur,burning-legion,384,demonhunter,havoc,12,4,8
Jabuzi,drakthul,384,demonhunter,havoc,12,4,8
Ninjantiz,antonidas,384,demonhunter,havoc,12,4,8
Maeltus,hyjal,384,demonhunter,havoc,12,4,8
Bobleeglave,darkspear,384,demonhunter,havoc,12,4,8
Ellatriel,blackrock,384,demonhunter,havoc,12,4,8
Deadrawdh,aegwynn,384,demonhunter,havoc,12,4,8
Zaekiel,burning-legion,384,demonhunter,havoc,12,4,8
Hellbrood,kazzak,384,demonhunter,havoc,12,4,8
Arkta,kazzak,384,demonhunter,havoc,12,4,8
Хреньещёта,booty-bay,384,demonhunter,havoc,12,4,8
Bratti,kazzak,384,demonhunter,havoc,12,4,8
Buggzii,silvermoon,384,demonhunter,havoc,12,4,8
Кеиичи,howling-fjord,384,demonhunter,havoc,12,4,8
Fbh,stormscale,384,demonhunter,havoc,12,4,8
Артёмблэйдх,blackscar,384,demonhunter,havoc,12,4,8
Juny,turalyon,384,demonhunter,havoc,12,4,8
Graffyre,eonar,384,demonhunter,havoc,12,4,8
Гагендан,fordragon,384,demonhunter,havoc,12,4,8
Топд,thermaplugg,384,demonhunter,havoc,16,4,12
Zynês,draenor,384,demonhunter,havoc,18,4,14
Aaryaa,archimonde,384,demonhunter,havoc,18,4,14
Tødø,nemesis,384,demonhunter,havoc,18,4,14
Zarín,outland,384,demonhunter,havoc,18,4,14
Lisilis,neptulon,384,demonhunter,havoc,18,4,14
Братилидана,gordunni,384,demonhunter,havoc,18,4,14
Sazukè,blackmoore,384,demonhunter,havoc,18,4,14
Vandazza,argent-dawn,384,demonhunter,havoc,18,4,14
Jeandh,nerzhul,384,demonhunter,havoc,18,4,14
Takeroids,kazzak,384,demonhunter,havoc,18,4,14
Skajlan,burning-legion,384,demonhunter,havoc,18,4,14
Kalav,outland,384,demonhunter,havoc,18,4,14
Linea,jaedenar,384,demonhunter,havoc,24,4,20
Lasthija,dun-modr,384,demonhunter,havoc,24,4,20
Némesîs,cthun,383,demonhunter,havoc,6,4,2
Rouzi,defias-brotherhood,383,demonhunter,havoc,6,4,2
Ræzzør,das-konsortium,383,demonhunter,havoc,6,4,2
Jüdgedëad,archimonde,383,demonhunter,havoc,6,4,2
Vikraal,kazzak,383,demonhunter,havoc,6,4,2
Yocolo,sinstralis,383,demonhunter,havoc,6,4,2
Walidaris,tarren-mill,383,demonhunter,havoc,6,4,2
Rèdtubê,outland,383,demonhunter,havoc,12,4,8
Talerias,magtheridon,383,demonhunter,havoc,12,4,8
Elenastar,kazzak,383,demonhunter,havoc,12,4,8
Vengatoria,cthun,383,demonhunter,havoc,12,4,8
Сязекть,goldrinn,383,demonhunter,havoc,12,4,8
Frootloop,blades-edge,383,demonhunter,havoc,12,4,8
Bighand,burning-legion,383,demonhunter,havoc,24,4,20
Felanora,turalyon,382,demonhunter,havoc,12,4,8
Lxantimagexl,silvermoon,381,demonhunter,havoc,12,4,8
Baphumet,zuljin,380,demonhunter,havoc,18,4,14
Deathniresa,argent-dawn,379,demonhunter,havoc,12,4,8
Хисаго,gordunni,372,demonhunter,havoc,17,7,10
Lyxliraren,kazzak,366,demonhunter,havoc,23,4,19
Feløut,eredar,352,demonhunter,havoc,16,4,12
Darren,wildhammer,351,demonhunter,havoc,10,4,6
Лавсон,soulflayer,351,demonhunter,havoc,11,4,7
Anänke,twisting-nether,351,demonhunter,havoc,20,5,15
Flétchér,kul-tiras,336,demonhunter,havoc,15,4,11
Nrage,darkspear,336,demonhunter,havoc,15,4,11
Fèll,silvermoon,336,demonhunter,havoc,15,4,11
Dexterzx,stormscale,336,demonhunter,havoc,16,4,12
Kíwì,archimonde,335,demonhunter,havoc,11,4,7
Lydari,die-arguswacht,330,demonhunter,havoc,17,5,12
Tchekken,tarren-mill,329,demonhunter,havoc,8,5,3
Valexya,pozzo-delleternità,320,demonhunter,havoc,10,4,6
Ironmass,chogall,319,demonhunter,havoc,5,4,1
Çrìñgéñämê,ravencrest,319,demonhunter,havoc,5,4,1
Felwaifu,tarren-mill,319,demonhunter,havoc,8,4,4
Элледарий,soulflayer,319,demonhunter,havoc,10,4,6
Yågåpøwér,twisting-nether,319,demonhunter,havoc,14,4,10
Squarty,wrathbringer,316,demonhunter,havoc,8,4,4
Anestes,dalaran,304,demonhunter,havoc,13,4,9
Froyha,ragnaros,288,demonhunter,havoc,6,3,3
Vtoriavgust,silvermoon,288,demonhunter,havoc,6,3,3
Cienlowczyni,silvermoon,288,demonhunter,havoc,6,3,3
Demonerchia,pozzo-delleternità,288,demonhunter,havoc,6,3,3
Slumhunter,silvermoon,288,demonhunter,havoc,6,3,3
Бану,howling-fjord,288,demonhunter,havoc,6,3,3
Skundrell,ragnaros,288,demonhunter,havoc,6,3,3
Ìllìdank,silvermoon,288,demonhunter,havoc,6,3,3
Pandaqt,ragnaros,288,demonhunter,havoc,6,3,3
Raili,kazzak,288,demonhunter,havoc,6,3,3
Чубрик,howling-fjord,288,demonhunter,havoc,6,3,3
Hyonzyyesh,silvermoon,288,demonhunter,havoc,6,3,3
Nerfdhxd,kazzak,288,demonhunter,havoc,6,3,3
Itaychie,kazzak,288,demonhunter,havoc,6,3,3
Klyvdh,silvermoon,288,demonhunter,havoc,6,3,3
Мальвада,galakrond,288,demonhunter,havoc,6,3,3
Uranoth,nemesis,288,demonhunter,havoc,6,3,3
Demonirto,arathor,288,demonhunter,havoc,6,3,3
Ккепсс,howling-fjord,288,demonhunter,havoc,6,3,3
Rehaell,burning-legion,288,demonhunter,havoc,6,3,3
Sivix,kazzak,288,demonhunter,havoc,6,3,3
Шрэдэр,thermaplugg,288,demonhunter,havoc,6,3,3
Cánoo,blackhand,288,demonhunter,havoc,6,3,3
Terraske,tyrande,288,demonhunter,havoc,6,3,3
Vqqxx,stormreaver,288,demonhunter,havoc,6,3,3
Eddylòl,ravencrest,288,demonhunter,havoc,6,3,3
Tígél,argent-dawn,288,demonhunter,havoc,6,3,3
Bwaynsgirl,onyxia,288,demonhunter,havoc,6,3,3
Terboven,outland,288,demonhunter,havoc,6,3,3
Xénôns,archimonde,288,demonhunter,havoc,6,3,3
Catchmebaby,sanguino,288,demonhunter,havoc,6,3,3
Bludmask,silvermoon,288,demonhunter,havoc,6,3,3
Ашерис,deathguard,288,demonhunter,havoc,6,3,3
Dinyaal,alakir,288,demonhunter,havoc,6,3,3
Futalicious,argent-dawn,288,demonhunter,havoc,6,3,3
Jmý,twisting-nether,288,demonhunter,havoc,6,3,3
Bräxas,la-croisade-écarlate,288,demonhunter,havoc,6,3,3
Ortä,sanguino,288,demonhunter,havoc,6,3,3
Jinfel,outland,288,demonhunter,havoc,6,3,3
Na,conseil-des-ombres,288,demonhunter,havoc,6,3,3
Skåre,ravenholdt,288,demonhunter,havoc,6,3,3
Naargof,outland,288,demonhunter,havoc,6,3,3
Cydonia,medivh,288,demonhunter,havoc,6,3,3
Voñbödefeld,frostmourne,288,demonhunter,havoc,6,3,3
Youns,medivh,288,demonhunter,havoc,6,3,3
Kyoukaii,kazzak,288,demonhunter,havoc,6,3,3
Cnbâckbb,archimonde,288,demonhunter,havoc,6,3,3
Voynex,blackmoore,288,demonhunter,havoc,6,3,3
Mialynn,aegwynn,288,demonhunter,havoc,6,3,3
Schwitte,tichondrius,288,demonhunter,havoc,6,3,3
Vùkal,kazzak,288,demonhunter,havoc,6,3,3
Solobolo,blackhand,288,demonhunter,havoc,6,3,3
Berlusconi,senjin,288,demonhunter,havoc,6,3,3
Trekpop,chamber-of-aspects,288,demonhunter,havoc,6,3,3
Rustedchurl,draenor,288,demonhunter,havoc,6,3,3
Nephthyis,draenor,288,demonhunter,havoc,6,3,3
Linîlim,ysondre,288,demonhunter,havoc,6,3,3
Killaden,ravenholdt,288,demonhunter,havoc,6,3,3
Nuqqet,blackmoore,288,demonhunter,havoc,6,3,3
Stòrmý,thrall,288,demonhunter,havoc,6,3,3
Ðémoralizing,archimonde,288,demonhunter,havoc,6,3,3
Гогафейсер,soulflayer,288,demonhunter,havoc,6,3,3
Azelar,ragnaros,288,demonhunter,havoc,6,3,3
Ricd,aggra-português,288,demonhunter,havoc,6,3,3
Гнильность,soulflayer,288,demonhunter,havoc,6,3,3
Shaadraz,stormscale,288,demonhunter,havoc,6,3,3
Dhkolben,blackmoore,288,demonhunter,havoc,6,3,3
Uruzpiq,kazzak,288,demonhunter,havoc,6,3,3
Unski,chamber-of-aspects,288,demonhunter,havoc,6,3,3
Ледехе,gordunni,288,demonhunter,havoc,6,3,3
Shinnu,antonidas,288,demonhunter,havoc,6,3,3
Cursedblade,archimonde,288,demonhunter,havoc,6,3,3
Marthael,tarren-mill,288,demonhunter,havoc,6,3,3
Zorrø,blackmoore,288,demonhunter,havoc,6,3,3
Андрюхадх,soulflayer,288,demonhunter,havoc,6,3,3
Тлюня,grom,288,demonhunter,havoc,6,3,3
Läminâ,hyjal,288,demonhunter,havoc,6,3,3
Leïaprincess,hyjal,288,demonhunter,havoc,6,3,3
Mephedroni,kazzak,288,demonhunter,havoc,6,3,3
Dadagodx,kazzak,288,demonhunter,havoc,6,3,3
Mannie,twisting-nether,288,demonhunter,havoc,6,3,3
Youngfelrush,blackrock,288,demonhunter,havoc,6,3,3
Caramvp,eredar,288,demonhunter,havoc,6,3,3
Sekido,silvermoon,288,demonhunter,havoc,6,3,3
Meserani,eredar,288,demonhunter,havoc,6,3,3
Hellboi,dun-modr,288,demonhunter,havoc,6,3,3
Térento,blackmoore,288,demonhunter,havoc,6,3,3
Exytûs,blackhand,288,demonhunter,havoc,6,3,3
Extitan,twisting-nether,288,demonhunter,havoc,6,3,3
Mamonaros,silvermoon,288,demonhunter,havoc,6,3,3
Sasuke,blackmoore,288,demonhunter,havoc,6,3,3
Qualron,twisting-nether,288,demonhunter,havoc,6,3,3
Darkshegal,dun-modr,288,demonhunter,havoc,6,3,3
Kyart,nemesis,288,demonhunter,havoc,6,3,3
Wubby,drakthul,288,demonhunter,havoc,6,3,3
Indominus,pozzo-delleternità,288,demonhunter,havoc,6,3,3
Nightfly,twisting-nether,288,demonhunter,havoc,6,3,3
Juuliana,twisting-nether,288,demonhunter,havoc,6,3,3
Tåkotsubo,archimonde,288,demonhunter,havoc,6,3,3
Dragash,nemesis,288,demonhunter,havoc,6,3,3
Deschacke,eredar,288,demonhunter,havoc,6,3,3
Crasyface,kazzak,288,demonhunter,havoc,6,3,3
Tutschi,defias-brotherhood,288,demonhunter,havoc,6,3,3
Lyannie,thrall,288,demonhunter,havoc,6,3,3
Preddh,twisting-nether,288,demonhunter,havoc,6,3,3
Höllenhugô,madmortem,288,demonhunter,havoc,6,3,3
Bossmac,mugthol,288,demonhunter,havoc,6,3,3
Zoøm,blackrock,288,demonhunter,havoc,6,3,3
Demonsushi,tarren-mill,288,demonhunter,havoc,6,3,3
Marilu,nathrezim,288,demonhunter,havoc,6,3,3
Felrage,tarren-mill,288,demonhunter,havoc,6,3,3
Watdefack,outland,288,demonhunter,havoc,6,3,3
Zampred,grim-batol,288,demonhunter,havoc,6,3,3
Fujizaki,sylvanas,288,demonhunter,havoc,6,3,3
Xaaero,blackrock,288,demonhunter,havoc,6,3,3
Serizhawa,tarren-mill,288,demonhunter,havoc,6,3,3
Jénsa,tarren-mill,288,demonhunter,havoc,6,3,3
Froog,frostmane,288,demonhunter,havoc,6,3,3
Yelans,twisting-nether,288,demonhunter,havoc,6,3,3
Arturià,thrall,288,demonhunter,havoc,6,3,3
Linshidh,grim-batol,288,demonhunter,havoc,6,3,3
Robertochaos,blackrock,288,demonhunter,havoc,6,3,3
Cytherias,antonidas,288,demonhunter,havoc,6,3,3
Dartyydh,tarren-mill,288,demonhunter,havoc,6,3,3
Lonedh,sylvanas,288,demonhunter,havoc,6,3,3
Askaroth,sanguino,288,demonhunter,havoc,6,3,3
Hellzz,tarren-mill,288,demonhunter,havoc,6,3,3
Wildest,blackmoore,288,demonhunter,havoc,9,4,5
Dêvilinside,antonidas,288,demonhunter,havoc,7,3,4
Trashcan,darksorrow,288,demonhunter,havoc,9,3,6
Zlna,archimonde,288,demonhunter,havoc,10,3,7
Mankestdeme,chamber-of-aspects,288,demonhunter,havoc,11,3,8
Aethilios,silvermoon,288,demonhunter,havoc,11,3,8
Vijiny,sylvanas,288,demonhunter,havoc,15,4,11
Gjanlemis,stormscale,288,demonhunter,havoc,12,3,9
Ïvø,sargeras,288,demonhunter,havoc,12,3,9
Nightwalk,blackmoore,288,demonhunter,havoc,12,3,9
Арвулфик,eversong,288,demonhunter,havoc,12,3,9
Rapp,nemesis,288,demonhunter,havoc,12,3,9
Холегдх,gordunni,288,demonhunter,havoc,12,3,9
Bernhoftdh,ravencrest,288,demonhunter,havoc,12,3,9
Dubbelnugge,ravencrest,288,demonhunter,havoc,12,3,9
Bananabritta,aegwynn,288,demonhunter,havoc,12,3,9
Kudevas,ravencrest,288,demonhunter,havoc,12,3,9
Ганстапутин,howling-fjord,288,demonhunter,havoc,12,3,9
Nörsedh,sanguino,288,demonhunter,havoc,12,3,9
Хемах,howling-fjord,288,demonhunter,havoc,12,3,9
Tenaebris,silvermoon,288,demonhunter,havoc,12,3,9
Galuran,drakthul,288,demonhunter,havoc,12,3,9
Naturalis,die-todeskrallen,288,demonhunter,havoc,12,3,9
Ðèvìllìà,ragnaros,288,demonhunter,havoc,12,3,9
Evaristoff,sanguino,288,demonhunter,havoc,12,3,9
Metaman,archimonde,288,demonhunter,havoc,12,3,9
Were,drakthul,288,demonhunter,havoc,12,3,9
Shadyhunter,drakthul,288,demonhunter,havoc,12,3,9
Blacklance,ravencrest,288,demonhunter,havoc,12,3,9
Valø,malganis,288,demonhunter,havoc,12,3,9
Yataganac,draenor,288,demonhunter,havoc,12,3,9
Sazzox,blackrock,288,demonhunter,havoc,12,3,9
Jaxoy,blackmoore,288,demonhunter,havoc,12,3,9
Fellout,burning-legion,288,demonhunter,havoc,12,3,9
Diminhintir,draenor,288,demonhunter,havoc,12,3,9
Hicke,burning-legion,288,demonhunter,havoc,12,3,9
Râny,blackmoore,288,demonhunter,havoc,12,3,9
Valdarîm,twisting-nether,288,demonhunter,havoc,12,3,9
Hellcowboy,blackmoore,288,demonhunter,havoc,12,3,9
Silandara,grim-batol,288,demonhunter,havoc,12,3,9
Sýfér,grim-batol,288,demonhunter,havoc,12,3,9
ßäxy,ragnaros,288,demonhunter,havoc,12,3,9
Wheelchairdh,twisting-nether,288,demonhunter,havoc,12,3,9
Ambodh,thrall,288,demonhunter,havoc,12,3,9
Mênding,kazzak,288,demonhunter,havoc,12,3,9
Fullinaretta,archimonde,288,demonhunter,havoc,12,3,9
Лорберн,soulflayer,288,demonhunter,havoc,12,3,9
Gpk,argent-dawn,288,demonhunter,havoc,12,3,9
Гелиосса,soulflayer,288,demonhunter,havoc,12,3,9
Nows,twisting-nether,288,demonhunter,havoc,12,3,9
Domiinator,sylvanas,288,demonhunter,havoc,12,3,9
Felezo,bloodscalp,288,demonhunter,havoc,12,3,9
Грота,soulflayer,288,demonhunter,havoc,12,3,9
Mashaz,archimonde,288,demonhunter,havoc,12,3,9
Xiliria,quelthalas,288,demonhunter,havoc,12,3,9
Kaeldral,blackrock,288,demonhunter,havoc,12,3,9
Silkzoom,kazzak,288,demonhunter,havoc,12,3,9
Nætx,ravencrest,288,demonhunter,havoc,12,3,9
Tacodhx,ravencrest,288,demonhunter,havoc,12,3,9
Happyhippø,antonidas,288,demonhunter,havoc,12,3,9
Elsorí,eredar,288,demonhunter,havoc,12,3,9
Пухшайсти,soulflayer,288,demonhunter,havoc,12,3,9
Феяужаса,soulflayer,288,demonhunter,havoc,12,3,9
Highskitten,tarren-mill,288,demonhunter,havoc,12,3,9
Donverräter,antonidas,288,demonhunter,havoc,12,3,9
Laurana,argent-dawn,288,demonhunter,havoc,12,3,9
Lamello,nemesis,288,demonhunter,havoc,12,3,9
Néèdgirly,malfurion,288,demonhunter,havoc,15,3,12
Stygo,silvermoon,288,demonhunter,havoc,18,3,15
Бумбумер,lich-king,287,demonhunter,havoc,6,3,3
Elfitoloco,sanguino,287,demonhunter,havoc,6,3,3
Menutzdh,tarren-mill,287,demonhunter,havoc,6,3,3
Makev,thunderhorn,287,demonhunter,havoc,6,3,3
Dimonanta,grim-batol,287,demonhunter,havoc,6,3,3
Saturnein,stormscale,287,demonhunter,havoc,6,3,3
Dethlyn,twisting-nether,287,demonhunter,havoc,6,3,3
Chifra,dun-modr,287,demonhunter,havoc,6,3,3
Mzyonhh,draenor,287,demonhunter,havoc,12,3,9
Дафард,ashenvale,286,demonhunter,havoc,6,3,3
Indagatrix,bladefist,271,demonhunter,havoc,12,4,8
Gêliôs,kazzak,271,demonhunter,havoc,11,3,8
Czl,silvermoon,256,demonhunter,havoc,10,3,7
Elosèn,magtheridon,255,demonhunter,havoc,11,3,8
Nuballan,ragnaros,240,demonhunter,havoc,9,3,6
Dreamhunt,stormreaver,239,demonhunter,havoc,5,3,2
Ponn,blackmoore,239,demonhunter,havoc,5,3,2
Itskarmax,outland,239,demonhunter,havoc,5,3,2
Этовсехил,eversong,239,demonhunter,havoc,5,3,2
Rexchânce,archimonde,239,demonhunter,havoc,5,3,2
Джерегумо,howling-fjord,234,demonhunter,havoc,10,4,6
Ñítøryù,ravencrest,234,demonhunter,havoc,10,4,6
Draecis,twisting-nether,223,demonhunter,havoc,8,3,5
Лэймрисх,gordunni,223,demonhunter,havoc,14,3,11
Legoo,archimonde,208,demonhunter,havoc,7,3,4
Пересыщение,soulflayer,208,demonhunter,havoc,7,3,4
Sìena,ravencrest,208,demonhunter,havoc,7,3,4
Idontseeafck,kazzak,192,demonhunter,havoc,4,3,1
Qspeedyboi,kazzak,192,demonhunter,havoc,4,3,1
Bibblës,turalyon,192,demonhunter,havoc,9,3,6
Mároon,frostmane,192,demonhunter,havoc,6,2,4
Xøxøø,blackhand,192,demonhunter,havoc,6,2,4
Aliye,grim-batol,192,demonhunter,havoc,6,2,4
Lifiria,blackhand,192,demonhunter,havoc,6,2,4
Chlorel,arthas,192,demonhunter,havoc,6,2,4
Zenô,antonidas,192,demonhunter,havoc,6,2,4
Ориджин,grom,192,demonhunter,havoc,6,2,4
Монрепо,soulflayer,192,demonhunter,havoc,6,2,4
Sñüîîâ,kazzak,192,demonhunter,havoc,6,2,4
Damagedetlef,antonidas,192,demonhunter,havoc,6,2,4
Stôrmjâdê,ravencrest,192,demonhunter,havoc,6,2,4
Aggrodíte,antonidas,192,demonhunter,havoc,6,2,4
Xîè,dalaran,192,demonhunter,havoc,6,2,4
Hykoolique,arakarahm,192,demonhunter,havoc,6,2,4
Дабллди,soulflayer,192,demonhunter,havoc,6,2,4
Aerkex,kazzak,192,demonhunter,havoc,6,2,4
Afer,eredar,192,demonhunter,havoc,6,2,4
Qixl,blackhand,192,demonhunter,havoc,6,2,4
Cøldlean,ravencrest,192,demonhunter,havoc,6,2,4
Trayce,antonidas,192,demonhunter,havoc,6,2,4
Bâdboy,blackrock,192,demonhunter,havoc,6,2,4
Flupo,stormscale,192,demonhunter,havoc,6,2,4
Fjanten,stormscale,192,demonhunter,havoc,6,2,4
Cáválórth,blackhand,192,demonhunter,havoc,6,2,4
Kaily,eredar,192,demonhunter,havoc,6,2,4
Маскитол,soulflayer,192,demonhunter,havoc,6,2,4
Riveén,blackhand,192,demonhunter,havoc,6,2,4
Cíondra,aegwynn,192,demonhunter,havoc,6,2,4
Omegahunterx,ravencrest,192,demonhunter,havoc,6,2,4
Остинджейн,soulflayer,192,demonhunter,havoc,6,2,4
Lixxersmeta,stormscale,192,demonhunter,havoc,6,2,4
Chaeeri,twisting-nether,192,demonhunter,havoc,6,2,4
Lexdh,blackrock,192,demonhunter,havoc,6,2,4
Кораксс,howling-fjord,192,demonhunter,havoc,6,2,4
Sälexz,ysondre,192,demonhunter,havoc,6,2,4
Kasmo,dalaran,192,demonhunter,havoc,6,2,4
Kuzchooh,dalaran,192,demonhunter,havoc,6,2,4
Grìzmo,garona,192,demonhunter,havoc,6,2,4
Lucziane,blackmoore,192,demonhunter,havoc,6,2,4
Merei,dalaran,192,demonhunter,havoc,6,2,4
Barocs,antonidas,192,demonhunter,havoc,6,2,4
Dêmø,ravencrest,192,demonhunter,havoc,6,2,4
Burnsweg,antonidas,192,demonhunter,havoc,6,2,4
Ryohìrst,stormscale,192,demonhunter,havoc,6,2,4
Hÿrôkk,ysondre,192,demonhunter,havoc,6,2,4
Dikcitx,archimonde,192,demonhunter,havoc,6,2,4
Theonlydemon,frostmane,192,demonhunter,havoc,6,2,4
Итерночка,soulflayer,192,demonhunter,havoc,6,2,4
Аххмхх,soulflayer,192,demonhunter,havoc,6,2,4
Razzàl,sinstralis,192,demonhunter,havoc,6,2,4
Ôdhyn,hyjal,192,demonhunter,havoc,6,2,4
Alcadejas,pozzo-delleternità,192,demonhunter,havoc,6,2,4
Tæyana,khaz-modan,192,demonhunter,havoc,6,2,4
Kyiuz,archimonde,192,demonhunter,havoc,6,2,4
Sârgan,khaz-modan,192,demonhunter,havoc,6,2,4
Facerolling,kazzak,192,demonhunter,havoc,6,2,4
Malkyor,ysondre,192,demonhunter,havoc,6,2,4
Охина,howling-fjord,192,demonhunter,havoc,6,2,4
Nathrohir,argent-dawn,192,demonhunter,havoc,6,2,4
Anekk,kazzak,192,demonhunter,havoc,6,2,4
Dondado,pozzo-delleternità,192,demonhunter,havoc,6,2,4
Grapesoda,echsenkessel,192,demonhunter,havoc,6,2,4
Fyxi,talnivarr,192,demonhunter,havoc,6,2,4
Moratrasmus,the-maelstrom,192,demonhunter,havoc,6,2,4
Saphira,laughing-skull,192,demonhunter,havoc,6,2,4
Nalefan,hyjal,192,demonhunter,havoc,6,2,4
Янгфрукт,howling-fjord,192,demonhunter,havoc,6,2,4
Аврорамур,howling-fjord,192,demonhunter,havoc,6,2,4
Шоксенсацияя,howling-fjord,192,demonhunter,havoc,6,2,4
Amnestîa,antonidas,192,demonhunter,havoc,6,2,4
Draneka,argent-dawn,192,demonhunter,havoc,6,2,4
Squanch,auchindoun,192,demonhunter,havoc,6,2,4
Khinn,tyrande,192,demonhunter,havoc,6,2,4
Aiyarin,argent-dawn,192,demonhunter,havoc,6,2,4
Яростьдуры,gordunni,192,demonhunter,havoc,6,2,4
Deadspeak,burning-legion,192,demonhunter,havoc,6,2,4
Demontoolz,outland,192,demonhunter,havoc,6,2,4
Alatharx,dun-morogh,192,demonhunter,havoc,6,2,4
Nectorn,outland,192,demonhunter,havoc,6,2,4
Schakalèn,ragnaros,192,demonhunter,havoc,6,2,4
Neimfel,outland,192,demonhunter,havoc,6,2,4
Børn,aegwynn,192,demonhunter,havoc,6,2,4
Wolfex,hellfire,192,demonhunter,havoc,6,2,4
Sephy,argent-dawn,192,demonhunter,havoc,6,2,4
Duweißtselbe,dun-morogh,192,demonhunter,havoc,6,2,4
Ропинирол,gordunni,192,demonhunter,havoc,6,2,4
Satyna,der-mithrilorden,192,demonhunter,havoc,6,2,4
Kaelisi,argent-dawn,192,demonhunter,havoc,6,2,4
Тэнсу,borean-tundra,192,demonhunter,havoc,6,2,4
Kaprisun,turalyon,192,demonhunter,havoc,6,2,4
Dhslayer,magtheridon,192,demonhunter,havoc,6,2,4
Маннорохх,blackscar,192,demonhunter,havoc,6,2,4
Thaeraa,hyjal,192,demonhunter,havoc,6,2,4
Brolafsen,ragnaros,192,demonhunter,havoc,6,2,4
Илюшанадх,gordunni,192,demonhunter,havoc,6,2,4
Lty,archimonde,192,demonhunter,havoc,6,2,4
Gracë,outland,192,demonhunter,havoc,6,2,4
Nïcta,sanguino,192,demonhunter,havoc,6,2,4
Dreamøn,aegwynn,192,demonhunter,havoc,6,2,4
Linkôs,aegwynn,192,demonhunter,havoc,6,2,4
Mharú,outland,192,demonhunter,havoc,6,2,4
Kryshan,burning-legion,192,demonhunter,havoc,6,2,4
Diaemus,hyjal,192,demonhunter,havoc,6,2,4
Имфаразел,gordunni,192,demonhunter,havoc,6,2,4
Aleryx,ragnaros,192,demonhunter,havoc,6,2,4
Maddamon,malorne,192,demonhunter,havoc,6,2,4
Qúkn,tarren-mill,192,demonhunter,havoc,6,2,4
Mnnmmnmnmnmn,zuljin,192,demonhunter,havoc,6,2,4
Solo,auchindoun,192,demonhunter,havoc,6,2,4
Jumanjeez,draenor,192,demonhunter,havoc,6,2,4
Aionic,draenor,192,demonhunter,havoc,6,2,4
Noxha,outland,192,demonhunter,havoc,6,2,4
Elyes,archimonde,192,demonhunter,havoc,6,2,4
Amythest,tarren-mill,192,demonhunter,havoc,6,2,4
Hyype,draenor,192,demonhunter,havoc,6,2,4
Deramora,shadowsong,192,demonhunter,havoc,6,2,4
Superscalar,tarren-mill,192,demonhunter,havoc,6,2,4
Mäiskelinko,vashj,192,demonhunter,havoc,6,2,4
Qyria,tarren-mill,192,demonhunter,havoc,6,2,4
Ragnarak,amanthul,192,demonhunter,havoc,6,2,4
Hommeessa,stormreaver,192,demonhunter,havoc,6,2,4
Pablino,darksorrow,192,demonhunter,havoc,6,2,4
Kibikari,nemesis,192,demonhunter,havoc,6,2,4
Haveadad,outland,192,demonhunter,havoc,6,2,4
Sandy,anubarak,192,demonhunter,havoc,6,2,4
Buffdhx,sylvanas,192,demonhunter,havoc,6,2,4
Экзектикус,gordunni,192,demonhunter,havoc,6,2,4
Stifeur,archimonde,192,demonhunter,havoc,6,2,4
Emkogødx,outland,192,demonhunter,havoc,6,2,4
Malkoran,draenor,192,demonhunter,havoc,6,2,4
Скид,gordunni,192,demonhunter,havoc,6,2,4
Jayuslol,stormrage,192,demonhunter,havoc,6,2,4
Лилэйв,gordunni,192,demonhunter,havoc,6,2,4
Juicyglaives,ragnaros,192,demonhunter,havoc,6,2,4
Flasz,sylvanas,192,demonhunter,havoc,6,2,4
Ralffeh,auchindoun,192,demonhunter,havoc,6,2,4
Деорру,gordunni,192,demonhunter,havoc,6,2,4
Williamgrant,alonsus,192,demonhunter,havoc,6,2,4
Мэлифсб,blackscar,192,demonhunter,havoc,6,2,4
Ieraserl,drakthul,192,demonhunter,havoc,6,2,4
Huntonez,outland,192,demonhunter,havoc,6,2,4
Khrum,rajaxx,192,demonhunter,havoc,6,2,4
Флайрин,blackscar,192,demonhunter,havoc,6,2,4
Disconecting,outland,192,demonhunter,havoc,6,2,4
Kakovicz,gorgonnash,192,demonhunter,havoc,6,2,4
Артесдх,gordunni,192,demonhunter,havoc,6,2,4
Arenvald,saurfang,192,demonhunter,havoc,6,2,4
Люблюмеф,gordunni,192,demonhunter,havoc,6,2,4
Delusionary,sanguino,192,demonhunter,havoc,6,2,4
Andariell,sylvanas,192,demonhunter,havoc,6,2,4
Datejust,archimonde,192,demonhunter,havoc,6,2,4
Altrazax,hyjal,192,demonhunter,havoc,6,2,4
Врадость,soulflayer,192,demonhunter,havoc,8,2,6
Wsvarus,dun-morogh,192,demonhunter,havoc,10,2,8
Aytèè,eredar,192,demonhunter,havoc,12,2,10
Nellyy,dalaran,192,demonhunter,havoc,12,2,10
Mayzhi,hyjal,192,demonhunter,havoc,12,2,10
Парагони,gordunni,192,demonhunter,havoc,12,2,10
Sedorax,tarren-mill,192,demonhunter,havoc,12,2,10
Nezarec,sanguino,192,demonhunter,havoc,12,2,10
Deehoh,twisting-nether,192,demonhunter,havoc,12,2,10
Qweasda,stormscale,192,demonhunter,havoc,12,2,10
Tôx,dalaran,192,demonhunter,havoc,12,2,10
Kandres,ragnaros,192,demonhunter,havoc,12,2,10
Tbomb,ragnaros,192,demonhunter,havoc,12,2,10
Boo,sunstrider,192,demonhunter,havoc,12,2,10
Kengoo,ravencrest,192,demonhunter,havoc,12,2,10
Djbazz,blackrock,192,demonhunter,havoc,12,2,10
Shockzzyydh,ravencrest,192,demonhunter,havoc,12,2,10
Valaces,eredar,192,demonhunter,havoc,12,2,10
Rettoz,aszune,192,demonhunter,havoc,12,2,10
Dhogus,twisting-nether,192,demonhunter,havoc,12,2,10
Themogar,earthen-ring,192,demonhunter,havoc,12,2,10
Esseline,outland,192,demonhunter,havoc,12,2,10
Enygamy,frostmane,192,demonhunter,havoc,12,2,10
Sajr,twisting-nether,192,demonhunter,havoc,12,2,10
Tvé,ravencrest,192,demonhunter,havoc,12,2,10
Thenangel,alleria,192,demonhunter,havoc,12,2,10
Zaydra,the-maelstrom,192,demonhunter,havoc,12,2,10
Aloera,blackmoore,192,demonhunter,havoc,12,2,10
Babadoc,sanguino,192,demonhunter,havoc,12,2,10
Wruzna,shattered-halls,192,demonhunter,havoc,12,2,10
Riplocksz,outland,192,demonhunter,havoc,18,2,16
Zinzira,blackmoore,191,demonhunter,havoc,6,2,4
Karmos,khaz-modan,191,demonhunter,havoc,6,2,4
Fullmutter,twisting-nether,191,demonhunter,havoc,6,2,4
Ashvius,kult-der-verdammten,191,demonhunter,havoc,6,2,4
Manjirosano,blackmoore,191,demonhunter,havoc,12,2,10
Illidori,sunstrider,191,demonhunter,havoc,12,2,10
Lilarii,argent-dawn,191,demonhunter,havoc,12,2,10
Balistar,thrall,191,demonhunter,havoc,15,2,13
Kurox,drakthul,191,demonhunter,havoc,18,2,16
Íllídãn,aegwynn,180,demonhunter,havoc,25,6,19
Mabkdh,ravencrest,175,demonhunter,havoc,11,2,9
Onorera,tarren-mill,160,demonhunter,havoc,10,2,8
Galafel,outland,159,demonhunter,havoc,5,2,3
Misswillydan,ravencrest,159,demonhunter,havoc,5,2,3
Kalinda,sanguino,159,demonhunter,havoc,5,2,3
Mayrelxd,blackhand,159,demonhunter,havoc,5,2,3
Gucknicht,blackrock,144,demonhunter,havoc,9,2,7
Novacáne,silvermoon,138,demonhunter,havoc,9,4,5
Видхант,soulflayer,138,demonhunter,havoc,8,3,5
Razerøø,ysondre,138,demonhunter,havoc,9,3,6
Kantklipper,ragnaros,138,demonhunter,havoc,10,3,7
Sorondos,ravencrest,138,demonhunter,havoc,12,3,9
Мегапташка,howling-fjord,128,demonhunter,havoc,4,2,2
Yuui,silvermoon,128,demonhunter,havoc,4,2,2
Izanawi,outland,127,demonhunter,havoc,8,2,6
Antbroo,twisting-nether,96,demonhunter,havoc,3,2,1
Demoncarlios,blackhand,96,demonhunter,havoc,3,2,1
Possíble,kazzak,96,demonhunter,havoc,9,2,7
Lílynn,antonidas,96,demonhunter,havoc,6,1,5
Alaw,anachronos,96,demonhunter,havoc,6,1,5
Illigawn,grim-batol,96,demonhunter,havoc,6,1,5
Bizchazi,outland,96,demonhunter,havoc,6,1,5
Fantamazing,ragnaros,96,demonhunter,havoc,6,1,5
Artemisîa,argent-dawn,96,demonhunter,havoc,6,1,5
Hadilka,drakthul,96,demonhunter,havoc,6,1,5
Skyfo,khadgar,96,demonhunter,havoc,6,1,5
Factra,outland,96,demonhunter,havoc,6,1,5
Sohunt,twisting-nether,96,demonhunter,havoc,6,1,5
Xuruleitor,uldum,96,demonhunter,havoc,6,1,5
Nutragehonda,twisting-nether,96,demonhunter,havoc,6,1,5
Ellare,burning-blade,96,demonhunter,havoc,6,1,5
Roxany,aszune,96,demonhunter,havoc,6,1,5
Rëdencounter,ravencrest,96,demonhunter,havoc,6,1,5
Benaska,twisting-nether,96,demonhunter,havoc,6,1,5
Tønyx,dalaran,96,demonhunter,havoc,6,1,5
Pêrsephôné,blackmoore,96,demonhunter,havoc,6,1,5
Kulls,outland,96,demonhunter,havoc,6,1,5
Laethas,twisting-nether,96,demonhunter,havoc,6,1,5
Olaladh,blackhand,96,demonhunter,havoc,6,1,5
Lemmiwinks,the-maelstrom,96,demonhunter,havoc,6,1,5
Abere,drakthul,96,demonhunter,havoc,6,1,5
Shaelby,archimonde,96,demonhunter,havoc,6,1,5
Malboosted,archimonde,96,demonhunter,havoc,6,1,5
Federica,zuljin,96,demonhunter,havoc,6,1,5
Kuñkkïsh,twisting-nether,96,demonhunter,havoc,6,1,5
ßaßayaga,blackhand,96,demonhunter,havoc,6,1,5
Demonhapo,pozzo-delleternità,96,demonhunter,havoc,6,1,5
Aveeda,ravencrest,96,demonhunter,havoc,6,1,5
Speedyusus,silvermoon,96,demonhunter,havoc,6,1,5
Cruptiq,kazzak,96,demonhunter,havoc,6,1,5
Vireus,draenor,96,demonhunter,havoc,6,1,5
Askari,lothar,96,demonhunter,havoc,6,1,5
Kâtsumî,archimonde,96,demonhunter,havoc,6,1,5
Ellsie,archimonde,96,demonhunter,havoc,6,1,5
Sadclownz,blackrock,96,demonhunter,havoc,6,1,5
Ryuhayabusa,stormscale,96,demonhunter,havoc,6,1,5
Zoer,kazzak,96,demonhunter,havoc,6,1,5
Josedh,twisting-nether,96,demonhunter,havoc,6,1,5
Jiínx,kazzak,96,demonhunter,havoc,6,1,5
Blulake,silvermoon,96,demonhunter,havoc,6,1,5
Evangelios,ravencrest,96,demonhunter,havoc,6,1,5
Loreleyy,stormscale,96,demonhunter,havoc,6,1,5
Louú,blackmoore,96,demonhunter,havoc,6,1,5
Bootyspread,twisting-nether,96,demonhunter,havoc,6,1,5
Распилил,gordunni,96,demonhunter,havoc,6,1,5
Valkyal,nemesis,96,demonhunter,havoc,6,1,5
Спокоивич,soulflayer,96,demonhunter,havoc,6,1,5
Mlecznygolem,silvermoon,96,demonhunter,havoc,6,1,5
Permachill,blackmoore,96,demonhunter,havoc,6,1,5
Martosh,sylvanas,96,demonhunter,havoc,6,1,5
Cirylia,blackrock,96,demonhunter,havoc,6,1,5
Lyonett,terokkar,96,demonhunter,havoc,6,1,5
Mizuri,sylvanas,96,demonhunter,havoc,6,1,5
Fertriz,arthas,96,demonhunter,havoc,6,1,5
Samila,azshara,96,demonhunter,havoc,6,1,5
Soulpurge,twisting-nether,96,demonhunter,havoc,6,1,5
Chronic,die-aldor,96,demonhunter,havoc,6,1,5
Fisseslayer,ravencrest,96,demonhunter,havoc,6,1,5
Pkdaemon,draenor,96,demonhunter,havoc,6,1,5
Kassin,dun-modr,96,demonhunter,havoc,6,1,5
Annee,eredar,96,demonhunter,havoc,6,1,5
Bröwnye,dun-modr,96,demonhunter,havoc,6,1,5
Saulhax,sylvanas,96,demonhunter,havoc,6,1,5
Ilovesabrina,dun-modr,96,demonhunter,havoc,6,1,5
Acrius,twisting-nether,96,demonhunter,havoc,6,1,5
Ebachebg,darksorrow,96,demonhunter,havoc,6,1,5
Flasqo,eredar,96,demonhunter,havoc,6,1,5
Fyy,sylvanas,96,demonhunter,havoc,6,1,5
Pepbimsidan,eredar,96,demonhunter,havoc,6,1,5
Ergoo,blackmoore,96,demonhunter,havoc,6,1,5
Teimotevey,silvermoon,96,demonhunter,havoc,6,1,5
Bïquette,ysondre,96,demonhunter,havoc,6,1,5
Satela,azjolnerub,96,demonhunter,havoc,6,1,5
Аззазэль,howling-fjord,96,demonhunter,havoc,6,1,5
Unk,outland,96,demonhunter,havoc,6,1,5
Anät,twisting-nether,96,demonhunter,havoc,6,1,5
Найлинель,fordragon,96,demonhunter,havoc,6,1,5
Winchestèr,draenor,96,demonhunter,havoc,6,1,5
Burritodh,tarren-mill,96,demonhunter,havoc,6,1,5
Akron,magtheridon,96,demonhunter,havoc,6,1,5
Demonlia,blackrock,96,demonhunter,havoc,6,1,5
Zarafel,hyjal,96,demonhunter,havoc,6,1,5
Locomotiv,twisting-nether,96,demonhunter,havoc,6,1,5
Remagon,thrall,96,demonhunter,havoc,6,1,5
Zaracky,khaz-modan,96,demonhunter,havoc,6,1,5
Dhmónster,blackrock,96,demonhunter,havoc,6,1,5
Romancutza,tarren-mill,96,demonhunter,havoc,6,1,5
Tyhop,ragnaros,96,demonhunter,havoc,6,1,5
Medena,nemesis,96,demonhunter,havoc,6,1,5
Lepiredh,hyjal,96,demonhunter,havoc,6,1,5
Танукигодх,gordunni,96,demonhunter,havoc,6,1,5
Соларт,howling-fjord,96,demonhunter,havoc,6,1,5
Niqel,blackrock,96,demonhunter,havoc,6,1,5
Ðévx,argent-dawn,96,demonhunter,havoc,6,1,5
Äzot,burning-legion,96,demonhunter,havoc,6,1,5
Булёхинс,howling-fjord,96,demonhunter,havoc,6,1,5
Nizano,kult-der-verdammten,96,demonhunter,havoc,6,1,5
Oob,ysondre,96,demonhunter,havoc,6,1,5
Youngføtmx,blackrock,96,demonhunter,havoc,6,1,5
Гоорыныч,howling-fjord,96,demonhunter,havoc,6,1,5
Рвей,howling-fjord,96,demonhunter,havoc,6,1,5
Demlilith,kazzak,96,demonhunter,havoc,6,1,5
Stormma,kazzak,96,demonhunter,havoc,6,1,5
Illiwonka,outland,96,demonhunter,havoc,6,1,5
Syldrae,hyjal,96,demonhunter,havoc,6,1,5
Áarón,der-mithrilorden,96,demonhunter,havoc,6,1,5
Esthá,argent-dawn,96,demonhunter,havoc,6,1,5
Maverish,silvermoon,96,demonhunter,havoc,6,1,5
Maikko,los-errantes,96,demonhunter,havoc,6,1,5
Tiina,daggerspine,96,demonhunter,havoc,6,1,5
Dýlän,argent-dawn,96,demonhunter,havoc,6,1,5
Тадждх,howling-fjord,96,demonhunter,havoc,6,1,5
Tempyy,ragnaros,96,demonhunter,havoc,6,1,5
Jimbarend,argent-dawn,96,demonhunter,havoc,6,1,5
Ripgodx,bronzebeard,96,demonhunter,havoc,6,1,5
Avandar,burning-legion,96,demonhunter,havoc,6,1,5
Yecuma,tyrande,96,demonhunter,havoc,6,1,5
Camotheck,stormscale,96,demonhunter,havoc,6,1,5
Wiizzs,defias-brotherhood,96,demonhunter,havoc,6,1,5
Frizzy,dethecus,96,demonhunter,havoc,6,1,5
Grobax,uldaman,96,demonhunter,havoc,6,1,5
Nargyla,magtheridon,96,demonhunter,havoc,12,1,11
Эрсидия,gordunni,96,demonhunter,havoc,12,1,11
Ecthelionn,outland,96,demonhunter,havoc,12,1,11
Бонятяф,gordunni,96,demonhunter,havoc,12,1,11
Ämy,grim-batol,96,demonhunter,havoc,12,1,11
Shaliel,madmortem,96,demonhunter,havoc,12,1,11
Álloces,silvermoon,96,demonhunter,havoc,12,1,11
Cléra,blackhand,96,demonhunter,havoc,12,1,11
Диэльва,eversong,96,demonhunter,havoc,12,1,11
Kastrelia,ravencrest,96,demonhunter,havoc,12,1,11
Chosenundead,blackmoore,96,demonhunter,havoc,12,1,11
Babyyéah,sunstrider,96,demonhunter,havoc,12,1,11
Jásírá,shattrath,96,demonhunter,havoc,12,1,11
Vasudev,blades-edge,96,demonhunter,havoc,13,1,12
Sctrippi,frostwolf,96,demonhunter,havoc,18,1,17
Illemnorh,auchindoun,96,demonhunter,havoc,20,1,19
Shinarei,silvermoon,95,demonhunter,havoc,6,1,5
Hárald,sanguino,84,demonhunter,havoc,20,4,16
Виллидж,gordunni,79,demonhunter,havoc,5,2,3
Cocaineflyin,tarren-mill,79,demonhunter,havoc,5,1,4
Caluxe,blackmoore,79,demonhunter,havoc,5,1,4
Lezabel,destromath,79,demonhunter,havoc,10,1,9
Violend,blackmoore,64,demonhunter,havoc,4,1,3
Impulz,archimonde,42,demonhunter,havoc,9,2,7
Milaje,tarren-mill,42,demonhunter,havoc,10,2,8
Neednerf,draenor,31,demonhunter,havoc,2,1,1
Nibør,doomhammer,31,demonhunter,havoc,2,1,1
Дазвен,gordunni,31,demonhunter,havoc,2,1,1
Frozensoules,turalyon,31,demonhunter,havoc,8,1,7
Vengeancezin,frostwhisper,1987,demonhunter,vengeance,258,133,125
Yamehd,stormreaver,1569,demonhunter,vengeance,66,34,32
Thewalker,argent-dawn,1496,demonhunter,vengeance,110,49,61
Strqt,archimonde,1441,demonhunter,vengeance,108,55,53
Zarín,outland,1394,demonhunter,vengeance,78,41,37
Illislan,darksorrow,1314,demonhunter,vengeance,60,34,26
Paindemon,outland,1182,demonhunter,vengeance,144,73,71
Qvn,sylvanas,1105,demonhunter,vengeance,26,12,14
Damodex,grim-batol,1076,demonhunter,vengeance,80,31,49
Enithy,twisting-nether,1058,demonhunter,vengeance,50,25,25
Dæmyst,outland,1053,demonhunter,vengeance,66,20,46
Kubusz,ravencrest,939,demonhunter,vengeance,66,33,33
Сумърак,grom,894,demonhunter,vengeance,35,10,25
Avye,tichondrius,672,demonhunter,vengeance,18,7,11
Arussil,pozzo-delleternità,663,demonhunter,vengeance,24,7,17
Kekburagól,kazzak,575,demonhunter,vengeance,12,6,6
Zarafel,hyjal,543,demonhunter,vengeance,30,6,24
Jakoby,tarren-mill,480,demonhunter,vengeance,12,5,7
Камуи,gordunni,478,demonhunter,vengeance,18,5,13
Quavanity,sylvanas,384,demonhunter,vengeance,18,4,14
Demonlucy,colinas-pardas,287,demonhunter,vengeance,12,3,9
Gauchino,aegwynn,287,demonhunter,vengeance,12,3,9
Tôrxy,antonidas,192,demonhunter,vengeance,6,2,4
Nephthyis,draenor,192,demonhunter,vengeance,6,2,4
Camtoe,ravencrest,192,demonhunter,vengeance,6,2,4
Askari,lothar,192,demonhunter,vengeance,6,2,4
Геммула,howling-fjord,192,demonhunter,vengeance,6,2,4
Dharuel,cthun,192,demonhunter,vengeance,6,2,4
Chosenundead,blackmoore,192,demonhunter,vengeance,12,2,10
Bigmóm,stormscale,192,demonhunter,vengeance,12,2,10
Макай,deathguard,191,demonhunter,vengeance,6,2,4
Xenits,kazzak,96,demonhunter,vengeance,6,1,5
Chamillions,archimonde,96,demonhunter,vengeance,6,1,5
Kuzchooh,dalaran,96,demonhunter,vengeance,6,1,5
Myztiko,hellscream,96,demonhunter,vengeance,6,1,5
Øß,moonglade,96,demonhunter,vengeance,6,1,5
Блъя,gordunni,96,demonhunter,vengeance,6,1,5
ßroken,ragnaros,96,demonhunter,vengeance,6,1,5
Opmuch,eonar,96,demonhunter,vengeance,6,1,5
Чорновласка,soulflayer,16,demonhunter,vengeance,1,1,0
Asgá,stormscale,2296,druid,restoration,72,51,21
Håbibi,kazzak,2280,druid,restoration,131,74,57
Hibibi,kazzak,2278,druid,restoration,149,90,59
Kókushibò,archimonde,2273,druid,restoration,109,70,39
Vinniehacker,archimonde,2271,druid,restoration,95,57,38
Sqx,ravencrest,2263,druid,restoration,310,169,141
Lúh,kazzak,2258,druid,restoration,150,103,47
Vanostboom,kazzak,2230,druid,restoration,112,66,46
Джелони,soulflayer,2221,druid,restoration,98,55,43
Maldrýn,stormscale,2219,druid,restoration,59,38,21
Trèes,outland,2206,druid,restoration,413,222,191
Pegasu,kelthuzad,2182,druid,restoration,114,66,48
Iloveher,ravencrest,2167,druid,restoration,206,112,94
Miouzy,archimonde,2156,druid,restoration,66,36,30
Rives,sylvanas,2149,druid,restoration,174,100,74
Zaeli,archimonde,2147,druid,restoration,72,40,32
Thotz,kazzak,2147,druid,restoration,298,156,142
Kev,elune,2136,druid,restoration,333,179,154
Acondris,ravencrest,2135,druid,restoration,277,140,137
Yoogy,ravencrest,2133,druid,restoration,72,45,27
Kætachy,archimonde,2131,druid,restoration,191,98,93
Unohanâ,archimonde,2126,druid,restoration,192,112,80
Surfingbirdx,ragnaros,2126,druid,restoration,66,33,33
Drjmy,silvermoon,2125,druid,restoration,107,76,31
Dokixo,kazzak,2121,druid,restoration,65,38,27
Zonsy,twisting-nether,2116,druid,restoration,94,60,34
Tropjeune,dalaran,2112,druid,restoration,108,58,50
Quabo,doomhammer,2104,druid,restoration,524,286,238
Niksidruid,grim-batol,2101,druid,restoration,106,59,47
Hånukkah,outland,2101,druid,restoration,129,65,64
Trèes,draenor,2096,druid,restoration,166,91,75
Syví,outland,2093,druid,restoration,124,65,59
Bananadru,stormscale,2090,druid,restoration,54,33,21
Nesedondon,stormscale,2077,druid,restoration,142,84,58
Chas,ravencrest,2063,druid,restoration,98,57,41
Yseraheal,drakthul,2050,druid,restoration,365,198,167
Píshi,silvermoon,2041,druid,restoration,90,49,41
Druu,stormscale,2039,druid,restoration,108,55,53
Renewer,argent-dawn,2037,druid,restoration,69,33,36
Pobrica,stormscale,2033,druid,restoration,119,64,55
Leyô,archimonde,2032,druid,restoration,108,55,53
Kyomã,burning-legion,2024,druid,restoration,220,112,108
Ovérheal,ravencrest,2023,druid,restoration,124,70,54
Druidomedio,pozzo-delleternità,2022,druid,restoration,96,55,41
Sintiq,silvermoon,2020,druid,restoration,77,42,35
Threesixnìne,dun-morogh,2019,druid,restoration,473,252,221
Galadronìa,aegwynn,2018,druid,restoration,77,42,35
Druidrak,eredar,2017,druid,restoration,114,57,57
Jaytiz,ravencrest,2015,druid,restoration,71,36,35
Joksica,draenor,2011,druid,restoration,77,39,38
Habibyy,kazzak,2008,druid,restoration,95,51,44
Doodlez,blackrock,2008,druid,restoration,136,69,67
Maxpojke,ravencrest,2000,druid,restoration,196,121,75
Bambambimbim,draenor,1998,druid,restoration,102,52,50
Friedbrocolí,tarren-mill,1997,druid,restoration,92,45,47
Thugzie,kazzak,1996,druid,restoration,256,128,128
Nantou,stormscale,1993,druid,restoration,208,103,105
Beesoup,blackrock,1991,druid,restoration,170,93,77
Traick,antonidas,1990,druid,restoration,71,36,35
Exzotic,ravencrest,1989,druid,restoration,83,47,36
Shinöbü,sanguino,1989,druid,restoration,105,59,46
Hyggefinger,ravencrest,1988,druid,restoration,96,48,48
Clone,aegwynn,1986,druid,restoration,322,171,151
Lyricx,kazzak,1983,druid,restoration,84,42,42
Sasosins,ravencrest,1975,druid,restoration,141,74,67
Thysabtw,archimonde,1971,druid,restoration,105,61,44
Alolexx,archimonde,1971,druid,restoration,81,45,36
Granquercia,nemesis,1969,druid,restoration,120,73,47
Shiftyshaft,tarren-mill,1969,druid,restoration,391,214,177
Traffix,outland,1967,druid,restoration,63,33,30
Tjxaxa,ravencrest,1966,druid,restoration,78,38,40
Acxaryl,ravencrest,1963,druid,restoration,59,30,29
Afky,stormreaver,1962,druid,restoration,210,106,104
Shredzz,ravencrest,1962,druid,restoration,60,28,32
Druidello,stormscale,1960,druid,restoration,70,35,35
Epicskin,kazzak,1956,druid,restoration,125,75,50
Druidella,stormscale,1955,druid,restoration,60,32,28
Sheippi,stormreaver,1954,druid,restoration,120,61,59
Tommix,ravencrest,1953,druid,restoration,79,42,37
Uñsullied,kazzak,1952,druid,restoration,123,60,63
Muraebbasta,pozzo-delleternità,1952,druid,restoration,78,37,41
Thebiggest,ravencrest,1946,druid,restoration,120,66,54
Myndrá,varimathras,1944,druid,restoration,149,81,68
Galoony,blackrock,1941,druid,restoration,60,36,24
Angrykejton,silvermoon,1940,druid,restoration,276,138,138
Ûnsullied,kazzak,1940,druid,restoration,131,64,67
Rhonir,twisting-nether,1938,druid,restoration,266,135,131
Adokai,alleria,1937,druid,restoration,108,54,54
Jamuhlee,kult-der-verdammten,1937,druid,restoration,85,40,45
Heçtôr,silvermoon,1934,druid,restoration,113,54,59
Stevedru,ravencrest,1933,druid,restoration,36,22,14
Dendariottvx,sunstrider,1930,druid,restoration,109,57,52
Bloomitize,ravencrest,1930,druid,restoration,114,59,55
Ralaa,guldan,1926,druid,restoration,66,33,33
Reins,silvermoon,1918,druid,restoration,233,123,110
Cplazi,kazzak,1917,druid,restoration,60,34,26
Xkirtach,dun-modr,1917,druid,restoration,48,21,27
Sprøut,drakthul,1916,druid,restoration,118,53,65
Builtdiffy,kazzak,1915,druid,restoration,468,250,218
Ltmx,ravencrest,1914,druid,restoration,113,52,61
Fantastix,silvermoon,1912,druid,restoration,138,79,59
Nediena,twisting-nether,1911,druid,restoration,132,67,65
Traickovic,antonidas,1909,druid,restoration,60,31,29
Andr,voljin,1907,druid,restoration,220,109,111
Luminøuz,outland,1902,druid,restoration,327,173,154
Riplilpeep,grim-batol,1901,druid,restoration,66,33,33
Афклалка,gordunni,1900,druid,restoration,66,32,34
Mafiasnipe,ravencrest,1899,druid,restoration,48,29,19
Drèamer,ravencrest,1899,druid,restoration,175,94,81
Buffshaman,sylvanas,1897,druid,restoration,72,34,38
Naffelle,ysondre,1896,druid,restoration,101,49,52
Skrood,kazzak,1896,druid,restoration,96,45,51
Solowlevel,ravencrest,1894,druid,restoration,72,33,39
Gummysnake,aszune,1893,druid,restoration,60,34,26
Eduarda,dun-modr,1893,druid,restoration,90,40,50
Arthéas,archimonde,1892,druid,restoration,186,96,90
Åä,ravencrest,1888,druid,restoration,38,23,15
Kryptonîte,twisting-nether,1881,druid,restoration,135,68,67
Rhapsodý,twisting-nether,1880,druid,restoration,60,35,25
Lunamimi,argent-dawn,1878,druid,restoration,380,193,187
Tedel,kazzak,1877,druid,restoration,81,50,31
Ishiftmyself,pozzo-delleternità,1875,druid,restoration,90,42,48
Asga,stormscale,1874,druid,restoration,48,28,20
Дикаякиара,blackscar,1874,druid,restoration,676,332,344
Amaré,burning-legion,1873,druid,restoration,114,57,57
Matteps,outland,1873,druid,restoration,119,58,61
Spamclone,draenor,1872,druid,restoration,63,33,30
Naruhot,archimonde,1870,druid,restoration,109,62,47
Metagrass,stormscale,1870,druid,restoration,159,75,84
Georn,sylvanas,1869,druid,restoration,98,53,45
Chacopic,archimonde,1869,druid,restoration,222,117,105
Bamsemoms,sylvanas,1869,druid,restoration,72,36,36
Lhûne,twisting-nether,1866,druid,restoration,60,29,31
Wraithshape,stormscale,1865,druid,restoration,66,37,29
Ромкабикстар,gordunni,1865,druid,restoration,52,26,26
Skrrlock,ravencrest,1865,druid,restoration,114,54,60
Aesha,los-errantes,1864,druid,restoration,60,31,29
Foxyfeet,outland,1858,druid,restoration,77,43,34
Pll,defias-brotherhood,1853,druid,restoration,159,90,69
Køngx,blackhand,1853,druid,restoration,137,71,66
Tj,frostmane,1853,druid,restoration,64,27,37
Troc,karazhan,1852,druid,restoration,56,28,28
Starsyo,twisting-nether,1851,druid,restoration,142,85,57
Naraia,aegwynn,1850,druid,restoration,221,118,103
Loleh,ragnaros,1848,druid,restoration,101,53,48
Lalalime,arthas,1848,druid,restoration,70,33,37
Jmdr,silvermoon,1848,druid,restoration,77,32,45
Брэвно,gordunni,1845,druid,restoration,480,261,219
Asaj,argent-dawn,1843,druid,restoration,371,202,169
Хлайси,gordunni,1840,druid,restoration,54,25,29
Theatrex,ravencrest,1839,druid,restoration,225,124,101
Asøri,antonidas,1839,druid,restoration,78,33,45
Skillfall,ravencrest,1837,druid,restoration,102,51,51
Ammare,burning-legion,1836,druid,restoration,120,63,57
Bjoernbrudn,ravencrest,1835,druid,restoration,84,44,40
Promethezine,tarren-mill,1834,druid,restoration,545,281,264
Deretus,blackmoore,1833,druid,restoration,58,28,30
Делоникс,soulflayer,1832,druid,restoration,96,46,50
Telary,baelgun,1830,druid,restoration,48,29,19
Happypeanut,blackmoore,1830,druid,restoration,75,43,32
Treliuz,twilights-hammer,1823,druid,restoration,346,190,156
Maiverdr,ravencrest,1821,druid,restoration,60,30,30
Yesco,malganis,1821,druid,restoration,63,27,36
Lunglung,blutkessel,1819,druid,restoration,204,112,92
Мафио,blackscar,1819,druid,restoration,54,28,26
Jìnró,ravencrest,1819,druid,restoration,183,89,94
Stiffýz,archimonde,1819,druid,restoration,60,29,31
Panørax,archimonde,1819,druid,restoration,71,33,38
Erika,vashj,1817,druid,restoration,120,67,53
Helløkittyßß,dun-modr,1817,druid,restoration,699,361,338
Skadooshee,kazzak,1816,druid,restoration,36,19,17
Дуггизавр,howling-fjord,1815,druid,restoration,51,27,24
Bëstwôrld,archimonde,1815,druid,restoration,130,68,62
Nastycat,magtheridon,1815,druid,restoration,263,127,136
Migami,nemesis,1815,druid,restoration,113,54,59
Xvmon,draenor,1815,druid,restoration,99,45,54
Notsikaan,blackhand,1815,druid,restoration,83,37,46
Lyalis,kazzak,1814,druid,restoration,71,37,34
Peterpain,grim-batol,1813,druid,restoration,42,26,16
Diolives,stormscale,1813,druid,restoration,446,236,210
Mentallyill,ravencrest,1813,druid,restoration,234,115,119
Critstorm,nemesis,1812,druid,restoration,82,33,49
Riddlerdruid,aegwynn,1811,druid,restoration,50,33,17
Demiannie,argent-dawn,1810,druid,restoration,230,128,102
Bigborst,ravencrest,1808,druid,restoration,80,55,25
Terenzyo,veklor,1808,druid,restoration,36,19,17
Celéry,silvermoon,1807,druid,restoration,45,27,18
Улдрэйн,deathguard,1807,druid,restoration,283,151,132
Mòzat,stormscale,1807,druid,restoration,90,45,45
Muraglia,pozzo-delleternità,1806,druid,restoration,30,19,11
Koshai,twisting-nether,1806,druid,restoration,59,34,25
Bellatrx,darksorrow,1806,druid,restoration,98,54,44
Morkius,ravencrest,1806,druid,restoration,36,19,17
Eduthecat,dun-modr,1805,druid,restoration,114,47,67
Kokanine,ravencrest,1804,druid,restoration,81,46,35
Eyvimel,ravencrest,1804,druid,restoration,810,427,383
Kìttÿ,dun-modr,1803,druid,restoration,72,43,29
Shiftycents,ravencrest,1803,druid,restoration,54,31,23
Layzz,archimonde,1802,druid,restoration,35,19,16
Qjkuug,ravencrest,1802,druid,restoration,88,47,41
Tommiz,silvermoon,1802,druid,restoration,42,22,20
Diriculous,kazzak,1802,druid,restoration,289,142,147
Csmo,blackmoore,1800,druid,restoration,48,29,19
Clonesy,outland,1800,druid,restoration,48,26,22
Maedic,outland,1799,druid,restoration,233,118,115
Moondra,outland,1799,druid,restoration,209,101,108
Sorryblya,ravencrest,1799,druid,restoration,100,45,55
Lindorel,khaz-modan,1798,druid,restoration,246,128,118
Hadok,azjolnerub,1798,druid,restoration,167,76,91
Крашдру,gordunni,1796,druid,restoration,112,64,48
Panigale,dun-modr,1795,druid,restoration,184,87,97
Wømbat,ravencrest,1794,druid,restoration,66,31,35
Ðezo,stormscale,1791,druid,restoration,60,29,31
Néøu,archimonde,1790,druid,restoration,78,36,42
Ninadobrev,ragnaros,1789,druid,restoration,69,35,34
Noramun,alexstrasza,1786,druid,restoration,47,28,19
Asklepion,twisting-nether,1785,druid,restoration,42,19,23
Çãm,magtheridon,1783,druid,restoration,191,109,82
Plantpuzzl,silvermoon,1783,druid,restoration,351,173,178
Dyloxe,silvermoon,1781,druid,restoration,48,24,24
Fusetòn,tarren-mill,1779,druid,restoration,60,36,24
Lexopewpew,ravencrest,1779,druid,restoration,47,22,25
Zydrux,outland,1778,druid,restoration,54,37,17
Lamatoes,ravencrest,1777,druid,restoration,77,34,43
Amaree,burning-legion,1774,druid,restoration,131,59,72
Zmira,outland,1773,druid,restoration,78,40,38
Tunling,ravencrest,1772,druid,restoration,201,121,80
Slayced,blackrock,1772,druid,restoration,89,44,45
Baawz,blackmoore,1772,druid,restoration,132,56,76
Crìmz,aszune,1767,druid,restoration,105,45,60
Gøðførm,silvermoon,1765,druid,restoration,184,96,88
Shiftypenny,ragnaros,1765,druid,restoration,47,22,25
Kùrámágødx,ravencrest,1764,druid,restoration,41,19,22
Велаине,gordunni,1763,druid,restoration,429,234,195
Wraithmoon,stormscale,1761,druid,restoration,42,21,21
Shufflebot,sylvanas,1760,druid,restoration,48,28,20
Jimpä,outland,1760,druid,restoration,84,48,36
Poporseven,archimonde,1760,druid,restoration,42,20,22
Krewèlla,emerald-dream,1759,druid,restoration,34,19,15
Кенкертайм,gordunni,1759,druid,restoration,142,71,71
Zekmvp,silvermoon,1759,druid,restoration,185,87,98
Kittyperry,tarren-mill,1758,druid,restoration,141,73,68
Wéédmâñ,ravencrest,1756,druid,restoration,45,30,15
Kanyevotèrx,ravencrest,1756,druid,restoration,102,41,61
Sangré,suramar,1753,druid,restoration,220,113,107
Isquatbrah,tarren-mill,1753,druid,restoration,57,22,35
Jìnro,stormscale,1751,druid,restoration,54,35,19
Kosebamse,sylvanas,1750,druid,restoration,57,26,31
Weezíng,ysondre,1747,druid,restoration,73,40,33
Badashellm,ravencrest,1744,druid,restoration,66,37,29
Chainbrake,sylvanas,1744,druid,restoration,57,28,29
Feelstreeman,twisting-nether,1740,druid,restoration,245,135,110
Soguu,thrall,1740,druid,restoration,60,32,28
Tooclosex,outland,1739,druid,restoration,212,116,96
Mabkferal,ravencrest,1739,druid,restoration,53,29,24
Rozt,ravencrest,1738,druid,restoration,54,28,26
Dëlins,outland,1738,druid,restoration,56,25,31
Тэддибиар,gordunni,1737,druid,restoration,95,62,33
Kroghelf,tarren-mill,1737,druid,restoration,58,28,30
Neverfall,aegwynn,1735,druid,restoration,61,28,33
Nasduck,ravencrest,1734,druid,restoration,322,167,155
Wörstplayêr,archimonde,1733,druid,restoration,42,21,21
Vijaja,aegwynn,1732,druid,restoration,88,51,37
Bellhooks,blackrock,1731,druid,restoration,42,28,14
Naphé,ysondre,1731,druid,restoration,60,38,22
Dóodlez,aegwynn,1731,druid,restoration,45,23,22
Lfsecondreju,ravencrest,1730,druid,restoration,30,22,8
Jnzymiau,blackrock,1725,druid,restoration,156,92,64
Tarshish,outland,1724,druid,restoration,54,37,17
Филавтия,gordunni,1724,druid,restoration,60,32,28
Bigmeandruid,twisting-nether,1724,druid,restoration,66,33,33
Друлихаз,gordunni,1724,druid,restoration,96,45,51
Evílz,kazzak,1723,druid,restoration,63,32,31
Hizzy,burning-legion,1723,druid,restoration,309,149,160
Terenzlol,veklor,1722,druid,restoration,51,27,24
Ystalgia,sylvanas,1722,druid,restoration,78,39,39
Ooktharg,turalyon,1721,druid,restoration,105,58,47
Toltekx,ravencrest,1721,druid,restoration,64,28,36
Drøødis,archimonde,1720,druid,restoration,108,56,52
Georn,bladefist,1719,druid,restoration,87,58,29
Sprøutt,drakthul,1719,druid,restoration,36,18,18
Treeførm,ravencrest,1718,druid,restoration,59,36,23
Hyggef,ravencrest,1718,druid,restoration,48,22,26
Kawèlz,archimonde,1715,druid,restoration,42,25,17
Bárdiandru,blackhand,1714,druid,restoration,41,21,20
Лабирошка,blackscar,1714,druid,restoration,60,24,36
Billydruida,sanguino,1713,druid,restoration,54,25,29
Slaugh,zuljin,1713,druid,restoration,66,26,40
Shumamakan,nemesis,1712,druid,restoration,48,26,22
Хуссипусси,galakrond,1711,druid,restoration,65,36,29
Siaz,archimonde,1711,druid,restoration,59,31,28
Isitbleedin,silvermoon,1711,druid,restoration,54,24,30
Noramun,blackmoore,1711,druid,restoration,54,24,30
Crownydrood,hyjal,1708,druid,restoration,84,49,35
Kvalitet,outland,1708,druid,restoration,127,59,68
Rozi,draenor,1705,druid,restoration,65,38,27
Monatamis,kazzak,1705,druid,restoration,156,84,72
Ittei,korgall,1704,druid,restoration,156,86,70
Synapes,outland,1704,druid,restoration,105,51,54
Lifelover,outland,1704,druid,restoration,60,28,32
Hotsy,ravencrest,1700,druid,restoration,38,25,13
Nevax,blackrock,1700,druid,restoration,36,18,18
Skipperd,blackmoore,1700,druid,restoration,48,22,26
Bibeed,blackmoore,1699,druid,restoration,48,22,26
Rougetreize,khaz-modan,1694,druid,restoration,106,60,46
Plsbuffdruid,ravencrest,1692,druid,restoration,46,23,23
Josedudu,twisting-nether,1692,druid,restoration,75,37,38
Øhshift,drakthul,1690,druid,restoration,71,37,34
Аренатренер,gordunni,1690,druid,restoration,378,192,186
Fryén,archimonde,1690,druid,restoration,111,52,59
Setztes,tarren-mill,1689,druid,restoration,370,197,173
Nuurah,silvermoon,1688,druid,restoration,36,20,16
Eedaza,argent-dawn,1687,druid,restoration,176,91,85
Bigorkey,blackrock,1686,druid,restoration,319,164,155
Luhmanish,thunderhorn,1683,druid,restoration,160,82,78
Weisslogia,aegwynn,1683,druid,restoration,48,24,24
Кекичан,howling-fjord,1682,druid,restoration,65,26,39
Olaphy,elune,1681,druid,restoration,563,282,281
Pogoth,turalyon,1680,druid,restoration,228,118,110
Ðæððÿçhïll,ravencrest,1678,druid,restoration,169,100,69
Doktordudu,drakthul,1678,druid,restoration,128,49,79
Akumei,ravencrest,1676,druid,restoration,47,24,23
Scorlok,eredar,1675,druid,restoration,163,94,69
Praetorian,sylvanas,1674,druid,restoration,369,181,188
Woohoo,ravencrest,1673,druid,restoration,36,21,15
Унаген,howling-fjord,1673,druid,restoration,79,44,35
Zhosy,shattrath,1673,druid,restoration,79,33,46
Catdoge,thrall,1672,druid,restoration,24,18,6
Qjkuug,twisting-nether,1671,druid,restoration,214,118,96
Funnyjoker,outland,1671,druid,restoration,335,166,169
Cøwgirl,draenor,1670,druid,restoration,78,40,38
Lxstcentury,stormscale,1669,druid,restoration,36,19,17
Elviiradruid,tarren-mill,1669,druid,restoration,97,51,46
Yö,deathwing,1668,druid,restoration,381,198,183
Mònsterz,archimonde,1667,druid,restoration,243,130,113
Elayria,blackmoore,1663,druid,restoration,36,19,17
Ксенона,gordunni,1663,druid,restoration,60,30,30
Artichte,archimonde,1662,druid,restoration,66,39,27
Pawful,malganis,1661,druid,restoration,412,219,193
Pavelot,runetotem,1661,druid,restoration,113,60,53
Kaamirach,blackmoore,1659,druid,restoration,202,122,80
Heavysmoker,emeriss,1659,druid,restoration,282,137,145
Demerit,aegwynn,1657,druid,restoration,32,18,14
Hotsnthots,elune,1657,druid,restoration,66,35,31
Sélia,sylvanas,1657,druid,restoration,116,57,59
Taurvid,outland,1657,druid,restoration,41,18,23
Bâneth,destromath,1656,druid,restoration,60,33,27
Ilarilén,blackmoore,1655,druid,restoration,96,49,47
Bjútiful,silvermoon,1654,druid,restoration,129,68,61
Bulldócer,sanguino,1654,druid,restoration,116,55,61
Doodougie,silvermoon,1653,druid,restoration,76,37,39
Ýanux,aegwynn,1652,druid,restoration,40,25,15
Zudwa,twisting-nether,1651,druid,restoration,62,37,25
Lùnæxqt,hyjal,1650,druid,restoration,30,18,12
Чекхмеаскохз,gordunni,1650,druid,restoration,114,61,53
Estariol,auchindoun,1650,druid,restoration,42,18,24
Bunzor,sylvanas,1649,druid,restoration,60,32,28
Alásea,kazzak,1649,druid,restoration,60,24,36
Holybarkz,aegwynn,1648,druid,restoration,53,25,28
Чухх,howling-fjord,1647,druid,restoration,151,77,74
Arogane,outland,1645,druid,restoration,162,87,75
Eldi,uldum,1643,druid,restoration,42,18,24
Itswoland,emeriss,1641,druid,restoration,53,33,20
Orayin,ravencrest,1641,druid,restoration,535,282,253
Toddler,twisting-nether,1641,druid,restoration,52,19,33
Kyssope,chants-éternels,1640,druid,restoration,42,25,17
Hatecrew,twisting-nether,1640,druid,restoration,101,60,41
Hólo,blackrock,1639,druid,restoration,186,87,99
Mohyo,antonidas,1638,druid,restoration,146,84,62
Wallenstein,outland,1638,druid,restoration,36,19,17
Sintiq,stormscale,1638,druid,restoration,48,25,23
Kiadorn,stormreaver,1637,druid,restoration,52,30,22
Абраг,soulflayer,1637,druid,restoration,72,36,36
Tamburoo,tarren-mill,1637,druid,restoration,477,236,241
Pardus,ambossar,1635,druid,restoration,50,27,23
Stommz,defias-brotherhood,1635,druid,restoration,112,54,58
Uknowwhaddup,silvermoon,1634,druid,restoration,108,51,57
Andromedda,twisting-nether,1632,druid,restoration,221,117,104
Ekexd,grim-batol,1630,druid,restoration,48,26,22
Thilethyl,aggra-português,1630,druid,restoration,48,22,26
Farashh,archimonde,1630,druid,restoration,107,45,62
Tolteked,ravencrest,1629,druid,restoration,45,23,22
Cheçhy,aegwynn,1628,druid,restoration,147,78,69
Watchmebear,stormscale,1627,druid,restoration,66,35,31
Nozome,draenor,1627,druid,restoration,135,66,69
Rêvétoile,sinstralis,1627,druid,restoration,197,91,106
Möllemäck,sylvanas,1626,druid,restoration,91,58,33
Holybarkzqt,aegwynn,1626,druid,restoration,48,27,21
Olympïee,archimonde,1625,druid,restoration,48,25,23
Amarerawr,burning-legion,1624,druid,restoration,42,24,18
Ёу,soulflayer,1624,druid,restoration,161,85,76
Demdeepconvx,twisting-nether,1623,druid,restoration,60,22,38
Miyá,sylvanas,1622,druid,restoration,82,43,39
Ecological,outland,1622,druid,restoration,48,22,26
Chaboom,hyjal,1622,druid,restoration,60,25,35
Zevana,tarren-mill,1621,druid,restoration,42,23,19
Нубстримсс,gordunni,1621,druid,restoration,124,62,62
Опапенелопа,blackscar,1620,druid,restoration,45,30,15
Jamieform,ravencrest,1619,druid,restoration,85,46,39
Apokalypse,stormreaver,1619,druid,restoration,198,104,94
Twerkdabooty,azjolnerub,1619,druid,restoration,60,29,31
Zaelitwo,archimonde,1618,druid,restoration,54,36,18
Frances,auchindoun,1618,druid,restoration,69,39,30
Elu,eredar,1617,druid,restoration,48,28,20
Haszard,outland,1617,druid,restoration,134,68,66
Wernøs,archimonde,1617,druid,restoration,99,48,51
Jackyblue,silvermoon,1617,druid,restoration,48,22,26
Probablyahoe,ravencrest,1616,druid,restoration,42,21,21
Rááy,blackrock,1616,druid,restoration,47,20,27
Goldrax,outland,1615,druid,restoration,24,17,7
Tåylor,laughing-skull,1615,druid,restoration,41,21,20
Buffbloom,auchindoun,1615,druid,restoration,183,93,90
Драменбейз,gordunni,1615,druid,restoration,42,20,22
Dûdûrînâ,blackrock,1614,druid,restoration,66,42,24
Nstt,dun-modr,1614,druid,restoration,32,17,15
Neluun,die-aldor,1613,druid,restoration,66,42,24
Catgirlx,ravencrest,1612,druid,restoration,54,30,24
Ånåphorå,archimonde,1609,druid,restoration,35,20,15
Xalio,ravencrest,1609,druid,restoration,167,93,74
Kll,defias-brotherhood,1609,druid,restoration,90,47,43
Folzenqt,archimonde,1609,druid,restoration,92,40,52
Fabsl,archimonde,1608,druid,restoration,141,71,70
Fatøumatä,archimonde,1608,druid,restoration,144,71,73
Malacella,marécage-de-zangar,1608,druid,restoration,54,22,32
Slimp,the-maelstrom,1608,druid,restoration,54,21,33
Ына,gordunni,1607,druid,restoration,287,152,135
Místergreen,ravencrest,1607,druid,restoration,48,23,25
Kheazar,blackmoore,1606,druid,restoration,115,69,46
Nímbs,tarren-mill,1606,druid,restoration,99,52,47
Oceleaf,tarren-mill,1606,druid,restoration,46,21,25
Блицклик,gordunni,1605,druid,restoration,148,73,75
Youngdinozzo,dalaran,1604,druid,restoration,36,23,13
Cioban,stormscale,1604,druid,restoration,418,209,209
Bîrke,blackrock,1604,druid,restoration,36,17,19
Tjann,darksorrow,1603,druid,restoration,48,23,25
Donaarr,stormscale,1603,druid,restoration,122,56,66
Sarxidor,defias-brotherhood,1603,druid,restoration,96,38,58
Нагетсмяу,howling-fjord,1602,druid,restoration,249,136,113
Feyzode,ysondre,1601,druid,restoration,30,17,13
Guccicken,garona,1601,druid,restoration,310,166,144
Mikeisbike,ragnaros,1601,druid,restoration,44,22,22
Viggez,outland,1601,druid,restoration,36,17,19
Ðarckness,kazzak,1600,druid,restoration,24,17,7
Zuuhhl,ravencrest,1600,druid,restoration,54,31,23
Swifte,argent-dawn,1600,druid,restoration,48,27,21
Swisz,bronzebeard,1600,druid,restoration,137,73,64
Dwaokut,ravencrest,1600,druid,restoration,242,125,117
Akmón,tarren-mill,1600,druid,restoration,58,20,38
Dïsä,ravencrest,1599,druid,restoration,30,17,13
Bägira,sylvanas,1599,druid,restoration,590,306,284
Delviri,stormreaver,1597,druid,restoration,277,141,136
Moonfinder,tarren-mill,1597,druid,restoration,60,29,31
Shaelx,nethersturm,1597,druid,restoration,60,28,32
Loltree,outland,1596,druid,restoration,54,26,28
Druncha,sunstrider,1596,druid,restoration,213,88,125
Maltøx,archimonde,1593,druid,restoration,36,17,19
Tôrmêñtêd,outland,1591,druid,restoration,200,113,87
Миледистайпи,gordunni,1591,druid,restoration,81,39,42
Kiggstar,blackmoore,1590,druid,restoration,83,46,37
Pega,archimonde,1589,druid,restoration,189,91,98
Adjaara,ravencrest,1588,druid,restoration,157,87,70
Solutionx,aegwynn,1588,druid,restoration,98,41,57
Buklau,stormscale,1588,druid,restoration,54,22,32
Muminoses,burning-legion,1587,druid,restoration,155,76,79
Bêvêrly,ravencrest,1586,druid,restoration,70,37,33
Гвенивар,soulflayer,1586,druid,restoration,42,20,22
Гипертропик,gordunni,1585,druid,restoration,30,17,13
Homek,eredar,1584,druid,restoration,264,138,126
Prayx,dalaran,1583,druid,restoration,89,45,44
Halyconwings,outland,1582,druid,restoration,91,52,39
Smightydr,silvermoon,1579,druid,restoration,71,32,39
Naridruidx,eredar,1578,druid,restoration,42,26,16
Ssonty,drakthul,1578,druid,restoration,93,43,50
Nyxxz,shattered-hand,1577,druid,restoration,66,38,28
Nightmoon,hellscream,1576,druid,restoration,67,29,38
Animaldoh,kazzak,1576,druid,restoration,66,27,39
Eeivi,argent-dawn,1575,druid,restoration,337,182,155
Рамчег,gordunni,1575,druid,restoration,54,26,28
Solern,ravencrest,1573,druid,restoration,41,23,18
Búse,twisting-nether,1573,druid,restoration,66,27,39
Phelessa,silvermoon,1571,druid,restoration,78,37,41
Wagoneis,grim-batol,1570,druid,restoration,154,86,68
Mortalnight,sinstralis,1570,druid,restoration,538,266,272
Rawri,blackmoore,1570,druid,restoration,104,51,53
Reya,hyjal,1567,druid,restoration,273,141,132
Друлёнышь,eversong,1566,druid,restoration,236,127,109
Devastras,ravencrest,1564,druid,restoration,58,29,29
Jakeparkki,sylvanas,1564,druid,restoration,38,18,20
Erebear,ravencrest,1563,druid,restoration,123,73,50
Кьюкамбер,gordunni,1562,druid,restoration,66,36,30
Miyokô,grim-batol,1560,druid,restoration,96,51,45
Deluron,malganis,1560,druid,restoration,200,104,96
Yzher,archimonde,1558,druid,restoration,43,25,18
Kundz,dalaran,1558,druid,restoration,160,88,72
Jagerdog,archimonde,1558,druid,restoration,39,18,21
Clonecity,ravencrest,1558,druid,restoration,47,18,29
Naturez,sylvanas,1557,druid,restoration,32,20,12
Bammedrudu,archimonde,1557,druid,restoration,54,32,22
Ninø,gorgonnash,1557,druid,restoration,266,147,119
Hashtagone,ysondre,1556,druid,restoration,111,59,52
Артекриодру,howling-fjord,1556,druid,restoration,60,31,29
Moonbee,burning-blade,1556,druid,restoration,212,105,107
Kasugia,aegwynn,1556,druid,restoration,48,20,28
Kaher,ravencrest,1555,druid,restoration,114,61,53
Bigdaddyshay,twisting-nether,1553,druid,restoration,60,30,30
Crïn,ravencrest,1553,druid,restoration,36,17,19
Nancey,auchindoun,1552,druid,restoration,197,97,100
Dafapa,twilights-hammer,1550,druid,restoration,72,40,32
Фатуомуэрте,razuvious,1550,druid,restoration,96,43,53
Bearform,blackhand,1548,druid,restoration,48,23,25
Khunahype,thrall,1546,druid,restoration,88,48,40
Ráw,dun-modr,1546,druid,restoration,167,84,83
Cörelly,ravencrest,1544,druid,restoration,537,293,244
Lyvuni,blackmoore,1543,druid,restoration,66,40,26
Рамзес,gordunni,1543,druid,restoration,105,55,50
Gladiata,tarren-mill,1542,druid,restoration,47,21,26
Shiftway,stormscale,1541,druid,restoration,87,45,42
Reinulfen,blackmoore,1541,druid,restoration,556,286,270
Ihatemétoo,stormscale,1541,druid,restoration,100,51,49
Seherbaz,ravencrest,1539,druid,restoration,76,44,32
Лэвиш,blackscar,1539,druid,restoration,96,55,41
Мекс,gordunni,1537,druid,restoration,29,17,12
Deliveru,outland,1537,druid,restoration,52,27,25
Wheretowrite,ravencrest,1536,druid,restoration,327,172,155
Critdruid,kazzak,1536,druid,restoration,60,23,37
Уэсериктх,blackscar,1535,druid,restoration,51,28,23
Roshaga,blackrock,1535,druid,restoration,51,25,26
Maníx,tarren-mill,1534,druid,restoration,222,124,98
Hideme,tarren-mill,1534,druid,restoration,209,108,101
Директорх,blackscar,1534,druid,restoration,47,22,25
Лабирон,soulflayer,1534,druid,restoration,36,16,20
Pzqlol,outland,1533,druid,restoration,24,16,8
Инкуль,gordunni,1533,druid,restoration,198,111,87
Néllä,archimonde,1532,druid,restoration,113,65,48
Ðès,ravencrest,1532,druid,restoration,156,72,84
Sonyk,drakthul,1531,druid,restoration,60,26,34
Jellyxdd,silvermoon,1530,druid,restoration,24,16,8
Styleexd,ragnaros,1530,druid,restoration,111,63,48
Icecöld,silvermoon,1529,druid,restoration,24,16,8
Eviscreator,stormscale,1529,druid,restoration,45,27,18
Fouser,shattered-hand,1528,druid,restoration,27,20,7
Kittý,terokkar,1528,druid,restoration,180,92,88
Yellow,sylvanas,1528,druid,restoration,69,30,39
Beerform,ravencrest,1528,druid,restoration,45,17,28
Ванечка,razuvious,1528,druid,restoration,84,30,54
Hasselhoof,eredar,1526,druid,restoration,63,26,37
Treedog,ravencrest,1525,druid,restoration,84,35,49
Melonmanx,outland,1523,druid,restoration,30,17,13
Felisin,ravencrest,1523,druid,restoration,53,27,26
Bullander,sylvanas,1521,druid,restoration,36,16,20
Snuffurious,ragnaros,1520,druid,restoration,54,32,22
Flensí,stormscale,1518,druid,restoration,36,16,20
Oøom,stormscale,1518,druid,restoration,60,23,37
Baldurix,blackrock,1516,druid,restoration,71,35,36
Nasgra,malganis,1516,druid,restoration,77,34,43
Caldino,tarren-mill,1516,druid,restoration,41,17,24
Ravenfang,dun-modr,1515,druid,restoration,241,139,102
Burgergodx,tarren-mill,1515,druid,restoration,42,22,20
Cesn,vashj,1515,druid,restoration,155,74,81
Лапыбонги,lich-king,1515,druid,restoration,123,56,67
Квирит,razuvious,1515,druid,restoration,116,47,69
Utopiah,ravencrest,1513,druid,restoration,80,45,35
Supremecat,tarren-mill,1513,druid,restoration,102,57,45
Keldraïn,hyjal,1513,druid,restoration,60,24,36
Latêralus,silvermoon,1513,druid,restoration,67,26,41
Leafceld,aggra-português,1512,druid,restoration,180,93,87
Tinkérbell,blackmoore,1512,druid,restoration,35,17,18
Сладуляя,gordunni,1512,druid,restoration,71,32,39
Локотьдрева,gordunni,1511,druid,restoration,48,19,29
Dartdogg,sanguino,1510,druid,restoration,125,55,70
Buckié,twisting-nether,1509,druid,restoration,97,51,46
Azchuk,blackmoore,1509,druid,restoration,53,22,31
Eaglefox,aszune,1508,druid,restoration,113,55,58
Bloomies,tarren-mill,1507,druid,restoration,100,59,41
Larlye,dun-modr,1507,druid,restoration,60,31,29
Åzjôl,magtheridon,1507,druid,restoration,42,20,22
Ríkku,sargeras,1507,druid,restoration,144,68,76
Мостурбаза,soulflayer,1506,druid,restoration,30,16,14
Clownrad,tarren-mill,1506,druid,restoration,54,28,26
Друрашка,soulflayer,1504,druid,restoration,129,67,62
Dardargnan,throkferoth,1504,druid,restoration,172,83,89
Cæsífer,area-52,1504,druid,restoration,109,51,58
Lÿter,dun-modr,1502,druid,restoration,60,27,33
Greenlips,ravencrest,1502,druid,restoration,60,23,37
Jìkkz,aegwynn,1502,druid,restoration,76,29,47
Skysrex,outland,1501,druid,restoration,42,18,24
Soný,aegwynn,1500,druid,restoration,54,35,19
Edal,chogall,1500,druid,restoration,354,179,175
Worstdruid,sanguino,1499,druid,restoration,24,16,8
Stratocaster,blackmoore,1498,druid,restoration,54,26,28
Xoriauz,archimonde,1497,druid,restoration,246,119,127
Innos,azshara,1497,druid,restoration,60,27,33
Aebí,dalaran,1496,druid,restoration,60,40,20
Groundpovx,blackmoore,1496,druid,restoration,72,37,35
Helkondr,thrall,1496,druid,restoration,48,17,31
Trayndaras,drakthul,1495,druid,restoration,35,23,12
Sushikîng,ravencrest,1495,druid,restoration,48,27,21
Ccmydcv,archimonde,1495,druid,restoration,37,19,18
Akasuky,thrall,1494,druid,restoration,271,142,129
Djvapelordx,stormscale,1494,druid,restoration,281,144,137
Oloreformed,ravencrest,1494,druid,restoration,52,24,28
Lemicus,twisting-nether,1494,druid,restoration,78,31,47
Pyctograhm,eldrethalas,1493,druid,restoration,60,26,34
Fredhqt,tarren-mill,1491,druid,restoration,58,32,26
Jtepdru,ravencrest,1490,druid,restoration,132,67,65
Катяблум,gordunni,1490,druid,restoration,151,74,77
Ldoctorl,ravencrest,1489,druid,restoration,130,61,69
Atôtheex,kazzak,1488,druid,restoration,43,21,22
Roshava,stormscale,1487,druid,restoration,64,42,22
Moonfetamine,silvermoon,1487,druid,restoration,211,108,103
Gaeldeth,silvermoon,1486,druid,restoration,143,74,69
Kyjaa,eredar,1486,druid,restoration,108,48,60
Veganbtw,tarren-mill,1486,druid,restoration,97,34,63
Mnine,twisting-nether,1485,druid,restoration,42,23,19
Phala,outland,1485,druid,restoration,54,23,31
Høttýbálbøà,blackrock,1484,druid,restoration,29,19,10
Mw,dun-modr,1484,druid,restoration,148,70,78
Champaa,aggra-português,1484,druid,restoration,93,40,53
Salagkoydi,sylvanas,1483,druid,restoration,96,55,41
Moontriix,kazzak,1481,druid,restoration,103,54,49
Zaerox,ambossar,1481,druid,restoration,114,56,58
Trollisha,mannoroth,1481,druid,restoration,1780,873,907
Flåppers,stormscale,1481,druid,restoration,64,26,38
Bearliheals,draenor,1480,druid,restoration,110,65,45
Bloompuf,draenor,1479,druid,restoration,337,164,173
Атмос,deathguard,1478,druid,restoration,198,109,89
Devióus,twilights-hammer,1478,druid,restoration,502,254,248
Nezpa,ravencrest,1477,druid,restoration,70,43,27
Lukass,drakthul,1477,druid,restoration,242,125,117
Xôárqt,aegwynn,1477,druid,restoration,72,33,39
Maqer,argent-dawn,1476,druid,restoration,56,31,25
Brorsnor,ravencrest,1476,druid,restoration,195,93,102
Høtbøt,ysera,1475,druid,restoration,81,40,41
Drozzie,twisting-nether,1472,druid,restoration,24,16,8
Иггдрассиль,blackscar,1472,druid,restoration,54,31,23
Sandh,uldum,1472,druid,restoration,84,40,44
Iløvelucy,ravencrest,1472,druid,restoration,50,18,32
Taèzoth,terokkar,1471,druid,restoration,56,34,22
Thanom,auchindoun,1470,druid,restoration,324,166,158
Clovér,outland,1470,druid,restoration,131,65,66
Islandbôy,blackrock,1470,druid,restoration,42,16,26
Nixter,ravencrest,1469,druid,restoration,95,48,47
Exilia,kragjin,1469,druid,restoration,53,25,28
Didi,frostwhisper,1468,druid,restoration,315,161,154
Hótty,antonidas,1468,druid,restoration,83,37,46
Skoony,kazzak,1465,druid,restoration,146,78,68
Tehira,antonidas,1465,druid,restoration,118,52,66
Myxer,ravencrest,1463,druid,restoration,110,65,45
Kormakurr,silvermoon,1463,druid,restoration,87,51,36
Lolhaha,ravencrest,1463,druid,restoration,54,24,30
Jcpenney,xavius,1462,druid,restoration,630,313,317
Shiftshow,ravencrest,1461,druid,restoration,64,41,23
Feyzoude,ysondre,1461,druid,restoration,40,24,16
Фапдрим,howling-fjord,1460,druid,restoration,670,337,333
Блумха,howling-fjord,1459,druid,restoration,78,41,37
Bløødberry,ravencrest,1459,druid,restoration,54,28,26
Sodamncute,ravencrest,1458,druid,restoration,41,24,17
Маминапуська,soulflayer,1458,druid,restoration,57,32,25
Spliçe,draenor,1458,druid,restoration,48,24,24
Arlandia,drakthul,1458,druid,restoration,42,17,25
Asanaria,ravencrest,1457,druid,restoration,113,52,61
Дилайт,blackscar,1456,druid,restoration,222,116,106
Hellcow,blackmoore,1455,druid,restoration,119,54,65
Lhithium,kazzak,1453,druid,restoration,175,98,77
Ööh,outland,1453,druid,restoration,48,25,23
Друмания,gordunni,1452,druid,restoration,300,144,156
Hellofresh,silvermoon,1451,druid,restoration,111,49,62
Euskal,chogall,1451,druid,restoration,42,18,24
Dêrbombär,guldan,1451,druid,restoration,52,21,31
Будклим,blackscar,1450,druid,restoration,48,27,21
Deltalol,blackmoore,1450,druid,restoration,48,25,23
Ivysun,auchindoun,1450,druid,restoration,38,17,21
Skailzdruid,hyjal,1449,druid,restoration,291,161,130
Fangornn,outland,1448,druid,restoration,131,73,58
Estrogenlord,auchindoun,1448,druid,restoration,66,33,33
Zyndril,silvermoon,1448,druid,restoration,50,25,25
Druidelf,sylvanas,1448,druid,restoration,53,16,37
Ààlunåhlolz,azjolnerub,1447,druid,restoration,24,17,7
Cyclonebroo,blackmoore,1447,druid,restoration,64,31,33
Bigßoi,stormscale,1446,druid,restoration,164,87,77
Pharaah,stormscale,1446,druid,restoration,36,16,20
Afret,kazzak,1444,druid,restoration,147,78,69
Ráay,blackrock,1444,druid,restoration,126,66,60
Dârkacêû,blackmoore,1444,druid,restoration,121,56,65
Pureballs,twisting-nether,1442,druid,restoration,201,109,92
Siuo,ravencrest,1442,druid,restoration,78,31,47
Alexialol,silvermoon,1441,druid,restoration,31,19,12
Kajiun,silvermoon,1441,druid,restoration,54,32,22
Evoon,emeriss,1441,druid,restoration,78,42,36
Shadowmeld,stormreaver,1441,druid,restoration,62,32,30
Vashiko,tarren-mill,1441,druid,restoration,125,63,62
Dadjus,kazzak,1441,druid,restoration,81,39,42
Xyruden,kazzak,1441,druid,restoration,171,69,102
Hotlotta,aegwynn,1440,druid,restoration,31,16,15
Shlipshlap,eredar,1440,druid,restoration,78,28,50
Luuxiå,archimonde,1439,druid,restoration,24,15,9
Sùmmêrz,outland,1439,druid,restoration,59,23,36
Цукерище,gordunni,1438,druid,restoration,64,36,28
Bgwell,archimonde,1438,druid,restoration,30,15,15
Vacuumcleanr,ravencrest,1438,druid,restoration,30,15,15
Kicki,outland,1438,druid,restoration,87,42,45
Filyina,blackrock,1438,druid,restoration,182,86,96
Opresse,archimonde,1437,druid,restoration,51,21,30
Emersyn,ragnaros,1437,druid,restoration,50,19,31
Síggíe,eredar,1436,druid,restoration,30,17,13
Rawillinen,kazzak,1436,druid,restoration,54,28,26
Вексиус,gordunni,1436,druid,restoration,72,36,36
Cliftshifter,outland,1434,druid,restoration,54,33,21
Solàryx,hyjal,1434,druid,restoration,72,38,34
Febricyla,blackmoore,1434,druid,restoration,96,47,49
Mordraxx,archimonde,1434,druid,restoration,66,31,35
Druma,stormscale,1433,druid,restoration,48,25,23
Karenvolf,outland,1433,druid,restoration,30,15,15
Healingwoods,outland,1433,druid,restoration,36,17,19
Kukisanban,stormscale,1432,druid,restoration,314,168,146
Senoka,shattrath,1432,druid,restoration,335,174,161
Buckxxz,aegwynn,1432,druid,restoration,60,31,29
Davorian,frostmane,1432,druid,restoration,123,57,66
Sejki,aegwynn,1431,druid,restoration,94,50,44
Мегабамбук,soulflayer,1430,druid,restoration,24,17,7
Маккаланн,soulflayer,1430,druid,restoration,105,56,49
Wenciorek,kazzak,1430,druid,restoration,177,88,89
Rensselitäti,korgall,1430,druid,restoration,182,90,92
Elmáestró,aegwynn,1430,druid,restoration,72,33,39
Òniz,hyjal,1428,druid,restoration,46,30,16
Maethar,stormrage,1428,druid,restoration,111,67,44
Cylantus,eredar,1427,druid,restoration,72,45,27
Grïmsïght,draenor,1427,druid,restoration,214,108,106
Analmonstret,shattered-hand,1427,druid,restoration,35,17,18
Märe,defias-brotherhood,1426,druid,restoration,84,45,39
Buckxxz,nazjatar,1426,druid,restoration,166,88,78
Csmedruid,blackrock,1426,druid,restoration,84,44,40
Nelffie,kazzak,1425,druid,restoration,227,123,104
Mayurí,kazzak,1423,druid,restoration,92,60,32
Smucka,ragnaros,1423,druid,restoration,42,19,23
Xoat,marécage-de-zangar,1422,druid,restoration,66,35,31
Sygko,kazzak,1422,druid,restoration,30,15,15
Làhen,ravencrest,1422,druid,restoration,395,194,201
Knzm,dun-modr,1420,druid,restoration,198,106,92
Brosephiné,stormscale,1420,druid,restoration,74,38,36
Tînkerbèll,blackmoore,1420,druid,restoration,59,27,32
Shiu,blackmoore,1420,druid,restoration,60,21,39
Akuda,blackrock,1419,druid,restoration,158,79,79
Tokifong,kazzak,1419,druid,restoration,36,15,21
Iqqzazagotme,hyjal,1418,druid,restoration,68,29,39
Xontpos,stormscale,1417,druid,restoration,30,19,11
Obamos,stormscale,1416,druid,restoration,64,37,27
Althei,argent-dawn,1416,druid,restoration,116,62,54
Budspencebär,draenor,1416,druid,restoration,82,41,41
Thorns,blackrock,1416,druid,restoration,30,15,15
Âurum,silvermoon,1416,druid,restoration,56,27,29
Basilethe,hyjal,1415,druid,restoration,72,41,31
Кингкиса,gordunni,1415,druid,restoration,66,26,40
Trúdl,das-konsortium,1414,druid,restoration,53,31,22
Cptfalcony,outland,1413,druid,restoration,106,54,52
Schwertlilie,aegwynn,1413,druid,restoration,59,26,33
Shredz,destromath,1413,druid,restoration,36,15,21
Огрызокрыбы,howling-fjord,1412,druid,restoration,47,32,15
Barkingdog,tarren-mill,1412,druid,restoration,57,31,26
Stuu,nathrezim,1411,druid,restoration,90,45,45
Drbse,silvermoon,1411,druid,restoration,86,40,46
Antheiaa,frostmane,1411,druid,restoration,72,32,40
Qekw,blackhand,1410,druid,restoration,77,40,37
Buffmeplz,medivh,1410,druid,restoration,54,23,31
Mortagua,kazzak,1410,druid,restoration,36,15,21
Elwenyss,outland,1408,druid,restoration,95,41,54
Prettysavage,blackhand,1408,druid,restoration,55,17,38
Wooshy,kazzak,1406,druid,restoration,105,52,53
Plàntz,tarren-mill,1406,druid,restoration,79,39,40
Avemonthemus,silvermoon,1405,druid,restoration,46,21,25
Jikuni,ravencrest,1404,druid,restoration,81,39,42
Drukae,stormscale,1403,druid,restoration,97,46,51
Goatd,ravencrest,1403,druid,restoration,36,16,20
Mischkonsum,outland,1403,druid,restoration,68,27,41
Béccàbtw,draenor,1402,druid,restoration,30,16,14
Peerpope,draenor,1402,druid,restoration,311,164,147
Elysea,antonidas,1402,druid,restoration,120,63,57
Cuxorb,rexxar,1402,druid,restoration,752,383,369
Suprot,aggramar,1402,druid,restoration,106,52,54
Deví,twilights-hammer,1401,druid,restoration,54,27,27
Akindudu,twisting-nether,1401,druid,restoration,39,18,21
Друидсимба,howling-fjord,1400,druid,restoration,206,109,97
Cevto,drakthul,1400,druid,restoration,50,22,28
Liunara,nemesis,1400,druid,restoration,67,29,38
Lavague,hyjal,1400,druid,restoration,48,20,28
Pumplt,thrall,1399,druid,restoration,84,46,38
Minipilsen,outland,1399,druid,restoration,77,38,39
Qri,ahnqiraj,1398,druid,restoration,84,46,38
Азя,blackscar,1398,druid,restoration,80,36,44
Lycann,burning-blade,1397,druid,restoration,54,30,24
Noosh,thrall,1397,druid,restoration,86,44,42
Grololotte,dalaran,1397,druid,restoration,598,305,293
Feinberg,stormscale,1397,druid,restoration,101,44,57
Legyna,ravencrest,1396,druid,restoration,118,59,59
Yandris,argent-dawn,1396,druid,restoration,42,19,23
Tharteu,sanguino,1395,druid,restoration,170,85,85
Tokitoc,archimonde,1394,druid,restoration,101,59,42
Daewen,blackhand,1394,druid,restoration,112,61,51
Sucukk,antonidas,1393,druid,restoration,74,37,37
Drineh,ravencrest,1393,druid,restoration,48,21,27
Fth,dethecus,1392,druid,restoration,39,22,17
Røxhot,archimonde,1392,druid,restoration,162,90,72
Ilyethea,earthen-ring,1392,druid,restoration,476,250,226
Glückstaler,die-aldor,1392,druid,restoration,78,33,45
Saberrtooth,twisting-nether,1391,druid,restoration,105,53,52
Oceanvibes,tarren-mill,1391,druid,restoration,41,18,23
Indann,kazzak,1390,druid,restoration,48,21,27
Sandirion,silvermoon,1388,druid,restoration,976,487,489
Plúx,antonidas,1388,druid,restoration,44,18,26
Orinkhealer,ravencrest,1385,druid,restoration,202,97,105
Sertris,kazzak,1385,druid,restoration,70,30,40
Rbosse,aszune,1384,druid,restoration,26,16,10
Tanariel,ravencrest,1384,druid,restoration,89,50,39
Greengolly,argent-dawn,1384,druid,restoration,54,27,27
Sgtdrood,archimonde,1384,druid,restoration,55,27,28
Lestty,the-maelstrom,1383,druid,restoration,80,43,37
Nuwell,arathor,1383,druid,restoration,156,78,78
Hotto,antonidas,1382,druid,restoration,65,43,22
Вакидзами,gordunni,1382,druid,restoration,486,250,236
Starryraven,argent-dawn,1381,druid,restoration,235,122,113
Corroboree,archimonde,1380,druid,restoration,118,65,53
Mewiz,ravencrest,1380,druid,restoration,42,23,19
Gandraste,neptulon,1379,druid,restoration,24,19,5
Hanibalector,silvermoon,1379,druid,restoration,69,39,30
Maghh,ravencrest,1379,druid,restoration,124,66,58
Wwvwwvwwvwvw,burning-legion,1378,druid,restoration,145,62,83
Laserlars,blackrock,1377,druid,restoration,25,16,9
Blacksage,dragonmaw,1376,druid,restoration,107,50,57
Tjruid,twisting-nether,1375,druid,restoration,34,20,14
Whiplazh,archimonde,1375,druid,restoration,58,32,26
Spacedout,taerar,1375,druid,restoration,61,33,28
Basajáun,dun-modr,1375,druid,restoration,240,117,123
Ðaezk,archimonde,1374,druid,restoration,36,16,20
Yunalaa,blackmoore,1373,druid,restoration,95,49,46
Niknoom,azjolnerub,1372,druid,restoration,356,201,155
Badbloom,ravencrest,1372,druid,restoration,54,26,28
Untouchablè,outland,1371,druid,restoration,69,31,38
Oltoker,korgall,1370,druid,restoration,252,123,129
Saintbiose,dalaran,1368,druid,restoration,24,17,7
Rumbus,sanguino,1368,druid,restoration,52,21,31
Lindémann,blackhand,1367,druid,restoration,42,23,19
Lynysae,blackmoore,1366,druid,restoration,57,29,28
Fondü,outland,1366,druid,restoration,48,24,24
Brømberry,blackrock,1366,druid,restoration,167,82,85
Mudruu,blackrock,1366,druid,restoration,60,24,36
Emørtality,aegwynn,1366,druid,restoration,111,43,68
Atí,the-maelstrom,1365,druid,restoration,36,19,17
Milkmepls,balnazzar,1364,druid,restoration,30,19,11
Рефикс,gordunni,1364,druid,restoration,115,72,43
Кнесис,howling-fjord,1363,druid,restoration,103,59,44
Канимэ,howling-fjord,1362,druid,restoration,45,19,26
Diastra,silvermoon,1360,druid,restoration,354,181,173
Yaaji,archimonde,1359,druid,restoration,170,84,86
Inkeyes,outland,1358,druid,restoration,259,128,131
Floka,archimonde,1358,druid,restoration,102,47,55
Uuni,sylvanas,1358,druid,restoration,102,45,57
Biomat,norgannon,1357,druid,restoration,131,65,66
Zwierzyniec,jaedenar,1357,druid,restoration,60,27,33
Shinymoomoo,tarren-mill,1356,druid,restoration,74,38,36
Móònlight,ravencrest,1355,druid,restoration,53,25,28
Stonesight,argent-dawn,1354,druid,restoration,81,39,42
Bakicadr,sylvanas,1353,druid,restoration,93,42,51
Euklid,frostwolf,1353,druid,restoration,36,15,21
Animaltucher,nemesis,1352,druid,restoration,35,15,20
Nayokô,grim-batol,1351,druid,restoration,72,36,36
Царапкатян,gordunni,1351,druid,restoration,212,101,111
Ånaðeårmas,outland,1351,druid,restoration,39,16,23
Exïlla,archimonde,1350,druid,restoration,112,56,56
Zadrood,rashgarroth,1349,druid,restoration,227,117,110
Shadowcat,archimonde,1348,druid,restoration,49,22,27
Efru,silvermoon,1348,druid,restoration,47,18,29
Parkydru,draenor,1346,druid,restoration,30,20,10
Jinxaran,culte-de-la-rive-noire,1346,druid,restoration,30,18,12
Mlvn,outland,1346,druid,restoration,59,26,33
Hotsandpot,outland,1346,druid,restoration,36,15,21
Torawara,ragnaros,1345,druid,restoration,53,27,26
Duharbrahud,outland,1345,druid,restoration,54,22,32
Feralgodx,quelthalas,1344,druid,restoration,27,16,11
Pøwêr,blackrock,1344,druid,restoration,36,16,20
Ipossible,kazzak,1344,druid,restoration,54,18,36
Zaelithree,archimonde,1343,druid,restoration,24,14,10
Antimend,draenor,1341,druid,restoration,24,14,10
Scaleo,stormreaver,1341,druid,restoration,168,89,79
Shufflê,blackmoore,1341,druid,restoration,154,69,85
Bayerant,burning-legion,1341,druid,restoration,36,15,21
Nohos,blackrock,1340,druid,restoration,24,14,10
Sariel,saurfang,1340,druid,restoration,377,189,188
Zuzam,bladefist,1340,druid,restoration,144,67,77
Лдрион,gordunni,1339,druid,restoration,57,36,21
Idect,silvermoon,1339,druid,restoration,348,177,171
Göli,argent-dawn,1335,druid,restoration,62,29,33
Maxekaxe,sylvanas,1334,druid,restoration,113,59,54
Mangy,xavius,1334,druid,restoration,161,83,78
Rockyfella,alexstrasza,1334,druid,restoration,55,27,28
Cdurdroød,culte-de-la-rive-noire,1334,druid,restoration,117,56,61
Shifthappénz,draenor,1334,druid,restoration,60,28,32
Mojorising,drakthul,1333,druid,restoration,36,21,15
Мехнакиске,howling-fjord,1333,druid,restoration,95,51,44
Weregoon,blackmoore,1333,druid,restoration,300,149,151
Tormentedlol,outland,1333,druid,restoration,30,14,16
Dortalon,outland,1333,druid,restoration,132,61,71
Béstfriend,uldum,1333,druid,restoration,34,15,19
Likh,das-konsortium,1332,druid,restoration,24,14,10
Phebzdrood,archimonde,1332,druid,restoration,63,34,29
Хекзкор,ashenvale,1332,druid,restoration,60,30,30
Ekaterina,dun-morogh,1331,druid,restoration,99,54,45
Forzendl,twisting-nether,1331,druid,restoration,89,46,43
Emodruid,sunstrider,1330,druid,restoration,24,14,10
Trä,zenedar,1330,druid,restoration,91,50,41
Séifér,auchindoun,1330,druid,restoration,56,28,28
Druidorie,ravencrest,1330,druid,restoration,48,24,24
Whatismeld,outland,1330,druid,restoration,42,14,28
Тчаёк,gordunni,1329,druid,restoration,56,32,24
Belangy,exodar,1329,druid,restoration,36,17,19
Cønvoke,kazzak,1329,druid,restoration,54,23,31
Cazzette,grim-batol,1328,druid,restoration,85,52,33
Thornat,chamber-of-aspects,1328,druid,restoration,130,70,60
Søykañ,hyjal,1327,druid,restoration,128,65,63
Ивантяй,gordunni,1327,druid,restoration,245,119,126
Versatil,uldum,1327,druid,restoration,65,28,37
Blomberg,burning-legion,1326,druid,restoration,96,52,44
Kramit,ravencrest,1326,druid,restoration,54,26,28
Hidras,tarren-mill,1326,druid,restoration,48,21,27
Norkenis,neptulon,1324,druid,restoration,79,40,39
Bennydruid,kazzak,1324,druid,restoration,144,64,80
Teengirl,blackmoore,1323,druid,restoration,30,14,16
Армсдру,gordunni,1322,druid,restoration,48,23,25
Huebbi,blackmoore,1322,druid,restoration,36,14,22
Hazuki,echsenkessel,1321,druid,restoration,18,14,4
Kattbjörnen,ragnaros,1321,druid,restoration,254,134,120
Meowsovs,draenor,1321,druid,restoration,66,28,38
Нортикус,soulflayer,1320,druid,restoration,59,27,32
Alune,chogall,1320,druid,restoration,64,29,35
Kreuger,the-maelstrom,1320,druid,restoration,53,23,30
Akifumi,archimonde,1320,druid,restoration,58,19,39
Koemarkt,sunstrider,1319,druid,restoration,46,29,17
Endoplazmik,silvermoon,1319,druid,restoration,61,36,25
Gvairon,silvermoon,1319,druid,restoration,102,42,60
Jmaz,outland,1318,druid,restoration,132,67,65
Esmerito,tarren-mill,1318,druid,restoration,36,17,19
Coineagan,frostmourne,1318,druid,restoration,48,14,34
Subslut,ravencrest,1317,druid,restoration,30,19,11
Eô,antonidas,1317,druid,restoration,87,46,41
Berkalicious,frostmane,1317,druid,restoration,41,21,20
Крайсонг,soulflayer,1316,druid,restoration,42,21,21
Skiplegdays,aegwynn,1316,druid,restoration,30,14,16
Aolynk,twisting-nether,1316,druid,restoration,41,17,24
Funkagenda,silvermoon,1315,druid,restoration,42,24,18
Hypnosoad,outland,1315,druid,restoration,452,230,222
Hrustek,tarren-mill,1315,druid,restoration,54,25,29
Zappydudu,tarren-mill,1314,druid,restoration,42,24,18
Nizkul,dun-modr,1314,druid,restoration,164,81,83
Тое,soulflayer,1314,druid,restoration,102,49,53
Schrödínger,culte-de-la-rive-noire,1314,druid,restoration,54,24,30
Delarion,nemesis,1312,druid,restoration,77,44,33
Leakybuttxx,kilrogg,1312,druid,restoration,28,15,13
Kladdkaka,earthen-ring,1312,druid,restoration,42,22,20
Bhorumir,colinas-pardas,1310,druid,restoration,115,58,57
Wusor,blackhand,1309,druid,restoration,59,36,23
Scra,anubarak,1309,druid,restoration,246,120,126
Noxlunaire,ravencrest,1309,druid,restoration,100,46,54
Taylorshîft,burning-legion,1309,druid,restoration,42,15,27
Blacksagex,dragonmaw,1308,druid,restoration,47,15,32
Shelby,tirion,1307,druid,restoration,195,100,95
Closér,stormscale,1307,druid,restoration,60,30,30
Druids,blackhand,1307,druid,restoration,36,15,21
Disclaimed,twisting-nether,1307,druid,restoration,36,15,21
Digestivebis,defias-brotherhood,1306,druid,restoration,192,110,82
Айшиш,gordunni,1306,druid,restoration,36,18,18
Devdude,blackrock,1306,druid,restoration,143,66,77
Cultivatedz,twisting-nether,1306,druid,restoration,54,24,30
Harei,archimonde,1305,druid,restoration,52,24,28
Feyzboom,ysondre,1304,druid,restoration,47,23,24
Mommymìlkers,archimonde,1302,druid,restoration,36,14,22
Boomayé,archimonde,1301,druid,restoration,56,34,22
Zeportheal,archimonde,1301,druid,restoration,50,26,24
Mindru,sylvanas,1301,druid,restoration,93,40,53
Bk,chamber-of-aspects,1300,druid,restoration,36,21,15
ßløøm,outland,1300,druid,restoration,104,59,45
Bekkjin,todeswache,1300,druid,restoration,60,30,30
Løùise,nemesis,1300,druid,restoration,84,32,52
Килаф,gordunni,1299,druid,restoration,106,54,52
Hotsexpress,aegwynn,1299,druid,restoration,75,31,44
Krayzz,tarren-mill,1299,druid,restoration,40,14,26
Tigroufou,kaelthas,1298,druid,restoration,24,15,9
Autoritär,gilneas,1298,druid,restoration,359,182,177
Mchots,ragnaros,1298,druid,restoration,149,71,78
Entja,outland,1298,druid,restoration,61,26,35
Druchori,eredar,1297,druid,restoration,67,33,34
Тремакулан,gordunni,1296,druid,restoration,42,24,18
Memento,kazzak,1296,druid,restoration,48,24,24
Ekologiskxx,outland,1296,druid,restoration,85,40,45
Pølymorphe,ysondre,1296,druid,restoration,78,28,50
Cernacc,silvermoon,1295,druid,restoration,23,14,9
Wannabanhere,outland,1295,druid,restoration,41,16,25
Geeorge,stormscale,1294,druid,restoration,54,28,26
Delmond,sylvanas,1294,druid,restoration,296,150,146
Bronox,ragnaros,1294,druid,restoration,77,34,43
Atsumåsterx,archimonde,1294,druid,restoration,46,19,27
Benzimaax,ragnaros,1293,druid,restoration,72,36,36
Ningannel,argent-dawn,1293,druid,restoration,107,50,57
Ponytheone,burning-legion,1293,druid,restoration,54,21,33
Nîppe,ravencrest,1293,druid,restoration,42,15,27
Ryletha,argent-dawn,1292,druid,restoration,224,111,113
Brocosifredo,hyjal,1292,druid,restoration,72,35,37
Nøbødy,silvermoon,1292,druid,restoration,47,19,28
Papjin,blackhand,1291,druid,restoration,89,46,43
Hordzee,blackmoore,1291,druid,restoration,292,144,148
Elainia,emerald-dream,1291,druid,restoration,85,32,53
Sveoris,malganis,1290,druid,restoration,36,23,13
Nightelvejkm,dun-modr,1290,druid,restoration,42,17,25
Alberthotz,silvermoon,1290,druid,restoration,42,14,28
Flum,darksorrow,1289,druid,restoration,149,77,72
Midnightowl,stormscale,1287,druid,restoration,76,40,36
Eyetea,terokkar,1286,druid,restoration,121,64,57
Julss,archimonde,1286,druid,restoration,184,91,93
Dudujoker,aggra-português,1286,druid,restoration,45,17,28
Vurgyl,hyjal,1284,druid,restoration,139,83,56
Tarîx,aegwynn,1284,druid,restoration,104,61,43
Kattig,grim-batol,1284,druid,restoration,44,21,23
Seikoo,defias-brotherhood,1284,druid,restoration,91,41,50
Yeats,blackmoore,1283,druid,restoration,48,20,28
Talyfox,outland,1282,druid,restoration,142,70,72
Exoar,ravencrest,1282,druid,restoration,115,53,62
Warami,eredar,1282,druid,restoration,113,47,66
Lil,elune,1282,druid,restoration,55,22,33
Paawz,stormscale,1281,druid,restoration,65,33,32
Siako,sanguino,1281,druid,restoration,113,54,59
Vulcäin,ysondre,1281,druid,restoration,36,15,21
Manuka,argent-dawn,1280,druid,restoration,94,50,44
Урька,blackscar,1280,druid,restoration,93,43,50
Khalec,silvermoon,1279,druid,restoration,103,55,48
Silvyan,silvermoon,1278,druid,restoration,75,37,38
Malbo,archimonde,1277,druid,restoration,64,26,38
Cubalitis,tarren-mill,1276,druid,restoration,39,24,15
Zaratras,arathor,1276,druid,restoration,79,39,40
Naturberserk,tarren-mill,1276,druid,restoration,75,36,39
Bakara,arthas,1276,druid,restoration,36,15,21
Rrayed,kazzak,1274,druid,restoration,94,47,47
Yazari,nathrezim,1274,druid,restoration,78,38,40
Yeroso,burning-legion,1273,druid,restoration,30,16,14
Gyvunas,silvermoon,1272,druid,restoration,157,91,66
Trõn,draenor,1272,druid,restoration,164,95,69
Sânká,ysondre,1272,druid,restoration,48,24,24
Telaroxx,die-nachtwache,1272,druid,restoration,78,34,44
Desuslol,stormscale,1272,druid,restoration,65,28,37
Primdâhl,ravencrest,1271,druid,restoration,32,17,15
Neri,shattered-hand,1271,druid,restoration,73,37,36
Valoryon,outland,1271,druid,restoration,36,18,18
Rêdx,archimonde,1271,druid,restoration,30,14,16
Ischumekcid,anubarak,1270,druid,restoration,36,19,17
Rabacki,blackmoore,1270,druid,restoration,168,77,91
Steuerung,twisting-nether,1269,druid,restoration,83,28,55
Bloomer,stormreaver,1268,druid,restoration,110,56,54
Spacenoub,archimonde,1268,druid,restoration,72,35,37
Paddyv,earthen-ring,1268,druid,restoration,33,16,17
Belucky,outland,1268,druid,restoration,67,32,35
Hót,ravencrest,1268,druid,restoration,60,27,33
Walexx,kazzak,1266,druid,restoration,44,25,19
Nitro,kazzak,1266,druid,restoration,74,40,34
Nalreaa,kazzak,1265,druid,restoration,48,27,21
Lalon,blackrock,1265,druid,restoration,48,24,24
Elainx,thrall,1264,druid,restoration,30,16,14
Badbeliø,hyjal,1264,druid,restoration,105,39,66
Дюссельдорф,blackscar,1263,druid,restoration,30,19,11
Sarkophag,blackrock,1263,druid,restoration,53,30,23
Wazam,kazzak,1262,druid,restoration,208,105,103
Blazoor,frostwolf,1262,druid,restoration,91,45,46
Обейрин,gordunni,1261,druid,restoration,78,40,38
Fåtå,archimonde,1261,druid,restoration,101,41,60
Svass,ragnaros,1260,druid,restoration,44,27,17
Балаклаваа,soulflayer,1260,druid,restoration,36,20,16
Lathariuss,frostwhisper,1260,druid,restoration,80,37,43
Tsunami,ragnaros,1259,druid,restoration,54,29,25
Mv,gorgonnash,1259,druid,restoration,136,69,67
Zfaf,hyjal,1259,druid,restoration,78,37,41
Buitonix,khaz-modan,1258,druid,restoration,357,180,177
Дудумейстер,howling-fjord,1257,druid,restoration,263,124,139
Пивч,soulflayer,1256,druid,restoration,111,57,54
Driftmaster,defias-brotherhood,1256,druid,restoration,36,17,19
Ubbeleg,kazzak,1255,druid,restoration,86,48,38
Karodoom,twisting-nether,1254,druid,restoration,86,44,42
Mexymeøw,ragnaros,1254,druid,restoration,141,70,71
Drooddude,blackhand,1254,druid,restoration,48,22,26
Närthex,kazzak,1253,druid,restoration,24,14,10
Zelíx,bronzebeard,1253,druid,restoration,113,64,49
Jyggz,azshara,1253,druid,restoration,45,25,20
Лилкрип,soulflayer,1253,druid,restoration,30,15,15
Márron,blackhand,1252,druid,restoration,34,20,14
Amberleaff,auchindoun,1252,druid,restoration,49,28,21
Yazzle,draenor,1252,druid,restoration,72,36,36
Avimoo,tarren-mill,1252,druid,restoration,56,27,29
Mealann,drakthul,1251,druid,restoration,50,17,33
Morfer,grim-batol,1250,druid,restoration,265,135,130
Ryuzu,aegwynn,1249,druid,restoration,36,17,19
Waldwächter,eredar,1248,druid,restoration,18,13,5
Shaize,dalaran,1248,druid,restoration,30,16,14
Monstret,dragonblight,1248,druid,restoration,113,53,60
Suunto,blackrock,1248,druid,restoration,48,21,27
Phatbushy,silvermoon,1248,druid,restoration,75,32,43
Hælìñgtøúçh,ysondre,1248,druid,restoration,42,14,28
Ownglow,sylvanas,1247,druid,restoration,18,13,5
Deltsur,stormscale,1247,druid,restoration,35,17,18
Racadruid,antonidas,1247,druid,restoration,66,31,35
Lucael,blackmoore,1247,druid,restoration,104,47,57
Jaesax,twisting-nether,1247,druid,restoration,30,13,17
Feralcompat,aszune,1247,druid,restoration,36,13,23
Djgírlßøssqt,argent-dawn,1246,druid,restoration,24,13,11
Shegal,uldum,1246,druid,restoration,30,13,17
Gøpreña,silvermoon,1246,druid,restoration,30,13,17
Jenelin,silvermoon,1246,druid,restoration,42,16,26
Xomeboci,draenor,1246,druid,restoration,42,14,28
Ghostbustér,emeriss,1244,druid,restoration,371,195,176
Varriant,kazzak,1243,druid,restoration,131,60,71
Erdnuckèl,antonidas,1242,druid,restoration,33,21,12
Robutt,runetotem,1242,druid,restoration,40,25,15
Acwi,dun-morogh,1242,druid,restoration,90,46,44
Moundîr,archimonde,1242,druid,restoration,142,69,73
Autisticdog,aegwynn,1242,druid,restoration,30,13,17
Ghostpanther,outland,1241,druid,restoration,30,17,13
Theeix,silvermoon,1241,druid,restoration,202,99,103
Dridoxx,archimonde,1241,druid,restoration,90,39,51
Merceý,ravencrest,1241,druid,restoration,34,14,20
Хаширожизни,gordunni,1241,druid,restoration,66,25,41
Namenloser,azshara,1240,druid,restoration,99,55,44
Leliaen,sylvanas,1240,druid,restoration,135,68,67
Tosuncan,twisting-nether,1240,druid,restoration,54,24,30
Shapéshifter,argent-dawn,1240,druid,restoration,76,25,51
Jiujiteiro,tarren-mill,1239,druid,restoration,89,51,38
Piggo,tarren-mill,1239,druid,restoration,24,13,11
Вертуос,soulflayer,1238,druid,restoration,93,47,46
Бульбион,gordunni,1238,druid,restoration,376,189,187
Кэлиборн,gordunni,1238,druid,restoration,113,55,58
Громозилка,soulflayer,1238,druid,restoration,36,17,19
ßlackßåmßå,zuljin,1238,druid,restoration,53,24,29
Speegle,kazzak,1237,druid,restoration,24,13,11
Pròxy,hyjal,1237,druid,restoration,91,38,53
Sprössling,blackmoore,1236,druid,restoration,41,22,19
Arulol,aegwynn,1236,druid,restoration,102,48,54
Happyhoter,blackrock,1235,druid,restoration,71,35,36
Zladium,laughing-skull,1235,druid,restoration,42,13,29
Applestrudle,blackrock,1234,druid,restoration,24,15,9
Holziger,azshara,1234,druid,restoration,30,14,16
Gotyoufam,tarren-mill,1234,druid,restoration,74,32,42
Инский,howling-fjord,1233,druid,restoration,120,66,54
Adiycrazy,outland,1233,druid,restoration,114,56,58
Тырубльдуде,gordunni,1233,druid,restoration,96,45,51
Ømégäìnfëctz,argent-dawn,1233,druid,restoration,36,13,23
Shapeshiptur,argent-dawn,1232,druid,restoration,30,13,17
Arazorwyn,ravencrest,1231,druid,restoration,125,70,55
Kantêzu,thrall,1231,druid,restoration,33,16,17
Thatzdmg,blackmoore,1230,druid,restoration,24,13,11
Dreaddot,archimonde,1230,druid,restoration,30,15,15
Weihrauch,azshara,1230,druid,restoration,65,31,34
Druiddingo,lightnings-blade,1230,druid,restoration,80,38,42
Weremyst,outland,1230,druid,restoration,44,15,29
Корнерит,gordunni,1229,druid,restoration,82,43,39
Bonza,agamaggan,1229,druid,restoration,107,52,55
Nimbrestor,silvermoon,1229,druid,restoration,40,13,27
Octul,magtheridon,1228,druid,restoration,42,25,17
Saimdude,blackrock,1228,druid,restoration,66,38,28
Cemiink,drakthul,1228,druid,restoration,188,97,91
Азазиона,gordunni,1227,druid,restoration,107,47,60
Rumbusxx,dun-modr,1227,druid,restoration,30,13,17
Pomjo,archimonde,1227,druid,restoration,36,13,23
Kirïllx,silvermoon,1226,druid,restoration,135,76,59
Vanlise,ravencrest,1226,druid,restoration,126,64,62
Eko,auchindoun,1226,druid,restoration,291,144,147
Tadag,defias-brotherhood,1226,druid,restoration,81,40,41
Thieane,blackhand,1226,druid,restoration,71,35,36
Reiss,tarren-mill,1226,druid,restoration,182,85,97
Solstrale,ravencrest,1226,druid,restoration,144,67,77
Урголяфа,gordunni,1226,druid,restoration,36,15,21
Walenok,thrall,1225,druid,restoration,310,153,157
Ridania,ravenholdt,1225,druid,restoration,150,65,85
Spidete,sanguino,1224,druid,restoration,214,116,98
Драконы,blackscar,1224,druid,restoration,35,13,22
Krizak,eredar,1223,druid,restoration,251,130,121
Ромамаваши,soulflayer,1223,druid,restoration,99,47,52
Tskilli,draenor,1223,druid,restoration,60,28,32
Heidepaa,tichondrius,1222,druid,restoration,36,18,18
Chiendetalus,ysondre,1221,druid,restoration,35,18,17
Chicobullz,ysondre,1220,druid,restoration,24,13,11
Randomhot,antonidas,1220,druid,restoration,91,39,52
Homurá,tarren-mill,1220,druid,restoration,36,13,23
Xadidruîd,blackrock,1219,druid,restoration,72,26,46
Khyalia,ysondre,1218,druid,restoration,39,19,20
Halleyz,hyjal,1217,druid,restoration,150,79,71
Випера,gordunni,1217,druid,restoration,72,36,36
Gotika,blackrock,1217,druid,restoration,65,32,33
Madshad,draenor,1217,druid,restoration,73,29,44
Charliebaum,antonidas,1216,druid,restoration,105,46,59
Remewal,ravencrest,1215,druid,restoration,24,13,11
Sÿlph,sylvanas,1215,druid,restoration,213,107,106
ßïgßúll,twisting-nether,1215,druid,restoration,31,15,16
Horkz,frostmourne,1215,druid,restoration,40,19,21
Пупсики,gordunni,1215,druid,restoration,92,43,49
Raïby,archimonde,1215,druid,restoration,58,27,31
Дружез,soulflayer,1214,druid,restoration,70,36,34
Tsuteymanga,veknilash,1214,druid,restoration,120,59,61
Maryz,varimathras,1214,druid,restoration,54,21,33
Røsary,stormscale,1213,druid,restoration,117,63,54
Adawehi,ravencrest,1213,druid,restoration,278,134,144
Wtfck,outland,1213,druid,restoration,126,60,66
Kasjuz,tarren-mill,1212,druid,restoration,84,50,34
Triskelion,burning-legion,1212,druid,restoration,34,16,18
Herbiko,turalyon,1211,druid,restoration,387,198,189
Mochiløxz,tarren-mill,1211,druid,restoration,281,143,138
Дазашо,soulflayer,1211,druid,restoration,511,251,260
Иксвовски,gordunni,1211,druid,restoration,28,13,15
Ruberg,kazzak,1210,druid,restoration,51,26,25
Shylanna,ragnaros,1210,druid,restoration,114,55,59
Wyngx,blackrock,1209,druid,restoration,127,72,55
Séyla,blackrock,1209,druid,restoration,24,13,11
Unionpivo,doomhammer,1209,druid,restoration,126,64,62
Microw,ghostlands,1209,druid,restoration,141,69,72
Alenemor,frostmane,1209,druid,restoration,42,20,22
Weiden,twisting-nether,1209,druid,restoration,80,36,44
Tallu,das-konsortium,1209,druid,restoration,36,13,23
Imaginarý,ravencrest,1209,druid,restoration,45,13,32
Chinoiserie,aszune,1208,druid,restoration,269,136,133
Аммазония,gordunni,1208,druid,restoration,110,55,55
Ghaara,outland,1207,druid,restoration,58,32,26
Mutato,draenor,1207,druid,restoration,251,137,114
Midnightstry,alakir,1207,druid,restoration,345,179,166
Rakúsh,thrall,1207,druid,restoration,124,63,61
Bynxx,antonidas,1207,druid,restoration,208,103,105
Древнина,gordunni,1206,druid,restoration,258,134,124
Kharora,hellfire,1206,druid,restoration,66,29,37
Dèxò,blackmoore,1205,druid,restoration,40,24,16
Elgallonegro,blackrock,1205,druid,restoration,24,14,10
Knææl,argent-dawn,1204,druid,restoration,60,35,25
Soratess,azshara,1204,druid,restoration,81,38,43
Lethius,silvermoon,1204,druid,restoration,140,63,77
Rytmusdudu,ragnaros,1204,druid,restoration,47,19,28
Shenandoah,hyjal,1203,druid,restoration,54,32,22
Spankproof,kazzak,1203,druid,restoration,38,21,17
Varázabab,ragnaros,1203,druid,restoration,70,36,34
Эверих,soulflayer,1203,druid,restoration,71,34,37
Boxofdoom,twisting-nether,1203,druid,restoration,66,29,37
Kunîbert,frostwolf,1203,druid,restoration,74,30,44
Tmsqediboo,silvermoon,1203,druid,restoration,36,13,23
Betelgues,kazzak,1202,druid,restoration,219,120,99
Jugaia,frostmourne,1202,druid,restoration,80,36,44
Ironveins,ravencrest,1201,druid,restoration,66,38,28
Glaskål,draenor,1201,druid,restoration,218,97,121
Berdix,ragnaros,1200,druid,restoration,67,35,32
Meall,blackmoore,1199,druid,restoration,30,20,10
Drøod,kazzak,1199,druid,restoration,23,15,8
Mimisiek,burning-legion,1199,druid,restoration,60,31,29
Roria,neptulon,1199,druid,restoration,84,41,43
Goodzychoo,silvermoon,1199,druid,restoration,36,17,19
Behemothe,dalaran,1198,druid,restoration,24,13,11
Paranoido,eredar,1198,druid,restoration,94,36,58
Karlsn,ravencrest,1197,druid,restoration,25,14,11
Lïs,the-maelstrom,1197,druid,restoration,137,75,62
Venedría,eredar,1196,druid,restoration,72,38,34
Julianbgnoir,archimonde,1196,druid,restoration,49,23,26
Ensanglante,twisting-nether,1196,druid,restoration,81,38,43
Ballosh,hyjal,1196,druid,restoration,48,21,27
Vertymbras,hyjal,1195,druid,restoration,134,73,61
Shadraw,arakarahm,1195,druid,restoration,30,13,17
Släshes,stormreaver,1195,druid,restoration,56,24,32
Mitnik,stormscale,1194,druid,restoration,204,110,94
Papì,magtheridon,1194,druid,restoration,30,14,16
Røxána,thunderhorn,1193,druid,restoration,18,13,5
Димитруа,howling-fjord,1193,druid,restoration,48,27,21
Néilié,tarren-mill,1193,druid,restoration,49,27,22
Tsurío,thrall,1193,druid,restoration,144,78,66
Bearinator,aggramar,1191,druid,restoration,753,388,365
Kattman,tarren-mill,1191,druid,restoration,42,21,21
Juicy,stormreaver,1190,druid,restoration,109,56,53
Коляскальяс,howling-fjord,1190,druid,restoration,154,63,91
Flomaster,stormscale,1190,druid,restoration,36,13,23
Друоид,howling-fjord,1188,druid,restoration,57,26,31
Zwareshag,ravencrest,1188,druid,restoration,56,24,32
Silverdice,thrall,1187,druid,restoration,30,16,14
Fotmrerollér,darksorrow,1187,druid,restoration,164,87,77
Chable,hyjal,1187,druid,restoration,60,31,29
Chæmp,blackmoore,1187,druid,restoration,35,16,19
Proxis,the-maelstrom,1187,druid,restoration,73,31,42
Vícvega,ravencrest,1186,druid,restoration,100,51,49
Lépaw,twisting-nether,1186,druid,restoration,107,51,56
Wiyah,hyjal,1186,druid,restoration,30,14,16
Yamsha,dalaran,1186,druid,restoration,46,14,32
Fettpumpad,karazhan,1185,druid,restoration,157,85,72
Meatboi,burning-legion,1185,druid,restoration,54,28,26
Docdruid,outland,1185,druid,restoration,66,24,42
Fadroo,tarren-mill,1185,druid,restoration,78,26,52
Archbloom,twisting-nether,1185,druid,restoration,42,13,29
Spacebéam,ravencrest,1184,druid,restoration,111,50,61
Quorn,pozzo-delleternità,1184,druid,restoration,42,18,24
Amakary,blackrock,1183,druid,restoration,78,37,41
Exane,ragnaros,1182,druid,restoration,44,26,18
Эмплхибои,gordunni,1182,druid,restoration,36,20,16
Inspira,teldrassil,1182,druid,restoration,24,13,11
Qvadriologic,argent-dawn,1182,druid,restoration,48,20,28
Guiri,los-errantes,1181,druid,restoration,54,24,30
Mchøt,ravencrest,1181,druid,restoration,96,42,54
Fuzzy,the-venture-co,1181,druid,restoration,71,26,45
Benfufu,kazzak,1180,druid,restoration,37,20,17
Scotchnsoda,twisting-nether,1180,druid,restoration,35,17,18
Secondage,blackmoore,1180,druid,restoration,98,45,53
Irrlycht,blackrock,1179,druid,restoration,42,16,26
Cäsïo,khaz-modan,1178,druid,restoration,92,53,39
Alarìy,ravencrest,1178,druid,restoration,36,15,21
Gargara,sanguino,1177,druid,restoration,35,13,22
Forestranger,outland,1176,druid,restoration,24,13,11
Shawtyx,argent-dawn,1176,druid,restoration,104,42,62
Tílac,eredar,1174,druid,restoration,23,14,9
Hílarío,sanguino,1174,druid,restoration,38,13,25
Tani,kazzak,1173,druid,restoration,28,17,11
Mirana,drakthul,1173,druid,restoration,75,44,31
Dreäms,ravencrest,1173,druid,restoration,326,170,156
Quiksx,blackrock,1173,druid,restoration,84,42,42
Noballz,blackhand,1173,druid,restoration,38,13,25
Skeexd,argent-dawn,1172,druid,restoration,130,55,75
Skuhlxz,thrall,1172,druid,restoration,108,42,66
Ðelnôs,destromath,1170,druid,restoration,84,39,45
Testoration,twisting-nether,1170,druid,restoration,36,13,23
Bonsai,terrordar,1169,druid,restoration,55,25,30
Dobbmaster,aegwynn,1168,druid,restoration,256,128,128
Simplydrood,archimonde,1168,druid,restoration,57,20,37
Xdrus,argent-dawn,1167,druid,restoration,98,50,48
Balanc,ragnaros,1167,druid,restoration,53,25,28
Yenwe,kazzak,1166,druid,restoration,219,111,108
Rippertimmie,draenor,1166,druid,restoration,53,25,28
Karakarrtaal,silvermoon,1165,druid,restoration,60,31,29
Collîî,aegwynn,1165,druid,restoration,98,50,48
Vickepicke,stormreaver,1165,druid,restoration,110,46,64
Ruhlide,anetheron,1165,druid,restoration,59,22,37
Денчикбратиш,soulflayer,1165,druid,restoration,54,19,35
Bbc,elune,1164,druid,restoration,88,51,37
Fluffypaws,auchindoun,1163,druid,restoration,107,55,52
Callìa,sylvanas,1163,druid,restoration,142,66,76
Huayhey,the-maelstrom,1162,druid,restoration,82,45,37
Tyzme,blackrock,1162,druid,restoration,30,14,16
Amoreah,silvermoon,1162,druid,restoration,172,71,101
Forzend,twisting-nether,1161,druid,restoration,20,13,7
Фотинайдер,blackscar,1161,druid,restoration,48,23,25
Shifts,aggramar,1161,druid,restoration,60,27,33
Hallibell,frostmane,1160,druid,restoration,30,13,17
Daarty,tarren-mill,1159,druid,restoration,36,14,22
Crep,krasus,1158,druid,restoration,83,44,39
Жолудь,gordunni,1158,druid,restoration,211,105,106
Ankhenature,outland,1156,druid,restoration,112,64,48
Plethi,antonidas,1156,druid,restoration,48,19,29
Zêrg,ysondre,1155,druid,restoration,48,21,27
Farodiin,blackmoore,1154,druid,restoration,217,109,108
Drix,frostwolf,1154,druid,restoration,51,23,28
Corias,blackmoore,1154,druid,restoration,42,14,28
Nivcat,kazzak,1152,druid,restoration,24,12,12
Лайфдруид,blackscar,1152,druid,restoration,101,44,57
Sllatkica,draenor,1152,druid,restoration,63,27,36
Pikkusuhnu,twisting-nether,1152,druid,restoration,30,12,18
Ÿdrassia,archimonde,1152,druid,restoration,44,17,27
Gøash,aegwynn,1151,druid,restoration,18,12,6
Sturehoof,ravencrest,1151,druid,restoration,18,12,6
Ковамедведь,borean-tundra,1151,druid,restoration,65,27,38
Hotop,draenor,1151,druid,restoration,30,12,18
Sykebiceps,the-maelstrom,1150,druid,restoration,24,12,12
Dreathqt,twisting-nether,1150,druid,restoration,24,12,12
Bloomitizé,ravencrest,1150,druid,restoration,24,12,12
Chocofrijj,tarren-mill,1150,druid,restoration,30,12,18
Rufío,ravencrest,1150,druid,restoration,67,24,43
Ушастикэ,gordunni,1149,druid,restoration,84,53,31
Deé,nozdormu,1149,druid,restoration,52,26,26
Eñzo,stormscale,1149,druid,restoration,30,12,18
Druidtar,burning-steppes,1148,druid,restoration,24,12,12
Vioboomie,blackrock,1148,druid,restoration,36,17,19
Burattino,draenor,1147,druid,restoration,12,12,0
Restopesto,silvermoon,1147,druid,restoration,44,24,20
Pzyhlol,anetheron,1147,druid,restoration,51,26,25
Lisovamavka,draenor,1147,druid,restoration,181,92,89
Haarbál,tarren-mill,1147,druid,restoration,30,15,15
Kooglaash,kazzak,1147,druid,restoration,189,89,100
Reâlity,todeswache,1147,druid,restoration,30,13,17
Eluñeãdore,silvermoon,1146,druid,restoration,41,26,15
Mykk,ravencrest,1146,druid,restoration,33,19,14
Kaburax,blackrock,1146,druid,restoration,28,14,14
Meowmf,silvermoon,1146,druid,restoration,30,12,18
Nubsi,aegwynn,1146,druid,restoration,30,12,18
Ankhar,auchindoun,1145,druid,restoration,35,17,18
Vacaleiteira,aggra-português,1145,druid,restoration,30,12,18
Djungelgrabb,twisting-nether,1144,druid,restoration,93,47,46
Mikshak,drakthul,1144,druid,restoration,24,12,12
Vaacku,stormreaver,1144,druid,restoration,24,12,12
Golddy,hyjal,1144,druid,restoration,140,66,74
Shapeshafter,twisting-nether,1144,druid,restoration,179,84,95
Enzymex,burning-blade,1144,druid,restoration,42,19,23
Knocowt,ragnaros,1143,druid,restoration,45,18,27
Hirodompa,archimonde,1143,druid,restoration,30,12,18
Busenlilli,kelthuzad,1142,druid,restoration,18,12,6
Mcneil,wrathbringer,1142,druid,restoration,49,26,23
Ayehotx,ragnaros,1142,druid,restoration,89,43,46
Trànsformer,nemesis,1142,druid,restoration,30,12,18
Elleanarr,hyjal,1141,druid,restoration,94,52,42
Zikloe,arathor,1141,druid,restoration,24,12,12
Eithnne,ravencrest,1141,druid,restoration,27,13,14
Ajwen,tarren-mill,1141,druid,restoration,30,12,18
Mayte,ragnaros,1140,druid,restoration,44,26,18
Pwníca,aegwynn,1140,druid,restoration,30,12,18
Relxc,outland,1139,druid,restoration,39,24,15
Baineaordur,krasus,1139,druid,restoration,54,27,27
Longhornjohn,ragnaros,1139,druid,restoration,24,12,12
Nightfáll,tarren-mill,1139,druid,restoration,88,39,49
Сваткумбрат,eversong,1139,druid,restoration,161,69,92
Шинедрелл,gordunni,1138,druid,restoration,48,16,32
Fanboij,kazzak,1137,druid,restoration,30,12,18
Rìften,stormscale,1137,druid,restoration,52,20,32
Фонш,soulflayer,1136,druid,restoration,24,12,12
Symba,uldum,1136,druid,restoration,24,12,12
Hristiana,outland,1135,druid,restoration,24,12,12
Csmeferal,blackrock,1134,druid,restoration,35,22,13
Оррех,howling-fjord,1134,druid,restoration,35,12,23
Ganoförd,zuljin,1133,druid,restoration,25,15,10
Catbear,kazzak,1132,druid,restoration,402,209,193
Ymgrawl,zuljin,1132,druid,restoration,42,18,24
Luneriá,blackmoore,1132,druid,restoration,48,16,32
Oushen,silvermoon,1131,druid,restoration,58,23,35
Scuta,sylvanas,1131,druid,restoration,36,12,24
Bioházard,blackrock,1130,druid,restoration,36,20,16
Feroxe,kazzak,1130,druid,restoration,24,12,12
Thunderzeus,mazrigos,1129,druid,restoration,40,20,20
Mushröøms,nemesis,1128,druid,restoration,18,16,2
Imoen,hyjal,1128,druid,restoration,132,59,73
Elysiá,twisting-nether,1128,druid,restoration,66,27,39
Pinkpanda,arthas,1128,druid,restoration,30,12,18
Sâty,draenor,1128,druid,restoration,60,22,38
Стенлимур,eversong,1127,druid,restoration,120,57,63
Lailaqt,arthas,1127,druid,restoration,87,41,46
Druibe,burning-legion,1127,druid,restoration,56,23,33
Kelbim,draenor,1126,druid,restoration,107,49,58
Fricky,burning-blade,1125,druid,restoration,100,53,47
Kbåkå,ravencrest,1125,druid,restoration,42,19,23
Helpwss,outland,1125,druid,restoration,30,12,18
Sorahe,arthas,1124,druid,restoration,32,17,15
Jelouda,cthun,1124,druid,restoration,28,14,14
Сицилиец,galakrond,1124,druid,restoration,24,12,12
Vâkkrï,archimonde,1124,druid,restoration,54,16,38
Ilovealex,blackmoore,1123,druid,restoration,119,64,55
Enggetsu,drakthul,1123,druid,restoration,90,40,50
Curoahojas,silvermoon,1123,druid,restoration,135,58,77
Yngboii,twisting-nether,1123,druid,restoration,30,12,18
Papanik,tarren-mill,1122,druid,restoration,140,70,70
Orten,dun-modr,1122,druid,restoration,114,53,61
Dancingrain,ravencrest,1122,druid,restoration,30,13,17
Vextron,burning-legion,1121,druid,restoration,70,38,32
Îcetiger,elune,1121,druid,restoration,64,32,32
Акетчи,howling-fjord,1120,druid,restoration,26,14,12
Vranz,draenor,1120,druid,restoration,67,32,35
Psitol,silvermoon,1120,druid,restoration,30,12,18
Nightshíft,onyxia,1120,druid,restoration,58,18,40
Flintý,ravencrest,1119,druid,restoration,16,13,3
Аелин,blackscar,1119,druid,restoration,22,15,7
Kobrá,ravencrest,1119,druid,restoration,20,13,7
Thornstar,sylvanas,1119,druid,restoration,102,52,50
Raysa,archimonde,1119,druid,restoration,69,35,34
Kkriss,stormscale,1118,druid,restoration,81,46,35
Phandris,argent-dawn,1118,druid,restoration,96,54,42
Thaibarian,shattered-hand,1118,druid,restoration,99,52,47
Subu,drakthul,1118,druid,restoration,36,12,24
Flandersdru,ravencrest,1117,druid,restoration,23,12,11
Kikinho,argent-dawn,1117,druid,restoration,24,12,12
Whiskers,emerald-dream,1117,druid,restoration,66,27,39
Хрик,howling-fjord,1116,druid,restoration,56,28,28
Zillo,stormscale,1116,druid,restoration,92,41,51
Bubadruid,silvermoon,1116,druid,restoration,37,14,23
Celendiil,argent-dawn,1115,druid,restoration,103,30,73
Brooklynzoo,ravencrest,1114,druid,restoration,22,13,9
Багетлюбви,howling-fjord,1114,druid,restoration,86,37,49
Cigamt,kazzak,1113,druid,restoration,27,16,11
Ndnd,drakthul,1112,druid,restoration,82,42,40
Ênfaktüs,silvermoon,1112,druid,restoration,41,15,26
Лаегмерил,gordunni,1111,druid,restoration,64,35,29
Rootmoschner,blackmoore,1111,druid,restoration,167,81,86
Mayhh,ragnaros,1111,druid,restoration,90,41,49
Legharta,ravencrest,1111,druid,restoration,84,31,53
Deboiteurr,archimonde,1111,druid,restoration,42,15,27
Ðrake,eredar,1110,druid,restoration,48,23,25
Uvøgin,ragnaros,1109,druid,restoration,18,12,6
Dudupwwer,frostwolf,1109,druid,restoration,77,29,48
Papa,sylvanas,1108,druid,restoration,28,14,14
Räysa,archimonde,1108,druid,restoration,216,107,109
Димсн,gordunni,1107,druid,restoration,30,12,18
Zauräk,ysondre,1106,druid,restoration,24,14,10
Arfedan,kazzak,1106,druid,restoration,66,35,31
Klerosa,moonglade,1105,druid,restoration,56,24,32
Фераст,azuregos,1104,druid,restoration,54,25,29
Tyraloll,ghostlands,1104,druid,restoration,54,23,31
Аматэррасу,blackscar,1102,druid,restoration,66,34,32
Lutzmiller,eredar,1099,druid,restoration,514,252,262
Arear,frostmane,1098,druid,restoration,109,47,62
Croassant,archimonde,1097,druid,restoration,44,24,20
Xenva,blackmoore,1097,druid,restoration,66,32,34
Wolfeiy,ravenholdt,1096,druid,restoration,175,99,76
Leafy,sanguino,1096,druid,restoration,132,71,61
Petitchät,archimonde,1096,druid,restoration,82,42,40
Hotmenow,antonidas,1095,druid,restoration,17,12,5
Chidorî,twisting-nether,1095,druid,restoration,41,18,23
Surinox,blackrock,1094,druid,restoration,83,48,35
Theguyandbea,draenor,1094,druid,restoration,294,142,152
Snowrk,hyjal,1093,druid,restoration,54,31,23
Irondruid,silvermoon,1093,druid,restoration,301,150,151
Nissemand,ravencrest,1093,druid,restoration,90,42,48
Åfk,ravencrest,1093,druid,restoration,35,14,21
Tharandrél,argent-dawn,1092,druid,restoration,72,20,52
Тианна,razuvious,1091,druid,restoration,48,24,24
Auspicer,moonglade,1090,druid,restoration,58,29,29
Ultrassick,kazzak,1090,druid,restoration,45,21,24
Hotouck,hyjal,1089,druid,restoration,38,22,16
Simouch,archimonde,1089,druid,restoration,381,194,187
Wrak,eonar,1089,druid,restoration,24,12,12
Дремлин,deathguard,1089,druid,restoration,230,110,120
Zagrem,antonidas,1088,druid,restoration,28,13,15
Worxor,hyjal,1087,druid,restoration,24,14,10
Ruetinjeri,blackmoore,1087,druid,restoration,30,14,16
Taatz,stormscale,1087,druid,restoration,85,33,52
Neyribi,blackhand,1087,druid,restoration,47,13,34
Relache,twisting-nether,1085,druid,restoration,81,42,39
Alexstraza,arthas,1085,druid,restoration,49,23,26
Escortdruid,blackmoore,1085,druid,restoration,94,40,54
Жекабиг,soulflayer,1084,druid,restoration,103,54,49
Fapmasterx,eredar,1084,druid,restoration,35,12,23
Draneis,les-sentinelles,1083,druid,restoration,117,69,48
Nyooxix,blackmoore,1082,druid,restoration,54,22,32
Sainthree,dalaran,1080,druid,restoration,36,15,21
Jimmorris,eredar,1079,druid,restoration,60,30,30
Làzerðjings,archimonde,1079,druid,restoration,30,12,18
Jøos,hyjal,1078,druid,restoration,24,12,12
Thaldrenaar,argent-dawn,1078,druid,restoration,74,28,46
Gibx,ravencrest,1077,druid,restoration,62,33,29
Trikill,hyjal,1077,druid,restoration,102,51,51
Razmus,lightbringer,1076,druid,restoration,25,13,12
Zarlaac,ravencrest,1075,druid,restoration,84,36,48
Tenbe,outland,1074,druid,restoration,24,12,12
Bigbones,frostwolf,1074,druid,restoration,102,39,63
Bloomly,tarren-mill,1073,druid,restoration,36,18,18
Lynare,argent-dawn,1073,druid,restoration,36,16,20
Makelsi,tarren-mill,1073,druid,restoration,91,40,51
Druidathor,uldum,1072,druid,restoration,36,22,14
Shäylä,sinstralis,1072,druid,restoration,30,15,15
Zirkuszwei,aegwynn,1072,druid,restoration,151,73,78
Jàgêr,archimonde,1071,druid,restoration,43,12,31
Алунар,lich-king,1070,druid,restoration,84,39,45
Flaah,dalaran,1070,druid,restoration,48,21,27
Nyctala,argent-dawn,1069,druid,restoration,43,16,27
Growiêlle,ravencrest,1068,druid,restoration,77,41,36
Kotkacy,silvermoon,1067,druid,restoration,22,12,10
Kelerun,blackhand,1067,druid,restoration,54,26,28
Domsz,dalaran,1067,druid,restoration,152,73,79
Melcharis,frostwolf,1067,druid,restoration,42,14,28
Januzo,kazzak,1066,druid,restoration,42,16,26
Elanrya,argent-dawn,1066,druid,restoration,53,15,38
Néxct,stormscale,1065,druid,restoration,42,16,26
Nezruslfour,dun-modr,1064,druid,restoration,54,33,21
Киберужас,gordunni,1064,druid,restoration,175,90,85
Kalimdori,antonidas,1064,druid,restoration,24,12,12
Шмору,deathguard,1063,druid,restoration,76,38,38
Medvecica,twisting-nether,1062,druid,restoration,74,25,49
Moonwrath,hyjal,1061,druid,restoration,25,12,13
Inspiredrood,archimonde,1060,druid,restoration,195,104,91
Jambonmaster,archimonde,1060,druid,restoration,118,62,56
Gribix,kazzak,1060,druid,restoration,42,22,20
Maryjuanita,silvermoon,1060,druid,restoration,170,74,96
Xaeerow,archimonde,1060,druid,restoration,30,12,18
Qabusnama,nemesis,1058,druid,restoration,36,20,16
Кишкинахир,razuvious,1058,druid,restoration,66,33,33
Nrathal,doomhammer,1058,druid,restoration,54,18,36
Ölwen,sanguino,1058,druid,restoration,42,14,28
Aliani,trollbane,1058,druid,restoration,50,16,34
Syre,pozzo-delleternità,1057,druid,restoration,18,12,6
Greenhot,kult-der-verdammten,1057,druid,restoration,72,33,39
Ферний,gordunni,1057,druid,restoration,30,13,17
Justforgames,ravencrest,1056,druid,restoration,12,11,1
Degentiuso,alakir,1056,druid,restoration,30,21,9
Målukah,archimonde,1056,druid,restoration,18,11,7
Jagu,blackrock,1056,druid,restoration,49,27,22
Hyperunknown,grim-batol,1056,druid,restoration,156,78,78
Kerelya,argent-dawn,1055,druid,restoration,54,23,31
Арбузир,howling-fjord,1055,druid,restoration,54,21,33
Mooz,kazzak,1055,druid,restoration,66,24,42
Sharlla,burning-legion,1055,druid,restoration,36,11,25
Oschlandor,blackmoore,1054,druid,restoration,12,11,1
Светдру,blackscar,1054,druid,restoration,24,11,13
Luckyhell,silvermoon,1054,druid,restoration,60,27,33
Nariune,argent-dawn,1054,druid,restoration,53,23,30
Lïlja,tarren-mill,1053,druid,restoration,30,16,14
Liquis,outland,1053,druid,restoration,224,111,113
Brennariss,outland,1053,druid,restoration,30,11,19
Noskillx,auchindoun,1052,druid,restoration,12,11,1
Inet,aegwynn,1052,druid,restoration,54,25,29
Boomkïn,draenor,1052,druid,restoration,24,11,13
Kopet,the-maelstrom,1052,druid,restoration,30,11,19
Eriaeda,stormscale,1051,druid,restoration,30,12,18
Иксджа,gordunni,1051,druid,restoration,30,11,19
Higuys,the-maelstrom,1051,druid,restoration,30,11,19
Hâyâbusa,antonidas,1051,druid,restoration,36,12,24
Druidenbeton,antonidas,1050,druid,restoration,24,13,11
Panøràmix,archimonde,1050,druid,restoration,41,12,29
Malleria,blackmoore,1049,druid,restoration,54,26,28
Zka,archimonde,1049,druid,restoration,24,11,13
Tealy,turalyon,1049,druid,restoration,100,44,56
Duduque,twisting-nether,1049,druid,restoration,68,27,41
Tompax,kazzak,1048,druid,restoration,24,11,13
Влажныйдру,soulflayer,1048,druid,restoration,24,11,13
Milkyheals,burning-blade,1048,druid,restoration,24,11,13
Tapex,ravencrest,1048,druid,restoration,27,12,15
Ihone,frostmane,1048,druid,restoration,32,12,20
Toacon,destromath,1047,druid,restoration,30,11,19
Borne,aggra-português,1046,druid,restoration,30,13,17
Strave,azjolnerub,1046,druid,restoration,126,48,78
Blòódý,ravencrest,1045,druid,restoration,25,13,12
Kamikazedk,frostmane,1045,druid,restoration,24,11,13
Santamonica,blackrock,1045,druid,restoration,48,19,29
Shipmaster,ravencrest,1044,druid,restoration,38,16,22
Kaserion,sylvanas,1044,druid,restoration,72,26,46
Ella,kult-der-verdammten,1043,druid,restoration,311,156,155
Омгдру,gordunni,1043,druid,restoration,149,71,78
Aspegic,grim-batol,1043,druid,restoration,48,14,34
Orangee,blackmoore,1042,druid,restoration,150,67,83
Luarbak,kazzak,1041,druid,restoration,18,11,7
Блэкфорест,gordunni,1041,druid,restoration,107,49,58
Elverbak,argent-dawn,1041,druid,restoration,30,11,19
Spoco,defias-brotherhood,1040,druid,restoration,102,56,46
Ранок,fordragon,1040,druid,restoration,24,11,13
Dfjguidfg,baelgun,1040,druid,restoration,36,13,23
Tângo,eredar,1039,druid,restoration,55,28,27
Найадра,gordunni,1039,druid,restoration,24,11,13
Daleen,silvermoon,1038,druid,restoration,24,11,13
Берды,gordunni,1038,druid,restoration,24,11,13
Arenus,argent-dawn,1038,druid,restoration,74,31,43
Хикобай,gordunni,1036,druid,restoration,63,29,34
Theridrax,twisting-nether,1036,druid,restoration,50,22,28
Greyhøund,archimonde,1036,druid,restoration,83,35,48
Fiberpäls,magtheridon,1036,druid,restoration,30,11,19
Maiavin,earthen-ring,1035,druid,restoration,27,17,10
Kezbaniye,silvermoon,1035,druid,restoration,18,11,7
Grówl,kazzak,1035,druid,restoration,39,14,25
Sfarcolacul,tarren-mill,1034,druid,restoration,193,103,90
Pakù,archimonde,1033,druid,restoration,12,11,1
Macanbre,tarren-mill,1033,druid,restoration,162,85,77
Jølinaar,twisting-nether,1033,druid,restoration,104,49,55
Nortii,drakthul,1033,druid,restoration,30,12,18
Scopar,aegwynn,1033,druid,restoration,42,11,31
Avadakodavra,ravencrest,1032,druid,restoration,159,75,84
Socialphobia,draenor,1032,druid,restoration,46,18,28
Feraly,zenedar,1032,druid,restoration,30,11,19
Ilovejager,archimonde,1032,druid,restoration,38,12,26
Murmétoile,chants-éternels,1031,druid,restoration,104,36,68
Прожималодру,deathguard,1030,druid,restoration,102,48,54
Dadud,twisting-nether,1029,druid,restoration,60,29,31
Mendozä,stormscale,1029,druid,restoration,82,38,44
Eldrosile,outland,1029,druid,restoration,120,53,67
Corrupthz,outland,1028,druid,restoration,24,11,13
Cárnagè,stormscale,1028,druid,restoration,116,53,63
Storpboom,drakthul,1028,druid,restoration,31,13,18
Lyyâ,blackrock,1027,druid,restoration,24,11,13
Greenthûmbs,sylvanas,1027,druid,restoration,24,11,13
Drúídárn,talnivarr,1027,druid,restoration,60,27,33
Klørfem,draenor,1027,druid,restoration,36,13,23
Driiptoohard,turalyon,1026,druid,restoration,201,102,99
Davincidru,tarren-mill,1026,druid,restoration,68,32,36
Muffinjump,outland,1026,druid,restoration,30,11,19
Remaxxos,kazzak,1026,druid,restoration,36,11,25
Pelacanyes,dun-modr,1025,druid,restoration,24,11,13
Holykòw,silvermoon,1025,druid,restoration,66,30,36
Ванилане,ashenvale,1023,druid,restoration,116,54,62
Baroona,kazzak,1022,druid,restoration,78,44,34
Luaavin,madmortem,1022,druid,restoration,34,17,17
Ximenia,argent-dawn,1022,druid,restoration,30,15,15
Takuna,nemesis,1022,druid,restoration,30,12,18
Tetödrea,dun-modr,1022,druid,restoration,30,12,18
Karova,alleria,1022,druid,restoration,33,12,21
Æøøm,blackmoore,1021,druid,restoration,18,11,7
Raysien,doomhammer,1021,druid,restoration,24,13,11
Moonshîne,arygos,1021,druid,restoration,120,63,57
Shanikya,argent-dawn,1021,druid,restoration,44,20,24
Elrroir,dun-modr,1021,druid,restoration,34,12,22
Catwalk,azshara,1020,druid,restoration,42,11,31
Nøboorst,ravencrest,1019,druid,restoration,18,11,7
Celegorn,burning-legion,1019,druid,restoration,18,11,7
Yøunsa,medivh,1019,druid,restoration,54,29,25
Slashndasher,frostmane,1017,druid,restoration,24,17,7
Эмканегодяйк,galakrond,1016,druid,restoration,95,50,45
Fawna,kazzak,1016,druid,restoration,42,14,28
Artracos,thrall,1016,druid,restoration,65,18,47
Tsihsel,ravencrest,1014,druid,restoration,24,11,13
Trolléverte,archimonde,1012,druid,restoration,141,69,72
Nyha,garrosh,1012,druid,restoration,48,15,33
Komiker,ravencrest,1011,druid,restoration,47,29,18
Dirtyhacks,blackmoore,1010,druid,restoration,36,17,19
Bartoluca,twisting-nether,1010,druid,restoration,64,14,50
Дендринис,gordunni,1009,druid,restoration,30,19,11
Ukri,ravencrest,1008,druid,restoration,22,11,11
Pitsas,silvermoon,1007,druid,restoration,473,234,239
Ceapamatii,sylvanas,1006,druid,restoration,122,53,69
Felfran,ravencrest,1005,druid,restoration,72,29,43
Fyllesvinet,azjolnerub,1004,druid,restoration,24,12,12
Snakemane,tarren-mill,1003,druid,restoration,83,44,39
Магараганага,azuregos,1003,druid,restoration,37,16,21
Feedbark,stormscale,1002,druid,restoration,23,13,10
Do,alakir,1002,druid,restoration,80,42,38
Dahelire,shendralar,1002,druid,restoration,60,30,30
Каирон,deepholm,1002,druid,restoration,42,13,29
Noxann,archimonde,1001,druid,restoration,34,12,22
Hopê,burning-legion,1000,druid,restoration,138,76,62
Витшел,gordunni,999,druid,restoration,24,14,10
Lunatrixs,dun-modr,998,druid,restoration,58,27,31
Ugubani,kazzak,998,druid,restoration,36,13,23
Drooed,jaedenar,997,druid,restoration,24,14,10
Hotilio,kelthuzad,996,druid,restoration,34,13,21
Creadora,ravencrest,996,druid,restoration,48,17,31
Mjutun,outland,995,druid,restoration,26,12,14
Iseron,uldum,993,druid,restoration,58,32,26
Iprex,outland,992,druid,restoration,333,172,161
Gnaro,ragnaros,992,druid,restoration,142,61,81
Chir,blackrock,991,druid,restoration,27,15,12
Norrma,silvermoon,991,druid,restoration,42,16,26
Chantalya,ravencrest,989,druid,restoration,35,21,14
Ærîs,garona,989,druid,restoration,42,22,20
Kirkey,terokkar,989,druid,restoration,118,60,58
Heilomat,kazzak,989,druid,restoration,28,11,17
Uwina,silvermoon,988,druid,restoration,30,16,14
Menolao,dun-morogh,988,druid,restoration,140,71,69
Nokodo,silvermoon,988,druid,restoration,39,19,20
Ревёрсс,soulflayer,988,druid,restoration,60,19,41
Sooamazing,korgall,987,druid,restoration,27,15,12
Wolfverina,sylvanas,986,druid,restoration,99,53,46
Moonfan,darkmoon-faire,986,druid,restoration,48,17,31
Zalherbata,burning-legion,986,druid,restoration,42,13,29
Yespapa,kazzak,985,druid,restoration,273,140,133
Spikill,uldaman,984,druid,restoration,40,26,14
Featherball,tarren-mill,983,druid,restoration,96,53,43
Leafy,twisting-nether,982,druid,restoration,52,16,36
Тевио,gordunni,981,druid,restoration,195,88,107
Бацна,gordunni,980,druid,restoration,36,15,21
Madschinken,malganis,980,druid,restoration,118,45,73
Mirreska,silvermoon,979,druid,restoration,269,123,146
Ковролин,gordunni,979,druid,restoration,37,14,23
Ellismera,argent-dawn,978,druid,restoration,36,17,19
Kannzi,draenor,978,druid,restoration,36,16,20
Raylla,dun-modr,976,druid,restoration,36,19,17
Johndru,kazzak,976,druid,restoration,113,48,65
Aègon,ravencrest,975,druid,restoration,30,13,17
Arydan,quelthalas,974,druid,restoration,28,11,17
Фэйблуд,blackscar,973,druid,restoration,258,131,127
Амильфийка,blackscar,973,druid,restoration,27,13,14
Xlife,silvermoon,973,druid,restoration,270,122,148
Khânz,twisting-nether,973,druid,restoration,46,11,35
Sinthorasia,blackrock,972,druid,restoration,28,12,16
Zydruid,silvermoon,971,druid,restoration,30,11,19
Tombenuit,tarren-mill,970,druid,restoration,30,15,15
Garzok,rashgarroth,970,druid,restoration,33,12,21
Roséa,ravencrest,969,druid,restoration,46,20,26
Zalmoxiss,ravencrest,968,druid,restoration,60,34,26
Xidenn,quelthalas,967,druid,restoration,24,11,13
Lùmy,arygos,967,druid,restoration,42,18,24
Benjosef,blackmoore,966,druid,restoration,110,53,57
Nermax,kazzak,966,druid,restoration,30,14,16
Chéchédroïd,marécage-de-zangar,966,druid,restoration,106,48,58
Альбигоиц,thermaplugg,966,druid,restoration,40,17,23
Nali,arthas,965,druid,restoration,55,31,24
Tranduiil,drakthul,965,druid,restoration,54,24,30
Jehtrotull,nemesis,965,druid,restoration,46,18,28
Флиперкэт,howling-fjord,965,druid,restoration,98,38,60
Zerschmatzen,aegwynn,965,druid,restoration,75,23,52
Yodox,kazzak,963,druid,restoration,54,31,23
Naturaliista,burning-legion,963,druid,restoration,64,25,39
Wegian,sylvanas,962,druid,restoration,63,36,27
Alirynn,argent-dawn,962,druid,restoration,66,35,31
Blolzz,silvermoon,962,druid,restoration,48,25,23
Hushorde,twisting-nether,962,druid,restoration,120,55,65
Teranaattori,the-maelstrom,962,druid,restoration,47,14,33
Karochi,kazzak,961,druid,restoration,28,17,11
Bntyx,dun-modr,960,druid,restoration,18,10,8
Aliyxo,aegwynn,960,druid,restoration,21,11,10
Борзойрог,soulflayer,960,druid,restoration,84,41,43
Kîfï,dun-modr,960,druid,restoration,33,16,17
Nargaí,kargath,960,druid,restoration,72,31,41
Eviency,outland,960,druid,restoration,24,10,14
Bloomzy,outland,960,druid,restoration,30,12,18
Dørckness,ravencrest,959,druid,restoration,18,10,8
Sakkosækk,ravencrest,959,druid,restoration,18,10,8
Bll,defias-brotherhood,959,druid,restoration,18,10,8
Mysao,dalaran,959,druid,restoration,18,10,8
Snedden,silvermoon,959,druid,restoration,30,15,15
Juhudy,kazzak,959,druid,restoration,24,10,14
Bäckey,silvermoon,958,druid,restoration,12,10,2
Milfshákez,ravencrest,958,druid,restoration,18,10,8
Mancy,silvermoon,958,druid,restoration,18,10,8
Demncow,twisting-nether,958,druid,restoration,18,10,8
Rînaa,ravencrest,958,druid,restoration,18,10,8
Дела,eversong,958,druid,restoration,74,40,34
Bazilika,argent-dawn,958,druid,restoration,161,82,79
Sheâ,nemesis,958,druid,restoration,42,18,24
Soraiyaqt,blackhand,958,druid,restoration,24,10,14
Krattos,outland,958,druid,restoration,24,10,14
Djalexdruid,kazzak,958,druid,restoration,24,10,14
Iqfrags,silvermoon,957,druid,restoration,27,18,9
Shaorma,ravencrest,957,druid,restoration,42,25,17
Bigfathoe,tarren-mill,957,druid,restoration,18,10,8
Taylegøðx,ravencrest,957,druid,restoration,18,10,8
Ystøss,archimonde,957,druid,restoration,18,10,8
Cobradrood,culte-de-la-rive-noire,957,druid,restoration,91,42,49
Brindefolie,archimonde,957,druid,restoration,24,10,14
Takar,dalaran,957,druid,restoration,54,19,35
Catkayn,stormscale,957,druid,restoration,107,36,71
Bug,eredar,955,druid,restoration,39,21,18
Patrík,twisting-nether,955,druid,restoration,30,10,20
Lzo,silvermoon,954,druid,restoration,18,10,8
Allod,stormscale,953,druid,restoration,267,136,131
Nicotic,kazzak,952,druid,restoration,18,10,8
Wizår,outland,952,druid,restoration,24,10,14
Энчантерес,gordunni,952,druid,restoration,30,10,20
Jenovas,argent-dawn,951,druid,restoration,24,10,14
Fackloner,zuljin,951,druid,restoration,24,10,14
Bloodhoofjr,blackhand,951,druid,restoration,36,10,26
Magneziie,drakthul,949,druid,restoration,18,10,8
Lightboxx,ravencrest,949,druid,restoration,100,54,46
Dstarzu,archimonde,949,druid,restoration,29,13,16
Cerius,drakthul,948,druid,restoration,18,10,8
Sinestah,ravencrest,947,druid,restoration,127,61,66
Triplej,twisting-nether,946,druid,restoration,52,26,26
Lathlas,defias-brotherhood,946,druid,restoration,24,12,12
Sweetanglesz,khadgar,946,druid,restoration,171,73,98
Мирафлоресс,booty-bay,945,druid,restoration,130,60,70
Paskixoxo,ravencrest,945,druid,restoration,24,10,14
Bleythia,silvermoon,943,druid,restoration,82,31,51
Bislait,archimonde,942,druid,restoration,117,53,64
Drblackus,draenor,941,druid,restoration,20,11,9
Тиктиктак,fordragon,941,druid,restoration,83,28,55
Jasof,sylvanas,940,druid,restoration,33,11,22
Erinark,aegwynn,940,druid,restoration,42,10,32
Fajia,frostmane,939,druid,restoration,36,10,26
Bunnykiss,kazzak,938,druid,restoration,48,24,24
Garypowers,kazzak,938,druid,restoration,41,10,31
Thaiboimbyy,veknilash,937,druid,restoration,46,25,21
Buffspencer,ragnaros,936,druid,restoration,107,56,51
Nimèl,argent-dawn,936,druid,restoration,42,18,24
Ganjeez,kazzak,935,druid,restoration,18,10,8
Бехеровка,grom,935,druid,restoration,76,33,43
Natyr,blackrock,933,druid,restoration,60,27,33
Nýxta,kazzak,933,druid,restoration,48,20,28
Fubarmeep,outland,932,druid,restoration,42,22,20
Narawenn,ysondre,932,druid,restoration,78,36,42
Kazekengan,draenor,932,druid,restoration,30,10,20
Testmah,silvermoon,932,druid,restoration,132,43,89
Krollix,dun-morogh,931,druid,restoration,76,40,36
Djclonex,archimonde,931,druid,restoration,64,32,32
Gunqer,burning-legion,931,druid,restoration,42,18,24
Krennan,darkspear,930,druid,restoration,39,19,20
Kaydjan,elune,929,druid,restoration,36,18,18
Revoidý,blackmoore,929,druid,restoration,72,20,52
Dimaox,terenas,926,druid,restoration,20,11,9
Argbjörn,sylvanas,926,druid,restoration,102,45,57
Firwyn,antonidas,925,druid,restoration,115,38,77
Uffknatschpl,blackmoore,924,druid,restoration,24,10,14
Malfis,the-maelstrom,924,druid,restoration,30,12,18
Kl,archimonde,924,druid,restoration,42,10,32
Drrood,stormscale,923,druid,restoration,14,11,3
Arminíus,die-silberne-hand,923,druid,restoration,101,39,62
Tribaldawn,ragnaros,922,druid,restoration,18,11,7
Healingelf,argent-dawn,922,druid,restoration,30,16,14
Ruap,blackmoore,922,druid,restoration,26,13,13
Knoohz,twisting-nether,921,druid,restoration,36,18,18
Køltyn,archimonde,920,druid,restoration,36,19,17
Bearshift,aggra-português,920,druid,restoration,79,32,47
Пачкачая,howling-fjord,916,druid,restoration,86,46,40
Visurat,tarren-mill,916,druid,restoration,100,46,54
Wellsie,blackmoore,915,druid,restoration,30,15,15
Druidicmorr,sylvanas,915,druid,restoration,22,10,12
Spaartaa,blackhand,914,druid,restoration,78,29,49
Rumjin,burning-blade,913,druid,restoration,46,13,33
Hairytree,outland,911,druid,restoration,26,12,14
Yam,thrall,911,druid,restoration,29,10,19
Feanthur,drakthul,909,druid,restoration,227,112,115
Shokazu,blackmoore,909,druid,restoration,202,97,105
Bigpopp,kazzak,909,druid,restoration,24,10,14
Woodrla,sylvanas,908,druid,restoration,54,30,24
Psychogirl,area-52,908,druid,restoration,55,26,29
Pøzy,sanguino,906,druid,restoration,69,36,33
Kárél,drakthul,906,druid,restoration,24,12,12
Kroshka,sylvanas,906,druid,restoration,24,10,14
Sároman,ravencrest,906,druid,restoration,55,14,41
Drubro,ragnaros,906,druid,restoration,42,10,32
Caturday,terrordar,905,druid,restoration,42,20,22
Alligatordru,kazzak,905,druid,restoration,30,13,17
Mokokokakau,ravencrest,904,druid,restoration,19,11,8
Maylika,hyjal,904,druid,restoration,92,35,57
Zorg,lightnings-blade,903,druid,restoration,25,11,14
Minimuuh,blackhand,902,druid,restoration,36,18,18
Meowu,twisting-nether,902,druid,restoration,25,11,14
Dablolo,ravencrest,901,druid,restoration,18,11,7
Medreas,argent-dawn,901,druid,restoration,27,13,14
Joji,la-croisade-écarlate,898,druid,restoration,45,17,28
Pussn,twisting-nether,898,druid,restoration,30,10,20
Bjaerntass,darksorrow,896,druid,restoration,21,11,10
Dùrban,archimonde,896,druid,restoration,28,14,14
Missfar,doomhammer,896,druid,restoration,66,28,38
Вокзи,gordunni,895,druid,restoration,27,11,16
Lorucka,die-nachtwache,894,druid,restoration,20,10,10
Gladyon,ravencrest,894,druid,restoration,30,13,17
Ктотоизкчр,gordunni,892,druid,restoration,14,10,4
Moonbloom,defias-brotherhood,891,druid,restoration,17,10,7
Pudseytree,doomhammer,890,druid,restoration,179,85,94
Zpredyn,dentarg,890,druid,restoration,82,31,51
Loumpa,hyjal,885,druid,restoration,84,43,41
Bidodici,nemesis,885,druid,restoration,212,99,113
Zyska,outland,885,druid,restoration,330,149,181
Kiwara,malganis,884,druid,restoration,24,12,12
Snifa,the-venture-co,883,druid,restoration,31,13,18
Malandrin,khazgoroth,882,druid,restoration,127,55,72
Nachtelf,lightbringer,881,druid,restoration,96,36,60
Onacor,stormrage,881,druid,restoration,34,12,22
Purple,draenor,880,druid,restoration,48,22,26
Coolbro,hyjal,879,druid,restoration,54,16,38
Arthoriana,thrall,878,druid,restoration,47,10,37
Yggdraasil,pozzo-delleternità,877,druid,restoration,48,23,25
Nozev,silvermoon,877,druid,restoration,153,68,85
Натурка,razuvious,874,druid,restoration,64,20,44
Trol,malganis,871,druid,restoration,33,16,17
Mandy,spinebreaker,871,druid,restoration,30,10,20
Ellinaki,neptulon,870,druid,restoration,144,69,75
Arianator,culte-de-la-rive-noire,870,druid,restoration,101,47,54
Beazze,drakthul,869,druid,restoration,90,36,54
Smexim,dalaran,868,druid,restoration,29,16,13
Инуараши,ashenvale,867,druid,restoration,56,23,33
Allagís,kul-tiras,865,druid,restoration,49,24,25
Sickomodê,blackmoore,864,druid,restoration,18,9,9
Thorrkk,azshara,864,druid,restoration,18,9,9
Nyllou,culte-de-la-rive-noire,864,druid,restoration,18,9,9
Isaacpewton,antonidas,864,druid,restoration,18,9,9
Biglet,tarren-mill,864,druid,restoration,18,9,9
Pissbomb,ravencrest,864,druid,restoration,18,9,9
Ponardo,outland,864,druid,restoration,19,9,10
Jàgër,archimonde,864,druid,restoration,24,9,15
Ночарик,blackscar,864,druid,restoration,30,9,21
Myndraa,varimathras,863,druid,restoration,12,9,3
Ëlyt,blackmoore,863,druid,restoration,15,10,5
Svanturken,kazzak,863,druid,restoration,18,9,9
Melo,blackmoore,863,druid,restoration,18,9,9
Kalihaze,silvermoon,863,druid,restoration,18,9,9
Madmanul,draenor,863,druid,restoration,18,9,9
Casic,echsenkessel,863,druid,restoration,24,9,15
Çhuucky,khaz-modan,863,druid,restoration,109,37,72
Nellro,blackrock,863,druid,restoration,30,9,21
Blblbl,ysondre,862,druid,restoration,18,9,9
Liluha,outland,862,druid,restoration,18,9,9
Tarneil,magtheridon,862,druid,restoration,43,17,26
Tigerroll,kazzak,862,druid,restoration,24,9,15
Bîloux,ysondre,861,druid,restoration,12,9,3
Shockdruid,grim-batol,861,druid,restoration,12,9,3
Thj,sylvanas,861,druid,restoration,30,15,15
Jugai,archimonde,861,druid,restoration,18,9,9
Ackyo,ysondre,861,druid,restoration,18,9,9
Furía,anubarak,861,druid,restoration,27,10,17
Crocobango,draenor,861,druid,restoration,117,40,77
Fknmad,burning-blade,860,druid,restoration,12,9,3
Mulx,die-ewige-wacht,860,druid,restoration,14,9,5
Bâchl,antonidas,860,druid,restoration,24,12,12
Hahnvm,stormscale,860,druid,restoration,18,9,9
Scarrymonsta,outland,860,druid,restoration,18,9,9
Dopadruid,ravencrest,860,druid,restoration,18,9,9
Thardruid,stormscale,860,druid,restoration,18,9,9
Vohdu,ragnaros,860,druid,restoration,22,10,12
Helguard,silvermoon,860,druid,restoration,24,9,15
Sneedlewøødz,exodar,860,druid,restoration,24,9,15
Nøny,gorgonnash,859,druid,restoration,18,9,9
Retroix,nefarian,859,druid,restoration,42,16,26
Shackari,ravencrest,858,druid,restoration,18,9,9
Elo,dun-morogh,858,druid,restoration,18,9,9
Crydotcom,aegwynn,858,druid,restoration,24,9,15
Gabbro,dalaran,857,druid,restoration,18,9,9
Angryfatdudu,draenor,857,druid,restoration,30,9,21
Gargasina,colinas-pardas,856,druid,restoration,28,15,13
Synoe,la-croisade-écarlate,855,druid,restoration,18,9,9
Wozay,archimonde,855,druid,restoration,24,9,15
Ashiothie,argent-dawn,854,druid,restoration,12,9,3
Aivy,boulderfist,854,druid,restoration,37,17,20
Robeala,twisting-nether,853,druid,restoration,54,23,31
Nious,kazzak,853,druid,restoration,24,9,15
Rexadria,blackrock,853,druid,restoration,30,9,21
Rawbacon,aegwynn,852,druid,restoration,12,9,3
Tightaníc,sylvanas,852,druid,restoration,18,9,9
Lynnarea,argent-dawn,852,druid,restoration,42,9,33
Egi,azshara,851,druid,restoration,26,12,14
Enføld,ravencrest,850,druid,restoration,20,9,11
Spiralout,nemesis,847,druid,restoration,854,423,431
Aglae,sylvanas,847,druid,restoration,53,19,34
Zeyne,ravencrest,847,druid,restoration,60,19,41
Faelune,argent-dawn,846,druid,restoration,18,9,9
Goingham,quelthalas,846,druid,restoration,42,19,23
Chujogrzmot,kazzak,843,druid,restoration,23,9,14
Jtsoigne,ysondre,842,druid,restoration,52,25,27
Panacée,dalaran,842,druid,restoration,102,48,54
Shakshun,draenor,842,druid,restoration,60,24,36
Laaide,blackmoore,841,druid,restoration,14,9,5
Speedlebee,malganis,841,druid,restoration,18,9,9
Seabath,kirin-tor,841,druid,restoration,24,9,15
Tuonq,sylvanas,841,druid,restoration,70,23,47
Ганаа,howling-fjord,840,druid,restoration,58,25,33
Barbesco,zuljin,839,druid,restoration,247,117,130
Skilloxus,gilneas,839,druid,restoration,251,104,147
Hootymactoot,magtheridon,838,druid,restoration,36,17,19
Drutoomight,tarren-mill,838,druid,restoration,24,9,15
Bezzel,doomhammer,838,druid,restoration,24,9,15
Шмыгадру,eversong,838,druid,restoration,24,9,15
Zulfran,blackrock,837,druid,restoration,24,9,15
Omegaheals,scarshield-legion,836,druid,restoration,72,35,37
Morphûs,kaelthas,836,druid,restoration,175,77,98
Liloè,onyxia,835,druid,restoration,138,64,74
Котанет,gordunni,835,druid,restoration,60,24,36
Clearwipe,thunderhorn,835,druid,restoration,24,9,15
Махх,howling-fjord,832,druid,restoration,24,9,15
Элеарсия,gordunni,832,druid,restoration,84,30,54
Braxxiloa,nazjatar,830,druid,restoration,18,9,9
Corrosion,outland,830,druid,restoration,118,51,67
Blacksnarl,kazzak,827,druid,restoration,678,323,355
Варсан,howling-fjord,825,druid,restoration,102,45,57
Dobradoonga,exodar,824,druid,restoration,24,10,14
Soif,rashgarroth,823,druid,restoration,58,26,32
Relay,ragnaros,821,druid,restoration,48,18,30
Oyoyo,kaelthas,819,druid,restoration,20,10,10
Mimesis,argent-dawn,819,druid,restoration,186,76,110
Metaboss,ravencrest,817,druid,restoration,71,24,47
Karvapersé,argent-dawn,816,druid,restoration,24,10,14
Tierundelfee,outland,816,druid,restoration,54,19,35
Потнаякиса,grom,815,druid,restoration,18,10,8
Jamburapro,sylvanas,814,druid,restoration,174,87,87
Darkstalker,arygos,814,druid,restoration,42,9,33
Maart,twisting-nether,808,druid,restoration,128,51,77
Khalynn,eredar,808,druid,restoration,86,28,58
Alexifaw,voljin,807,druid,restoration,16,10,6
Ratskrone,alleria,805,druid,restoration,190,85,105
Bärførceøne,blackrock,805,druid,restoration,36,14,22
Arysae,die-aldor,805,druid,restoration,54,18,36
Thélon,antonidas,804,druid,restoration,117,56,61
Healbrah,burning-blade,804,druid,restoration,99,28,71
Longtool,doomhammer,803,druid,restoration,126,46,80
Bullchóps,kazzak,803,druid,restoration,39,14,25
Grude,argent-dawn,801,druid,restoration,31,9,22
Bedcarx,ravencrest,800,druid,restoration,21,9,12
Leyea,ravencrest,800,druid,restoration,41,12,29
Slayerowl,blackmoore,798,druid,restoration,20,9,11
Karmabitz,ravencrest,797,druid,restoration,20,9,11
Nastygluejjr,terokkar,797,druid,restoration,44,17,27
Trytargetme,outland,796,druid,restoration,17,9,8
Adminble,alakir,796,druid,restoration,90,37,53
Rolven,defias-brotherhood,796,druid,restoration,29,11,18
Urlef,antonidas,795,druid,restoration,30,12,18
Merakir,dun-modr,795,druid,restoration,114,42,72
Detlaff,draenor,795,druid,restoration,28,9,19
Peaches,aerie-peak,794,druid,restoration,17,9,8
Sacmycløne,draenor,786,druid,restoration,35,10,25
Grüezi,sylvanas,785,druid,restoration,35,10,25
Rhaine,kult-der-verdammten,784,druid,restoration,17,9,8
Alatie,sylvanas,781,druid,restoration,27,10,17
Buufu,kazzak,780,druid,restoration,19,9,10
Lyarx,ragnaros,776,druid,restoration,53,30,23
Dokus,grim-batol,771,druid,restoration,46,19,27
Kerataas,lightnings-blade,769,druid,restoration,35,14,21
Citir,twisting-nether,769,druid,restoration,77,24,53
Acxaryl,stormscale,768,druid,restoration,12,8,4
Méné,blackhand,768,druid,restoration,12,8,4
Dablol,draenor,768,druid,restoration,12,8,4
Mojakravicaa,ravencrest,768,druid,restoration,12,8,4
Stinka,ravencrest,768,druid,restoration,12,8,4
Tebz,ravencrest,768,druid,restoration,12,8,4
Kaod,outland,768,druid,restoration,35,17,18
Arrvid,sylvanas,768,druid,restoration,18,8,10
Maeria,arakarahm,768,druid,restoration,18,8,10
Murlwywy,blackmoore,768,druid,restoration,18,8,10
Jin,the-venture-co,768,druid,restoration,18,8,10
Tmonstr,alakir,768,druid,restoration,18,8,10
Tomyn,burning-legion,768,druid,restoration,18,8,10
Réhagen,archimonde,768,druid,restoration,18,8,10
Xanxiety,outland,768,druid,restoration,18,8,10
Ajaÿ,sylvanas,768,druid,restoration,24,8,16
Taylrswftmnd,twisting-nether,767,druid,restoration,12,8,4
Druyddari,ravencrest,767,druid,restoration,12,8,4
Predattor,grim-batol,767,druid,restoration,20,10,10
Elyrai,drakthul,767,druid,restoration,18,8,10
Sùmmèrz,ravencrest,767,druid,restoration,18,8,10
Spoilers,amanthul,767,druid,restoration,18,8,10
Theprey,tarren-mill,767,druid,restoration,18,8,10
Птицун,gordunni,767,druid,restoration,18,8,10
Quasarx,ravencrest,767,druid,restoration,18,8,10
Bearpawzz,kazzak,766,druid,restoration,12,8,4
Seekx,silvermoon,766,druid,restoration,12,8,4
Thespanker,aggramar,766,druid,restoration,15,9,6
Ghxsty,silvermoon,766,druid,restoration,18,8,10
Джунали,howling-fjord,766,druid,restoration,24,8,16
Skrith,stormscale,766,druid,restoration,24,8,16
Alunjá,chamber-of-aspects,766,druid,restoration,24,8,16
Uncleruccus,outland,766,druid,restoration,24,8,16
Fòggie,silvermoon,766,druid,restoration,53,17,36
Сокдобрый,gordunni,765,druid,restoration,12,8,4
Мерлинз,lich-king,765,druid,restoration,12,8,4
Razudru,nerathor,765,druid,restoration,15,8,7
Гимодера,gordunni,765,druid,restoration,18,8,10
Biebear,sylvanas,765,druid,restoration,30,8,22
Oparegelt,eredar,765,druid,restoration,35,8,27
Wísh,stormscale,764,druid,restoration,18,8,10
Марголав,gordunni,764,druid,restoration,18,8,10
Pewpewflap,kazzak,764,druid,restoration,18,8,10
Druul,frostwolf,764,druid,restoration,18,8,10
Speeddemonx,tarren-mill,764,druid,restoration,19,8,11
Jahmandudu,ragnaros,764,druid,restoration,24,8,16
Daluria,malganis,763,druid,restoration,18,8,10
Furbyz,kazzak,763,druid,restoration,18,8,10
Jabizz,azjolnerub,763,druid,restoration,24,8,16
Aisak,burning-legion,763,druid,restoration,24,8,16
Patri,ravencrest,763,druid,restoration,43,8,35
Yamashi,stormscale,762,druid,restoration,18,8,10
Bêlion,dun-modr,762,druid,restoration,18,8,10
Dáxó,thrall,762,druid,restoration,24,8,16
Boompjeh,chamber-of-aspects,761,druid,restoration,12,8,4
Blazingmoon,twisting-nether,761,druid,restoration,24,8,16
Wakefields,dun-modr,761,druid,restoration,33,9,24
Thiudaish,tarren-mill,760,druid,restoration,24,8,16
Swiftbloom,bronze-dragonflight,759,druid,restoration,24,8,16
Зервес,gordunni,759,druid,restoration,30,8,22
Kkthanks,twisting-nether,757,druid,restoration,12,8,4
Avenzi,draenor,757,druid,restoration,18,8,10
Amaryllìs,twisting-nether,757,druid,restoration,24,8,16
Semiflora,silvermoon,757,druid,restoration,24,8,16
Muju,stormscale,756,druid,restoration,103,46,57
Karmacowboy,ravencrest,756,druid,restoration,24,8,16
Myos,conseil-des-ombres,756,druid,restoration,24,8,16
Мицкид,gordunni,756,druid,restoration,29,9,20
Houwalia,archimonde,754,druid,restoration,60,25,35
Vestor,ravencrest,754,druid,restoration,24,8,16
Inysea,die-aldor,752,druid,restoration,102,28,74
Ostara,blackmoore,751,druid,restoration,24,8,16
Nàrina,der-abyssische-rat,750,druid,restoration,18,8,10
Wildblu,nemesis,748,druid,restoration,24,8,16
Foyboy,ravencrest,747,druid,restoration,62,13,49
Arrock,malfurion,745,druid,restoration,36,13,23
Herdnotseen,stormscale,744,druid,restoration,66,19,47
Nithilana,argent-dawn,744,druid,restoration,30,8,22
Aelly,stormreaver,742,druid,restoration,18,8,10
Frostfox,ghostlands,741,druid,restoration,22,9,13
Haveacoffee,stormscale,741,druid,restoration,55,18,37
Skraks,ysondre,739,druid,restoration,30,8,22
Nutzlos,azshara,735,druid,restoration,165,60,105
Nelfurion,twisting-nether,734,druid,restoration,20,9,11
Saxondale,aszune,729,druid,restoration,18,8,10
Jendiiss,drakthul,728,druid,restoration,71,25,46
Широзоид,howling-fjord,728,druid,restoration,28,8,20
Soezzdrood,archimonde,727,druid,restoration,19,8,11
Kuokkanen,azuremyst,726,druid,restoration,21,9,12
Исмалат,howling-fjord,726,druid,restoration,25,9,16
Droodfist,khaz-modan,720,druid,restoration,144,59,85
Unt,emerald-dream,718,druid,restoration,17,8,9
Catman,eredar,717,druid,restoration,15,9,6
Rakelyhn,kazzak,717,druid,restoration,23,8,15
Haowl,argent-dawn,715,druid,restoration,23,8,15
Brayyjin,kul-tiras,712,druid,restoration,21,9,12
Treehead,ravencrest,709,druid,restoration,22,9,13
Nube,alonsus,708,druid,restoration,120,49,71
Savageftw,draenor,708,druid,restoration,37,9,28
Vénage,blackmoore,705,druid,restoration,34,13,21
Lyndruid,sylvanas,701,druid,restoration,156,57,99
Sylocin,earthen-ring,699,druid,restoration,16,8,8
Albx,archimonde,698,druid,restoration,22,8,14
Eodar,proudmoore,696,druid,restoration,23,8,15
Esøterix,malganis,695,druid,restoration,27,8,19
Søfiaa,argent-dawn,685,druid,restoration,46,9,37
Найтед,gordunni,678,druid,restoration,17,10,7
Dudu,sinstralis,677,druid,restoration,26,10,16
Антиблэк,soulflayer,672,druid,restoration,12,7,5
Graouphro,hyjal,672,druid,restoration,12,7,5
Tlxrdlx,archimonde,672,druid,restoration,12,7,5
Fadâ,archimonde,672,druid,restoration,12,7,5
Ohshift,drakthul,672,druid,restoration,12,7,5
Astodruid,defias-brotherhood,672,druid,restoration,12,7,5
Bomor,dragonblight,672,druid,restoration,12,7,5
Djdishwasher,kazzak,672,druid,restoration,12,7,5
Ripmacmiller,grim-batol,672,druid,restoration,12,7,5
Vertígo,ravencrest,672,druid,restoration,12,7,5
Zarune,sanguino,672,druid,restoration,12,7,5
Сумрачнный,gordunni,672,druid,restoration,12,7,5
Jacksonh,blackmoore,672,druid,restoration,12,7,5
Mojakravicaa,stormscale,672,druid,restoration,12,7,5
Jakeffsake,stormscale,672,druid,restoration,12,7,5
Zhényá,ravencrest,672,druid,restoration,16,8,8
Сайнтификх,gordunni,672,druid,restoration,18,7,11
Juhato,outland,672,druid,restoration,18,7,11
Buzzlîghtyea,outland,672,druid,restoration,18,7,11
Ðon,nemesis,672,druid,restoration,18,7,11
Xanánioma,ravencrest,672,druid,restoration,18,7,11
Darkyblood,archimonde,672,druid,restoration,18,7,11
Kurúk,die-aldor,672,druid,restoration,28,9,19
Vivere,frostmane,672,druid,restoration,23,7,16
Stormendru,kazzak,672,druid,restoration,24,7,17
Téddy,thrall,672,druid,restoration,24,7,17
Neverpanic,stormscale,672,druid,restoration,24,7,17
Inochi,ravencrest,672,druid,restoration,24,7,17
Kluggerz,silvermoon,672,druid,restoration,24,7,17
Xbalanc,kazzak,672,druid,restoration,24,7,17
Стомпбр,gordunni,672,druid,restoration,24,7,17
Лексика,gordunni,671,druid,restoration,12,7,5
Pomdöner,echsenkessel,671,druid,restoration,12,7,5
Bembz,twisting-nether,671,druid,restoration,12,7,5
Darktigrou,archimonde,671,druid,restoration,12,7,5
Badballance,outland,671,druid,restoration,12,7,5
Lorya,runetotem,671,druid,restoration,12,7,5
Thyana,blackrock,671,druid,restoration,12,7,5
Zatarmix,sylvanas,671,druid,restoration,12,7,5
Мамамышь,gordunni,671,druid,restoration,12,7,5
Zuldrood,sargeras,671,druid,restoration,12,7,5
Sitruu,zenedar,671,druid,restoration,18,7,11
Møonknight,ravencrest,671,druid,restoration,18,7,11
Zoura,ysondre,671,druid,restoration,18,7,11
Rosskemp,tarren-mill,671,druid,restoration,18,7,11
Smokahontas,kilrogg,671,druid,restoration,18,7,11
Nref,outland,671,druid,restoration,24,7,17
Frequentist,ragnaros,671,druid,restoration,24,7,17
Gstahr,taerar,671,druid,restoration,24,7,17
Trntydr,senjin,671,druid,restoration,24,7,17
Crazydos,tarren-mill,671,druid,restoration,24,7,17
Шеданна,gordunni,671,druid,restoration,24,7,17
Greenberry,eonar,670,druid,restoration,12,7,5
Blooming,ravencrest,670,druid,restoration,12,7,5
Azumera,silvermoon,670,druid,restoration,12,7,5
Curinas,argent-dawn,670,druid,restoration,12,7,5
Alvee,ravencrest,670,druid,restoration,14,8,6
Wurzeldor,ravencrest,670,druid,restoration,18,7,11
Skeolicious,hyjal,670,druid,restoration,18,7,11
Taugenîchts,blackmoore,670,druid,restoration,18,7,11
Imissclone,outland,670,druid,restoration,18,7,11
Elunælle,les-sentinelles,670,druid,restoration,24,7,17
Trickortree,frostwolf,670,druid,restoration,24,7,17
Naicy,khaz-modan,670,druid,restoration,30,7,23
Тиимон,borean-tundra,669,druid,restoration,12,7,5
Mailiin,lordaeron,669,druid,restoration,18,7,11
Derie,nazjatar,669,druid,restoration,18,7,11
Snorg,twisting-nether,669,druid,restoration,18,7,11
Xavoths,outland,669,druid,restoration,18,7,11
Хамулл,howling-fjord,669,druid,restoration,18,7,11
Azenoir,ravencrest,669,druid,restoration,18,7,11
Chintawaz,archimonde,669,druid,restoration,22,8,14
Gailiûga,kazzak,669,druid,restoration,25,8,17
Eladhria,arakarahm,669,druid,restoration,24,7,17
Druidbox,ravencrest,668,druid,restoration,12,7,5
Shadowdury,frostwolf,668,druid,restoration,18,7,11
Milkniatrump,tarren-mill,668,druid,restoration,18,7,11
Alfrëd,quelthalas,668,druid,restoration,18,7,11
Seasexsune,antonidas,668,druid,restoration,18,7,11
Cláire,stormscale,668,druid,restoration,18,7,11
Gugruguuguu,eredar,668,druid,restoration,18,7,11
Poweralone,ravencrest,668,druid,restoration,18,7,11
Coínlíp,drakthul,668,druid,restoration,24,7,17
Lùxs,silvermoon,667,druid,restoration,18,7,11
Thaeldres,argent-dawn,667,druid,restoration,18,7,11
Zuggan,tarren-mill,667,druid,restoration,18,7,11
Wardruíd,outland,667,druid,restoration,24,7,17
Tá,kazzak,667,druid,restoration,30,7,23
Zolaheuzis,argent-dawn,667,druid,restoration,42,7,35
Druidul,sylvanas,666,druid,restoration,12,7,5
Entler,twilights-hammer,666,druid,restoration,12,7,5
Acalien,ambossar,666,druid,restoration,24,7,17
Bepanten,azshara,665,druid,restoration,18,7,11
Bothvar,terokkar,662,druid,restoration,24,7,17
Druiddamage,the-maelstrom,660,druid,restoration,18,7,11
Rukashi,die-aldor,659,druid,restoration,12,7,5
Raktav,kazzak,659,druid,restoration,12,7,5
Kinisha,dun-morogh,659,druid,restoration,18,7,11
Сутулоерыгло,howling-fjord,658,druid,restoration,20,7,13
Jooblob,guldan,658,druid,restoration,30,7,23
Draxedin,kazzak,655,druid,restoration,11,7,4
Ластхоп,soulflayer,655,druid,restoration,18,7,11
Navicat,kazzak,651,druid,restoration,32,9,23
Florizar,elune,650,druid,restoration,18,7,11
Voodoodrood,draenor,645,druid,restoration,36,7,29
Muhjini,eredar,643,druid,restoration,27,9,18
Hornykarenn,bladefist,639,druid,restoration,17,7,10
Amelosta,silvermoon,637,druid,restoration,49,9,40
Lyvaley,dun-modr,629,druid,restoration,28,7,21
Mymoms,stormscale,624,druid,restoration,21,7,14
Нюхнимедведя,blackscar,623,druid,restoration,11,7,4
Wanessa,kazzak,622,druid,restoration,11,7,4
Fatdroodz,draenor,622,druid,restoration,30,8,22
Tmhaikyu,blackhand,621,druid,restoration,21,8,13
Justdmg,ravencrest,618,druid,restoration,13,8,5
Ноатаэль,gordunni,618,druid,restoration,17,7,10
Øxxy,ravencrest,618,druid,restoration,29,9,20
Whitemaine,aggramar,615,druid,restoration,14,8,6
Kapidrooqt,suramar,615,druid,restoration,15,8,7
Rammtarn,boulderfist,613,druid,restoration,73,20,53
Poonkin,ravencrest,610,druid,restoration,23,7,16
Vellusdruid,burning-legion,607,druid,restoration,14,7,7
Celene,zuljin,606,druid,restoration,11,7,4
Метафрея,gordunni,605,druid,restoration,11,7,4
Wolfheart,norgannon,598,druid,restoration,39,13,26
Crazywild,archimonde,596,druid,restoration,18,8,10
Swiftkillz,outland,591,druid,restoration,13,7,6
Rëckiah,ysondre,590,druid,restoration,19,7,12
Gobachi,emeriss,585,druid,restoration,13,7,6
Friyiee,stormscale,585,druid,restoration,22,9,13
Abercrombx,thrall,576,druid,restoration,6,6,0
Lecoq,magtheridon,576,druid,restoration,6,6,0
Dolensdudu,argent-dawn,576,druid,restoration,6,6,0
Gigachas,tarren-mill,576,druid,restoration,6,6,0
Fotmheroqtxd,ravencrest,576,druid,restoration,12,6,6
Rycnd,tarren-mill,576,druid,restoration,12,6,6
Freddyßear,draenor,576,druid,restoration,12,6,6
Ravnac,aegwynn,576,druid,restoration,12,6,6
Theforest,stormscale,576,druid,restoration,12,6,6
Bøømerswågxx,twisting-nether,576,druid,restoration,12,6,6
Telpha,onyxia,576,druid,restoration,12,6,6
Tafsiri,stormscale,576,druid,restoration,12,6,6
Lolimadudu,silvermoon,576,druid,restoration,12,6,6
Piñaclo,archimonde,576,druid,restoration,12,6,6
Jincksdru,ravencrest,576,druid,restoration,12,6,6
Vindruva,ravencrest,576,druid,restoration,12,6,6
Yëkténíyá,ravencrest,576,druid,restoration,12,6,6
Taicoo,outland,576,druid,restoration,12,6,6
Bilmo,ragnaros,576,druid,restoration,12,6,6
Ferraribob,ravencrest,576,druid,restoration,12,6,6
Mccarthy,archimonde,576,druid,restoration,12,6,6
Jhiun,ragnaros,576,druid,restoration,12,6,6
Cyriaan,eredar,576,druid,restoration,12,6,6
Tashani,blackhand,576,druid,restoration,12,6,6
Hecatos,hyjal,576,druid,restoration,12,6,6
Sálty,aegwynn,576,druid,restoration,12,6,6
Ассканий,booty-bay,576,druid,restoration,12,6,6
Daurex,stormreaver,576,druid,restoration,12,6,6
Biggttgothgf,doomhammer,576,druid,restoration,12,6,6
Outformpoly,ravencrest,576,druid,restoration,12,6,6
Pogidruid,ragnaros,576,druid,restoration,12,6,6
Dijii,the-maelstrom,576,druid,restoration,13,6,7
Worsteux,blackrock,576,druid,restoration,14,6,8
Ãmba,blackrock,576,druid,restoration,15,6,9
Bearmeister,kazzak,576,druid,restoration,18,6,12
Suevlaki,ragnaros,576,druid,restoration,18,6,12
Manzqu,stormreaver,576,druid,restoration,18,6,12
Pansaa,stormscale,576,druid,restoration,18,6,12
Deazydrood,blackrock,576,druid,restoration,18,6,12
Randomnup,sanguino,576,druid,restoration,18,6,12
Pölkky,argent-dawn,576,druid,restoration,18,6,12
Arcaníer,draenor,576,druid,restoration,18,6,12
Psychopath,sylvanas,576,druid,restoration,18,6,12
Blackhood,ysondre,576,druid,restoration,18,6,12
Hánsolo,ravencrest,576,druid,restoration,18,6,12
Secô,sylvanas,576,druid,restoration,18,6,12
Tjillevippen,tarren-mill,576,druid,restoration,18,6,12
Woehaha,ravencrest,576,druid,restoration,24,6,18
Kebapino,kazzak,576,druid,restoration,24,6,18
Cridan,ravencrest,576,druid,restoration,26,6,20
Nobrainopain,aegwynn,575,druid,restoration,12,6,6
Greenriver,magtheridon,575,druid,restoration,12,6,6
Mistgone,hyjal,575,druid,restoration,12,6,6
Bullwyse,malganis,575,druid,restoration,12,6,6
Garbloom,silvermoon,575,druid,restoration,12,6,6
Wykked,outland,575,druid,restoration,12,6,6
Pinkponcho,defias-brotherhood,575,druid,restoration,12,6,6
Lucidor,frostmane,575,druid,restoration,12,6,6
Fordirion,ravencrest,575,druid,restoration,12,6,6
Reidens,moonglade,575,druid,restoration,12,6,6
Lanmìe,malganis,575,druid,restoration,12,6,6
Вооми,gordunni,575,druid,restoration,12,6,6
Iamsocute,silvermoon,575,druid,restoration,12,6,6
Ænea,aegwynn,575,druid,restoration,15,7,8
Шев,blackscar,575,druid,restoration,21,7,14
Hotundwech,blackrock,575,druid,restoration,18,6,12
Drbark,blackmoore,575,druid,restoration,18,6,12
Gekkøu,blackmoore,575,druid,restoration,18,6,12
Fiq,silvermoon,575,druid,restoration,18,6,12
Faelendris,culte-de-la-rive-noire,575,druid,restoration,18,6,12
Mascraxx,earthen-ring,575,druid,restoration,18,6,12
Clajzy,the-maelstrom,575,druid,restoration,18,6,12
Pouletqt,archimonde,575,druid,restoration,18,6,12
Ipiridian,kargath,575,druid,restoration,18,6,12
Sóratas,blackhand,575,druid,restoration,18,6,12
Dorange,stormscale,575,druid,restoration,18,6,12
Tanukii,twisting-nether,575,druid,restoration,18,6,12
Grîsh,burning-legion,575,druid,restoration,18,6,12
Barley,aegwynn,575,druid,restoration,18,6,12
Emidrem,ravencrest,575,druid,restoration,22,7,15
Kakoje,burning-legion,575,druid,restoration,24,6,18
Bobromila,burning-blade,575,druid,restoration,24,6,18
Эскоф,gordunni,575,druid,restoration,25,6,19
Kyrnox,ravencrest,575,druid,restoration,30,6,24
Thunderia,outland,574,druid,restoration,6,6,0
Zouzouille,ravencrest,574,druid,restoration,12,6,6
Heala,malganis,574,druid,restoration,12,6,6
Spritzer,tarren-mill,574,druid,restoration,12,6,6
Оксинаген,ashenvale,574,druid,restoration,12,6,6
Tryglor,blackhand,574,druid,restoration,18,6,12
Magnusson,shadowsong,574,druid,restoration,24,6,18
Koniny,drakthul,574,druid,restoration,24,6,18
Goatmeal,draenor,574,druid,restoration,24,6,18
Jezkö,kazzak,573,druid,restoration,6,6,0
Oaky,alonsus,573,druid,restoration,12,6,6
Ragdru,twisting-nether,573,druid,restoration,24,6,18
Swo,emeriss,573,druid,restoration,24,6,18
Shadówglen,defias-brotherhood,573,druid,restoration,30,6,24
Rouvikonas,silvermoon,572,druid,restoration,12,6,6
Taskingoman,twisting-nether,572,druid,restoration,12,6,6
Faderjord,zenedar,572,druid,restoration,12,6,6
Deb,uldaman,572,druid,restoration,12,6,6
Devilsdoll,ravencrest,572,druid,restoration,18,6,12
Bearhúg,kazzak,572,druid,restoration,18,6,12
Slange,ravencrest,572,druid,restoration,18,6,12
Evølvë,burning-blade,572,druid,restoration,24,6,18
Wildsoul,hyjal,571,druid,restoration,12,6,6
Лордсенка,eversong,571,druid,restoration,22,9,13
Diigga,eredar,571,druid,restoration,18,6,12
Sfteddy,tarren-mill,571,druid,restoration,18,6,12
Neridris,argent-dawn,570,druid,restoration,12,6,6
Kamiraach,aegwynn,570,druid,restoration,18,6,12
Эгерме24FA33,howling-fjord,569,druid,restoration,12,6,6
Crysís,sanguino,569,druid,restoration,24,8,16
Barki,silvermoon,569,druid,restoration,18,6,12
Essya,earthen-ring,569,druid,restoration,31,7,24
Frealar,trollbane,568,druid,restoration,12,6,6
Olekh,nemesis,568,druid,restoration,12,6,6
Myrkálfur,sylvanas,568,druid,restoration,12,6,6
Walkao,tarren-mill,566,druid,restoration,12,6,6
Moonhenge,neptulon,565,druid,restoration,18,6,12
Jusar,hyjal,564,druid,restoration,12,6,6
Xtrakul,bloodfeather,564,druid,restoration,15,7,8
Rakhajan,twisting-nether,553,druid,restoration,35,6,29
Fanso,burning-legion,543,druid,restoration,18,7,11
Vlookup,tarren-mill,543,druid,restoration,17,6,11
Siahra,khaz-modan,534,druid,restoration,48,6,42
Arún,nazjatar,527,druid,restoration,11,6,5
Traplordgen,outland,527,druid,restoration,17,6,11
Orgazmo,archimonde,526,druid,restoration,17,6,11
Noodledru,tarren-mill,526,druid,restoration,21,6,15
Toramix,dalaran,526,druid,restoration,44,10,34
Крысобой,ashenvale,523,druid,restoration,35,6,29
Noggerglatze,blackrock,522,druid,restoration,19,7,12
Boomykush,twisting-nether,521,druid,restoration,12,7,5
Ультраафина,gordunni,520,druid,restoration,16,7,9
Diazepam,draenor,519,druid,restoration,21,7,14
Хуфра,greymane,514,druid,restoration,31,9,22
Sethdr,hyjal,511,druid,restoration,20,6,14
Wolig,tarren-mill,510,druid,restoration,16,6,10
Lsdpinkcandy,twisting-nether,508,druid,restoration,22,6,16
Жибка,howling-fjord,496,druid,restoration,19,6,13
Vinesolar,runetotem,493,druid,restoration,13,6,7
Quadpulse,ravencrest,480,druid,restoration,6,5,1
Beamgødx,thrall,480,druid,restoration,6,5,1
Miskydruid,kazzak,480,druid,restoration,6,5,1
Feinrippjoe,blackhand,480,druid,restoration,6,5,1
Angelofbliss,tarren-mill,480,druid,restoration,6,5,1
Ccbrue,ambossar,480,druid,restoration,6,5,1
Bobthebull,ragnaros,480,druid,restoration,6,5,1
Zapx,hyjal,480,druid,restoration,6,5,1
Celetik,archimonde,480,druid,restoration,6,5,1
Coldyxzqt,blackrock,480,druid,restoration,6,5,1
Neldoran,outland,480,druid,restoration,6,5,1
Druidicchi,stormscale,480,druid,restoration,12,5,7
Tilikum,stormscale,480,druid,restoration,12,5,7
Ppr,stormscale,480,druid,restoration,12,5,7
Mîraculix,dun-morogh,480,druid,restoration,12,5,7
Umbutsebada,ravencrest,480,druid,restoration,12,5,7
Wacrafting,kargath,480,druid,restoration,12,5,7
Hwrén,stormscale,480,druid,restoration,12,5,7
Xenrakh,blackhand,480,druid,restoration,12,5,7
Ipsylön,aggra-português,480,druid,restoration,12,5,7
Napsta,sylvanas,480,druid,restoration,12,5,7
Maelst,sanguino,480,druid,restoration,12,5,7
Свэпп,blackscar,480,druid,restoration,12,5,7
Xclonedotcom,aegwynn,480,druid,restoration,12,5,7
Adyllon,die-aldor,480,druid,restoration,12,5,7
Гемайншафт,soulflayer,480,druid,restoration,12,5,7
Aridardruid,silvermoon,480,druid,restoration,12,5,7
Whisk,ravencrest,480,druid,restoration,12,5,7
Skirr,kelthuzad,480,druid,restoration,12,5,7
Asude,outland,480,druid,restoration,12,5,7
Idkmàn,ravencrest,480,druid,restoration,12,5,7
Zunixboosted,lothar,480,druid,restoration,12,5,7
Flanagàn,hyjal,480,druid,restoration,12,5,7
Marmotini,the-maelstrom,480,druid,restoration,12,5,7
Bøøstèdtréè,ravencrest,480,druid,restoration,12,5,7
Sucream,burning-legion,480,druid,restoration,12,5,7
Lúxtrá,antonidas,480,druid,restoration,12,5,7
Trashgamex,eredar,480,druid,restoration,12,5,7
Аронэл,blackscar,480,druid,restoration,12,5,7
Tokamon,blackrock,480,druid,restoration,12,5,7
Solonely,argent-dawn,480,druid,restoration,12,5,7
Димадубощит,blackscar,480,druid,restoration,12,5,7
Horstyolo,blackrock,480,druid,restoration,12,5,7
Maebd,sanguino,480,druid,restoration,12,5,7
Agatîta,dun-modr,480,druid,restoration,12,5,7
Bezkin,tarren-mill,480,druid,restoration,12,5,7
Trollingt,draenor,480,druid,restoration,12,5,7
Alolexxtwo,archimonde,480,druid,restoration,12,5,7
Daisyx,eredar,480,druid,restoration,12,5,7
Woopidou,chants-éternels,480,druid,restoration,12,5,7
Druni,blackrock,480,druid,restoration,12,5,7
Ilovekush,gilneas,480,druid,restoration,12,5,7
Fjry,draenor,480,druid,restoration,12,5,7
Taldrus,argent-dawn,480,druid,restoration,12,5,7
Cheddar,tyrande,480,druid,restoration,12,5,7
Druidka,grim-batol,480,druid,restoration,12,5,7
Neshalry,blackhand,480,druid,restoration,13,5,8
Hottêd,sylvanas,480,druid,restoration,26,8,18
Jebaitor,tarren-mill,480,druid,restoration,18,5,13
Erelieva,silvermoon,480,druid,restoration,18,5,13
Bigbaddream,stormscale,480,druid,restoration,18,5,13
Músclébéach,silvermoon,480,druid,restoration,18,5,13
Wikdruid,ravencrest,480,druid,restoration,18,5,13
Restaidpvs,wildhammer,480,druid,restoration,18,5,13
Aionx,ravencrest,480,druid,restoration,18,5,13
Farathey,twisting-nether,480,druid,restoration,36,5,31
Винстяша,gordunni,479,druid,restoration,6,5,1
Rocknrollà,doomhammer,479,druid,restoration,6,5,1
Клиптыч,soulflayer,479,druid,restoration,6,5,1
Superdupa,burning-blade,479,druid,restoration,6,5,1
Ñãvy,archimonde,479,druid,restoration,6,5,1
Lebton,blackmoore,479,druid,restoration,12,5,7
Qb,blackrock,479,druid,restoration,12,5,7
Datshifter,magtheridon,479,druid,restoration,12,5,7
Midrialis,sinstralis,479,druid,restoration,12,5,7
Skatten,the-maelstrom,479,druid,restoration,12,5,7
Мунпраид,gordunni,479,druid,restoration,12,5,7
Gunelak,blackmoore,479,druid,restoration,12,5,7
Kvorning,ravencrest,479,druid,restoration,12,5,7
Myxa,arthas,479,druid,restoration,12,5,7
Delphina,dun-modr,479,druid,restoration,12,5,7
Eliame,hyjal,479,druid,restoration,12,5,7
Abyssaldepth,ravencrest,479,druid,restoration,12,5,7
Epidruid,stormrage,479,druid,restoration,12,5,7
Malfurioff,twisting-nether,479,druid,restoration,12,5,7
Sieur,archimonde,479,druid,restoration,12,5,7
Abye,tichondrius,479,druid,restoration,12,5,7
Derrion,burning-legion,479,druid,restoration,12,5,7
Caliyo,kazzak,479,druid,restoration,14,5,9
Rydo,turalyon,479,druid,restoration,14,5,9
Asklepiøs,blackmoore,479,druid,restoration,18,5,13
Akínos,tarren-mill,479,druid,restoration,18,5,13
Devolboy,turalyon,479,druid,restoration,18,5,13
Tinykiwi,silvermoon,479,druid,restoration,18,5,13
Baracüda,draenor,479,druid,restoration,22,6,16
Jemyd,aegwynn,479,druid,restoration,24,5,19
Adrosus,blackrock,479,druid,restoration,30,5,25
Absolutsprit,kazzak,479,druid,restoration,30,5,25
Multihoopsi,ysondre,478,druid,restoration,6,5,1
Capacious,drakthul,478,druid,restoration,6,5,1
Beef,the-maelstrom,478,druid,restoration,12,5,7
Blackfür,sylvanas,478,druid,restoration,12,5,7
Kuivea,the-maelstrom,478,druid,restoration,18,5,13
Druzroz,arathor,478,druid,restoration,23,5,18
Hurutuk,ysondre,478,druid,restoration,24,5,19
Drusila,alonsus,478,druid,restoration,30,5,25
Fanofkreemax,archimonde,477,druid,restoration,6,5,1
Kodobursto,stormscale,477,druid,restoration,12,5,7
Lêshâ,dun-modr,477,druid,restoration,18,5,13
Wybsalt,dragonblight,477,druid,restoration,18,5,13
Xtraflash,silvermoon,477,druid,restoration,24,5,19
Томография,howling-fjord,475,druid,restoration,12,5,7
Kufcuf,eredar,475,druid,restoration,12,5,7
Sýrês,malganis,475,druid,restoration,12,5,7
Saltilac,ragnaros,474,druid,restoration,30,5,25
Prowlinger,silvermoon,473,druid,restoration,12,5,7
Thellma,argent-dawn,473,druid,restoration,12,5,7
Tajfun,burning-legion,472,druid,restoration,12,5,7
Êlvis,kazzak,472,druid,restoration,12,5,7
Urgrull,baelgun,472,druid,restoration,18,5,13
Thaurus,durotan,471,druid,restoration,24,5,19
Аллишана,howling-fjord,465,druid,restoration,25,8,17
Iamtheone,ragnaros,463,druid,restoration,17,5,12
Grogégé,illidan,460,druid,restoration,17,5,12
Lylle,doomhammer,459,druid,restoration,23,5,18
Jopidr,stormreaver,447,druid,restoration,11,5,6
Happyhippo,arathor,447,druid,restoration,17,5,12
Dhomaris,emerald-dream,447,druid,restoration,17,5,12
Ambracer,silvermoon,444,druid,restoration,8,6,2
Amindenes,ragnaros,438,druid,restoration,34,5,29
Sumecßeast,aegwynn,432,druid,restoration,15,6,9
Mozzin,frostwolf,431,druid,restoration,17,5,12
Izhusky,ravencrest,426,druid,restoration,14,6,8
Pfandmalle,blackrock,426,druid,restoration,14,6,8
Atomanna,blackmoore,426,druid,restoration,15,6,9
Nythielle,argent-dawn,426,druid,restoration,20,6,14
Sartipus,draenor,425,druid,restoration,23,7,16
Avilary,tarren-mill,425,druid,restoration,20,6,14
Storfjåset,stormscale,425,druid,restoration,21,6,15
Jadhy,hyjal,414,druid,restoration,22,5,17
Знаменоносец,soulflayer,414,druid,restoration,22,5,17
Meridus,thrall,400,druid,restoration,13,5,8
Vineguhl,thrall,399,druid,restoration,5,5,0
Xneji,sylvanas,397,druid,restoration,19,5,14
Híraad,blackmoore,384,druid,restoration,6,4,2
Sensisdruid,blackmoore,384,druid,restoration,6,4,2
Кискалисичка,soulflayer,384,druid,restoration,6,4,2
Elinity,blackrock,384,druid,restoration,6,4,2
Uñbreakabull,aegwynn,384,druid,restoration,6,4,2
Thëca,dun-modr,384,druid,restoration,6,4,2
Феразинария,gordunni,384,druid,restoration,6,4,2
Xsnøw,ysera,384,druid,restoration,6,4,2
Brushié,kazzak,384,druid,restoration,6,4,2
Hakirâ,archimonde,384,druid,restoration,6,4,2
Cyclonebot,kazzak,384,druid,restoration,6,4,2
Koala,temple-noir,384,druid,restoration,6,4,2
Mentaldead,tarren-mill,384,druid,restoration,6,4,2
Heathen,defias-brotherhood,384,druid,restoration,6,4,2
Neuroz,ravencrest,384,druid,restoration,6,4,2
Gurenx,ravencrest,384,druid,restoration,6,4,2
Divicîacøs,ysondre,384,druid,restoration,6,4,2
Bombiix,sanguino,384,druid,restoration,6,4,2
Xandersito,sanguino,384,druid,restoration,6,4,2
Starlites,silvermoon,384,druid,restoration,6,4,2
Razzarius,draenor,384,druid,restoration,6,4,2
Juicypus,ragnaros,384,druid,restoration,6,4,2
Sinyi,arathor,384,druid,restoration,6,4,2
Cykablyaster,defias-brotherhood,384,druid,restoration,6,4,2
Lerralol,eredar,384,druid,restoration,6,4,2
Jimmyxdd,kazzak,384,druid,restoration,6,4,2
Jimmyjam,archimonde,384,druid,restoration,6,4,2
Duckiethotx,twisting-nether,384,druid,restoration,6,4,2
Zuldram,uldaman,384,druid,restoration,6,4,2
Claptastic,magtheridon,384,druid,restoration,6,4,2
Àrkange,hyjal,384,druid,restoration,6,4,2
Мелонбласт,howling-fjord,384,druid,restoration,6,4,2
Deeizm,ravencrest,384,druid,restoration,6,4,2
Zeroclones,the-maelstrom,384,druid,restoration,6,4,2
Xanguinary,outland,384,druid,restoration,6,4,2
Tenzuk,archimonde,384,druid,restoration,6,4,2
Lazzon,grim-batol,384,druid,restoration,6,4,2
Bullbash,twisting-nether,384,druid,restoration,6,4,2
Theeix,twisting-nether,384,druid,restoration,6,4,2
Backtoferal,kazzak,384,druid,restoration,6,4,2
Notmyfriend,sylvanas,384,druid,restoration,6,4,2
Mikba,blackrock,384,druid,restoration,10,4,6
Flauschtatze,wrathbringer,384,druid,restoration,13,5,8
Chelsealeart,frostmane,384,druid,restoration,15,5,10
Celtimi,antonidas,384,druid,restoration,12,4,8
Zivela,blackrock,384,druid,restoration,12,4,8
Saadxd,sanguino,384,druid,restoration,12,4,8
Ghostgirl,drakthul,384,druid,restoration,12,4,8
Swiftlife,blackrock,384,druid,restoration,12,4,8
Lorèen,argent-dawn,384,druid,restoration,12,4,8
Jöggel,perenolde,384,druid,restoration,12,4,8
Смизм,gordunni,384,druid,restoration,12,4,8
Holdmabeer,blackmoore,384,druid,restoration,12,4,8
Flewks,silvermoon,384,druid,restoration,12,4,8
Thigh,blackrock,384,druid,restoration,12,4,8
Monfroar,archimonde,384,druid,restoration,12,4,8
Baraforet,archimonde,384,druid,restoration,12,4,8
Танганэку,howling-fjord,384,druid,restoration,12,4,8
Bonesphera,sylvanas,384,druid,restoration,12,4,8
Enriya,blackhand,384,druid,restoration,12,4,8
Astrobazooka,stormreaver,384,druid,restoration,12,4,8
Totempiedzam,dalaran,384,druid,restoration,12,4,8
Muhlí,malygos,384,druid,restoration,12,4,8
Cumulisama,sylvanas,384,druid,restoration,12,4,8
Shapees,sylvanas,384,druid,restoration,12,4,8
Restolol,outland,384,druid,restoration,12,4,8
Mokeff,twisting-nether,384,druid,restoration,12,4,8
Hûibûh,eredar,384,druid,restoration,12,4,8
Bryzix,the-maelstrom,384,druid,restoration,12,4,8
Sìmbano,eredar,384,druid,restoration,12,4,8
Pedra,zuljin,384,druid,restoration,12,4,8
Råèkwøñ,ravencrest,384,druid,restoration,12,4,8
Togara,kazzak,384,druid,restoration,12,4,8
Momine,burning-blade,384,druid,restoration,12,4,8
Иная,grom,384,druid,restoration,12,4,8
Wheezygamer,aegwynn,384,druid,restoration,12,4,8
Muushu,aegwynn,384,druid,restoration,12,4,8
Youdog,kazzak,384,druid,restoration,12,4,8
Ðanøne,ysondre,384,druid,restoration,12,4,8
Xxîn,blackrock,384,druid,restoration,12,4,8
Wootbeam,silvermoon,384,druid,restoration,12,4,8
Shamelêss,eredar,384,druid,restoration,12,4,8
Littleogre,silvermoon,384,druid,restoration,12,4,8
Sqoopy,tarren-mill,384,druid,restoration,12,4,8
Toffyfee,anetheron,384,druid,restoration,12,4,8
Emsitua,draenor,384,druid,restoration,12,4,8
Northstarx,kazzak,384,druid,restoration,12,4,8
Exilliá,twisting-nether,384,druid,restoration,12,4,8
Dafidruid,argent-dawn,384,druid,restoration,12,4,8
Аренатренер,blackscar,384,druid,restoration,12,4,8
Curtainscall,kazzak,384,druid,restoration,12,4,8
Сулинея,blackscar,384,druid,restoration,12,4,8
Kobra,twilights-hammer,384,druid,restoration,12,4,8
Зурсага,deathguard,384,druid,restoration,12,4,8
Farmmygold,dun-modr,384,druid,restoration,12,4,8
Ravenfel,argent-dawn,384,druid,restoration,12,4,8
Litany,drakthul,384,druid,restoration,13,4,9
Bignunu,silvermoon,384,druid,restoration,18,4,14
Fiskmåsn,twisting-nether,384,druid,restoration,18,4,14
Vertabrain,twilights-hammer,384,druid,restoration,18,4,14
Revivication,aggramar,384,druid,restoration,18,4,14
Tacobender,tarren-mill,384,druid,restoration,18,4,14
Grunka,silvermoon,384,druid,restoration,18,4,14
Dmai,burning-legion,384,druid,restoration,18,4,14
Matmoo,hyjal,384,druid,restoration,18,4,14
Moolß,uldaman,384,druid,restoration,18,4,14
Nezara,kazzak,384,druid,restoration,18,4,14
Hrz,kazzak,384,druid,restoration,18,4,14
Ymagyne,frostmane,384,druid,restoration,24,4,20
Yøungreidzz,blackrock,384,druid,restoration,24,4,20
Termadol,kazzak,383,druid,restoration,6,4,2
Gaiinthewood,rexxar,383,druid,restoration,6,4,2
Бабазарулем,fordragon,383,druid,restoration,6,4,2
Yogui,zuljin,383,druid,restoration,6,4,2
Elurra,archimonde,383,druid,restoration,6,4,2
Jabbah,defias-brotherhood,383,druid,restoration,6,4,2
Cmfg,blackrock,383,druid,restoration,6,4,2
Santoniq,dun-morogh,383,druid,restoration,6,4,2
Rainwhisper,outland,383,druid,restoration,6,4,2
Ozy,emeriss,383,druid,restoration,6,4,2
Kyoshima,blackhand,383,druid,restoration,6,4,2
Noxndruid,blackhand,383,druid,restoration,12,4,8
Hefdgaharald,antonidas,383,druid,restoration,12,4,8
Eoinsriaops,hyjal,383,druid,restoration,12,4,8
Venh,forscherliga,383,druid,restoration,12,4,8
Druidguy,ghostlands,383,druid,restoration,12,4,8
Semenisback,archimonde,383,druid,restoration,12,4,8
Замакибо,howling-fjord,383,druid,restoration,12,4,8
Høpè,die-silberne-hand,383,druid,restoration,12,4,8
Arns,kazzak,383,druid,restoration,12,4,8
Prikolica,quelthalas,383,druid,restoration,12,4,8
Сигстейнхохо,blackscar,383,druid,restoration,12,4,8
Lazår,tarren-mill,383,druid,restoration,12,4,8
Mejlin,drakthul,383,druid,restoration,18,4,14
Itê,dun-morogh,383,druid,restoration,18,4,14
Leeonore,burning-legion,383,druid,restoration,18,4,14
Шикалат,howling-fjord,383,druid,restoration,24,4,20
Lyø,draenor,383,druid,restoration,24,4,20
Cowabanga,shattered-hand,382,druid,restoration,6,4,2
Bantha,hyjal,382,druid,restoration,6,4,2
Hauserqqt,auchindoun,382,druid,restoration,6,4,2
Xele,destromath,382,druid,restoration,6,4,2
Mongetout,ravencrest,382,druid,restoration,6,4,2
Девочкамиши,soulflayer,382,druid,restoration,10,6,4
Murma,dalaran,382,druid,restoration,12,4,8
Pega,nazjatar,382,druid,restoration,12,4,8
Sabflordr,outland,381,druid,restoration,12,4,8
Amalou,ravencrest,381,druid,restoration,12,4,8
Dolob,ragnaros,381,druid,restoration,18,4,14
Lewy,aegwynn,381,druid,restoration,18,4,14
Mômmôm,aggra-português,380,druid,restoration,18,4,14
Boomboox,kazzak,379,druid,restoration,15,5,10
Tranquillo,outland,379,druid,restoration,12,4,8
Фигоначи,soulflayer,379,druid,restoration,12,4,8
Teix,aggra-português,370,druid,restoration,30,7,23
Nøkki,draenor,367,druid,restoration,21,8,13
Jincksdru,anachronos,367,druid,restoration,11,4,7
Opla,nethersturm,366,druid,restoration,23,8,15
Siire,ravencrest,352,druid,restoration,10,4,6
Druidenee,hyjal,351,druid,restoration,8,5,3
Ríckø,ysondre,351,druid,restoration,8,5,3
Lyrvaz,ravencrest,351,druid,restoration,11,4,7
Ymöthep,archimonde,351,druid,restoration,11,4,7
Stkk,dun-modr,351,druid,restoration,11,4,7
Biegel,ysera,351,druid,restoration,11,4,7
Demerit,defias-brotherhood,351,druid,restoration,11,4,7
Moderjord,stormreaver,351,druid,restoration,14,5,9
Ysu,silvermoon,351,druid,restoration,25,5,20
Lyhene,outland,339,druid,restoration,32,8,24
Incheon,archimonde,335,druid,restoration,11,4,7
Querasidru,ravencrest,330,druid,restoration,16,5,11
Wuppii,blackmoore,329,druid,restoration,10,6,4
Swarmah,draenor,329,druid,restoration,18,5,13
Hubek,silvermoon,328,druid,restoration,8,6,2
Vhio,eredar,326,druid,restoration,12,5,7
Heav,kiljaeden,319,druid,restoration,7,4,3
Chéon,nethersturm,319,druid,restoration,10,4,6
Jirenthegrey,antonidas,318,druid,restoration,14,4,10
Mímír,frostmane,317,druid,restoration,10,4,6
Elsnorro,sylvanas,313,druid,restoration,19,5,14
Holographic,ravencrest,304,druid,restoration,7,4,3
Eftersmak,ravencrest,288,druid,restoration,6,3,3
Ghøstavdruid,ravencrest,288,druid,restoration,6,3,3
Polimorphism,tarren-mill,288,druid,restoration,6,3,3
Preda,thunderhorn,288,druid,restoration,6,3,3
Мореллоо,gordunni,288,druid,restoration,6,3,3
Luphrekmeow,ravencrest,288,druid,restoration,6,3,3
Thecousins,ravencrest,288,druid,restoration,6,3,3
Fluentgcds,ravencrest,288,druid,restoration,6,3,3
Blackdrd,archimonde,288,druid,restoration,6,3,3
Infernaltaxy,nemesis,288,druid,restoration,6,3,3
Noobr,ravencrest,288,druid,restoration,6,3,3
Armënovitch,ravencrest,288,druid,restoration,6,3,3
Koprogatos,twilights-hammer,288,druid,restoration,6,3,3
Астраджет,gordunni,288,druid,restoration,6,3,3
Tubeme,frostwolf,288,druid,restoration,6,3,3
Dharli,stormscale,288,druid,restoration,6,3,3
Fallken,burning-blade,288,druid,restoration,6,3,3
Whelpss,archimonde,288,druid,restoration,6,3,3
Numaresto,stormscale,288,druid,restoration,6,3,3
Thundruid,archimonde,288,druid,restoration,6,3,3
Kekferal,eredar,288,druid,restoration,6,3,3
Háléx,ravencrest,288,druid,restoration,6,3,3
Spielmann,ravencrest,288,druid,restoration,6,3,3
Soyzanahoriâ,zuljin,288,druid,restoration,6,3,3
Ñark,archimonde,288,druid,restoration,6,3,3
Mcbobb,ravencrest,288,druid,restoration,6,3,3
Jéssíé,silvermoon,288,druid,restoration,6,3,3
Haise,echsenkessel,288,druid,restoration,6,3,3
Vaspy,sylvanas,288,druid,restoration,6,3,3
Dimki,kazzak,288,druid,restoration,6,3,3
Couleaf,stormscale,288,druid,restoration,6,3,3
Semia,archimonde,288,druid,restoration,6,3,3
Àxilì,stormscale,288,druid,restoration,6,3,3
Darkömwz,ysondre,288,druid,restoration,6,3,3
Sliffar,azshara,288,druid,restoration,6,3,3
Eshäe,marécage-de-zangar,288,druid,restoration,6,3,3
Pâlarïns,dalaran,288,druid,restoration,6,3,3
Blacknarus,drakthul,288,druid,restoration,6,3,3
Qwopeiqpwoid,kazzak,288,druid,restoration,6,3,3
Shakenbake,grim-batol,288,druid,restoration,6,3,3
Juvencus,twisting-nether,288,druid,restoration,6,3,3
Beere,kazzak,288,druid,restoration,6,3,3
Bißear,archimonde,288,druid,restoration,6,3,3
Ipsdray,ysondre,288,druid,restoration,6,3,3
Luphrekfurry,ysondre,288,druid,restoration,6,3,3
Leahuwu,argent-dawn,288,druid,restoration,6,3,3
Pigcat,twisting-nether,288,druid,restoration,6,3,3
Cattu,argent-dawn,288,druid,restoration,6,3,3
Pipima,kazzak,288,druid,restoration,6,3,3
Npel,twisting-nether,288,druid,restoration,6,3,3
Nominell,kazzak,288,druid,restoration,6,3,3
Vinav,burning-legion,288,druid,restoration,6,3,3
Ullainho,stormscale,288,druid,restoration,6,3,3
Hutini,magtheridon,288,druid,restoration,6,3,3
Sportzdruid,argent-dawn,288,druid,restoration,6,3,3
Faustîno,dun-modr,288,druid,restoration,6,3,3
Hafsa,xavius,288,druid,restoration,6,3,3
Дробовик,soulflayer,288,druid,restoration,6,3,3
Laylie,aegwynn,288,druid,restoration,6,3,3
Healol,sanguino,288,druid,restoration,6,3,3
Druidtraîner,ysera,288,druid,restoration,6,3,3
Реллинг,gordunni,288,druid,restoration,6,3,3
Ærøßits,uldum,288,druid,restoration,6,3,3
Kajidru,frostmane,288,druid,restoration,6,3,3
Veganvapex,draenor,288,druid,restoration,6,3,3
Hð,blackmoore,288,druid,restoration,6,3,3
Currare,aegwynn,288,druid,restoration,6,3,3
Magiskeforme,draenor,288,druid,restoration,6,3,3
Skrewu,silvermoon,288,druid,restoration,6,3,3
Närgof,outland,288,druid,restoration,6,3,3
Blownaway,outland,288,druid,restoration,6,3,3
Shaakm,nerathor,288,druid,restoration,6,3,3
Nøur,blackmoore,288,druid,restoration,6,3,3
Kælýx,silvermoon,288,druid,restoration,6,3,3
Houkka,doomhammer,288,druid,restoration,6,3,3
Hoofysnoopy,outland,288,druid,restoration,6,3,3
Madnuzzmoo,draenor,288,druid,restoration,6,3,3
Qtdok,outland,288,druid,restoration,6,3,3
Dezcore,hyjal,288,druid,restoration,6,3,3
Treyni,outland,288,druid,restoration,6,3,3
ßot,hyjal,288,druid,restoration,6,3,3
Youngdipper,draenor,288,druid,restoration,6,3,3
Dystaleon,blackrock,288,druid,restoration,6,3,3
Owldschool,blackmoore,288,druid,restoration,6,3,3
Drullenobama,silvermoon,288,druid,restoration,6,3,3
Shyni,outland,288,druid,restoration,6,3,3
Zaethul,draenor,288,druid,restoration,6,3,3
Ærõxy,aegwynn,288,druid,restoration,6,3,3
Jobberwock,outland,288,druid,restoration,6,3,3
Lèafy,silvermoon,288,druid,restoration,6,3,3
Shìinx,hyjal,288,druid,restoration,6,3,3
Lolaven,turalyon,288,druid,restoration,6,3,3
Fairdul,blackmoore,288,druid,restoration,6,3,3
Lisunaria,silvermoon,288,druid,restoration,6,3,3
Droodyàz,hyjal,288,druid,restoration,6,3,3
Saadi,der-rat-von-dalaran,288,druid,restoration,6,3,3
Gehrkehotter,silvermoon,288,druid,restoration,6,3,3
Fx,mazrigos,288,druid,restoration,8,3,5
Sôalôgel,blackrock,288,druid,restoration,11,4,7
Piñaclonada,archimonde,288,druid,restoration,9,3,6
Æøiæn,blackmoore,288,druid,restoration,9,3,6
Draawun,burning-legion,288,druid,restoration,11,3,8
Smarticle,aegwynn,288,druid,restoration,11,3,8
Nostigon,azshara,288,druid,restoration,12,3,9
Sadgeconvoke,draenor,288,druid,restoration,12,3,9
Skrubbarn,frostmane,288,druid,restoration,12,3,9
Juicý,eredar,288,druid,restoration,12,3,9
Fejgi,stormreaver,288,druid,restoration,12,3,9
Marryat,argent-dawn,288,druid,restoration,12,3,9
Cheezy,defias-brotherhood,288,druid,restoration,12,3,9
Hérby,kazzak,288,druid,restoration,12,3,9
Doup,alakir,288,druid,restoration,12,3,9
Chapawee,eredar,288,druid,restoration,12,3,9
Xbrokeaf,eredar,288,druid,restoration,12,3,9
Awienx,kazzak,288,druid,restoration,12,3,9
Ezils,silvermoon,288,druid,restoration,12,3,9
Pelpes,dun-modr,288,druid,restoration,12,3,9
Ireso,kelthuzad,288,druid,restoration,12,3,9
Asharah,blutkessel,288,druid,restoration,12,3,9
Wheyproteín,dun-modr,288,druid,restoration,12,3,9
Coffeebean,twisting-nether,288,druid,restoration,12,3,9
Marlymeow,silvermoon,288,druid,restoration,12,3,9
Navra,ravencrest,288,druid,restoration,12,3,9
Xecksi,twisting-nether,288,druid,restoration,12,3,9
Vregord,twisting-nether,288,druid,restoration,12,3,9
Trolthelhas,chogall,288,druid,restoration,12,3,9
Restodruidx,ravencrest,288,druid,restoration,12,3,9
Lukøu,blackrock,288,druid,restoration,12,3,9
Megustatu,ravencrest,288,druid,restoration,12,3,9
Elxa,silvermoon,288,druid,restoration,12,3,9
Sojiz,outland,288,druid,restoration,12,3,9
Jonnaxø,ravencrest,288,druid,restoration,12,3,9
Ajày,sylvanas,288,druid,restoration,12,3,9
Footfame,kazzak,288,druid,restoration,12,3,9
Smallspoon,stormscale,288,druid,restoration,12,3,9
Phatzoo,stormscale,288,druid,restoration,12,3,9
Nebrahl,silvermoon,288,druid,restoration,12,3,9
Basedgôd,alakir,288,druid,restoration,12,3,9
Amazed,wildhammer,288,druid,restoration,12,3,9
Transgînger,blackmoore,288,druid,restoration,12,3,9
Bluebear,der-rat-von-dalaran,288,druid,restoration,12,3,9
Tbgw,stormscale,288,druid,restoration,12,3,9
Rzo,blackmoore,288,druid,restoration,12,3,9
Còwgummi,blackhand,288,druid,restoration,12,3,9
Ragingliam,emerald-dream,288,druid,restoration,12,3,9
Emeskay,ravencrest,288,druid,restoration,12,3,9
Teah,darkmoon-faire,288,druid,restoration,12,3,9
Xåy,der-rat-von-dalaran,288,druid,restoration,12,3,9
Ritualofmoon,darkmoon-faire,288,druid,restoration,12,3,9
Shiotake,hyjal,288,druid,restoration,12,3,9
Киряаниме,gordunni,288,druid,restoration,12,3,9
Snowlight,der-rat-von-dalaran,288,druid,restoration,12,3,9
Джоннчек,gordunni,288,druid,restoration,12,3,9
Храмульчик,blackscar,288,druid,restoration,12,3,9
Raila,pozzo-delleternità,288,druid,restoration,12,3,9
Reehzx,ravencrest,288,druid,restoration,12,3,9
Areidhel,pozzo-delleternità,288,druid,restoration,12,3,9
Kiirsi,arygos,288,druid,restoration,12,3,9
Nyùú,dun-morogh,288,druid,restoration,12,3,9
Harrasmoes,ravencrest,288,druid,restoration,12,3,9
Eusébus,ysondre,288,druid,restoration,13,3,10
Gámóra,argent-dawn,288,druid,restoration,18,3,15
Astralpandas,kazzak,288,druid,restoration,18,3,15
Boomdruud,tarren-mill,288,druid,restoration,18,3,15
Rakuy,thrall,288,druid,restoration,18,3,15
Brokul,kazzak,288,druid,restoration,18,3,15
Dadyheals,kazzak,288,druid,restoration,18,3,15
Amstaffio,blackhand,288,druid,restoration,18,3,15
Belisw,silvermoon,288,druid,restoration,18,3,15
Квазарм,gordunni,288,druid,restoration,18,3,15
Eyune,tarren-mill,288,druid,restoration,24,3,21
Youngjin,ravencrest,287,druid,restoration,6,3,3
Nehalem,blackrock,287,druid,restoration,6,3,3
Villetta,aegwynn,287,druid,restoration,6,3,3
Lalou,saurfang,287,druid,restoration,6,3,3
Ятвоямяу,howling-fjord,287,druid,restoration,6,3,3
Smittly,bloodhoof,287,druid,restoration,6,3,3
Foxîo,frostmane,287,druid,restoration,6,3,3
Mgelolaf,doomhammer,287,druid,restoration,6,3,3
Touchpad,archimonde,287,druid,restoration,6,3,3
Kuhlheit,der-rat-von-dalaran,287,druid,restoration,6,3,3
Lundx,ravencrest,287,druid,restoration,6,3,3
Grimmie,frostmane,287,druid,restoration,6,3,3
Dorjeè,defias-brotherhood,287,druid,restoration,6,3,3
Zethane,ragnaros,287,druid,restoration,6,3,3
Jeepers,quelthalas,287,druid,restoration,12,3,9
Senul,sanguino,287,druid,restoration,12,3,9
Reckóning,draenor,287,druid,restoration,12,3,9
Xulian,exodar,287,druid,restoration,12,3,9
Papalegba,kilrogg,287,druid,restoration,12,3,9
Lamsélår,ravencrest,287,druid,restoration,12,3,9
Лёшациклонх,deathguard,287,druid,restoration,12,3,9
Grimbear,hellfire,287,druid,restoration,18,3,15
Ìncubus,pozzo-delleternità,287,druid,restoration,24,3,21
Kebanos,ravencrest,286,druid,restoration,6,3,3
Analterorist,chamber-of-aspects,286,druid,restoration,6,3,3
Paniel,amanthul,286,druid,restoration,6,3,3
Kittenmitten,ragnaros,286,druid,restoration,12,3,9
Anniko,garona,286,druid,restoration,18,3,15
Elônea,antonidas,285,druid,restoration,12,3,9
Адаладиус,howling-fjord,285,druid,restoration,42,3,39
Charlierunkl,gorgonnash,283,druid,restoration,24,3,21
Smradzblech,drakthul,275,druid,restoration,25,6,19
Niél,sylvanas,271,druid,restoration,17,3,14
Bunga,quelthalas,255,druid,restoration,11,3,8
Kaliyuga,dalaran,255,druid,restoration,11,3,8
Yopi,stormscale,240,druid,restoration,15,3,12
Taqul,silvermoon,239,druid,restoration,5,3,2
Amélor,ragnaros,239,druid,restoration,5,3,2
Woodbison,tarren-mill,239,druid,restoration,5,3,2
Foqua,twisting-nether,239,druid,restoration,8,3,5
Tyariel,die-aldor,238,druid,restoration,5,3,2
Lxz,blackhand,234,druid,restoration,8,4,4
Hamilina,thunderhorn,234,druid,restoration,9,4,5
Noegang,hyjal,234,druid,restoration,15,5,10
Rowlet,twisting-nether,234,druid,restoration,12,4,8
Therøn,dun-modr,234,druid,restoration,17,5,12
Beerplusbeer,kazzak,234,druid,restoration,23,6,17
Bigdambitex,draenor,234,druid,restoration,16,4,12
Àlec,silvermoon,234,druid,restoration,17,4,13
Æîîs,blackrock,234,druid,restoration,35,5,30
Lynaee,cthun,224,druid,restoration,10,3,7
Razorleaf,turalyon,222,druid,restoration,14,3,11
Öakenheart,kazzak,208,druid,restoration,7,3,4
Trydru,blackmoore,192,druid,restoration,9,3,6
Wolfhealer,blackmoore,192,druid,restoration,9,3,6
Forigiver,draenor,192,druid,restoration,6,2,4
Mjáy,tarren-mill,192,druid,restoration,6,2,4
Drøda,aegwynn,192,druid,restoration,6,2,4
Scar,dentarg,192,druid,restoration,6,2,4
Zì,stormscale,192,druid,restoration,6,2,4
Héryse,hyjal,192,druid,restoration,6,2,4
Miyukíí,ravencrest,192,druid,restoration,6,2,4
Jamley,tarren-mill,192,druid,restoration,6,2,4
Arijel,die-aldor,192,druid,restoration,6,2,4
Baldhir,nemesis,192,druid,restoration,6,2,4
Droigan,die-aldor,192,druid,restoration,6,2,4
Lenays,die-aldor,192,druid,restoration,6,2,4
Xérà,blackmoore,192,druid,restoration,6,2,4
Sleepz,blackrock,192,druid,restoration,6,2,4
Шокоокулист,gordunni,192,druid,restoration,6,2,4
Akeha,stormscale,192,druid,restoration,6,2,4
Kÿara,khaz-modan,192,druid,restoration,6,2,4
Tkusernamez,stormscale,192,druid,restoration,6,2,4
Praythysun,khaz-modan,192,druid,restoration,6,2,4
Vandalís,garrosh,192,druid,restoration,6,2,4
Кенарейка,howling-fjord,192,druid,restoration,6,2,4
Nyrociel,pozzo-delleternità,192,druid,restoration,6,2,4
Друшл,howling-fjord,192,druid,restoration,6,2,4
Sajlol,doomhammer,192,druid,restoration,6,2,4
Rngmåchinéx,ravencrest,192,druid,restoration,6,2,4
Zenkillers,outland,192,druid,restoration,6,2,4
Náiledx,stormscale,192,druid,restoration,6,2,4
Yourßâßygîrl,sylvanas,192,druid,restoration,6,2,4
Оладентик,howling-fjord,192,druid,restoration,6,2,4
Чанголист,howling-fjord,192,druid,restoration,6,2,4
Slimsneeky,outland,192,druid,restoration,6,2,4
Cylàn,sylvanas,192,druid,restoration,6,2,4
Rtxy,hyjal,192,druid,restoration,6,2,4
Zuta,ragnaros,192,druid,restoration,6,2,4
Disney,ragnaros,192,druid,restoration,6,2,4
Ciucciotutto,nemesis,192,druid,restoration,6,2,4
Luuvli,tarren-mill,192,druid,restoration,6,2,4
Пикаббука,gordunni,192,druid,restoration,6,2,4
Реймика,gordunni,192,druid,restoration,6,2,4
Yerachmiel,argent-dawn,192,druid,restoration,6,2,4
Megaball,sylvanas,192,druid,restoration,6,2,4
Ekxn,archimonde,192,druid,restoration,6,2,4
Falconn,outland,192,druid,restoration,6,2,4
Vermz,tarren-mill,192,druid,restoration,6,2,4
Hotseîdank,blackrock,192,druid,restoration,6,2,4
Naraël,varimathras,192,druid,restoration,6,2,4
Xerrean,ravencrest,192,druid,restoration,6,2,4
Griminal,norgannon,192,druid,restoration,6,2,4
Morphael,ravencrest,192,druid,restoration,6,2,4
Muundar,stormscale,192,druid,restoration,6,2,4
Bulleyo,ysondre,192,druid,restoration,6,2,4
Lootmann,die-silberne-hand,192,druid,restoration,6,2,4
Bøa,twisting-nether,192,druid,restoration,6,2,4
Kremhelt,outland,192,druid,restoration,6,2,4
Lefancytrash,ravencrest,192,druid,restoration,6,2,4
Harryjane,antonidas,192,druid,restoration,6,2,4
Yugelbaum,twisting-nether,192,druid,restoration,6,2,4
Deép,nazjatar,192,druid,restoration,6,2,4
Restoboi,stormscale,192,druid,restoration,6,2,4
Gaiaa,kilrogg,192,druid,restoration,6,2,4
Ðarach,ravencrest,192,druid,restoration,6,2,4
Uptoyou,defias-brotherhood,192,druid,restoration,6,2,4
Sekunden,ravencrest,192,druid,restoration,6,2,4
Healnau,aegwynn,192,druid,restoration,6,2,4
Блиденг,gordunni,192,druid,restoration,6,2,4
Reyai,ravencrest,192,druid,restoration,6,2,4
Märkis,minahonda,192,druid,restoration,6,2,4
Almuntaqim,ravencrest,192,druid,restoration,6,2,4
Crâshley,sargeras,192,druid,restoration,6,2,4
Луноэльф,gordunni,192,druid,restoration,6,2,4
Celitharion,tarren-mill,192,druid,restoration,6,2,4
Chrisdruid,argent-dawn,192,druid,restoration,6,2,4
Bosco,blutkessel,192,druid,restoration,6,2,4
Docdru,antonidas,192,druid,restoration,6,2,4
Адорабэль,deathguard,192,druid,restoration,6,2,4
Faintntt,outland,192,druid,restoration,6,2,4
Кейсильда,soulflayer,192,druid,restoration,6,2,4
Эйяфлятлайок,gordunni,192,druid,restoration,6,2,4
Conn,ravencrest,192,druid,restoration,6,2,4
Tandstickan,auchindoun,192,druid,restoration,6,2,4
Tàazz,sargeras,192,druid,restoration,6,2,4
Palavanus,stormscale,192,druid,restoration,6,2,4
Limmiited,ravencrest,192,druid,restoration,6,2,4
Laithie,draenor,192,druid,restoration,6,2,4
Kaldon,thrall,192,druid,restoration,6,2,4
Droodu,dun-modr,192,druid,restoration,6,2,4
Zhiwé,ravencrest,192,druid,restoration,6,2,4
Fumalia,sanguino,192,druid,restoration,6,2,4
Borticow,sanguino,192,druid,restoration,6,2,4
Tarostar,frostmane,192,druid,restoration,6,2,4
Skavenlol,zuljin,192,druid,restoration,6,2,4
Príimé,kazzak,192,druid,restoration,6,2,4
Beluga,uldum,192,druid,restoration,6,2,4
Benjiee,kazzak,192,druid,restoration,6,2,4
Hydrochronic,ravencrest,192,druid,restoration,6,2,4
Heejåe,archimonde,192,druid,restoration,6,2,4
Nooz,thrall,192,druid,restoration,6,2,4
Zandu,eredar,192,druid,restoration,6,2,4
Trusten,nemesis,192,druid,restoration,6,2,4
Luznyczeslaw,burning-legion,192,druid,restoration,6,2,4
Атитока,goldrinn,192,druid,restoration,6,2,4
Cpt,xavius,192,druid,restoration,6,2,4
Mäismz,hyjal,192,druid,restoration,6,2,4
Bärenmarke,alleria,192,druid,restoration,6,2,4
Nyrrh,blackmoore,192,druid,restoration,6,2,4
Cuzzywuzzy,ragnaros,192,druid,restoration,6,2,4
Imbadxx,kazzak,192,druid,restoration,6,2,4
Moodee,kazzak,192,druid,restoration,6,2,4
Nourishshen,silvermoon,192,druid,restoration,6,2,4
Kkona,silvermoon,192,druid,restoration,6,2,4
Treenaa,silvermoon,192,druid,restoration,6,2,4
Zerpent,silvermoon,192,druid,restoration,6,2,4
Revølter,kazzak,192,druid,restoration,6,2,4
Underdog,kazzak,192,druid,restoration,6,2,4
Naturedork,kazzak,192,druid,restoration,6,2,4
Naturnørd,kazzak,192,druid,restoration,6,2,4
Heligakatten,twisting-nether,192,druid,restoration,10,3,7
Blubberfish,silvermoon,192,druid,restoration,8,2,6
Gonco,blackrock,192,druid,restoration,8,2,6
Degendruid,silvermoon,192,druid,restoration,20,4,16
Shaggí,draenor,192,druid,restoration,11,2,9
Mahero,outland,192,druid,restoration,12,2,10
Thymesia,outland,192,druid,restoration,12,2,10
Sök,hyjal,192,druid,restoration,12,2,10
Lyj,dalaran,192,druid,restoration,12,2,10
Billsmafia,draenor,192,druid,restoration,12,2,10
Eljinso,blackhand,192,druid,restoration,12,2,10
Imperador,tyrande,192,druid,restoration,12,2,10
Qocotte,archimonde,192,druid,restoration,12,2,10
Skorpo,blackrock,192,druid,restoration,12,2,10
Qdrood,quelthalas,192,druid,restoration,12,2,10
Drâcâ,antonidas,192,druid,restoration,12,2,10
Amaaja,blackmoore,192,druid,restoration,12,2,10
Jul,kelthuzad,192,druid,restoration,12,2,10
Jacksonella,dun-morogh,192,druid,restoration,12,2,10
Anníe,tarren-mill,192,druid,restoration,12,2,10
Maceyx,ravencrest,192,druid,restoration,12,2,10
Nakkikastike,magtheridon,192,druid,restoration,12,2,10
Quentalius,argent-dawn,192,druid,restoration,12,2,10
Kizanimagus,magtheridon,192,druid,restoration,12,2,10
Blâckrök,blackhand,192,druid,restoration,12,2,10
Keløkss,silvermoon,192,druid,restoration,12,2,10
Testomake,kazzak,192,druid,restoration,12,2,10
Rumî,blackhand,192,druid,restoration,12,2,10
Snapeshifter,blackhand,192,druid,restoration,12,2,10
Wahahoo,la-croisade-écarlate,192,druid,restoration,12,2,10
Салона,deathguard,192,druid,restoration,12,2,10
Asteria,earthen-ring,192,druid,restoration,12,2,10
Sveraés,draenor,192,druid,restoration,12,2,10
Tayswiftmend,defias-brotherhood,192,druid,restoration,12,2,10
Louisv,kazzak,192,druid,restoration,12,2,10
Penywiser,sylvanas,192,druid,restoration,12,2,10
Piper,culte-de-la-rive-noire,192,druid,restoration,12,2,10
Álou,dalaran,192,druid,restoration,12,2,10
Zeustriker,draenor,192,druid,restoration,12,2,10
Ealith,sylvanas,192,druid,restoration,12,2,10
Milfurion,emerald-dream,192,druid,restoration,12,2,10
Kenvello,ragnaros,192,druid,restoration,12,2,10
Helpthebear,twisting-nether,192,druid,restoration,12,2,10
Jagogi,malfurion,192,druid,restoration,12,2,10
Màf,silvermoon,192,druid,restoration,12,2,10
Lupiñ,sylvanas,192,druid,restoration,12,2,10
Bigstop,kazzak,192,druid,restoration,17,2,15
Luluheilt,antonidas,192,druid,restoration,18,2,16
Andonius,confrérie-du-thorium,192,druid,restoration,18,2,16
Galerion,ragnaros,192,druid,restoration,18,2,16
Quza,lightbringer,192,druid,restoration,18,2,16
Madmanz,arathor,192,druid,restoration,18,2,16
Охломон,gordunni,192,druid,restoration,24,2,22
Aütumn,twisting-nether,191,druid,restoration,9,3,6
Зулгасилич,howling-fjord,191,druid,restoration,6,2,4
Trolnatos,exodar,191,druid,restoration,6,2,4
Касалапый,thermaplugg,191,druid,restoration,6,2,4
Morphintime,nordrassil,191,druid,restoration,6,2,4
Oldghost,doomhammer,191,druid,restoration,6,2,4
Bingó,blutkessel,191,druid,restoration,6,2,4
Siyoo,thrall,191,druid,restoration,6,2,4
Bönüs,cthun,191,druid,restoration,6,2,4
Lodne,defias-brotherhood,191,druid,restoration,6,2,4
Zackuqtkitty,blackmoore,191,druid,restoration,6,2,4
Лолэтохег,soulflayer,191,druid,restoration,12,2,10
Westbeast,doomhammer,191,druid,restoration,12,2,10
Эхосна,howling-fjord,191,druid,restoration,12,2,10
Aeyrine,archimonde,191,druid,restoration,18,2,16
Natur,gorgonnash,191,druid,restoration,18,2,16
Bwonsamndi,frostwolf,191,druid,restoration,18,2,16
Ardy,echsenkessel,191,druid,restoration,18,2,16
Trarus,nazjatar,191,druid,restoration,23,2,21
Marynlord,dalaran,175,druid,restoration,11,2,9
Menance,draenor,175,druid,restoration,11,2,9
Knekkebrøød,ravencrest,169,druid,restoration,11,4,7
Maw,hellfire,159,druid,restoration,5,2,3
Zvyn,draenor,159,druid,restoration,5,2,3
Zayrok,throkferoth,159,druid,restoration,8,3,5
Кукубой,deathguard,158,druid,restoration,26,3,23
Кимоношка,gordunni,149,druid,restoration,31,14,17
Ихет,gordunni,144,druid,restoration,9,3,6
Сугрик,deathweaver,143,druid,restoration,15,2,13
Starcrash,amanthul,138,druid,restoration,6,3,3
Milknosugar,tarren-mill,138,druid,restoration,7,3,4
Айтера,goldrinn,138,druid,restoration,7,3,4
Oaksage,kazzak,138,druid,restoration,8,3,5
Ðrøøði,dun-modr,138,druid,restoration,8,3,5
Zzblaah,archimonde,138,druid,restoration,10,3,7
Chauntee,draenor,138,druid,restoration,15,3,12
Yushuliene,sanguino,137,druid,restoration,9,3,6
Arcanís,draenor,128,druid,restoration,10,2,8
Preform,burning-legion,112,druid,restoration,7,2,5
Trä,earthen-ring,96,druid,restoration,3,2,1
Tigedur,ravencrest,96,druid,restoration,12,2,10
Gintoni,dun-modr,96,druid,restoration,6,1,5
Chapuk,kazzak,96,druid,restoration,6,1,5
Nikta,trollbane,96,druid,restoration,6,1,5
Амеллида,soulflayer,96,druid,restoration,6,1,5
Trekkertt,zuljin,96,druid,restoration,6,1,5
Enfy,lightbringer,96,druid,restoration,6,1,5
Misumisi,sanguino,96,druid,restoration,6,1,5
Ragnahr,sanguino,96,druid,restoration,6,1,5
Puraza,kazzak,96,druid,restoration,6,1,5
Ka,the-maelstrom,96,druid,restoration,6,1,5
Жарищка,soulflayer,96,druid,restoration,6,1,5
Wildsoûl,kazzak,96,druid,restoration,6,1,5
Miscodedru,twisting-nether,96,druid,restoration,6,1,5
Gløbalzx,aegwynn,96,druid,restoration,6,1,5
Haginator,twisting-nether,96,druid,restoration,6,1,5
Moonfay,kazzak,96,druid,restoration,6,1,5
Kruwkamilka,burning-legion,96,druid,restoration,6,1,5
Deezforms,kazzak,96,druid,restoration,6,1,5
Ilsar,burning-legion,96,druid,restoration,6,1,5
Manbeardruid,twisting-nether,96,druid,restoration,6,1,5
Aiwendil,alakir,96,druid,restoration,6,1,5
Kweelor,der-abyssische-rat,96,druid,restoration,6,1,5
Сейтил,deathguard,96,druid,restoration,6,1,5
Grosminouu,dalaran,96,druid,restoration,6,1,5
Sozu,magtheridon,96,druid,restoration,6,1,5
Пасторизсша,soulflayer,96,druid,restoration,6,1,5
Bazikk,kazzak,96,druid,restoration,6,1,5
Kisyqt,aegwynn,96,druid,restoration,6,1,5
Elzoido,kazzak,96,druid,restoration,6,1,5
Naturaven,sylvanas,96,druid,restoration,6,1,5
Nuggetspøwa,dalaran,96,druid,restoration,6,1,5
Cryßye,ragnaros,96,druid,restoration,6,1,5
Xaralius,das-syndikat,96,druid,restoration,6,1,5
Nanuu,sylvanas,96,druid,restoration,6,1,5
Jïng,hyjal,96,druid,restoration,6,1,5
Chimmi,ragnaros,96,druid,restoration,6,1,5
Blodemoon,ragnaros,96,druid,restoration,6,1,5
Klarimgeist,mannoroth,96,druid,restoration,6,1,5
Gardã,ragnaros,96,druid,restoration,6,1,5
Madmoss,twisting-nether,96,druid,restoration,6,1,5
Элнут,gordunni,96,druid,restoration,6,1,5
Злодзейка,gordunni,96,druid,restoration,6,1,5
Тзейн,howling-fjord,96,druid,restoration,6,1,5
Elarc,khaz-modan,96,druid,restoration,6,1,5
Thebartender,khaz-modan,96,druid,restoration,6,1,5
Droodae,hyjal,96,druid,restoration,6,1,5
Skìzzy,stormscale,96,druid,restoration,6,1,5
Fedelmae,nagrand,96,druid,restoration,6,1,5
Дрейнсол,gordunni,96,druid,restoration,6,1,5
Sermando,blackrock,96,druid,restoration,6,1,5
Обриад,gordunni,96,druid,restoration,6,1,5
Eïdendog,hyjal,96,druid,restoration,6,1,5
Cowárd,blackmoore,96,druid,restoration,6,1,5
Hotterhot,blackhand,96,druid,restoration,6,1,5
Броша,gordunni,96,druid,restoration,6,1,5
Goldencat,blackhand,96,druid,restoration,6,1,5
Clonuts,sylvanas,96,druid,restoration,6,1,5
Mynilia,blackhand,96,druid,restoration,6,1,5
Винш,grom,96,druid,restoration,6,1,5
Kaliapari,nefarian,96,druid,restoration,6,1,5
Ðîwø,blackhand,96,druid,restoration,6,1,5
Cumcowshot,sylvanas,96,druid,restoration,6,1,5
Meisterd,aegwynn,96,druid,restoration,6,1,5
Dízzy,malganis,96,druid,restoration,6,1,5
Nwal,thunderhorn,96,druid,restoration,6,1,5
Sevá,sylvanas,96,druid,restoration,6,1,5
Blytz,ravencrest,96,druid,restoration,6,1,5
Utuabzu,grim-batol,96,druid,restoration,6,1,5
Valoruk,ravencrest,96,druid,restoration,6,1,5
Altore,ravencrest,96,druid,restoration,6,1,5
Blanoz,ravencrest,96,druid,restoration,6,1,5
Lackofexp,ravencrest,96,druid,restoration,6,1,5
Tuzuku,frostmane,96,druid,restoration,6,1,5
Nøunøurss,dalaran,96,druid,restoration,6,1,5
Malurith,silvermoon,96,druid,restoration,6,1,5
Bëckah,kazzak,96,druid,restoration,6,1,5
Phiero,ravencrest,96,druid,restoration,6,1,5
Ralorenz,ravencrest,96,druid,restoration,6,1,5
Stefun,kazzak,96,druid,restoration,6,1,5
Joppartok,outland,96,druid,restoration,6,1,5
Mvpx,outland,96,druid,restoration,6,1,5
Seekíng,blackmoore,96,druid,restoration,6,1,5
Vionia,alexstrasza,96,druid,restoration,6,1,5
Vicedxo,kazzak,96,druid,restoration,6,1,5
Réalmadruid,archimonde,96,druid,restoration,6,1,5
Thaïs,blackmoore,96,druid,restoration,6,1,5
Smah,archimonde,96,druid,restoration,6,1,5
Teryx,blackmoore,96,druid,restoration,6,1,5
Durlehardu,archimonde,96,druid,restoration,6,1,5
Johnybalker,hyjal,96,druid,restoration,6,1,5
Kerydwen,silvermoon,96,druid,restoration,6,1,5
Tanulia,senjin,96,druid,restoration,6,1,5
Ilikecaipi,eredar,96,druid,restoration,6,1,5
Trippieboy,eredar,96,druid,restoration,6,1,5
Tshungubuäch,eredar,96,druid,restoration,6,1,5
Pølïna,ysondre,96,druid,restoration,6,1,5
Hélioxine,ysondre,96,druid,restoration,6,1,5
Shapeer,hellscream,96,druid,restoration,6,1,5
Celestiella,turalyon,96,druid,restoration,6,1,5
Effi,aggramar,96,druid,restoration,6,1,5
Druiruu,tarren-mill,96,druid,restoration,6,1,5
Kouribow,sargeras,96,druid,restoration,6,1,5
Natåsha,argent-dawn,96,druid,restoration,6,1,5
Horadruid,silvermoon,96,druid,restoration,6,1,5
Winstonka,doomhammer,96,druid,restoration,6,1,5
Sylindra,argent-dawn,96,druid,restoration,6,1,5
Craycrays,argent-dawn,96,druid,restoration,6,1,5
Towaha,outland,96,druid,restoration,6,1,5
Blackird,argent-dawn,96,druid,restoration,6,1,5
Druvian,argent-dawn,96,druid,restoration,6,1,5
Exist,kul-tiras,96,druid,restoration,6,1,5
Ayåshi,tarren-mill,96,druid,restoration,6,1,5
Catzoro,tarren-mill,96,druid,restoration,6,1,5
Monopolying,dentarg,96,druid,restoration,6,1,5
Tardej,tarren-mill,96,druid,restoration,6,1,5
Syberka,burning-blade,96,druid,restoration,6,1,5
Druidguden,tarren-mill,96,druid,restoration,6,1,5
Zulk,draenor,96,druid,restoration,6,1,5
Jordnötssmör,draenor,96,druid,restoration,6,1,5
Fikd,draenor,96,druid,restoration,6,1,5
Khaoix,draenor,96,druid,restoration,6,1,5
Vaizier,defias-brotherhood,96,druid,restoration,6,1,5
Ninetyseven,outland,96,druid,restoration,6,1,5
Mommonga,onyxia,96,druid,restoration,6,1,5
Lunarveil,draenor,96,druid,restoration,6,1,5
Linkin,azshara,96,druid,restoration,6,1,5
Sodapop,aszune,96,druid,restoration,6,1,5
Doodud,twisting-nether,96,druid,restoration,7,1,6
Faladriel,zirkel-des-cenarius,96,druid,restoration,7,1,6
Zanorákma,ravencrest,96,druid,restoration,8,1,7
Maaghera,silvermoon,96,druid,restoration,11,1,10
Ra,stormscale,96,druid,restoration,12,1,11
Mariss25076F,chogall,96,druid,restoration,12,1,11
Radagas,malygos,96,druid,restoration,12,1,11
Alfadera,kazzak,96,druid,restoration,12,1,11
Kli,los-errantes,96,druid,restoration,12,1,11
Athenex,azshara,96,druid,restoration,12,1,11
Kindret,dun-modr,96,druid,restoration,12,1,11
Feminhacked,outland,96,druid,restoration,12,1,11
Forbode,darkspear,96,druid,restoration,12,1,11
Püpply,antonidas,96,druid,restoration,12,1,11
Xilmai,darksorrow,96,druid,restoration,12,1,11
Avalora,the-maelstrom,96,druid,restoration,12,1,11
Hecaloth,drakthul,96,druid,restoration,12,1,11
Pesza,bloodscalp,96,druid,restoration,12,1,11
Phëys,hyjal,96,druid,restoration,12,1,11
Tafs,stormscale,96,druid,restoration,12,1,11
Meowmeowmeow,stormscale,96,druid,restoration,12,1,11
Svartvit,sylvanas,96,druid,restoration,12,1,11
Tauh,blackhand,96,druid,restoration,12,1,11
Griimmjjow,kazzak,96,druid,restoration,12,1,11
Blark,sylvanas,96,druid,restoration,12,1,11
Лапунька,gordunni,96,druid,restoration,12,1,11
Fûzzybear,ravencrest,96,druid,restoration,12,1,11
Чупакамра,gordunni,96,druid,restoration,12,1,11
Blietmachine,ravencrest,96,druid,restoration,12,1,11
Келиса,blackscar,96,druid,restoration,12,1,11
Valfreya,nemesis,96,druid,restoration,12,1,11
Drudd,hellscream,96,druid,restoration,12,1,11
Nevthren,aggra-português,96,druid,restoration,12,1,11
Kittycatmeow,stormscale,96,druid,restoration,12,1,11
Napukka,silvermoon,96,druid,restoration,12,1,11
Kûmo,blackmoore,96,druid,restoration,12,1,11
Raveous,tarren-mill,96,druid,restoration,18,1,17
Woolee,area-52,96,druid,restoration,18,1,17
Anahots,silvermoon,96,druid,restoration,18,1,17
Chijara,destromath,95,druid,restoration,6,1,5
Undomíel,antonidas,95,druid,restoration,6,1,5
Lübka,amanthul,95,druid,restoration,12,1,11
Bëniheal,la-croisade-écarlate,95,druid,restoration,12,1,11
Arayura,kirin-tor,95,druid,restoration,18,1,17
Acidbrate,aegwynn,90,druid,restoration,12,3,9
Jý,die-arguswacht,84,druid,restoration,17,4,13
Watchmymoon,blackrock,84,druid,restoration,20,4,16
Дарзамат,blackscar,79,druid,restoration,5,1,4
Sealife,destromath,79,druid,restoration,5,1,4
Tuskid,hellscream,79,druid,restoration,11,1,10
Bartige,blackmoore,73,druid,restoration,19,6,13
Mooji,darksorrow,66,druid,restoration,25,7,18
Lebrochet,medivh,64,druid,restoration,4,1,3
Rasserdruid,runetotem,63,druid,restoration,2,2,0
Jaykerlol,kazzak,48,druid,restoration,3,1,2
Shaolinkilla,ragnaros,48,druid,restoration,9,1,8
Iloveluci,ravencrest,42,druid,restoration,8,3,5
Quizdarude,draenor,42,druid,restoration,10,3,7
Mnee,steamwheedle-cartel,42,druid,restoration,7,2,5
Merawr,ravencrest,42,druid,restoration,8,2,6
Growlithe,hellfire,42,druid,restoration,8,2,6
Lamyty,antonidas,42,druid,restoration,8,2,6
Zedomeld,auchindoun,42,druid,restoration,8,2,6
Kidawi,frostwolf,42,druid,restoration,13,3,10
Feráx,doomhammer,42,druid,restoration,9,2,7
Rédbullz,silvermoon,42,druid,restoration,9,2,7
Eceria,the-maelstrom,42,druid,restoration,9,2,7
Amadi,grim-batol,42,druid,restoration,9,2,7
Nytaleas,naxxramas,42,druid,restoration,10,2,8
Pornheal,drakthul,42,druid,restoration,10,2,8
Fâucon,eitrigg,42,druid,restoration,16,3,13
Jimboza,stormscale,42,druid,restoration,11,2,9
Uniquz,sylvanas,42,druid,restoration,11,2,9
Vanarea,argent-dawn,42,druid,restoration,14,2,12
Druiden,the-maelstrom,31,druid,restoration,2,1,1
Sendä,hyjal,31,druid,restoration,3,1,2
Bulleyo,ysondre,1588,druid,guardian,148,78,70
Djemdruid,argent-dawn,1585,druid,guardian,42,18,24
Сверххищникк,soulflayer,1409,druid,guardian,172,91,81
Sleepykitty,argent-dawn,1298,druid,guardian,229,105,124
Blacksagex,dragonmaw,1251,druid,guardian,129,50,79
Reshifted,sunstrider,1220,druid,guardian,185,90,95
Laracroft,the-maelstrom,1210,druid,guardian,28,14,14
Lioky,dun-modr,1184,druid,guardian,54,25,29
Windythemilf,stormscale,1180,druid,guardian,201,99,102
Вестхем,howling-fjord,1170,druid,guardian,108,52,56
Rbgbear,blackhand,1156,druid,guardian,36,15,21
Rapatera,argent-dawn,1115,druid,guardian,24,12,12
Ластгодх,soulflayer,1064,druid,guardian,47,22,25
Durlehardu,archimonde,1018,druid,guardian,59,27,32
Микайо,goldrinn,986,druid,guardian,41,17,24
Avior,eonar,981,druid,guardian,279,132,147
Crazydudu,tarren-mill,977,druid,guardian,68,25,43
Renaissancee,silvermoon,943,druid,guardian,68,21,47
Овлай,razuvious,894,druid,guardian,36,19,17
Avisa,blackhand,793,druid,guardian,203,91,112
Bigdomas,sylvanas,757,druid,guardian,52,21,31
Ноорру,gordunni,715,druid,guardian,11,8,3
Ксидронис,eversong,687,druid,guardian,22,8,14
Critter,kargath,661,druid,guardian,24,7,17
Kïnjuk,archimonde,658,druid,guardian,54,15,39
Гибрайт,soulflayer,623,druid,guardian,15,7,8
Fatalis,zuljin,573,druid,guardian,18,6,12
Beörñ,hyjal,568,druid,guardian,18,6,12
Win,hellscream,496,druid,guardian,23,7,16
Brisemeute,kirin-tor,480,druid,guardian,6,5,1
Tibaz,sylvanas,480,druid,guardian,12,5,7
Slotheron,ravencrest,480,druid,guardian,18,5,13
Гохгерункянк,soulflayer,477,druid,guardian,12,5,7
Sheâ,nemesis,476,druid,guardian,12,5,7
Xangy,drakthul,467,druid,guardian,22,8,14
Wildsoûl,kazzak,425,druid,guardian,27,6,21
Gimlis,area-52,384,druid,guardian,6,4,2
Tigerbear,argent-dawn,384,druid,guardian,12,4,8
Guacho,aegwynn,383,druid,guardian,6,4,2
Pabloskyn,sanguino,383,druid,guardian,6,4,2
Walenok,thrall,382,druid,guardian,6,4,2
Horizonline,terokkar,350,druid,guardian,11,4,7
Icxigo,silvermoon,288,druid,guardian,6,3,3
Фэк,eversong,288,druid,guardian,6,3,3
Pumpick,doomhammer,285,druid,guardian,13,3,10
Druidyy,exodar,192,druid,guardian,6,2,4
Deppresso,tarren-mill,192,druid,guardian,6,2,4
Savageftw,draenor,192,druid,guardian,6,2,4
Astralcore,stormscale,192,druid,guardian,6,2,4
Sároman,ravencrest,192,druid,guardian,6,2,4
Pöcä,arakarahm,192,druid,guardian,6,2,4
Skwair,garona,192,druid,guardian,6,2,4
Jebga,thrall,192,druid,guardian,6,2,4
Bulldozerkin,ragnaros,192,druid,guardian,6,2,4
Justtrollîng,twisting-nether,192,druid,guardian,6,2,4
Джирас,gordunni,192,druid,guardian,6,2,4
Envidius,kazzak,192,druid,guardian,6,2,4
Фдру,eversong,192,druid,guardian,6,2,4
Dualipas,outland,192,druid,guardian,6,2,4
Zinister,hyjal,192,druid,guardian,6,2,4
Kárrde,balnazzar,192,druid,guardian,6,2,4
Kaynine,lightnings-blade,192,druid,guardian,6,2,4
Beteralsjij,frostwhisper,192,druid,guardian,12,2,10
Nwal,thunderhorn,192,druid,guardian,12,2,10
Fynvola,anubarak,192,druid,guardian,12,2,10
Naeysea,argent-dawn,192,druid,guardian,12,2,10
Mássive,darkmoon-faire,191,druid,guardian,18,2,16
Pure,kul-tiras,190,druid,guardian,15,3,12
Bierbär,theradras,159,druid,guardian,5,2,3
Zàphiirò,archimonde,159,druid,guardian,11,2,9
Leondir,quelthalas,96,druid,guardian,6,1,5
Cleandc,blackhand,96,druid,guardian,6,1,5
Pudseytree,doomhammer,96,druid,guardian,6,1,5
Beduin,stormscale,96,druid,guardian,6,1,5
Monsterpuppy,magtheridon,96,druid,guardian,6,1,5
Дудумейстер,howling-fjord,96,druid,guardian,6,1,5
Murmétoile,chants-éternels,96,druid,guardian,6,1,5
Almightydudu,draenor,96,druid,guardian,6,1,5
Plandros,draenor,96,druid,guardian,6,1,5
Oõ,aggra-português,96,druid,guardian,6,1,5
Kaamirach,blackmoore,96,druid,guardian,6,1,5
Locass,blackrock,96,druid,guardian,6,1,5
Anthlas,outland,96,druid,guardian,6,1,5
Жекакотик,eversong,96,druid,guardian,6,1,5
Kabuul,dun-modr,96,druid,guardian,6,1,5
Túrnip,aerie-peak,96,druid,guardian,6,1,5
Waldkuh,thrall,96,druid,guardian,12,1,11
Tjoepert,azjolnerub,95,druid,guardian,3,2,1
Silver,terokkar,42,druid,guardian,16,3,13
Brutaldamage,ravencrest,2343,druid,feral,148,82,66
Verycringe,ravencrest,2329,druid,feral,266,140,126
Cåssidy,archimonde,2297,druid,feral,108,61,47
Xercas,outland,2250,druid,feral,71,44,27
Lïved,nemesis,2248,druid,feral,153,91,62
Ktx,aegwynn,2238,druid,feral,84,50,34
Twinklex,ravencrest,2237,druid,feral,293,146,147
Vârima,ravencrest,2229,druid,feral,84,56,28
Ðevilwhite,nemesis,2220,druid,feral,120,66,54
Tael,elune,2216,druid,feral,132,70,62
Cataferal,ravencrest,2199,druid,feral,180,97,83
Mabkferal,ravencrest,2146,druid,feral,133,67,66
Mykk,ravencrest,2144,druid,feral,160,98,62
Elîas,kazzak,2141,druid,feral,77,45,32
Tûêsdäÿblûês,ravencrest,2134,druid,feral,136,70,66
Lïndalûnå,ravencrest,2134,druid,feral,214,110,104
Trauller,outland,2125,druid,feral,132,68,64
Nekocat,ravencrest,2121,druid,feral,116,71,45
Mutaattori,sylvanas,2115,druid,feral,163,82,81
Bloodyredlyx,ysera,2112,druid,feral,90,46,44
Öøöøöøöøöøöø,anachronos,2110,druid,feral,72,47,25
Shizën,bladefist,2109,druid,feral,92,52,40
Ромкабикстар,gordunni,2107,druid,feral,78,40,38
Animålz,archimonde,2101,druid,feral,90,48,42
Desenlace,ravencrest,2101,druid,feral,369,191,178
Houmrx,ravencrest,2095,druid,feral,179,91,88
Tomyn,burning-legion,2075,druid,feral,78,46,32
Rubbershark,ravencrest,2074,druid,feral,253,150,103
Jakamx,ravencrest,2072,druid,feral,539,273,266
Mmlprox,burning-legion,2068,druid,feral,151,76,75
Bleêds,dun-modr,2061,druid,feral,60,35,25
Degmond,silvermoon,2061,druid,feral,246,127,119
Nìm,outland,2057,druid,feral,124,60,64
Wex,darksorrow,2055,druid,feral,54,36,18
Трэвисдог,gordunni,2053,druid,feral,77,38,39
Эриэс,gordunni,2043,druid,feral,214,115,99
Zøte,ravencrest,2037,druid,feral,117,58,59
Опакот,howling-fjord,2028,druid,feral,124,62,62
Uebiwe,silvermoon,2022,druid,feral,84,48,36
Rapatera,argent-dawn,2019,druid,feral,54,30,24
Норланда,gordunni,2012,druid,feral,78,39,39
Yone,blackmoore,2011,druid,feral,131,68,63
Muckì,alleria,2003,druid,feral,102,55,47
Lxve,tarren-mill,1999,druid,feral,66,34,32
Kaldorei,nemesis,1974,druid,feral,175,94,81
Calaftayou,ravencrest,1974,druid,feral,114,52,62
Taladruide,archimonde,1970,druid,feral,198,97,101
Desenlace,silvermoon,1966,druid,feral,233,112,121
Gurranq,argent-dawn,1964,druid,feral,60,32,28
Bigangrycatx,ravencrest,1964,druid,feral,85,43,42
Crøwnd,twisting-nether,1962,druid,feral,66,37,29
Kàraba,archimonde,1962,druid,feral,172,88,84
Iminz,ravencrest,1961,druid,feral,349,168,181
Purgatxry,ravencrest,1960,druid,feral,521,262,259
Yesbody,tarren-mill,1959,druid,feral,72,34,38
Trøüpäx,outland,1955,druid,feral,123,61,62
Kaÿn,tarren-mill,1952,druid,feral,89,42,47
Nîîght,ravencrest,1950,druid,feral,108,54,54
Obeseferal,outland,1945,druid,feral,132,61,71
Mortality,proudmoore,1940,druid,feral,125,63,62
Noxxìe,draenor,1925,druid,feral,236,118,118
Jåkeferalta,outland,1923,druid,feral,161,85,76
Vãrima,ravencrest,1922,druid,feral,48,27,21
Nzmdruid,burning-legion,1920,druid,feral,66,32,34
Fyrkax,aegwynn,1911,druid,feral,54,31,23
Фейкхехе,gordunni,1908,druid,feral,54,32,22
Nevercloneqt,argent-dawn,1907,druid,feral,101,54,47
Bigscarycatx,ravencrest,1901,druid,feral,57,31,26
Råbi,ravencrest,1896,druid,feral,57,25,32
Cocomojo,outland,1889,druid,feral,156,85,71
Cocaqt,nemesis,1881,druid,feral,155,86,69
Fürfur,ravencrest,1881,druid,feral,96,53,43
Garbagemonky,amanthul,1878,druid,feral,130,83,47
Kijan,silvermoon,1877,druid,feral,70,44,26
Themartyr,tarren-mill,1874,druid,feral,47,26,21
Khunahype,thrall,1873,druid,feral,60,39,21
Symbiosa,silvermoon,1870,druid,feral,30,20,10
Møonknight,ravencrest,1866,druid,feral,54,33,21
Mysticalmoon,ravencrest,1864,druid,feral,113,51,62
Cløwnferalx,argent-dawn,1863,druid,feral,66,29,37
Kokünomajo,kazzak,1861,druid,feral,42,34,8
Лардиан,gordunni,1859,druid,feral,84,45,39
Jhiun,ragnaros,1858,druid,feral,186,99,87
Jukeboks,silvermoon,1857,druid,feral,73,34,39
Shiftydruid,thunderhorn,1856,druid,feral,224,113,111
Блюгилли,ashenvale,1854,druid,feral,149,72,77
Djgírlßøssqt,argent-dawn,1851,druid,feral,198,95,103
Злодзейка,gordunni,1850,druid,feral,305,161,144
Roska,archimonde,1850,druid,feral,84,39,45
Sleepykitty,argent-dawn,1849,druid,feral,496,255,241
Boostedbear,ragnaros,1848,druid,feral,65,30,35
Léxiny,blackrock,1846,druid,feral,35,23,12
Dureka,tarren-mill,1845,druid,feral,82,50,32
Kattenvoer,stormscale,1842,druid,feral,36,27,9
Melsson,stormreaver,1842,druid,feral,66,31,35
Shylovez,aegwynn,1841,druid,feral,67,32,35
Skatch,sylvanas,1836,druid,feral,54,28,26
Nainket,ravencrest,1836,druid,feral,84,41,43
Tyranderawr,ravencrest,1833,druid,feral,108,64,44
Февти,gordunni,1828,druid,feral,59,34,25
Køgèr,kazzak,1824,druid,feral,84,50,34
Annksunamún,ysondre,1824,druid,feral,279,152,127
Drbeef,sanguino,1823,druid,feral,45,28,17
Zelaron,twisting-nether,1823,druid,feral,42,22,20
Нимир,soulflayer,1822,druid,feral,256,123,133
Dashfull,ravencrest,1821,druid,feral,709,353,356
Opresse,archimonde,1821,druid,feral,183,90,93
Reward,ragnaros,1819,druid,feral,64,30,34
Rheasilvià,silvermoon,1818,druid,feral,54,31,23
Flåppers,stormscale,1818,druid,feral,36,19,17
Kroñm,dun-modr,1818,druid,feral,60,25,35
Итильтириэль,gordunni,1817,druid,feral,311,155,156
Nouin,twisting-nether,1816,druid,feral,250,128,122
Fendrïl,varimathras,1814,druid,feral,90,55,35
Nøfåmïly,silvermoon,1814,druid,feral,160,83,77
Raznos,ravencrest,1813,druid,feral,124,77,47
Moonkniight,ravencrest,1810,druid,feral,30,22,8
Nfxdruid,argent-dawn,1810,druid,feral,102,60,42
Furrykruger,the-maelstrom,1810,druid,feral,102,48,54
Alexmeow,ravencrest,1809,druid,feral,62,36,26
Leylå,ravencrest,1809,druid,feral,84,41,43
Eccology,silvermoon,1806,druid,feral,162,78,84
Zechey,stormreaver,1805,druid,feral,42,22,20
Lycal,chogall,1804,druid,feral,38,22,16
Caprïsun,archimonde,1804,druid,feral,42,24,18
Ethryl,ravencrest,1804,druid,feral,231,115,116
Ratsimulator,tarren-mill,1802,druid,feral,54,32,22
Minaervea,antonidas,1802,druid,feral,162,77,85
Skytek,silvermoon,1801,druid,feral,120,59,61
Moskaros,turalyon,1800,druid,feral,156,80,76
Klaerke,tarren-mill,1800,druid,feral,105,48,57
Фейк,howling-fjord,1795,druid,feral,54,26,28
Snky,perenolde,1794,druid,feral,34,24,10
Ddru,ravencrest,1789,druid,feral,52,28,24
Facerippin,proudmoore,1787,druid,feral,161,82,79
Buffshred,ravencrest,1785,druid,feral,30,21,9
Goodtrip,hyjal,1782,druid,feral,95,56,39
Ålleyézoffme,ravencrest,1780,druid,feral,77,43,34
Kikihoux,ravencrest,1775,druid,feral,45,24,21
Goldrax,outland,1774,druid,feral,60,32,28
Zaibastus,doomhammer,1774,druid,feral,84,38,46
Indann,kazzak,1769,druid,feral,90,39,51
Блиденг,gordunni,1767,druid,feral,123,62,61
Nédith,archimonde,1767,druid,feral,54,27,27
Noé,aegwynn,1766,druid,feral,189,115,74
Dzandel,silvermoon,1766,druid,feral,644,320,324
Jarethy,dun-modr,1766,druid,feral,117,55,62
Каергорн,soulflayer,1766,druid,feral,54,19,35
Weyztwo,hyjal,1765,druid,feral,56,30,26
Bigcrazycatx,ravencrest,1762,druid,feral,132,59,73
Aendy,tarren-mill,1758,druid,feral,87,46,41
Селфика,gordunni,1757,druid,feral,66,21,45
Verbxp,kazzak,1756,druid,feral,101,54,47
Paranoia,outland,1756,druid,feral,160,82,78
Fallken,burning-blade,1755,druid,feral,42,26,16
Tangela,stormreaver,1746,druid,feral,84,49,35
Lenyl,dun-modr,1745,druid,feral,59,28,31
Bigpapad,ravencrest,1741,druid,feral,48,25,23
Elfsu,ravencrest,1740,druid,feral,106,54,52
Moldrokk,ravencrest,1739,druid,feral,52,31,21
Грязныекогти,gordunni,1737,druid,feral,89,55,34
Phenova,sargeras,1736,druid,feral,186,87,99
Babynaty,ravencrest,1735,druid,feral,108,51,57
Шев,blackscar,1733,druid,feral,48,23,25
Apuasaatana,stormreaver,1731,druid,feral,36,20,16
Loyoq,elune,1730,druid,feral,47,25,22
Catkovic,kult-der-verdammten,1730,druid,feral,59,28,31
Anatel,ravencrest,1726,druid,feral,59,24,35
Varø,aegwynn,1722,druid,feral,41,22,19
Мелталиора,soulflayer,1720,druid,feral,71,33,38
Faded,stormreaver,1719,druid,feral,102,43,59
Trevorkki,korgall,1714,druid,feral,104,54,50
Pänthërä,ravencrest,1711,druid,feral,36,18,18
Pilaf,emerald-dream,1711,druid,feral,239,115,124
Laguna,ravencrest,1711,druid,feral,89,41,48
Симбиозный,howling-fjord,1710,druid,feral,96,51,45
Frzx,stormscale,1710,druid,feral,90,44,46
Nîghtz,ravencrest,1708,druid,feral,39,22,17
Faveyo,die-nachtwache,1707,druid,feral,42,18,24
Даркедес,gordunni,1704,druid,feral,102,54,48
Texoria,twisting-nether,1699,druid,feral,257,134,123
Bearmantlé,outland,1699,druid,feral,58,28,30
Хэрес,gordunni,1698,druid,feral,30,19,11
Worgenshiftr,kazzak,1697,druid,feral,48,21,27
Bomoth,kazzak,1696,druid,feral,66,36,30
Coineagan,frostmourne,1695,druid,feral,76,29,47
Апвель,gordunni,1694,druid,feral,42,20,22
Kouda,draenor,1694,druid,feral,122,58,64
Scaleo,stormreaver,1692,druid,feral,142,76,66
Cyborgz,archimonde,1690,druid,feral,47,21,26
Fückøff,ravencrest,1689,druid,feral,65,33,32
Natakis,blades-edge,1688,druid,feral,48,25,23
Doopdroo,tarren-mill,1687,druid,feral,48,20,28
Kittcatx,ravencrest,1684,druid,feral,44,25,19
Ôkeanos,blackhand,1683,druid,feral,70,36,34
Arfgtdispo,hyjal,1680,druid,feral,48,23,25
Drunosio,magtheridon,1678,druid,feral,187,93,94
Heyiamdan,tarren-mill,1677,druid,feral,313,169,144
Yaddas,draenor,1676,druid,feral,90,37,53
Jellytardx,outland,1675,druid,feral,75,41,34
Retzerbil,ravencrest,1675,druid,feral,46,23,23
Zifr,dalaran,1675,druid,feral,66,22,44
Zarc,stormreaver,1672,druid,feral,91,48,43
Falláx,ravencrest,1672,druid,feral,52,25,27
Crazydos,tarren-mill,1671,druid,feral,57,27,30
Adastroeolo,sanguino,1669,druid,feral,87,49,38
Aedui,tarren-mill,1668,druid,feral,38,20,18
Banzeye,nordrassil,1668,druid,feral,184,96,88
Ðrüid,ravencrest,1668,druid,feral,72,34,38
Gediminas,argent-dawn,1665,druid,feral,186,86,100
Biggestnick,ravencrest,1664,druid,feral,44,24,20
Xirxy,silvermoon,1664,druid,feral,48,20,28
Silksharp,ravencrest,1663,druid,feral,60,31,29
Колайна,gordunni,1663,druid,feral,48,24,24
Jasperqt,silvermoon,1661,druid,feral,36,23,13
Rami,sylvanas,1661,druid,feral,177,89,88
Snapzy,sylvanas,1659,druid,feral,65,48,17
Emph,ravencrest,1659,druid,feral,66,38,28
Adabsurdum,kazzak,1659,druid,feral,124,55,69
Котосапенс,howling-fjord,1658,druid,feral,60,33,27
Mbk,kazzak,1657,druid,feral,113,55,58
Katzovic,kult-der-verdammten,1648,druid,feral,30,18,12
Juraci,forscherliga,1648,druid,feral,41,21,20
Garoh,dalaran,1648,druid,feral,42,18,24
Jgltrainer,archimonde,1646,druid,feral,89,48,41
Алексина,fordragon,1646,druid,feral,439,235,204
Ckelf,ravencrest,1646,druid,feral,42,18,24
Rbgbot,ragnaros,1644,druid,feral,69,39,30
Unreally,drakthul,1641,druid,feral,66,40,26
Simdruid,stormscale,1641,druid,feral,36,19,17
Mavne,outland,1640,druid,feral,42,22,20
Wucherwurzel,eredar,1640,druid,feral,142,67,75
Weedgras,eredar,1640,druid,feral,48,21,27
ßgøðx,argent-dawn,1639,druid,feral,85,47,38
Тёмныйзверь,borean-tundra,1639,druid,feral,365,186,179
Hugepepega,ravencrest,1638,druid,feral,66,37,29
Nèxtløls,twisting-nether,1637,druid,feral,122,68,54
Andreddi,ravencrest,1632,druid,feral,90,39,51
Tymke,burning-legion,1631,druid,feral,81,40,41
Bernfried,silvermoon,1631,druid,feral,76,33,43
Ñøpe,ravencrest,1630,druid,feral,30,17,13
Fzx,aegwynn,1629,druid,feral,30,17,13
Moderntalkin,aegwynn,1628,druid,feral,47,23,24
Blakkowl,drakthul,1627,druid,feral,48,24,24
Avanah,silvermoon,1626,druid,feral,78,38,40
Redlung,outland,1626,druid,feral,41,19,22
Spale,twisting-nether,1622,druid,feral,86,43,43
Hässelhoof,ragnaros,1622,druid,feral,246,113,133
Neyok,blackrock,1620,druid,feral,56,29,27
Voreli,silvermoon,1619,druid,feral,48,20,28
Milovolond,ravencrest,1618,druid,feral,30,19,11
Djmeowxd,blackrock,1616,druid,feral,69,30,39
Yamkar,blackrock,1616,druid,feral,57,24,33
Nøkki,draenor,1615,druid,feral,75,39,36
Tilikum,stormscale,1615,druid,feral,459,224,235
Rayjinn,dun-modr,1613,druid,feral,36,17,19
Freyanah,argent-dawn,1612,druid,feral,128,54,74
Jamera,stormscale,1610,druid,feral,87,40,47
Zhosy,shattrath,1609,druid,feral,69,29,40
Panthéra,ravencrest,1608,druid,feral,379,193,186
Арбузег,gordunni,1607,druid,feral,184,95,89
Feytique,aegwynn,1607,druid,feral,59,30,29
Фекаллис,soulflayer,1606,druid,feral,89,44,45
Blvckðvitchz,ravencrest,1606,druid,feral,241,114,127
Crisspurolss,ysondre,1605,druid,feral,73,38,35
Реалаг,howling-fjord,1604,druid,feral,47,20,27
Evilshade,ravencrest,1604,druid,feral,127,53,74
Markuslanz,blackrock,1603,druid,feral,53,21,32
Акиша,deepholm,1602,druid,feral,44,21,23
Køgér,kazzak,1601,druid,feral,30,17,13
Житмедветь,booty-bay,1601,druid,feral,128,68,60
Chronoqtxd,ravencrest,1601,druid,feral,52,24,28
Clipsy,twilights-hammer,1600,druid,feral,553,279,274
Thørkang,dun-modr,1599,druid,feral,185,98,87
Razoremperor,tarren-mill,1599,druid,feral,156,76,80
Развалустоев,blackscar,1597,druid,feral,218,113,105
Bulan,ghostlands,1595,druid,feral,130,72,58
Ajwen,tarren-mill,1593,druid,feral,30,20,10
Muucat,twisting-nether,1593,druid,feral,59,25,34
Kattenover,stormscale,1592,druid,feral,24,17,7
Frighton,ravencrest,1591,druid,feral,72,30,42
Tacodudu,ravencrest,1588,druid,feral,56,34,22
Shifthappens,dun-modr,1588,druid,feral,30,17,13
Crtx,blackhand,1587,druid,feral,210,121,89
Triluxa,blackmoore,1587,druid,feral,70,34,36
Zurllyn,ravencrest,1586,druid,feral,133,65,68
Спудич,eversong,1586,druid,feral,91,39,52
Bikiniwochen,antonidas,1585,druid,feral,48,24,24
Féral,hyjal,1584,druid,feral,155,76,79
Narunis,tarren-mill,1584,druid,feral,114,54,60
Mooncarnatio,burning-legion,1584,druid,feral,72,29,43
Rottweiler,doomhammer,1583,druid,feral,344,178,166
Tazdino,destromath,1583,druid,feral,66,26,40
Tonycatmeow,ravencrest,1582,druid,feral,30,18,12
Kasualx,stormscale,1582,druid,feral,123,69,54
Vëgâñgøðx,ragnaros,1582,druid,feral,170,90,80
Tani,kazzak,1580,druid,feral,93,49,44
Ringthaw,silvermoon,1578,druid,feral,54,24,30
Nasukka,grim-batol,1576,druid,feral,115,57,58
Sartipus,draenor,1575,druid,feral,48,24,24
Cjparker,archimonde,1575,druid,feral,98,47,51
Notsad,dun-modr,1574,druid,feral,45,20,25
Màz,blackmoore,1572,druid,feral,176,86,90
Asçdruid,kazzak,1572,druid,feral,56,24,32
Jabbari,outland,1570,druid,feral,347,172,175
Pitý,kaelthas,1568,druid,feral,53,17,36
Lorucka,die-nachtwache,1567,druid,feral,30,18,12
Pitchou,karazhan,1567,druid,feral,94,46,48
Unguis,outland,1566,druid,feral,134,73,61
Yongala,archimonde,1565,druid,feral,66,35,31
Stopwatching,outland,1565,druid,feral,42,18,24
Риама,blackscar,1564,druid,feral,102,50,52
Unoseeme,outland,1563,druid,feral,187,87,100
Extracssion,ysondre,1561,druid,feral,174,84,90
Saabeq,hyjal,1560,druid,feral,60,29,31
Fangornn,outland,1560,druid,feral,89,40,49
Skypinho,blackhand,1559,druid,feral,60,26,34
Ottur,argent-dawn,1558,druid,feral,220,106,114
Bearmeister,kazzak,1558,druid,feral,42,18,24
Melondru,dun-modr,1557,druid,feral,60,31,29
Drylle,argent-dawn,1555,druid,feral,93,50,43
Chiwsy,outland,1554,druid,feral,88,45,43
Christàlyst,garona,1553,druid,feral,92,50,42
Alessathrina,argent-dawn,1552,druid,feral,223,104,119
Sìa,frostmane,1552,druid,feral,130,56,74
Thecòntról,ravencrest,1551,druid,feral,111,64,47
Gyome,sargeras,1551,druid,feral,36,19,17
Cubswansón,outland,1550,druid,feral,85,46,39
Эверблуми,howling-fjord,1550,druid,feral,136,72,64
Righttwix,blackrock,1550,druid,feral,36,19,17
Smuktøs,twisting-nether,1546,druid,feral,47,28,19
Eranor,archimonde,1542,druid,feral,170,87,83
Ipunishcatz,ravencrest,1540,druid,feral,182,86,96
Goodtrip,archimonde,1535,druid,feral,146,67,79
Benyameow,ravencrest,1534,druid,feral,30,17,13
Shyngodx,archimonde,1533,druid,feral,41,17,24
Бабакошка,gordunni,1532,druid,feral,35,19,16
Dubakoo,outland,1531,druid,feral,91,49,42
Rysejr,nemesis,1531,druid,feral,30,16,14
Зонкс,gordunni,1530,druid,feral,122,63,59
Phøøn,blackrock,1530,druid,feral,58,26,32
Maccín,draenor,1530,druid,feral,52,18,34
Feralwilder,turalyon,1528,druid,feral,351,161,190
Eltroncazo,sanguino,1527,druid,feral,60,32,28
Oleander,zuljin,1523,druid,feral,274,139,135
Runeclaws,twisting-nether,1522,druid,feral,30,18,12
Kabraxis,silvermoon,1522,druid,feral,66,32,34
Lenzork,thrall,1519,druid,feral,67,30,37
Канвус,gordunni,1518,druid,feral,119,67,52
Fluffygoon,tarren-mill,1518,druid,feral,183,87,96
Mooqt,alexstrasza,1517,druid,feral,55,31,24
Бобасик,fordragon,1517,druid,feral,138,70,68
Diow,elune,1517,druid,feral,60,24,36
Одряя,soulflayer,1515,druid,feral,172,92,80
Ramoly,kazzak,1513,druid,feral,54,30,24
Xilmai,darksorrow,1510,druid,feral,79,37,42
Furmagic,tarren-mill,1508,druid,feral,107,52,55
Koumma,archimonde,1506,druid,feral,277,145,132
Jerrybeans,ravencrest,1504,druid,feral,120,57,63
Madeath,stormscale,1504,druid,feral,108,50,58
Lunamimi,argent-dawn,1503,druid,feral,239,131,108
Ponshü,hyjal,1502,druid,feral,57,34,23
Calîmerô,blackrock,1500,druid,feral,24,18,6
Vlcák,drakthul,1500,druid,feral,458,232,226
Psychodeliya,ragnaros,1500,druid,feral,60,19,41
Zyhm,archimonde,1498,druid,feral,60,33,27
Sadskia,sanguino,1494,druid,feral,96,44,52
Оудин,blackscar,1492,druid,feral,65,31,34
Soofyan,kazzak,1491,druid,feral,158,70,88
Chexdruid,silvermoon,1489,druid,feral,52,21,31
Beckett,aszune,1487,druid,feral,69,31,38
Hkwoaf,chants-éternels,1487,druid,feral,47,18,29
Беконайзер,howling-fjord,1483,druid,feral,98,51,47
Druidry,ragnaros,1483,druid,feral,155,79,76
Мунпраид,gordunni,1483,druid,feral,198,98,100
Annksunamun,ysondre,1482,druid,feral,46,23,23
Tàlented,aggra-português,1482,druid,feral,59,29,30
Phïl,ravencrest,1479,druid,feral,215,107,108
Chromaticx,argent-dawn,1478,druid,feral,183,98,85
Savvy,arthas,1478,druid,feral,42,18,24
Byet,kazzak,1478,druid,feral,42,17,25
Starkeknolle,blackmoore,1474,druid,feral,75,40,35
Chouan,marécage-de-zangar,1474,druid,feral,414,216,198
Everglow,argent-dawn,1474,druid,feral,581,293,288
Äcajou,hyjal,1472,druid,feral,132,74,58
Бритаякиска,gordunni,1470,druid,feral,42,23,19
Carridwyn,argent-dawn,1470,druid,feral,109,51,58
Samian,turalyon,1469,druid,feral,66,30,36
Tyldormeow,tarren-mill,1465,druid,feral,281,141,140
Взп,gordunni,1465,druid,feral,72,34,38
Тётявискас,howling-fjord,1464,druid,feral,106,53,53
Larryburns,nathrezim,1462,druid,feral,134,67,67
Liptonbite,blackhand,1461,druid,feral,54,17,37
Zaethul,draenor,1460,druid,feral,32,21,11
Sekunden,ravencrest,1460,druid,feral,156,76,80
Bigdaddytate,kazzak,1459,druid,feral,95,53,42
Cörelly,ravencrest,1459,druid,feral,118,62,56
Borja,malganis,1459,druid,feral,42,21,21
Cláire,stormscale,1458,druid,feral,72,37,35
Siire,ravencrest,1458,druid,feral,78,39,39
Хагисс,booty-bay,1454,druid,feral,108,51,57
Arlina,magtheridon,1454,druid,feral,57,26,31
Lemaromewmew,draenor,1453,druid,feral,34,18,16
Unlit,draenor,1453,druid,feral,144,71,73
Aestecias,blackhand,1451,druid,feral,36,17,19
Blacksagex,dragonmaw,1449,druid,feral,35,16,19
Baerminatør,blackrock,1449,druid,feral,84,38,46
Tanmax,blackmoore,1449,druid,feral,45,19,26
Zhényá,ravencrest,1447,druid,feral,42,22,20
Kattig,grim-batol,1446,druid,feral,86,40,46
Daddyßangz,das-konsortium,1446,druid,feral,52,24,28
Smellykitten,ravencrest,1445,druid,feral,36,18,18
Hordezai,outland,1445,druid,feral,89,40,49
Nariah,silvermoon,1443,druid,feral,51,17,34
Kärmä,eldrethalas,1442,druid,feral,239,119,120
Nspirit,ravencrest,1442,druid,feral,35,16,19
Naruh,ragnaros,1440,druid,feral,78,45,33
Брэвно,gordunni,1440,druid,feral,38,17,21
Alcik,silvermoon,1440,druid,feral,145,55,90
Бамбом,howling-fjord,1439,druid,feral,42,18,24
Chirnaruk,ravencrest,1438,druid,feral,90,45,45
ßußßo,ravencrest,1437,druid,feral,54,39,15
Docmedlove,aegwynn,1437,druid,feral,36,15,21
Køda,blackrock,1437,druid,feral,80,33,47
Sølaria,kazzak,1435,druid,feral,36,15,21
Erelae,twisting-nether,1434,druid,feral,103,53,50
Мумя,howling-fjord,1434,druid,feral,210,102,108
Crinji,ravencrest,1433,druid,feral,24,15,9
Trusten,nemesis,1433,druid,feral,232,127,105
Boomzter,frostmane,1433,druid,feral,75,36,39
Vanhelsíng,dun-modr,1431,druid,feral,76,46,30
Скагуар,blackscar,1430,druid,feral,219,113,106
Фэк,eversong,1429,druid,feral,56,29,27
Mímír,frostmane,1429,druid,feral,63,28,35
Ripgødx,outland,1426,druid,feral,152,81,71
Cheddar,tyrande,1425,druid,feral,123,64,59
Arilíaxo,amanthul,1424,druid,feral,28,17,11
Эскоф,gordunni,1424,druid,feral,289,148,141
Bløødberry,ravencrest,1423,druid,feral,36,18,18
Rollozuu,blackrock,1423,druid,feral,228,110,118
Акетчи,howling-fjord,1421,druid,feral,130,72,58
Indräkah,dun-modr,1421,druid,feral,105,52,53
Tilac,proudmoore,1421,druid,feral,53,24,29
Tîma,blackmoore,1420,druid,feral,469,236,233
Bagheera,archimonde,1420,druid,feral,137,66,71
Линнер,lich-king,1420,druid,feral,84,38,46
Mervend,tarren-mill,1420,druid,feral,41,15,26
Ephixa,burning-legion,1419,druid,feral,47,23,24
Enock,hyjal,1418,druid,feral,34,18,16
Blblbl,ysondre,1417,druid,feral,46,21,25
Wingnutz,argent-dawn,1415,druid,feral,90,43,47
Ялория,azuregos,1412,druid,feral,36,16,20
Healníx,blackrock,1411,druid,feral,86,46,40
Муунфаер,gordunni,1410,druid,feral,97,44,53
Kittyrawr,silvermoon,1410,druid,feral,36,15,21
Liqoú,tarren-mill,1409,druid,feral,60,35,25
Drudonja,silvermoon,1409,druid,feral,192,99,93
Муумуумуу,howling-fjord,1409,druid,feral,331,161,170
Lugtedyr,draenor,1408,druid,feral,88,43,45
Дочьпандарии,gordunni,1407,druid,feral,41,17,24
Degentiuso,alakir,1405,druid,feral,96,53,43
Wadles,draenor,1405,druid,feral,64,34,30
Сантиго,howling-fjord,1403,druid,feral,30,15,15
Друличч,blackscar,1400,druid,feral,120,60,60
Luigina,blackmoore,1400,druid,feral,30,15,15
Phesxd,sylvanas,1400,druid,feral,60,29,31
Kodobursto,stormscale,1398,druid,feral,159,87,72
Mònókox,eredar,1398,druid,feral,50,19,31
Mimir,la-croisade-écarlate,1397,druid,feral,60,28,32
Рефикс,gordunni,1395,druid,feral,49,27,22
Vrisanaar,bladefist,1395,druid,feral,58,29,29
Picatso,blackrock,1395,druid,feral,30,15,15
Vancis,ravencrest,1394,druid,feral,111,58,53
Seyyid,archimonde,1394,druid,feral,36,18,18
Hiio,ravencrest,1394,druid,feral,36,17,19
Беркамп,howling-fjord,1394,druid,feral,158,74,84
Thaelyy,drakthul,1394,druid,feral,96,42,54
Epicplays,sylvanas,1393,druid,feral,148,78,70
Sÿlph,sylvanas,1393,druid,feral,180,92,88
Neshalry,blackhand,1392,druid,feral,36,16,20
Bâbusch,blackmoore,1390,druid,feral,147,72,75
Котфилин,gordunni,1389,druid,feral,84,47,37
Сириль,soulflayer,1389,druid,feral,64,34,30
Медверх,gordunni,1385,druid,feral,105,53,52
Legitx,dentarg,1385,druid,feral,43,17,26
Микайо,goldrinn,1383,druid,feral,225,107,118
Tsopúnisher,twisting-nether,1383,druid,feral,46,20,26
Léxa,sunstrider,1382,druid,feral,41,17,24
Venusinfurs,drakthul,1381,druid,feral,42,19,23
Donoz,ravencrest,1378,druid,feral,42,26,16
Рэво,gordunni,1377,druid,feral,30,18,12
Margueriti,the-maelstrom,1377,druid,feral,166,82,84
Ferøsse,hyjal,1376,druid,feral,54,27,27
Elitarian,argent-dawn,1376,druid,feral,417,208,209
Pipima,kazzak,1374,druid,feral,48,20,28
Droodae,hyjal,1373,druid,feral,59,33,26
Treeflogger,ravencrest,1373,druid,feral,126,65,61
Vèlla,silvermoon,1373,druid,feral,102,52,50
Tayløre,ysondre,1371,druid,feral,29,16,13
Лорья,azuregos,1370,druid,feral,48,19,29
Soléda,thrall,1369,druid,feral,204,102,102
Сэднхорни,howling-fjord,1369,druid,feral,49,22,27
Quikahn,outland,1369,druid,feral,36,15,21
Migah,stormscale,1368,druid,feral,140,79,61
Chepochem,stormscale,1368,druid,feral,50,20,30
Stûnßîtêðêâð,ravencrest,1367,druid,feral,54,28,26
Enjoik,drakthul,1367,druid,feral,201,99,102
Hushorde,twisting-nether,1366,druid,feral,71,31,40
Sgourakoss,twilights-hammer,1363,druid,feral,42,20,22
Blintschiki,echsenkessel,1363,druid,feral,71,32,39
Niknikola,silvermoon,1362,druid,feral,54,23,31
Nîchtsnutz,blackmoore,1361,druid,feral,65,29,36
Cruelbunny,nemesis,1359,druid,feral,78,32,46
Agè,stormscale,1357,druid,feral,163,75,88
Monchita,ravencrest,1357,druid,feral,42,19,23
Mônchô,sanguino,1356,druid,feral,130,74,56
Crow,saurfang,1356,druid,feral,182,90,92
Kømo,draenor,1354,druid,feral,42,21,21
Dilleydank,ravencrest,1353,druid,feral,27,15,12
Tricklou,tarren-mill,1352,druid,feral,69,42,27
Dijem,wildhammer,1351,druid,feral,116,66,50
Loryaayroll,stormscale,1349,druid,feral,42,17,25
Chinoiserie,aszune,1348,druid,feral,60,34,26
Moonpuff,kazzak,1346,druid,feral,74,45,29
Kajhan,silvermoon,1346,druid,feral,164,85,79
Darkcon,silvermoon,1346,druid,feral,72,28,44
Inuah,veknilash,1345,druid,feral,129,62,67
Паинтер,blackscar,1345,druid,feral,139,58,81
Nalaa,festung-der-stürme,1344,druid,feral,268,129,139
Нуаду,gordunni,1344,druid,feral,241,115,126
Tropicqt,ravencrest,1344,druid,feral,41,19,22
Snapeshifter,blackhand,1343,druid,feral,36,19,17
Bignik,tarren-mill,1343,druid,feral,30,14,16
Hottad,tarren-mill,1342,druid,feral,192,103,89
Darkangelus,dethecus,1340,druid,feral,48,27,21
Ефомитстерша,gordunni,1339,druid,feral,36,17,19
Ashan,kirin-tor,1338,druid,feral,221,118,103
Элисандра,gordunni,1338,druid,feral,72,38,34
Teám,tarren-mill,1338,druid,feral,54,21,33
Mikor,aegwynn,1337,druid,feral,24,14,10
Snøwden,twisting-nether,1337,druid,feral,48,27,21
Carlitto,blackmoore,1336,druid,feral,49,29,20
Starasta,magtheridon,1335,druid,feral,30,14,16
Scumx,blackmoore,1333,druid,feral,24,14,10
Броодяга,razuvious,1333,druid,feral,77,29,48
Paws,dun-modr,1332,druid,feral,96,49,47
Stelthee,silvermoon,1329,druid,feral,84,40,44
Gonco,blackrock,1329,druid,feral,130,61,69
Kovlian,argent-dawn,1329,druid,feral,100,45,55
Liliolivia,outland,1327,druid,feral,24,14,10
Sabertoon,argent-dawn,1327,druid,feral,282,129,153
Sløthy,uldum,1326,druid,feral,58,28,30
Starliner,ravencrest,1326,druid,feral,36,14,22
Каиавасе,gordunni,1326,druid,feral,49,19,30
Lorya,kazzak,1324,druid,feral,66,30,36
Basedgôd,alakir,1321,druid,feral,24,14,10
Kalan,eredar,1321,druid,feral,60,29,31
Speedlebee,malganis,1321,druid,feral,113,52,61
Kimpine,kirin-tor,1320,druid,feral,263,133,130
Sethread,ragnaros,1319,druid,feral,36,14,22
Vargall,silvermoon,1318,druid,feral,65,33,32
Baccthana,auchindoun,1318,druid,feral,115,46,69
Lukeyferalxo,argent-dawn,1317,druid,feral,168,78,90
Ayahuàzka,dalaran,1317,druid,feral,84,35,49
Балаклаваа,soulflayer,1316,druid,feral,29,18,11
Deehe,thrall,1315,druid,feral,156,72,84
Yhavi,kazzak,1314,druid,feral,80,41,39
Kardashìan,ravencrest,1312,druid,feral,25,14,11
Dadzeus,khaz-modan,1312,druid,feral,104,54,50
Tussenfryd,draenor,1312,druid,feral,283,138,145
Liony,aegwynn,1311,druid,feral,47,24,23
Yoshia,shadowsong,1309,druid,feral,72,29,43
Majokz,ravencrest,1307,druid,feral,44,23,21
Ведмедив,blackscar,1307,druid,feral,96,44,52
Rustÿ,hyjal,1305,druid,feral,39,25,14
Tøktøk,blackhand,1305,druid,feral,24,14,10
Regelè,sylvanas,1305,druid,feral,86,45,41
Nightdruidcz,turalyon,1305,druid,feral,113,55,58
Âltashamane,elune,1304,druid,feral,47,23,24
Nuashoa,argent-dawn,1302,druid,feral,37,18,19
Shádynasty,silvermoon,1301,druid,feral,36,15,21
Jenelin,silvermoon,1300,druid,feral,34,15,19
Диаболус,gordunni,1299,druid,feral,68,33,35
Shàka,ravencrest,1299,druid,feral,29,14,15
Henessi,ragnaros,1299,druid,feral,62,27,35
Лякокля,soulflayer,1298,druid,feral,102,54,48
Nøwørnever,ulduar,1298,druid,feral,140,61,79
Miracoplixx,blackrock,1297,druid,feral,51,22,29
Drupal,argent-dawn,1295,druid,feral,89,45,44
Kindermaxii,ravencrest,1295,druid,feral,78,38,40
Eprophet,stormscale,1293,druid,feral,54,20,34
Nalreaa,kazzak,1292,druid,feral,32,17,15
Liya,ravencrest,1292,druid,feral,48,15,33
Nå,outland,1291,druid,feral,199,97,102
Ghettoven,kazzak,1290,druid,feral,93,45,48
Golddy,hyjal,1289,druid,feral,37,18,19
Turkus,draenor,1289,druid,feral,150,69,81
Xqeon,blackrock,1288,druid,feral,120,64,56
Zitusk,ragnaros,1288,druid,feral,124,58,66
Oblivark,draenor,1287,druid,feral,36,17,19
Druidicmorr,sylvanas,1287,druid,feral,85,36,49
Levila,defias-brotherhood,1284,druid,feral,72,41,31
Laxmînken,sylvanas,1284,druid,feral,84,43,41
Minaye,hyjal,1282,druid,feral,46,22,24
Котпартизан,gordunni,1281,druid,feral,74,36,38
Mordpaw,stormscale,1279,druid,feral,38,15,23
Darrkseid,kazzak,1278,druid,feral,30,17,13
Symbiosîs,stormscale,1276,druid,feral,96,44,52
Storslev,stormscale,1274,druid,feral,222,100,122
Garfield,uldum,1273,druid,feral,65,35,30
Tepni,ragnaros,1272,druid,feral,41,18,23
Хокан,deepholm,1271,druid,feral,31,15,16
Cayía,ravencrest,1271,druid,feral,44,20,24
Manoestouro,draenor,1267,druid,feral,60,22,38
Putzé,blackrock,1266,druid,feral,48,30,18
Owling,antonidas,1266,druid,feral,126,70,56
Noobbiiee,silvermoon,1266,druid,feral,60,32,28
Whizkazz,ravencrest,1266,druid,feral,68,36,32
Bilis,nazjatar,1265,druid,feral,60,24,36
Hornet,sanguino,1264,druid,feral,48,27,21
Криашин,goldrinn,1264,druid,feral,105,47,58
Cleandc,blackhand,1260,druid,feral,40,24,16
Koffee,archimonde,1259,druid,feral,48,23,25
Iloveadriana,kiljaeden,1258,druid,feral,60,29,31
Bâlou,nathrezim,1256,druid,feral,48,22,26
Shinshìva,twisting-nether,1255,druid,feral,211,107,104
Naturalie,silvermoon,1255,druid,feral,78,31,47
Kyoshî,blackmoore,1254,druid,feral,357,182,175
Pepeja,doomhammer,1253,druid,feral,24,15,9
Drudicious,ravencrest,1253,druid,feral,28,15,13
Croucher,shattrath,1253,druid,feral,172,78,94
Furryrawr,silvermoon,1253,druid,feral,48,21,27
Мендея,gordunni,1252,druid,feral,30,18,12
Malfyurion,ragnaros,1252,druid,feral,256,128,128
Dougi,argent-dawn,1252,druid,feral,60,28,32
Shifabull,kazzak,1251,druid,feral,78,40,38
Liionheart,khaz-modan,1250,druid,feral,66,34,32
Jaghut,burning-legion,1249,druid,feral,78,42,36
Herten,tarren-mill,1249,druid,feral,36,15,21
Ferrariferal,nethersturm,1248,druid,feral,18,13,5
Aliiass,drakthul,1248,druid,feral,99,57,42
Fyrka,aegwynn,1248,druid,feral,24,13,11
Flufie,alexstrasza,1248,druid,feral,27,14,13
Bignoober,blackrock,1248,druid,feral,29,13,16
Ryseqt,nemesis,1247,druid,feral,18,13,5
Collnaris,ravencrest,1247,druid,feral,38,22,16
Асония,deathguard,1247,druid,feral,30,13,17
Weedum,kazzak,1246,druid,feral,36,14,22
Druiidou,dalaran,1246,druid,feral,36,13,23
Grimgoor,burning-legion,1245,druid,feral,148,76,72
Malfurryon,drakthul,1245,druid,feral,78,38,40
Malvakten,kazzak,1244,druid,feral,31,17,14
Råèkwøñ,ravencrest,1243,druid,feral,28,14,14
Snûx,antonidas,1243,druid,feral,39,15,24
Shiningztar,twisting-nether,1240,druid,feral,59,33,26
Hecky,xavius,1240,druid,feral,30,15,15
Jxst,tarren-mill,1240,druid,feral,54,21,33
Salseo,uldum,1239,druid,feral,33,14,19
Veggiepro,uldum,1239,druid,feral,42,15,27
Devonshira,ravencrest,1237,druid,feral,54,23,31
Filiduttkatt,ravencrest,1235,druid,feral,24,13,11
Denadu,turalyon,1235,druid,feral,202,88,114
Naturewalker,eredar,1234,druid,feral,30,13,17
Кеорл,gordunni,1234,druid,feral,108,46,62
Krekigaadzre,draenor,1231,druid,feral,67,36,31
Deviantdruid,draenor,1231,druid,feral,39,20,19
Hàlunkè,eredar,1230,druid,feral,24,13,11
Weydjin,garona,1230,druid,feral,36,17,19
Катяблум,gordunni,1230,druid,feral,30,13,17
Andros,arathor,1229,druid,feral,42,15,27
Hermetic,turalyon,1228,druid,feral,244,124,120
Ganjeez,kazzak,1228,druid,feral,94,39,55
Whísperclaw,ravencrest,1226,druid,feral,41,21,20
Смизм,gordunni,1225,druid,feral,50,26,24
Kintax,drakthul,1223,druid,feral,139,74,65
Dawodz,archimonde,1222,druid,feral,38,16,22
Webla,blackmoore,1221,druid,feral,59,28,31
Taigarus,aerie-peak,1220,druid,feral,84,39,45
Hydorn,cthun,1220,druid,feral,104,44,60
Jdogger,tarren-mill,1219,druid,feral,24,13,11
Aøn,silvermoon,1219,druid,feral,92,42,50
Infêrno,twisting-nether,1218,druid,feral,46,19,27
Shaggery,stormscale,1216,druid,feral,105,45,60
Шонгу,soulflayer,1215,druid,feral,88,38,50
Ssaaff,outland,1215,druid,feral,42,16,26
Noyake,ragnaros,1214,druid,feral,60,28,32
Azmerloth,antonidas,1214,druid,feral,36,13,23
Moonglade,deathwing,1214,druid,feral,39,14,25
Defløwer,aegwynn,1213,druid,feral,42,21,21
Impertinent,outland,1209,druid,feral,86,42,44
Cøcøpøpsmøke,archimonde,1208,druid,feral,48,21,27
Naetsch,blackrock,1208,druid,feral,56,21,35
Eljinso,blackhand,1204,druid,feral,72,45,27
Derzis,eonar,1204,druid,feral,105,55,50
Kirmelastas,kazzak,1201,druid,feral,128,62,66
Dirtyfantasy,alakir,1199,druid,feral,66,36,30
Azenoir,ravencrest,1199,druid,feral,39,14,25
Sashika,shattrath,1197,druid,feral,88,43,45
Biffsteak,blackhand,1196,druid,feral,422,204,218
Naheliaqt,outland,1195,druid,feral,30,14,16
Богарт,soulflayer,1193,druid,feral,24,14,10
Slaaya,ravencrest,1193,druid,feral,30,15,15
Терамин,howling-fjord,1193,druid,feral,52,25,27
Bozidarka,burning-legion,1191,druid,feral,36,14,22
Dudeimgodly,ravencrest,1190,druid,feral,54,16,38
Niowën,ragnaros,1189,druid,feral,63,32,31
Womanhood,ravencrest,1188,druid,feral,42,13,29
Шэйпшифт,fordragon,1187,druid,feral,124,52,72
Icqnot,arthas,1187,druid,feral,36,13,23
Snootxt,blackmoore,1185,druid,feral,54,23,31
Papan,sylvanas,1184,druid,feral,102,55,47
Класк,gordunni,1183,druid,feral,36,19,17
Nerta,outland,1180,druid,feral,42,16,26
Mérias,archimonde,1180,druid,feral,42,13,29
Millenia,darkmoon-faire,1179,druid,feral,197,99,98
Zethane,ragnaros,1178,druid,feral,66,29,37
Zaltaruk,sanguino,1173,druid,feral,263,131,132
Lorcàn,argent-dawn,1173,druid,feral,133,62,71
Maaghera,silvermoon,1172,druid,feral,503,252,251
Йванныч,gordunni,1171,druid,feral,103,48,55
Cemiink,drakthul,1170,druid,feral,28,13,15
Almuntaqim,ravencrest,1168,druid,feral,35,13,22
Wallex,draenor,1166,druid,feral,41,13,28
Менстряк,howling-fjord,1165,druid,feral,58,25,33
Swagmode,draenor,1164,druid,feral,67,40,27
Tranduiil,drakthul,1164,druid,feral,150,84,66
Larkos,grim-batol,1164,druid,feral,159,82,77
Battleray,twisting-nether,1164,druid,feral,121,61,60
Tróllinger,blackrock,1164,druid,feral,51,24,27
Yorashi,blackhand,1162,druid,feral,42,27,15
Yøløswag,naxxramas,1156,druid,feral,192,103,89
Kageioshi,kazzak,1156,druid,feral,139,72,67
Eternas,elune,1156,druid,feral,136,69,67
Mgelolaf,doomhammer,1155,druid,feral,54,27,27
Quentalius,argent-dawn,1154,druid,feral,30,14,16
Snkyferalmov,aegwynn,1152,druid,feral,18,12,6
Aniprimal,auchindoun,1152,druid,feral,46,23,23
Rszn,ravencrest,1152,druid,feral,30,12,18
Howtonio,archimonde,1151,druid,feral,18,12,6
Zbear,kazzak,1151,druid,feral,36,16,20
Bloodrotten,silvermoon,1151,druid,feral,102,40,62
Sùmmèrz,ravencrest,1150,druid,feral,30,12,18
Mistic,twisting-nether,1149,druid,feral,85,46,39
Amandial,silvermoon,1149,druid,feral,30,12,18
Blacknight,aggramar,1148,druid,feral,75,30,45
Zokix,doomhammer,1147,druid,feral,107,54,53
Holditorsken,grim-batol,1147,druid,feral,30,15,15
Frs,bladefist,1147,druid,feral,30,12,18
Tibozx,stormscale,1146,druid,feral,36,21,15
Nightfáll,tarren-mill,1146,druid,feral,107,46,61
Ra,stormscale,1145,druid,feral,24,12,12
Snuggums,argent-dawn,1144,druid,feral,27,13,14
Ildrin,ragnaros,1142,druid,feral,42,22,20
Veryfast,blackhand,1142,druid,feral,24,12,12
Gatínho,ravencrest,1140,druid,feral,18,12,6
Xoat,marécage-de-zangar,1140,druid,feral,30,12,18
Thorface,kazzak,1137,druid,feral,24,13,11
Maylon,darksorrow,1137,druid,feral,125,56,69
Reawen,drakthul,1137,druid,feral,74,29,45
Jinxaran,culte-de-la-rive-noire,1135,druid,feral,36,12,24
Мунлайнер,soulflayer,1134,druid,feral,30,12,18
Vicendius,drakthul,1132,druid,feral,66,32,34
Jaxtn,tarren-mill,1132,druid,feral,58,25,33
Dunya,kazzak,1132,druid,feral,30,12,18
Жекакотик,eversong,1131,druid,feral,228,118,110
Catbear,kazzak,1130,druid,feral,30,14,16
Progodd,silvermoon,1129,druid,feral,126,64,62
Шйшка,gordunni,1129,druid,feral,92,33,59
Druidofix,marécage-de-zangar,1128,druid,feral,24,12,12
Skywíng,stormscale,1128,druid,feral,60,25,35
Bgam,ravencrest,1126,druid,feral,24,17,7
Carldroid,sylvanas,1126,druid,feral,40,22,18
Михася,gordunni,1125,druid,feral,29,13,16
Tyrianxx,zuljin,1124,druid,feral,30,15,15
Кыцко,soulflayer,1124,druid,feral,24,12,12
Кайтилир,blackscar,1123,druid,feral,77,39,38
Arnwaald,kaelthas,1123,druid,feral,66,32,34
Xhenon,dun-modr,1120,druid,feral,30,12,18
Lubeferal,ravencrest,1119,druid,feral,14,13,1
Zeyne,ravencrest,1117,druid,feral,48,21,27
Dash,the-maelstrom,1116,druid,feral,30,13,17
Kidabductorx,draenor,1116,druid,feral,42,16,26
Dulidica,tarren-mill,1115,druid,feral,52,25,27
Herbstkind,frostmourne,1115,druid,feral,107,46,61
Taco,eredar,1115,druid,feral,67,22,45
Phike,blackrock,1114,druid,feral,24,12,12
Flippintwit,quelthalas,1113,druid,feral,42,15,27
Twyty,khaz-modan,1112,druid,feral,193,91,102
Naxfae,argent-dawn,1112,druid,feral,60,23,37
Tl,archimonde,1110,druid,feral,175,83,92
Ivìs,nemesis,1110,druid,feral,140,62,78
Snupy,outland,1103,druid,feral,29,12,17
Rapuun,kult-der-verdammten,1102,druid,feral,27,13,14
Арвелл,gordunni,1099,druid,feral,30,13,17
Carakal,outland,1099,druid,feral,104,43,61
Брэмблс,soulflayer,1098,druid,feral,69,35,34
Käissi,blackmoore,1098,druid,feral,66,29,37
Leidbulle,blackrock,1098,druid,feral,48,18,30
Lemmí,frostwolf,1096,druid,feral,66,29,37
Bæghira,draenor,1095,druid,feral,100,55,45
Мукару,howling-fjord,1094,druid,feral,48,26,22
Mîyukí,ravencrest,1094,druid,feral,48,23,25
Zivertgodx,argent-dawn,1093,druid,feral,48,23,25
Lakaport,dun-modr,1093,druid,feral,90,39,51
Nicos,elune,1091,druid,feral,29,13,16
Vidlna,outland,1091,druid,feral,72,32,40
Chichisosa,ysondre,1090,druid,feral,33,12,21
Йонарк,gordunni,1087,druid,feral,41,20,21
Teacherr,quelthalas,1087,druid,feral,122,50,72
Greengünter,blackmoore,1086,druid,feral,22,12,10
Rootznloots,draenor,1082,druid,feral,48,26,22
Feraligator,sanguino,1081,druid,feral,180,84,96
Emrys,teldrassil,1080,druid,feral,59,17,42
Спэкк,gordunni,1077,druid,feral,101,45,56
Clawdiá,silvermoon,1076,druid,feral,116,59,57
Mickayøyø,khaz-modan,1076,druid,feral,60,17,43
Lirtiasan,forscherliga,1075,druid,feral,30,15,15
Sherkàn,dalaran,1074,druid,feral,43,24,19
Blazoor,frostwolf,1072,druid,feral,58,29,29
Tombenuit,tarren-mill,1072,druid,feral,24,12,12
Woodflower,silvermoon,1072,druid,feral,54,21,33
Janjalism,silvermoon,1068,druid,feral,113,62,51
Ripndip,eredar,1067,druid,feral,118,59,59
Taatz,stormscale,1066,druid,feral,45,28,17
Mcservietsky,chogall,1066,druid,feral,72,24,48
Nirvs,archimonde,1057,druid,feral,30,15,15
Sumecx,aegwynn,1056,druid,feral,18,11,7
Plazmo,ravencrest,1056,druid,feral,18,11,7
Vahid,antonidas,1055,druid,feral,12,11,1
Harryharrt,veknilash,1055,druid,feral,54,26,28
Salviaf,silvermoon,1055,druid,feral,94,43,51
Pølymorphe,ysondre,1055,druid,feral,30,11,19
Belsebub,ravencrest,1055,druid,feral,30,11,19
Hccl,blackhand,1055,druid,feral,30,11,19
Alimona,the-venture-co,1055,druid,feral,50,14,36
Wizzlafa,ravencrest,1054,druid,feral,18,11,7
Fruit,outland,1054,druid,feral,18,11,7
Growshax,nerzhul,1054,druid,feral,38,22,16
Ashtral,kazzak,1054,druid,feral,24,11,13
Iesei,outland,1054,druid,feral,24,11,13
Wildmushroom,drakthul,1054,druid,feral,41,12,29
Mudpie,stormscale,1053,druid,feral,79,34,45
Shutupsandra,archimonde,1051,druid,feral,24,11,13
Togara,kazzak,1050,druid,feral,30,11,19
Xroxo,hyjal,1048,druid,feral,24,11,13
Laek,chogall,1047,druid,feral,36,11,25
Huginmuninn,outland,1046,druid,feral,54,28,26
Maethar,stormrage,1046,druid,feral,30,11,19
Clawwy,kazzak,1046,druid,feral,36,13,23
Álex,anachronos,1045,druid,feral,134,59,75
Muffinjump,outland,1044,druid,feral,98,44,54
Magicerzz,voljin,1044,druid,feral,43,13,30
Ilsydur,shadowsong,1044,druid,feral,47,13,34
Exïlla,archimonde,1043,druid,feral,24,11,13
Duton,stormscale,1043,druid,feral,30,11,19
Erasil,exodar,1042,druid,feral,30,11,19
Dracaan,boulderfist,1041,druid,feral,18,11,7
Skyreapa,burning-legion,1039,druid,feral,67,27,40
Jamaican,outland,1038,druid,feral,78,33,45
Bäkø,dun-modr,1038,druid,feral,36,13,23
Mauzicek,drakthul,1037,druid,feral,60,29,31
Druul,frostwolf,1037,druid,feral,30,11,19
Aggoth,drakthul,1035,druid,feral,24,11,13
Exortas,kazzak,1035,druid,feral,130,58,72
Isaye,archimonde,1033,druid,feral,302,139,163
Melfir,dun-modr,1033,druid,feral,46,17,29
Kermit,die-aldor,1032,druid,feral,81,32,49
Bomchickawah,antonidas,1031,druid,feral,30,11,19
Descendance,ysondre,1030,druid,feral,121,62,59
Kynji,twisting-nether,1030,druid,feral,170,78,92
Cheeselake,blackmoore,1029,druid,feral,20,11,9
Tastyrawr,blackhand,1029,druid,feral,24,11,13
Ивантяй,gordunni,1026,druid,feral,24,11,13
Hetalia,culte-de-la-rive-noire,1025,druid,feral,24,13,11
Dooferdudu,azshara,1023,druid,feral,33,11,22
Morfâns,ragnaros,1021,druid,feral,84,40,44
Almightydudu,draenor,1021,druid,feral,30,12,18
Amoonaa,kazzak,1020,druid,feral,54,28,26
Маветт,blackscar,1020,druid,feral,134,67,67
Whiterun,pozzo-delleternità,1020,druid,feral,31,13,18
Biorythm,draenor,1018,druid,feral,36,15,21
Астраджет,gordunni,1017,druid,feral,18,11,7
Форресинг,gordunni,1014,druid,feral,46,15,31
Boombassador,stormscale,1012,druid,feral,36,20,16
Phanterus,chamber-of-aspects,1012,druid,feral,24,11,13
Domänia,onyxia,1012,druid,feral,66,23,43
Chlambak,archimonde,1009,druid,feral,30,17,13
Loserforever,archimonde,1008,druid,feral,15,12,3
Knææl,argent-dawn,1006,druid,feral,68,28,40
Cyriaan,eredar,1005,druid,feral,23,11,12
Nuktuk,blackhand,1005,druid,feral,27,12,15
Smittly,bloodhoof,1005,druid,feral,58,23,35
Лорирэнд,gordunni,1005,druid,feral,35,11,24
Ytzù,archimonde,1004,druid,feral,17,11,6
Пивч,soulflayer,1002,druid,feral,33,12,21
Glanis,malorne,1002,druid,feral,76,27,49
Ваддимка,soulflayer,1000,druid,feral,63,32,31
Агнотар,soulflayer,1000,druid,feral,36,15,21
Grynoth,silvermoon,1000,druid,feral,36,14,22
Poxu,eredar,998,druid,feral,59,22,37
Неваляка,gordunni,997,druid,feral,23,11,12
Ezpire,ravencrest,997,druid,feral,99,43,56
Графматье,soulflayer,995,druid,feral,36,11,25
Rellena,khaz-modan,992,druid,feral,84,41,43
Dohn,ravencrest,991,druid,feral,20,11,9
Nkoyi,argent-dawn,991,druid,feral,120,57,63
Trikill,hyjal,990,druid,feral,55,19,36
Беррсс,gordunni,983,druid,feral,86,29,57
Shymä,hyjal,982,druid,feral,163,69,94
Rubmyclaws,burning-legion,981,druid,feral,19,11,8
Rakuy,thrall,981,druid,feral,27,11,16
Bumsbert,teldrassil,980,druid,feral,66,35,31
Tierundelfee,outland,966,druid,feral,21,12,9
Druidou,kaelthas,964,druid,feral,88,35,53
Tharuun,teldrassil,961,druid,feral,36,12,24
Tjxaxa,ravencrest,960,druid,feral,12,10,2
Aliyxo,aegwynn,960,druid,feral,15,11,4
Jincksdruid,anachronos,960,druid,feral,18,10,8
Оссава,blackscar,960,druid,feral,18,10,8
Tatabomba,archimonde,960,druid,feral,102,50,52
Fuzzylol,haomarush,960,druid,feral,24,10,14
Suggly,ysondre,959,druid,feral,18,10,8
Beerista,tarren-mill,959,druid,feral,24,11,13
Luphrekfurry,ysondre,959,druid,feral,24,10,14
Hahafun,ravencrest,959,druid,feral,24,10,14
Dipz,frostwolf,958,druid,feral,18,10,8
Cyph,shadowsong,958,druid,feral,18,10,8
Трясишатай,gordunni,958,druid,feral,30,10,20
Nefertiti,baelgun,958,druid,feral,30,10,20
Ðjkillercat,ravencrest,958,druid,feral,36,10,26
Chikiz,ghostlands,957,druid,feral,18,10,8
Snorlaxza,ravencrest,957,druid,feral,65,26,39
Klatro,terokkar,956,druid,feral,239,122,117
Sadasch,dun-morogh,956,druid,feral,66,20,46
Tsajj,stormreaver,955,druid,feral,93,46,47
Corrupthz,outland,955,druid,feral,24,10,14
Zjukov,ragnaros,955,druid,feral,24,10,14
Pointlez,frostmane,954,druid,feral,24,10,14
Мехнакиске,howling-fjord,954,druid,feral,25,10,15
Kîñg,tarren-mill,952,druid,feral,136,68,68
Samandeega,kazzak,951,druid,feral,36,10,26
Aubenuit,dalaran,950,druid,feral,30,10,20
Kkriss,stormscale,946,druid,feral,18,10,8
Ультраафина,gordunni,946,druid,feral,24,10,14
Razzmina,culte-de-la-rive-noire,945,druid,feral,33,11,22
Окнет,grom,944,druid,feral,18,10,8
Жора,borean-tundra,943,druid,feral,24,10,14
Plingan,argent-dawn,942,druid,feral,23,10,13
Реептилоид,soulflayer,942,druid,feral,24,10,14
Ðexteroth,sanguino,940,druid,feral,30,15,15
Wuzzington,outland,940,druid,feral,24,10,14
Papricat,kazzak,938,druid,feral,34,19,15
Loafy,the-maelstrom,937,druid,feral,100,44,56
Храмнир,soulflayer,937,druid,feral,39,17,22
Blackwoodoo,kazzak,932,druid,feral,72,33,39
Hadesx,blackhand,931,druid,feral,76,37,39
Xpe,drakthul,931,druid,feral,42,12,30
Друлевой,greymane,930,druid,feral,60,28,32
Bimoon,archimonde,929,druid,feral,46,24,22
Sìíta,dun-modr,929,druid,feral,42,14,28
Sorron,blades-edge,926,druid,feral,36,19,17
Твойбарсик,gordunni,925,druid,feral,60,16,44
Tibaz,sylvanas,924,druid,feral,29,10,19
Asrekar,karazhan,922,druid,feral,36,18,18
Fyralion,silvermoon,921,druid,feral,46,21,25
Леминвинкс,eversong,920,druid,feral,30,17,13
Pawclaw,ragnaros,917,druid,feral,60,32,28
Whîskeycola,tarren-mill,916,druid,feral,46,16,30
Élmunia,ravencrest,915,druid,feral,82,39,43
Teddîursa,kazzak,915,druid,feral,34,10,24
Kratzbeiß,blackmoore,913,druid,feral,75,25,50
Ìncubus,pozzo-delleternità,912,druid,feral,26,11,15
Lutis,magtheridon,911,druid,feral,144,65,79
Zâtok,kargath,908,druid,feral,48,19,29
Migalo,outland,906,druid,feral,29,12,17
Muryo,der-rat-von-dalaran,903,druid,feral,90,34,56
Котбугимен,eversong,902,druid,feral,30,10,20
Gató,kazzak,899,druid,feral,32,11,21
Saltow,archimonde,899,druid,feral,64,19,45
Bislait,archimonde,896,druid,feral,66,24,42
Lohki,eredar,895,druid,feral,21,12,9
Джирас,gordunni,894,druid,feral,80,36,44
Jooriell,defias-brotherhood,893,druid,feral,42,21,21
Eivy,frostmane,891,druid,feral,145,60,85
Tardej,tarren-mill,891,druid,feral,67,23,44
Djarda,deathwing,888,druid,feral,36,11,25
Neischa,das-konsortium,886,druid,feral,48,21,27
Muju,stormscale,885,druid,feral,89,46,43
Mpounia,twilights-hammer,884,druid,feral,131,62,69
Maräanhatähr,silvermoon,884,druid,feral,60,21,39
Verbat,cthun,883,druid,feral,58,30,28
Zhabka,silvermoon,882,druid,feral,111,55,56
Deathzee,kazzak,879,druid,feral,71,35,36
Izumy,quelthalas,878,druid,feral,77,31,46
Эвгедент,deathguard,877,druid,feral,42,15,27
Stéely,ravencrest,876,druid,feral,45,24,21
Phandris,argent-dawn,876,druid,feral,103,51,52
Asarune,hyjal,875,druid,feral,50,24,26
Кошикк,azuregos,875,druid,feral,22,10,12
Фаллендэл,gordunni,873,druid,feral,67,31,36
Горртек,howling-fjord,873,druid,feral,69,31,38
Béar,arathor,870,druid,feral,76,28,48
Mikoor,aegwynn,864,druid,feral,12,9,3
Urfi,tyrande,864,druid,feral,12,9,3
Aleatório,grim-batol,864,druid,feral,18,9,9
Paramore,outland,864,druid,feral,18,9,9
Leylajr,ravencrest,864,druid,feral,18,9,9
Lolhaha,ravencrest,864,druid,feral,18,9,9
Dragonferal,tarren-mill,864,druid,feral,18,9,9
Sixmonthbann,ravencrest,864,druid,feral,18,9,9
Rímeru,blackmoore,864,druid,feral,18,9,9
Epikeks,blackmoore,863,druid,feral,16,10,6
Borknagar,thrall,863,druid,feral,18,9,9
Fíja,blackmoore,863,druid,feral,18,9,9
Nicodruid,ravencrest,863,druid,feral,18,9,9
Rbg,dun-modr,863,druid,feral,22,10,12
Sucukk,antonidas,863,druid,feral,22,10,12
Røxxy,silvermoon,863,druid,feral,24,9,15
Druipa,sylvanas,863,druid,feral,24,9,15
Пиггипоп,soulflayer,863,druid,feral,24,9,15
Àzà,dun-modr,863,druid,feral,27,9,18
Олежасутра,howling-fjord,863,druid,feral,30,9,21
Erenalby,draenor,862,druid,feral,18,9,9
Рубса,deathguard,862,druid,feral,18,9,9
Мунфайр,galakrond,862,druid,feral,18,9,9
Кецян,gordunni,862,druid,feral,19,9,10
Крофтт,goldrinn,861,druid,feral,12,9,3
Currare,aegwynn,861,druid,feral,18,9,9
Jeezuschrist,archimonde,861,druid,feral,24,9,15
Буйныйкот,gordunni,861,druid,feral,24,9,15
Feralfrenzy,twisting-nether,861,druid,feral,36,9,27
Caèlas,outland,859,druid,feral,18,9,9
Xerxës,outland,859,druid,feral,24,9,15
Бруан,gordunni,859,druid,feral,24,9,15
Hadespool,sanguino,859,druid,feral,24,9,15
Harbis,silvermoon,859,druid,feral,24,9,15
Toroboll,stormscale,858,druid,feral,18,9,9
Bigbear,stormrage,858,druid,feral,31,12,19
Feralzeus,sylvanas,858,druid,feral,24,9,15
Плагиат,grom,858,druid,feral,36,10,26
Cboi,aegwynn,857,druid,feral,24,9,15
Wathen,argent-dawn,857,druid,feral,34,12,22
Toaa,antonidas,857,druid,feral,30,9,21
Gámóra,argent-dawn,856,druid,feral,18,9,9
Arntooth,burning-legion,856,druid,feral,94,39,55
Мегасв,gordunni,856,druid,feral,24,9,15
Nitro,kazzak,856,druid,feral,24,9,15
Mivlang,kazzak,855,druid,feral,42,18,24
Blejkv,defias-brotherhood,855,druid,feral,24,10,14
Wainl,hyjal,854,druid,feral,30,9,21
Hönör,ysondre,853,druid,feral,192,91,101
Afta,ysondre,850,druid,feral,18,9,9
Леромейкен,fordragon,850,druid,feral,24,9,15
Envidius,kazzak,849,druid,feral,19,9,10
Elyrasin,argent-dawn,848,druid,feral,84,32,52
Somefcknname,stormscale,846,druid,feral,18,9,9
Frökensuss,stormscale,844,druid,feral,27,12,15
Tsill,archimonde,839,druid,feral,30,9,21
Ziovris,silvermoon,839,druid,feral,33,9,24
Miukïna,archimonde,837,druid,feral,12,9,3
Catsgomeow,outland,833,druid,feral,29,9,20
Elarya,ragnaros,829,druid,feral,20,10,10
Itzferal,durotan,820,druid,feral,20,9,11
Гимодера,gordunni,815,druid,feral,17,9,8
Зенза,howling-fjord,815,druid,feral,27,9,18
Sôalôgel,blackrock,813,druid,feral,21,9,12
Hwearingkid,ravencrest,808,druid,feral,102,42,60
Zulazain,bladefist,795,druid,feral,132,52,80
Düldül,kargath,781,druid,feral,240,113,127
Théó,grim-batol,777,druid,feral,53,22,31
Shadøwdruid,silvermoon,776,druid,feral,30,10,20
Mommonga,onyxia,775,druid,feral,63,24,39
Sedzun,magtheridon,770,druid,feral,39,9,30
Kgn,blackmoore,768,druid,feral,12,8,4
Meverrick,aegwynn,768,druid,feral,12,8,4
Snkxo,perenolde,768,druid,feral,12,8,4
Hakuchey,aegwynn,768,druid,feral,12,8,4
Babalito,tarren-mill,768,druid,feral,12,8,4
Drach,ravencrest,768,druid,feral,12,8,4
Gódcómplèx,argent-dawn,768,druid,feral,15,9,6
Drafter,ravencrest,768,druid,feral,18,8,10
Iproxy,dalaran,768,druid,feral,18,8,10
Iamtaladruid,archimonde,768,druid,feral,18,8,10
Stepsisdaky,stormreaver,768,druid,feral,18,8,10
Notaxtin,ravencrest,768,druid,feral,24,8,16
Bullhoezerx,silvermoon,768,druid,feral,24,8,16
Svxstarz,archimonde,768,druid,feral,30,8,22
Älênkâ,drakthul,768,druid,feral,30,8,22
Mapitom,stormscale,768,druid,feral,34,9,25
Kørnuto,nemesis,767,druid,feral,12,8,4
Ryáanz,ravencrest,767,druid,feral,12,8,4
Hanfjin,blackmoore,767,druid,feral,12,8,4
Firrothe,die-aldor,767,druid,feral,15,9,6
Vlashi,twisting-nether,767,druid,feral,18,8,10
Seysso,silvermoon,767,druid,feral,18,8,10
Braindamage,aegwynn,767,druid,feral,18,8,10
Стэлларпауэр,gordunni,767,druid,feral,18,8,10
Iathem,dun-modr,767,druid,feral,18,8,10
Xunjeral,blackhand,767,druid,feral,24,10,14
Уахо,howling-fjord,767,druid,feral,24,8,16
Baummaschine,blackrock,767,druid,feral,24,8,16
Acéré,archimonde,767,druid,feral,24,8,16
Pneuma,xavius,767,druid,feral,24,8,16
Imsothorny,genjuros,767,druid,feral,24,8,16
Hadoukan,ravencrest,766,druid,feral,12,8,4
Kutjing,dun-modr,766,druid,feral,12,8,4
Взпешка,gordunni,766,druid,feral,12,8,4
Thielyy,blackmoore,766,druid,feral,18,8,10
Krvopito,tarren-mill,765,druid,feral,12,8,4
Naraxz,ravencrest,765,druid,feral,12,8,4
Juri,blackrock,765,druid,feral,15,9,6
Koshde,blackrock,765,druid,feral,18,8,10
Chunkeykill,alonsus,765,druid,feral,18,8,10
Plankface,ravencrest,765,druid,feral,18,8,10
Шадараф,howling-fjord,765,druid,feral,21,9,12
Vorag,dalaran,765,druid,feral,24,8,16
Teknó,ragnaros,764,druid,feral,10,9,1
Lukass,drakthul,764,druid,feral,18,8,10
Djsnigel,stormscale,764,druid,feral,24,8,16
Shuffey,frostmane,763,druid,feral,12,8,4
Jimmorris,eredar,763,druid,feral,20,10,10
Valkeryu,hyjal,762,druid,feral,30,8,22
Razorleaf,turalyon,761,druid,feral,24,8,16
Kittyclâw,perenolde,761,druid,feral,36,8,28
Elbah,frostwolf,759,druid,feral,30,8,22
Fugazi,echsenkessel,759,druid,feral,30,8,22
Jupter,burning-blade,755,druid,feral,18,8,10
Имбахилка,lich-king,754,druid,feral,18,8,10
Kaycea,ragnaros,754,druid,feral,30,8,22
Деникин,thermaplugg,752,druid,feral,64,25,39
Cosiris,elune,749,druid,feral,48,17,31
Khai,argent-dawn,748,druid,feral,24,8,16
Nuada,skullcrusher,745,druid,feral,17,8,9
Greenfingerz,azjolnerub,744,druid,feral,36,9,27
Pegert,aegwynn,736,druid,feral,16,8,8
Viølin,silvermoon,729,druid,feral,24,8,16
Ellefina,suramar,723,druid,feral,29,8,21
Aègon,ravencrest,719,druid,feral,15,8,7
Iinfamousx,outland,719,druid,feral,15,8,7
Payday,darksorrow,712,druid,feral,21,8,13
Ianachu,tarren-mill,711,druid,feral,48,8,40
Euskal,chogall,703,druid,feral,14,8,6
Lionquokk,azjolnerub,703,druid,feral,16,8,8
Xarxius,sanguino,699,druid,feral,32,8,24
Ôpium,eldrethalas,693,druid,feral,34,12,22
Svarre,outland,690,druid,feral,16,8,8
Zoobidu,garona,672,druid,feral,12,7,5
Диздру,howling-fjord,672,druid,feral,12,7,5
Goretterog,archimonde,672,druid,feral,12,7,5
Hrtbrkn,ravencrest,672,druid,feral,12,7,5
Erebear,ravencrest,672,druid,feral,12,7,5
Minpeike,blackrock,672,druid,feral,12,7,5
Pàntoffel,thrall,672,druid,feral,12,7,5
Necorine,silvermoon,672,druid,feral,12,7,5
Iiora,thrall,672,druid,feral,12,7,5
Tofuchan,argent-dawn,672,druid,feral,12,7,5
Oni,kelthuzad,672,druid,feral,18,7,11
Luveena,kazzak,672,druid,feral,18,7,11
Coldkíng,twisting-nether,672,druid,feral,18,7,11
Dryáde,ravencrest,672,druid,feral,18,7,11
Sandirion,silvermoon,672,druid,feral,18,7,11
Найтдруляха,gordunni,672,druid,feral,18,7,11
Flawkin,kazzak,672,druid,feral,18,7,11
Marshy,kazzak,672,druid,feral,20,7,13
Zðe,la-croisade-écarlate,672,druid,feral,24,7,17
Zulucat,aegwynn,672,druid,feral,24,7,17
Druikraut,silvermoon,671,druid,feral,12,7,5
Déme,twisting-nether,671,druid,feral,12,7,5
Ytzü,archimonde,671,druid,feral,12,7,5
Rawberto,silvermoon,671,druid,feral,18,7,11
Kâgera,ysondre,671,druid,feral,18,7,11
Sheradel,argent-dawn,671,druid,feral,18,7,11
Pronkson,tarren-mill,671,druid,feral,18,7,11
Kig,ragnaros,671,druid,feral,18,7,11
Toron,dalaran,671,druid,feral,18,7,11
Falbâlas,hyjal,671,druid,feral,18,7,11
Bærbell,blackrock,671,druid,feral,18,7,11
Axiu,kazzak,671,druid,feral,24,7,17
Lazerbinks,blackmoore,671,druid,feral,24,7,17
Schniekers,blackmoore,671,druid,feral,24,7,17
Millya,sargeras,670,druid,feral,12,7,5
Сибирячечка,greymane,670,druid,feral,13,7,6
Rèvelyth,nemesis,670,druid,feral,18,7,11
Bigdaddykane,mannoroth,670,druid,feral,24,7,17
Тэйлаксу,howling-fjord,670,druid,feral,24,7,17
Docdruid,outland,670,druid,feral,30,7,23
Toredorxy,blackrock,669,druid,feral,12,7,5
Radime,khaz-modan,669,druid,feral,12,7,5
Линбус,gordunni,669,druid,feral,12,7,5
Kissmyson,draenor,669,druid,feral,24,7,17
Stoormrage,deathwing,668,druid,feral,12,7,5
Tinykiwi,silvermoon,668,druid,feral,24,7,17
Grassroots,ravencrest,668,druid,feral,30,7,23
Nidaalee,thrall,667,druid,feral,12,7,5
Rastinfalle,argent-dawn,667,druid,feral,18,7,11
Грэкхэк,soulflayer,666,druid,feral,15,8,7
Xicobahn,aggra-português,666,druid,feral,24,7,17
Fedas,neptulon,665,druid,feral,18,7,11
Amethistle,ravencrest,664,druid,feral,18,7,11
Fiagard,antonidas,662,druid,feral,12,7,5
Mãui,blackhand,658,druid,feral,27,8,19
Swiftblow,argent-dawn,657,druid,feral,24,7,17
Dinopwns,silvermoon,653,druid,feral,28,7,21
Tomalas,aggramar,644,druid,feral,36,7,29
Drujdjel,die-todeskrallen,641,druid,feral,17,7,10
Karahana,draenor,632,druid,feral,23,7,16
Shalys,archimonde,622,druid,feral,11,7,4
Зулгасилич,howling-fjord,620,druid,feral,23,7,16
Diktus,outland,618,druid,feral,14,8,6
Хённим,howling-fjord,607,druid,feral,11,7,4
Àyóorts,archimonde,607,druid,feral,14,7,7
Halabanaha,silvermoon,606,druid,feral,11,7,4
Zink,sanguino,590,druid,feral,25,7,18
Flaiq,twisting-nether,576,druid,feral,6,6,0
Snkyexpress,aegwynn,576,druid,feral,12,6,6
Sefardita,nemesis,576,druid,feral,12,6,6
Откинсяназад,howling-fjord,576,druid,feral,12,6,6
Seekx,silvermoon,576,druid,feral,12,6,6
Exoar,ravencrest,576,druid,feral,12,6,6
Asoli,aegwynn,576,druid,feral,12,6,6
Cagaboliches,sanguino,576,druid,feral,12,6,6
Arlandia,drakthul,576,druid,feral,12,6,6
Nyç,tarren-mill,576,druid,feral,12,6,6
Мцк,deathguard,576,druid,feral,12,6,6
Migaah,stormscale,576,druid,feral,12,6,6
Mikecat,aegwynn,576,druid,feral,12,6,6
Дикарьчик,goldrinn,576,druid,feral,12,6,6
Mdtwoxo,tarren-mill,576,druid,feral,12,6,6
Aslanah,hyjal,576,druid,feral,12,6,6
Forrest,bronze-dragonflight,576,druid,feral,12,6,6
Imbadxx,kazzak,576,druid,feral,12,6,6
Syniixmeow,ravencrest,576,druid,feral,12,6,6
Túskér,stormscale,576,druid,feral,12,6,6
Сиэн,ashenvale,576,druid,feral,12,6,6
Swagdemonxd,outland,576,druid,feral,12,6,6
Kittý,terokkar,576,druid,feral,12,6,6
Гримах,soulflayer,576,druid,feral,12,6,6
Druiderex,outland,576,druid,feral,12,6,6
Rølly,blackrock,576,druid,feral,12,6,6
Ataxyhehe,sylvanas,576,druid,feral,12,6,6
Seasor,argent-dawn,576,druid,feral,12,6,6
Dægmondrtrd,silvermoon,576,druid,feral,17,6,11
Radauronny,malganis,576,druid,feral,18,6,12
Andranjr,kazzak,576,druid,feral,18,6,12
Elflord,nemesis,576,druid,feral,18,6,12
Hasted,kazzak,576,druid,feral,18,6,12
Royo,eldrethalas,576,druid,feral,18,6,12
Gruffeline,marécage-de-zangar,576,druid,feral,18,6,12
Bamso,daggerspine,576,druid,feral,18,6,12
Rimpularaisa,grim-batol,576,druid,feral,18,6,12
Svass,ragnaros,576,druid,feral,18,6,12
Taurendruid,the-maelstrom,576,druid,feral,18,6,12
Arceuss,lothar,576,druid,feral,21,6,15
Fur,antonidas,576,druid,feral,23,6,17
Bloodyredyx,ysera,576,druid,feral,24,6,18
Cudse,aegwynn,576,druid,feral,30,6,24
Lizziath,ravencrest,575,druid,feral,12,6,6
Kime,ysondre,575,druid,feral,12,6,6
Nikta,trollbane,575,druid,feral,12,6,6
Ацкийдру,gordunni,575,druid,feral,12,6,6
Broccoliform,eredar,575,druid,feral,12,6,6
Yiakuza,chamber-of-aspects,575,druid,feral,12,6,6
Psixx,blackhand,575,druid,feral,12,6,6
Тое,soulflayer,575,druid,feral,12,6,6
Razah,ravencrest,575,druid,feral,12,6,6
Xurta,kazzak,575,druid,feral,12,6,6
Varìx,ysondre,575,druid,feral,12,6,6
Patrík,twisting-nether,575,druid,feral,12,6,6
Omegaheals,scarshield-legion,575,druid,feral,12,6,6
Chrîslol,twisting-nether,575,druid,feral,18,6,12
Derni,burning-legion,575,druid,feral,18,6,12
Alstra,kaelthas,575,druid,feral,18,6,12
Jokizy,burning-legion,575,druid,feral,24,6,18
Скайтибрайдх,gordunni,575,druid,feral,24,6,18
Artjin,shattered-hand,574,druid,feral,12,6,6
Ociroza,outland,574,druid,feral,18,6,12
Casiu,blackmoore,574,druid,feral,24,6,18
Rakúsh,thrall,572,druid,feral,19,7,12
Masapotemasa,ragnaros,572,druid,feral,24,6,18
Iwillninjau,tarren-mill,572,druid,feral,30,6,24
Avior,eonar,571,druid,feral,12,6,6
Грегориан,galakrond,571,druid,feral,12,6,6
Escares,blackrock,571,druid,feral,12,6,6
Fòggie,silvermoon,571,druid,feral,18,6,12
Annajak,bloodfeather,570,druid,feral,12,6,6
Элинна,ashenvale,570,druid,feral,18,6,12
Isellia,dun-morogh,565,druid,feral,12,6,6
Rogalli,sylvanas,565,druid,feral,18,6,12
Altramuz,uldum,564,druid,feral,15,7,8
Wârden,twisting-nether,558,druid,feral,17,6,11
Spangle,stormscale,554,druid,feral,21,7,14
Nefariz,dun-modr,544,druid,feral,16,6,10
Shapeshifts,kul-tiras,543,druid,feral,11,6,5
Совулька,howling-fjord,542,druid,feral,11,6,5
Диджейкошка,howling-fjord,527,druid,feral,11,6,5
Sároman,ravencrest,526,druid,feral,17,6,11
Glookies,dun-modr,522,druid,feral,16,8,8
Séifér,auchindoun,512,druid,feral,16,6,10
Belvrin,argent-dawn,512,druid,feral,17,6,11
Amuini,draenor,511,druid,feral,14,6,8
Treecuddlerr,blackhand,510,druid,feral,20,6,14
Vaalya,hyjal,509,druid,feral,16,6,10
Testôstauren,khaz-modan,495,druid,feral,25,6,19
Ryselol,nemesis,480,druid,feral,6,5,1
Forthis,frostmane,480,druid,feral,6,5,1
Aolynk,twisting-nether,480,druid,feral,6,5,1
Shanikya,argent-dawn,480,druid,feral,6,5,1
Demiannie,argent-dawn,480,druid,feral,9,6,3
Банихоуп,gordunni,480,druid,feral,10,6,4
Synzuu,turalyon,480,druid,feral,10,6,4
Krïsu,ravencrest,480,druid,feral,12,5,7
Hrabioid,burning-legion,480,druid,feral,12,5,7
Bezrark,arathor,480,druid,feral,12,5,7
Retzerbil,sunstrider,480,druid,feral,12,5,7
Johnnybims,eredar,480,druid,feral,12,5,7
Epidruid,stormrage,480,druid,feral,12,5,7
Domturbo,blackhand,480,druid,feral,12,5,7
Einsfünfkcat,madmortem,480,druid,feral,12,5,7
Jooblob,guldan,480,druid,feral,12,5,7
Deßradator,stormscale,480,druid,feral,12,5,7
Vanilian,burning-legion,480,druid,feral,12,5,7
Жеводанский,gordunni,480,druid,feral,12,5,7
Ulabo,gorgonnash,480,druid,feral,12,5,7
Chpochm,stormscale,480,druid,feral,12,5,7
Rapzr,argent-dawn,480,druid,feral,12,5,7
Мидинваернэ,gordunni,480,druid,feral,12,5,7
Bloomly,tarren-mill,480,druid,feral,12,5,7
Jabizz,azjolnerub,480,druid,feral,12,5,7
West,drakthul,480,druid,feral,12,5,7
Sketz,stormscale,480,druid,feral,12,5,7
Denyssa,die-aldor,480,druid,feral,12,5,7
Guiltyas,turalyon,480,druid,feral,12,5,7
Refractory,jaedenar,480,druid,feral,12,5,7
Adileath,argent-dawn,480,druid,feral,12,5,7
Flum,darksorrow,480,druid,feral,12,5,7
Noxxzar,stormscale,480,druid,feral,12,5,7
Cnox,argent-dawn,480,druid,feral,12,5,7
Xoriauz,archimonde,480,druid,feral,12,5,7
Dianabigby,silvermoon,480,druid,feral,12,5,7
Hipølita,zuljin,480,druid,feral,12,5,7
Акуламатата,soulflayer,480,druid,feral,12,5,7
Cptsponksa,tarren-mill,480,druid,feral,12,5,7
Hardbasior,burning-legion,480,druid,feral,12,5,7
Böserbäär,blackrock,480,druid,feral,13,5,8
Derrezzed,stormscale,480,druid,feral,18,5,13
Shreedex,blackmoore,480,druid,feral,18,5,13
Namata,archimonde,480,druid,feral,18,5,13
Outtanowhere,drakthul,480,druid,feral,18,5,13
Enylasi,hyjal,480,druid,feral,18,5,13
Pethebär,tarren-mill,480,druid,feral,18,5,13
Shikamarûu,blackmoore,480,druid,feral,18,5,13
Wølveríne,frostmane,480,druid,feral,18,5,13
Tskilli,draenor,480,druid,feral,18,5,13
Yiradur,stormscale,480,druid,feral,18,5,13
Cdsxr,outland,480,druid,feral,24,5,19
Thibagon,ysondre,479,druid,feral,12,5,7
Morsee,hellfire,479,druid,feral,12,5,7
Hyperunknown,grim-batol,479,druid,feral,12,5,7
Astlanes,ysondre,479,druid,feral,12,5,7
Sàngha,frostwolf,479,druid,feral,12,5,7
Poskehh,outland,479,druid,feral,12,5,7
Horkz,frostmourne,479,druid,feral,12,5,7
Koudru,emerald-dream,479,druid,feral,12,5,7
Dorcelvision,archimonde,479,druid,feral,12,5,7
Miscodedru,twisting-nether,479,druid,feral,12,5,7
Shifts,the-maelstrom,479,druid,feral,12,5,7
Telpha,onyxia,479,druid,feral,12,5,7
Mambalol,sanguino,479,druid,feral,12,5,7
Zayam,archimonde,479,druid,feral,12,5,7
Gatojuan,dun-modr,479,druid,feral,12,5,7
Vhaegar,grim-batol,479,druid,feral,18,5,13
Гибрайт,soulflayer,479,druid,feral,18,5,13
Vapuro,blackmoore,479,druid,feral,24,5,19
Plandros,draenor,479,druid,feral,24,5,19
Sharab,stormscale,479,druid,feral,24,5,19
Эндердру,gordunni,478,druid,feral,12,5,7
Перекурю,eversong,478,druid,feral,12,5,7
Påst,pozzo-delleternità,478,druid,feral,18,5,13
Cattastrophe,bronzebeard,477,druid,feral,12,5,7
Svek,ravencrest,477,druid,feral,24,5,19
Marceeh,blackhand,477,druid,feral,30,5,25
Mitomen,ragnaros,476,druid,feral,12,5,7
Ляшок,gordunni,476,druid,feral,18,5,13
Skylarr,alexstrasza,475,druid,feral,12,5,7
Apetino,dun-modr,447,druid,feral,11,5,6
Mâjezik,twisting-nether,447,druid,feral,14,6,8
Овналь,gordunni,431,druid,feral,11,5,6
Zynmeow,lordaeron,416,druid,feral,19,6,13
Nipply,ravencrest,415,druid,feral,15,6,9
Bingó,blutkessel,414,druid,feral,14,5,9
Lybell,antonidas,414,druid,feral,14,5,9
Reckwøød,ravencrest,414,druid,feral,20,5,15
Staness,khaz-modan,413,druid,feral,38,5,33
Аидкатв,gordunni,398,druid,feral,13,5,8
Jekl,ragnaros,384,druid,feral,6,4,2
Kantareboy,drakthul,384,druid,feral,6,4,2
Шабашиоргия,soulflayer,384,druid,feral,6,4,2
Grrxd,tarren-mill,384,druid,feral,6,4,2
Takamizy,ysondre,384,druid,feral,6,4,2
Improved,hyjal,384,druid,feral,6,4,2
Cráck,nagrand,384,druid,feral,6,4,2
Catleyia,ravencrest,384,druid,feral,6,4,2
Knatch,outland,384,druid,feral,6,4,2
Zunixboosted,lothar,384,druid,feral,6,4,2
Коксвейн,ashenvale,384,druid,feral,6,4,2
Greenlips,ravencrest,384,druid,feral,6,4,2
Høtz,dalaran,384,druid,feral,6,4,2
Kralox,hyjal,384,druid,feral,6,4,2
Osaviciosa,shendralar,384,druid,feral,6,4,2
Vioboomie,blackrock,384,druid,feral,6,4,2
Dystaleon,blackrock,384,druid,feral,6,4,2
Alistår,outland,384,druid,feral,6,4,2
Idraly,kirin-tor,384,druid,feral,6,4,2
Furiol,darksorrow,384,druid,feral,6,4,2
Akifumi,archimonde,384,druid,feral,6,4,2
Rêdx,archimonde,384,druid,feral,6,4,2
Ábomínatíon,draenor,384,druid,feral,6,4,2
Drudulicious,outland,384,druid,feral,6,4,2
Damnuisance,blackmoore,384,druid,feral,6,4,2
Tradi,defias-brotherhood,384,druid,feral,6,4,2
Dèxò,blackmoore,384,druid,feral,17,7,10
Klayx,rexxar,384,druid,feral,12,4,8
Iloveluci,ravencrest,384,druid,feral,12,4,8
Skinnyleg,baelgun,384,druid,feral,12,4,8
Shiotake,hyjal,384,druid,feral,12,4,8
Ðeathwatch,ravencrest,384,druid,feral,12,4,8
Risibisi,blackmoore,384,druid,feral,12,4,8
Kittyexpress,arygos,384,druid,feral,12,4,8
Lizasha,kirin-tor,384,druid,feral,12,4,8
Bígbaddruid,blackrock,384,druid,feral,12,4,8
Noxxll,gorgonnash,384,druid,feral,12,4,8
Plumitelv,outland,384,druid,feral,12,4,8
Ysomnia,tirion,384,druid,feral,12,4,8
Wikus,kazzak,384,druid,feral,12,4,8
Tenader,draenor,384,druid,feral,12,4,8
Drodiax,outland,384,druid,feral,12,4,8
ßlackßåmßå,zuljin,384,druid,feral,12,4,8
Goatmeal,draenor,384,druid,feral,12,4,8
Éxy,kazzak,384,druid,feral,12,4,8
Loonytoonz,blackhand,384,druid,feral,12,4,8
Солнцеедка,gordunni,384,druid,feral,12,4,8
Дикобразик,soulflayer,384,druid,feral,12,4,8
Алендор,deathguard,384,druid,feral,12,4,8
Brisemeute,kirin-tor,384,druid,feral,12,4,8
Nibbl,doomhammer,384,druid,feral,12,4,8
Фдру,eversong,384,druid,feral,12,4,8
Fiadhaich,argent-dawn,384,druid,feral,12,4,8
Giaya,turalyon,384,druid,feral,12,4,8
Kúùsh,frostwolf,384,druid,feral,12,4,8
Vitaex,blackrock,384,druid,feral,12,4,8
Helltoothz,ragnaros,384,druid,feral,12,4,8
Ushioxtora,outland,384,druid,feral,12,4,8
Турбокалясик,gordunni,384,druid,feral,12,4,8
Deranion,drakthul,384,druid,feral,12,4,8
Dawgydawg,emerald-dream,384,druid,feral,12,4,8
Cacatus,tarren-mill,384,druid,feral,12,4,8
Meliodaas,outland,384,druid,feral,12,4,8
Forcedbeef,burning-legion,384,druid,feral,12,4,8
Csacsikuki,ragnaros,384,druid,feral,17,4,13
Lupa,drakthul,384,druid,feral,18,4,14
Туундра,howling-fjord,384,druid,feral,18,4,14
Senoka,shattrath,384,druid,feral,18,4,14
Wooden,terokkar,384,druid,feral,18,4,14
Milkniatrump,tarren-mill,384,druid,feral,18,4,14
Jellybra,tarren-mill,384,druid,feral,18,4,14
Legyna,ravencrest,384,druid,feral,18,4,14
Tigerroll,kazzak,384,druid,feral,30,4,26
Kôhon,blackhand,383,druid,feral,6,4,2
Hartzig,blackmoore,383,druid,feral,6,4,2
Tsukuyómi,ragnaros,383,druid,feral,6,4,2
Bearshift,aggra-português,383,druid,feral,6,4,2
Fendoras,argent-dawn,383,druid,feral,6,4,2
Jøkëër,hyjal,383,druid,feral,12,4,8
Jingho,blackrock,383,druid,feral,12,4,8
Kinoai,antonidas,383,druid,feral,12,4,8
Backeye,silvermoon,383,druid,feral,12,4,8
Murraywolf,dun-modr,383,druid,feral,12,4,8
Tettsu,silvermoon,383,druid,feral,12,4,8
Asterya,dun-modr,383,druid,feral,16,5,11
Astøriøn,elune,383,druid,feral,18,4,14
Кошатинко,booty-bay,383,druid,feral,18,4,14
Sheiheda,kazzak,383,druid,feral,18,4,14
Vanarea,argent-dawn,383,druid,feral,19,4,15
Jamaicanherb,bronzebeard,382,druid,feral,12,4,8
Hasdruida,zuljin,382,druid,feral,14,4,10
Kyth,forscherliga,382,druid,feral,18,4,14
Muntherx,twisting-nether,351,druid,feral,10,4,6
Yopi,stormscale,351,druid,feral,11,4,7
Zanorákma,ravencrest,330,druid,feral,16,5,11
Wintx,ragnaros,329,druid,feral,24,7,17
Rixdudu,silvermoon,319,druid,feral,5,4,1
Ninmah,quelthalas,303,druid,feral,25,4,21
Fraptal,dalaran,288,druid,feral,6,3,3
Амахасла,deathweaver,288,druid,feral,6,3,3
Boldwìck,kazzak,288,druid,feral,6,3,3
Kakoje,burning-legion,288,druid,feral,6,3,3
Kikïnøu,garona,288,druid,feral,6,3,3
Hardcrits,kazzak,288,druid,feral,6,3,3
Sìmbano,eredar,288,druid,feral,6,3,3
Druidicchi,stormscale,288,druid,feral,6,3,3
Trell,defias-brotherhood,288,druid,feral,6,3,3
Shirí,hyjal,288,druid,feral,6,3,3
Melither,ravencrest,288,druid,feral,6,3,3
Lil,elune,288,druid,feral,6,3,3
Tearxd,twisting-nether,288,druid,feral,6,3,3
Hundavidsad,quelthalas,288,druid,feral,6,3,3
Fearthecat,defias-brotherhood,288,druid,feral,6,3,3
Kørn,drakthul,288,druid,feral,6,3,3
Мивинчик,ashenvale,288,druid,feral,6,3,3
Жексоул,gordunni,288,druid,feral,6,3,3
Somalí,blackmoore,288,druid,feral,6,3,3
Vigôuróuz,blackmoore,288,druid,feral,6,3,3
Alessathrina,tarren-mill,288,druid,feral,6,3,3
Ferpylul,ragnaros,288,druid,feral,6,3,3
Gargnda,tarren-mill,288,druid,feral,6,3,3
Wildthing,blackmoore,288,druid,feral,6,3,3
Miruush,malganis,288,druid,feral,6,3,3
Reservebär,blackhand,288,druid,feral,6,3,3
Sök,hyjal,288,druid,feral,6,3,3
Zipydruid,tarren-mill,288,druid,feral,6,3,3
Sneakerpimps,draenor,288,druid,feral,6,3,3
Zusaria,azshara,288,druid,feral,6,3,3
Павлорион,gordunni,288,druid,feral,6,3,3
Kittys,ysondre,288,druid,feral,6,3,3
Theonlydruid,frostmane,288,druid,feral,6,3,3
Feign,blackmoore,288,druid,feral,6,3,3
Oddform,silvermoon,288,druid,feral,6,3,3
Urgrull,baelgun,288,druid,feral,6,3,3
Yepnesse,khaz-modan,288,druid,feral,6,3,3
Sylvy,dun-modr,288,druid,feral,6,3,3
Xercàs,outland,288,druid,feral,6,3,3
Lyrasanna,argent-dawn,288,druid,feral,6,3,3
Высерыш,galakrond,288,druid,feral,6,3,3
Мегатро,greymane,288,druid,feral,6,3,3
Muffler,ragnaros,288,druid,feral,6,3,3
Døgferal,stormscale,288,druid,feral,6,3,3
Вагинн,soulflayer,288,druid,feral,6,3,3
Sweazx,archimonde,288,druid,feral,6,3,3
Starryraven,argent-dawn,288,druid,feral,6,3,3
Bigbrrd,outland,288,druid,feral,6,3,3
Pyaw,kazzak,288,druid,feral,6,3,3
Lunanikuya,ravencrest,288,druid,feral,6,3,3
Exjuggy,twisting-nether,288,druid,feral,6,3,3
Bigborst,ravencrest,288,druid,feral,6,3,3
Mäffu,silvermoon,288,druid,feral,6,3,3
Alkurosa,sylvanas,288,druid,feral,6,3,3
Madgazfanboi,ravencrest,288,druid,feral,6,3,3
Zantill,chamber-of-aspects,288,druid,feral,7,3,4
Easywaay,silvermoon,288,druid,feral,7,3,4
Shingeki,alonsus,288,druid,feral,8,3,5
Muhehe,burning-blade,288,druid,feral,14,4,10
Bénjî,khazgoroth,288,druid,feral,12,3,9
Elocat,blackmoore,288,druid,feral,12,3,9
Avicî,ravencrest,288,druid,feral,12,3,9
Taatz,draenor,288,druid,feral,12,3,9
Gurudru,tarren-mill,288,druid,feral,12,3,9
Xdrive,blackrock,288,druid,feral,12,3,9
Drocos,genjuros,288,druid,feral,12,3,9
Snoozerboy,kazzak,288,druid,feral,12,3,9
Шокшо,soulflayer,288,druid,feral,12,3,9
Bepipane,pozzo-delleternità,288,druid,feral,12,3,9
Kajirä,archimonde,288,druid,feral,12,3,9
Føurtth,ragnaros,288,druid,feral,12,3,9
Ddggss,ragnaros,288,druid,feral,12,3,9
Azyol,argent-dawn,288,druid,feral,12,3,9
Wheen,dun-morogh,288,druid,feral,12,3,9
Papjin,blackhand,288,druid,feral,12,3,9
Hahnvm,stormscale,288,druid,feral,12,3,9
Healnpeel,turalyon,288,druid,feral,12,3,9
Käisur,doomhammer,288,druid,feral,12,3,9
Jimseung,drekthar,288,druid,feral,12,3,9
Norlanda,ravencrest,288,druid,feral,12,3,9
Teddytree,ravencrest,288,druid,feral,12,3,9
Qfrost,ragnaros,288,druid,feral,12,3,9
Myex,exodar,288,druid,feral,12,3,9
Onmyass,dragonblight,288,druid,feral,12,3,9
Оленяпеченя,gordunni,288,druid,feral,12,3,9
Ripern,silvermoon,288,druid,feral,12,3,9
Ferdax,outland,288,druid,feral,12,3,9
Murzzilka,kazzak,288,druid,feral,12,3,9
Phòènìx,twisting-nether,288,druid,feral,12,3,9
Некрокэт,gordunni,288,druid,feral,17,3,14
Khânz,twisting-nether,288,druid,feral,18,3,15
Tallbutshort,stormscale,288,druid,feral,18,3,15
Ashamane,outland,288,druid,feral,18,3,15
Frincessa,burning-legion,288,druid,feral,18,3,15
Joshmoldr,aszune,288,druid,feral,18,3,15
Япельсин,borean-tundra,288,druid,feral,18,3,15
Альне,howling-fjord,288,druid,feral,18,3,15
Cemendur,bronzebeard,287,druid,feral,6,3,3
Moxxim,ragnaros,287,druid,feral,6,3,3
Giosis,stormscale,287,druid,feral,6,3,3
Sinmanos,eredar,287,druid,feral,6,3,3
Swalli,stormscale,287,druid,feral,12,3,9
Vólotyr,ravencrest,287,druid,feral,12,3,9
Rockymarci,dalaran,287,druid,feral,12,3,9
Thélon,antonidas,287,druid,feral,18,3,15
Treébeárd,draenor,287,druid,feral,18,3,15
Papírzsepi,ragnaros,287,druid,feral,18,3,15
Alligatordru,kazzak,287,druid,feral,18,3,15
Búll,aegwynn,287,druid,feral,24,3,21
Puuhalí,stormreaver,286,druid,feral,6,3,3
Zottelmahne,blackrock,286,druid,feral,6,3,3
Dildor,ysondre,286,druid,feral,6,3,3
Bakar,ghostlands,286,druid,feral,6,3,3
Creadora,ravencrest,255,druid,feral,11,3,8
Bartax,culte-de-la-rive-noire,240,druid,feral,9,3,6
Hrrybo,argent-dawn,239,druid,feral,5,3,2
Ripbot,grim-batol,239,druid,feral,5,3,2
Kripl,ragnaros,239,druid,feral,5,3,2
Yopod,draenor,239,druid,feral,5,3,2
Persefal,garona,239,druid,feral,11,3,8
Anyône,dun-morogh,229,druid,feral,16,4,12
Tarmara,outland,223,druid,feral,8,3,5
Skiiter,draenor,223,druid,feral,14,3,11
Tommyferal,outland,192,druid,feral,4,3,1
Yerachmiel,argent-dawn,192,druid,feral,9,3,6
Тырубльдуде,gordunni,192,druid,feral,9,3,6
Yiraz,aegwynn,192,druid,feral,6,2,4
Stuu,nathrezim,192,druid,feral,6,2,4
Getsomefunny,archimonde,192,druid,feral,6,2,4
Mabylinshi,grim-batol,192,druid,feral,6,2,4
Metamø,blackrock,192,druid,feral,6,2,4
Santamonica,blackrock,192,druid,feral,6,2,4
Hairydøtter,aegwynn,192,druid,feral,6,2,4
Leafceld,aggra-português,192,druid,feral,6,2,4
Bïscøte,archimonde,192,druid,feral,6,2,4
Badbird,thunderhorn,192,druid,feral,6,2,4
Smat,thunderhorn,192,druid,feral,6,2,4
Wpierdol,aegwynn,192,druid,feral,6,2,4
Scotarella,nemesis,192,druid,feral,6,2,4
Sýlina,aegwynn,192,druid,feral,6,2,4
Comodruid,nemesis,192,druid,feral,6,2,4
Smirnó,aegwynn,192,druid,feral,6,2,4
Хайпхайп,howling-fjord,192,druid,feral,6,2,4
Zibark,nemesis,192,druid,feral,6,2,4
Pöttli,blackhand,192,druid,feral,6,2,4
Duzky,kazzak,192,druid,feral,6,2,4
Вендьета,blackscar,192,druid,feral,6,2,4
Zouzouille,ravencrest,192,druid,feral,6,2,4
Bóssít,doomhammer,192,druid,feral,6,2,4
Angrykefir,draenor,192,druid,feral,6,2,4
Lyvaley,dun-modr,192,druid,feral,6,2,4
Mjáy,tarren-mill,192,druid,feral,6,2,4
Nidra,silvermoon,192,druid,feral,6,2,4
Атиса,gordunni,192,druid,feral,6,2,4
Citrus,sargeras,192,druid,feral,6,2,4
Shyasiandru,area-52,192,druid,feral,6,2,4
Кентухен,gordunni,192,druid,feral,6,2,4
Bettyblue,blackmoore,192,druid,feral,6,2,4
Rabatout,eitrigg,192,druid,feral,6,2,4
Friidaf,lightbringer,192,druid,feral,6,2,4
Cylàn,sylvanas,192,druid,feral,6,2,4
Aleactor,exodar,192,druid,feral,6,2,4
Calimopat,draenor,192,druid,feral,6,2,4
Glyn,earthen-ring,192,druid,feral,6,2,4
Pitsas,silvermoon,192,druid,feral,6,2,4
Kormakurr,silvermoon,192,druid,feral,6,2,4
Smallbetty,silvermoon,192,druid,feral,6,2,4
Móurningwood,hellfire,192,druid,feral,6,2,4
Growlithe,hellfire,192,druid,feral,6,2,4
Senjí,archimonde,192,druid,feral,6,2,4
Tharae,blackmoore,192,druid,feral,6,2,4
Rekkonia,hyjal,192,druid,feral,6,2,4
Apexpredetor,moonglade,192,druid,feral,6,2,4
Сверххищникк,soulflayer,192,druid,feral,6,2,4
Voyerka,drakthul,192,druid,feral,6,2,4
Rrayed,kazzak,192,druid,feral,6,2,4
Druiddamage,the-maelstrom,192,druid,feral,6,2,4
Aryitu,blackrock,192,druid,feral,6,2,4
Yeats,blackmoore,192,druid,feral,6,2,4
Kisskossa,stormscale,192,druid,feral,6,2,4
Feralsaber,ghostlands,192,druid,feral,6,2,4
Treepoloski,stormscale,192,druid,feral,6,2,4
Insanexd,antonidas,192,druid,feral,6,2,4
Buffaloh,antonidas,192,druid,feral,6,2,4
Píshi,silvermoon,192,druid,feral,6,2,4
Nightsky,outland,192,druid,feral,6,2,4
Lilkâzzam,blackrock,192,druid,feral,6,2,4
Redyogurt,outland,192,druid,feral,6,2,4
Flewks,silvermoon,192,druid,feral,6,2,4
Ammetåke,kazzak,192,druid,feral,6,2,4
Lunaarria,blackrock,192,druid,feral,6,2,4
Rakuzo,kazzak,192,druid,feral,6,2,4
Inchmale,darkspear,192,druid,feral,6,2,4
Routasydän,shattered-hand,192,druid,feral,6,2,4
Lorya,terokkar,192,druid,feral,6,2,4
Álvaromel,blackmoore,192,druid,feral,6,2,4
Gibx,ravencrest,192,druid,feral,6,2,4
Zyron,sanguino,192,druid,feral,6,2,4
Erundrood,ysondre,192,druid,feral,6,2,4
Narawenn,ysondre,192,druid,feral,6,2,4
Variolus,dun-modr,192,druid,feral,6,2,4
Tylou,khaz-modan,192,druid,feral,6,2,4
Jimmyxdd,kazzak,192,druid,feral,6,2,4
Womzas,blackhand,192,druid,feral,6,2,4
Roronoa,antonidas,192,druid,feral,6,2,4
Вохако,howling-fjord,192,druid,feral,6,2,4
Nelfboyuk,tarren-mill,192,druid,feral,6,2,4
Rabacki,blackmoore,192,druid,feral,6,2,4
Цветий,howling-fjord,192,druid,feral,6,2,4
Melcharis,frostwolf,192,druid,feral,6,2,4
Savagehèals,ravencrest,192,druid,feral,6,2,4
Dwaokut,ravencrest,192,druid,feral,6,2,4
Hivjue,argent-dawn,192,druid,feral,6,2,4
Каирон,deepholm,192,druid,feral,6,2,4
Likë,frostwolf,192,druid,feral,6,2,4
Mopferal,twisting-nether,192,druid,feral,6,2,4
Catwild,blackmoore,192,druid,feral,6,2,4
Lechaource,silvermoon,192,druid,feral,6,2,4
Tøpkittyg,twisting-nether,192,druid,feral,6,2,4
Kiizal,twisting-nether,192,druid,feral,6,2,4
Melcow,eredar,192,druid,feral,6,2,4
Lsdpinkcandy,twisting-nether,192,druid,feral,6,2,4
Luftedar,twisting-nether,192,druid,feral,6,2,4
Sasðri,argent-dawn,192,druid,feral,6,2,4
Jænne,ysondre,192,druid,feral,6,2,4
Ryletha,argent-dawn,192,druid,feral,6,2,4
Jokiri,argent-dawn,192,druid,feral,6,2,4
Beginníng,outland,192,druid,feral,6,2,4
Seekíng,blackmoore,192,druid,feral,6,2,4
Nonstérilisé,dalaran,192,druid,feral,6,2,4
Yopede,medivh,192,druid,feral,6,2,4
Helpimstuck,ravencrest,192,druid,feral,6,2,4
Szondykhan,ragnaros,192,druid,feral,6,2,4
Spidete,sanguino,192,druid,feral,9,2,7
Frunze,sylvanas,192,druid,feral,9,2,7
Glenn,alakir,192,druid,feral,12,2,10
Daìs,dalaran,192,druid,feral,12,2,10
Aaune,argent-dawn,192,druid,feral,12,2,10
Amoveo,argent-dawn,192,druid,feral,12,2,10
Erelieva,silvermoon,192,druid,feral,12,2,10
Нахильник,howling-fjord,192,druid,feral,12,2,10
Nicotex,draenor,192,druid,feral,12,2,10
Инфернох,gordunni,192,druid,feral,12,2,10
Trànsformer,nemesis,192,druid,feral,12,2,10
Drujoty,cthun,192,druid,feral,12,2,10
Kuw,archimonde,192,druid,feral,12,2,10
Silverriver,ragnaros,192,druid,feral,12,2,10
Ellaria,burning-legion,192,druid,feral,12,2,10
Безусловно,deathguard,192,druid,feral,12,2,10
Kokotinka,drakthul,192,druid,feral,12,2,10
Affines,the-maelstrom,192,druid,feral,12,2,10
Naturexbot,silvermoon,192,druid,feral,12,2,10
Adawehi,ravencrest,192,druid,feral,12,2,10
Klintxweed,hyjal,192,druid,feral,12,2,10
Кратиос,soulflayer,192,druid,feral,12,2,10
Touchmehere,stormscale,192,druid,feral,12,2,10
Splatz,runetotem,192,druid,feral,12,2,10
Zeustriker,draenor,192,druid,feral,12,2,10
Shadaur,tarren-mill,192,druid,feral,12,2,10
Steakotaur,chamber-of-aspects,192,druid,feral,12,2,10
Seque,silvermoon,192,druid,feral,12,2,10
Busal,kazzak,192,druid,feral,12,2,10
Rasgath,kazzak,192,druid,feral,12,2,10
Moundîr,archimonde,192,druid,feral,12,2,10
Speegle,kazzak,192,druid,feral,12,2,10
Guisantes,shendralar,192,druid,feral,18,2,16
Zooluu,ragnaros,192,druid,feral,18,2,16
Venh,forscherliga,192,druid,feral,18,2,16
Gachal,kazzak,192,druid,feral,18,2,16
Citral,balnazzar,191,druid,feral,6,2,4
Luhxius,khaz-modan,191,druid,feral,6,2,4
Jompemanfish,stormscale,191,druid,feral,6,2,4
Денмакс,borean-tundra,191,druid,feral,6,2,4
Sellsarya,blackmoore,191,druid,feral,6,2,4
Nayato,draenor,191,druid,feral,12,2,10
Loriann,twisting-nether,191,druid,feral,18,2,16
Meuhtéki,hyjal,190,druid,feral,13,3,10
Avisa,blackhand,190,druid,feral,12,2,10
Wolfly,ravencrest,179,druid,feral,21,7,14
Smucka,ragnaros,176,druid,feral,7,3,4
Ilyethea,earthen-ring,175,druid,feral,11,2,9
Mazàr,pozzo-delleternità,160,druid,feral,10,2,8
Hiloqtdruid,blackmoore,159,druid,feral,5,2,3
Korkskruven,draenor,159,druid,feral,5,2,3
Scisan,aggra-português,159,druid,feral,5,2,3
Grawlex,silvermoon,159,druid,feral,11,2,9
Szamoca,hellfire,159,druid,feral,11,2,9
Bearfôrceône,blackrock,159,druid,feral,11,2,9
Найадра,gordunni,144,druid,feral,9,2,7
Несессари,howling-fjord,144,druid,feral,15,2,13
Chdanydrood,marécage-de-zangar,138,druid,feral,9,3,6
Tjann,darksorrow,138,druid,feral,9,3,6
Azaría,aegwynn,128,druid,feral,4,2,2
Trashcat,anetheron,128,druid,feral,4,2,2
Baniaucygana,draenor,127,druid,feral,4,2,2
Wildsoul,hyjal,127,druid,feral,8,2,6
Wurnas,silvermoon,121,druid,feral,15,3,12
Wolfheart,norgannon,96,druid,feral,3,2,1
Strand,ragnaros,96,druid,feral,6,1,5
Shaylanna,frostmane,96,druid,feral,6,1,5
Tael,argent-dawn,96,druid,feral,6,1,5
Feyzode,ysondre,96,druid,feral,6,1,5
Benfufu,kazzak,96,druid,feral,6,1,5
Onmamama,die-aldor,96,druid,feral,6,1,5
Пикиточеные,howling-fjord,96,druid,feral,6,1,5
Yamsha,dalaran,96,druid,feral,6,1,5
Théodên,dalaran,96,druid,feral,6,1,5
Tshungubuäch,eredar,96,druid,feral,6,1,5
Yaaji,archimonde,96,druid,feral,6,1,5
Bíerling,antonidas,96,druid,feral,6,1,5
Yarrp,stormscale,96,druid,feral,6,1,5
Ashleyx,antonidas,96,druid,feral,6,1,5
Mafakaclones,archimonde,96,druid,feral,6,1,5
Абапер,galakrond,96,druid,feral,6,1,5
Saliencias,kazzak,96,druid,feral,6,1,5
Hefdgaharald,antonidas,96,druid,feral,6,1,5
Hecone,los-errantes,96,druid,feral,6,1,5
Bitsuie,magtheridon,96,druid,feral,6,1,5
Jungamajunga,quelthalas,96,druid,feral,6,1,5
Арбузир,howling-fjord,96,druid,feral,6,1,5
Plantz,argent-dawn,96,druid,feral,6,1,5
Elhezar,dun-modr,96,druid,feral,6,1,5
Leslra,agamaggan,96,druid,feral,6,1,5
Sadete,sanguino,96,druid,feral,6,1,5
Cowronavirus,zuljin,96,druid,feral,6,1,5
Fabulous,genjuros,96,druid,feral,6,1,5
Kátzumoto,kazzak,96,druid,feral,6,1,5
Chowmien,alakir,96,druid,feral,6,1,5
Cegorach,xavius,96,druid,feral,6,1,5
Catgirlx,ravencrest,96,druid,feral,6,1,5
Lucianis,drakthul,96,druid,feral,6,1,5
Мурталор,soulflayer,96,druid,feral,6,1,5
Папакамбэк,grom,96,druid,feral,6,1,5
Опаснокрасив,soulflayer,96,druid,feral,6,1,5
Venomjr,bloodhoof,96,druid,feral,6,1,5
Dëlins,outland,96,druid,feral,6,1,5
Xenrakh,blackhand,96,druid,feral,6,1,5
Zypra,shadowsong,96,druid,feral,6,1,5
Majesty,nagrand,96,druid,feral,6,1,5
Haragmancs,arathor,96,druid,feral,6,1,5
Rbgbear,blackhand,96,druid,feral,6,1,5
Aureliañ,tarren-mill,96,druid,feral,6,1,5
Bakslat,draenor,96,druid,feral,6,1,5
Hävefunny,archimonde,96,druid,feral,6,1,5
Crocobango,draenor,96,druid,feral,6,1,5
Aahboom,draenor,96,druid,feral,6,1,5
Thecousins,ravencrest,96,druid,feral,6,1,5
Zinister,hyjal,96,druid,feral,6,1,5
Jãy,ravencrest,96,druid,feral,6,1,5
Ãnimal,argent-dawn,96,druid,feral,6,1,5
Sabresheep,twisting-nether,96,druid,feral,6,1,5
Awán,aegwynn,96,druid,feral,6,1,5
Sodniss,aggra-português,96,druid,feral,6,1,5
Prayshot,hyjal,96,druid,feral,6,1,5
Бьеорн,gordunni,96,druid,feral,6,1,5
Хеельхеем,gordunni,96,druid,feral,6,1,5
Plàntz,tarren-mill,96,druid,feral,6,1,5
Zàphiirò,archimonde,96,druid,feral,6,1,5
Ayatola,conseil-des-ombres,96,druid,feral,6,1,5
Nidrien,doomhammer,96,druid,feral,6,1,5
Виена,blackscar,96,druid,feral,6,1,5
Benduu,doomhammer,96,druid,feral,6,1,5
Worgren,doomhammer,96,druid,feral,6,1,5
Albinoape,doomhammer,96,druid,feral,6,1,5
Biggmac,hyjal,96,druid,feral,6,1,5
Seraxi,der-mithrilorden,96,druid,feral,6,1,5
Aristrea,dun-morogh,96,druid,feral,6,1,5
Cesty,silvermoon,96,druid,feral,6,1,5
Корбан,howling-fjord,96,druid,feral,6,1,5
Eneel,malganis,96,druid,feral,6,1,5
Edos,lordaeron,96,druid,feral,6,1,5
Tartáros,blackrock,96,druid,feral,6,1,5
Ragnai,emerald-dream,96,druid,feral,6,1,5
Hyza,bronzebeard,96,druid,feral,6,1,5
Esyae,silvermoon,96,druid,feral,6,1,5
Spoco,defias-brotherhood,96,druid,feral,6,1,5
Naturepower,ulduar,96,druid,feral,6,1,5
Stjärna,kult-der-verdammten,96,druid,feral,6,1,5
Bolhás,defias-brotherhood,96,druid,feral,6,1,5
Heav,kiljaeden,96,druid,feral,6,1,5
Rastacow,darkmoon-faire,96,druid,feral,6,1,5
Thaneo,blackmoore,96,druid,feral,6,1,5
Hârâohshît,blackmoore,96,druid,feral,6,1,5
Laaide,blackmoore,96,druid,feral,6,1,5
Toxii,argent-dawn,96,druid,feral,10,1,9
Egoistsenpai,draenor,96,druid,feral,11,1,10
Yabooni,ravencrest,96,druid,feral,12,1,11
Scaramouches,ravencrest,96,druid,feral,12,1,11
Voraxdr,draenor,96,druid,feral,12,1,11
Enukai,blackmoore,96,druid,feral,12,1,11
Sainsy,silvermoon,96,druid,feral,12,1,11
Mássive,darkmoon-faire,96,druid,feral,12,1,11
Druidlaba,drakthul,96,druid,feral,12,1,11
Hairypawter,bloodscalp,96,druid,feral,12,1,11
Raferalston,nathrezim,96,druid,feral,12,1,11
Mäywen,ravencrest,96,druid,feral,12,1,11
Farnae,kirin-tor,96,druid,feral,12,1,11
Snok,twisting-nether,96,druid,feral,12,1,11
Thaleus,archimonde,96,druid,feral,12,1,11
Réck,chamber-of-aspects,96,druid,feral,12,1,11
Nakkikastike,magtheridon,96,druid,feral,12,1,11
Veyronn,burning-legion,96,druid,feral,12,1,11
Anorixx,outland,96,druid,feral,12,1,11
Moonroxx,elune,96,druid,feral,12,1,11
Sempai,hyjal,96,druid,feral,18,1,17
Randompappa,stormreaver,96,druid,feral,18,1,17
Bidodici,nemesis,95,druid,feral,6,1,5
Малориус,eversong,95,druid,feral,9,1,8
Allîyâ,archimonde,79,druid,feral,5,1,4
Ethjunior,ravencrest,79,druid,feral,5,1,4
Tamakie,blackmoore,64,druid,feral,4,1,3
Прокси,gordunni,64,druid,feral,4,1,3
Beinskjørhët,silvermoon,64,druid,feral,4,1,3
Forigiver,draenor,64,druid,feral,4,1,3
Cus,tarren-mill,48,druid,feral,3,1,2
Férônïxa,dalaran,48,druid,feral,3,1,2
Philybo,blackrock,48,druid,feral,6,1,5
Buunchishi,archimonde,42,druid,feral,9,2,7
Methàz,stormscale,31,druid,feral,2,1,1
Zerzah,kazzak,31,druid,feral,2,1,1
Гримах,gordunni,16,druid,feral,1,1,0
Bregalad,twisting-nether,9,druid,feral,7,2,5
Fuséton,tarren-mill,2490,druid,balance,427,255,172
Kaabeedo,ravencrest,2416,druid,balance,120,74,46
Melby,tarren-mill,2415,druid,balance,285,154,131
Immuz,kazzak,2407,druid,balance,178,103,75
Wwboomy,kazzak,2401,druid,balance,210,118,92
Afky,stormreaver,2397,druid,balance,293,161,132
Bbl,rexxar,2358,druid,balance,126,79,47
Maroxd,stormscale,2351,druid,balance,186,118,68
Brøkéday,kazzak,2326,druid,balance,173,105,68
Merceý,ravencrest,2323,druid,balance,97,65,32
Yalojr,blackmoore,2323,druid,balance,80,52,28
Antahka,archimonde,2322,druid,balance,107,63,44
Опущеныйкелх,gordunni,2310,druid,balance,209,112,97
Frapucino,ravencrest,2302,druid,balance,141,99,42
Shåmss,kazzak,2265,druid,balance,72,43,29
Gigacooker,ravencrest,2264,druid,balance,138,91,47
Dezarden,die-aldor,2258,druid,balance,189,112,77
Sleepz,blackrock,2249,druid,balance,203,126,77
Rlwlwlwlwr,twisting-nether,2247,druid,balance,108,73,35
Boomky,blackmoore,2246,druid,balance,84,50,34
Deép,nazjatar,2234,druid,balance,290,148,142
Бубаджек,howling-fjord,2233,druid,balance,179,101,78
Топу,gordunni,2228,druid,balance,96,67,29
Muhammadali,ravencrest,2228,druid,balance,84,51,33
Bd,stormscale,2225,druid,balance,83,49,34
Senfkai,kelthuzad,2223,druid,balance,72,59,13
Jwrld,stormscale,2216,druid,balance,84,46,38
Wriong,ravencrest,2215,druid,balance,169,101,68
Tmeister,kazzak,2202,druid,balance,156,91,65
Méáckós,aegwynn,2201,druid,balance,206,108,98
Moodý,aegwynn,2199,druid,balance,217,128,89
Vabore,twisting-nether,2199,druid,balance,252,129,123
Batboomie,zuljin,2198,druid,balance,280,156,124
Lappe,stormreaver,2197,druid,balance,65,37,28
Lucidz,kazzak,2196,druid,balance,86,46,40
Trungoo,blackrock,2194,druid,balance,126,84,42
Bigdambitex,draenor,2192,druid,balance,66,46,20
Zødzin,kazzak,2187,druid,balance,138,75,63
Shayia,aegwynn,2187,druid,balance,209,112,97
Friedbrocolí,tarren-mill,2184,druid,balance,102,62,40
Kabôôm,stormscale,2182,druid,balance,149,86,63
Shayîa,nozdormu,2181,druid,balance,128,77,51
Celtimi,antonidas,2178,druid,balance,106,74,32
Eôxxd,blackrock,2177,druid,balance,125,80,45
Squirtdogx,drakthul,2174,druid,balance,71,43,28
Blanoz,ravencrest,2174,druid,balance,435,221,214
Norgand,die-aldor,2173,druid,balance,42,33,9
Flanagân,hyjal,2171,druid,balance,60,36,24
Shivany,outland,2165,druid,balance,222,131,91
Juicew,stormscale,2164,druid,balance,77,50,27
Handsoff,stormscale,2163,druid,balance,336,177,159
Broccoliboy,sylvanas,2162,druid,balance,234,123,111
Bakkú,ravencrest,2158,druid,balance,66,45,21
Catchmê,archimonde,2154,druid,balance,92,55,37
Výragosa,der-rat-von-dalaran,2150,druid,balance,170,98,72
Positivîty,stormscale,2150,druid,balance,224,129,95
Zyndril,silvermoon,2144,druid,balance,78,43,35
Sleepyhallow,blackmoore,2143,druid,balance,106,61,45
Votionex,tarren-mill,2142,druid,balance,112,69,43
Mopboomkin,twisting-nether,2140,druid,balance,90,48,42
Jettad,ravencrest,2135,druid,balance,106,61,45
Ursulaboomer,blackrock,2135,druid,balance,126,71,55
Flanders,blackrock,2134,druid,balance,84,61,23
Sadgeconvoke,draenor,2134,druid,balance,448,253,195
Winkler,kazzak,2130,druid,balance,56,41,15
Mdrgtwo,ravencrest,2129,druid,balance,133,87,46
Richandblind,ravencrest,2129,druid,balance,108,59,49
Стомпбр,gordunni,2128,druid,balance,228,131,97
Hehehahahah,kazzak,2127,druid,balance,93,62,31
Eviscreator,stormscale,2127,druid,balance,156,96,60
Isatá,ravencrest,2127,druid,balance,90,52,38
Starbro,grim-batol,2125,druid,balance,78,42,36
Laker,stormscale,2124,druid,balance,269,148,121
Стомпбр,howling-fjord,2123,druid,balance,131,77,54
Limme,ravencrest,2122,druid,balance,198,121,77
Eddiethepunk,ravencrest,2121,druid,balance,430,243,187
Ackiz,ravencrest,2121,druid,balance,129,71,58
Даирлин,gordunni,2121,druid,balance,214,111,103
Yore,tichondrius,2120,druid,balance,102,72,30
Bumkin,bloodhoof,2120,druid,balance,72,41,31
Ööh,outland,2120,druid,balance,186,99,87
Kirexz,blackrock,2119,druid,balance,89,58,31
Stb,outland,2119,druid,balance,96,60,36
Rek,sanguino,2119,druid,balance,153,84,69
Klimakleber,ravencrest,2119,druid,balance,182,94,88
Wrathgodx,aegwynn,2118,druid,balance,72,47,25
Nàaz,stormscale,2117,druid,balance,71,44,27
Tronchetto,nemesis,2113,druid,balance,126,69,57
Okøë,marécage-de-zangar,2112,druid,balance,72,42,30
Dakotaboomer,ravencrest,2112,druid,balance,132,72,60
Óðinn,stormscale,2110,druid,balance,71,57,14
Calê,blackrock,2110,druid,balance,391,219,172
Skivesnulle,kazzak,2110,druid,balance,369,185,184
Baerbock,kazzak,2109,druid,balance,112,73,39
Quadpulse,ravencrest,2109,druid,balance,75,42,33
Credenz,frostmane,2109,druid,balance,270,151,119
Muufasa,blackmoore,2109,druid,balance,338,179,159
Wrldx,twisting-nether,2107,druid,balance,334,185,149
Bompfer,blackmoore,2107,druid,balance,126,63,63
Løsër,ravencrest,2105,druid,balance,110,58,52
Pikatwo,tyrande,2104,druid,balance,68,46,22
Bambye,stormscale,2104,druid,balance,242,146,96
Øncê,durotan,2104,druid,balance,126,67,59
Cioaralba,sylvanas,2102,druid,balance,211,121,90
Connorz,blackmoore,2102,druid,balance,249,141,108
Senoxiia,antonidas,2101,druid,balance,172,95,77
Didiee,kazzak,2100,druid,balance,255,140,115
Jeaylqt,archimonde,2098,druid,balance,87,53,34
Crippaa,tarren-mill,2096,druid,balance,156,93,63
Владисзади,gordunni,2096,druid,balance,161,89,72
Эё,howling-fjord,2094,druid,balance,178,107,71
Feelstreeman,twisting-nether,2089,druid,balance,102,55,47
Nevermeldx,blackrock,2088,druid,balance,107,62,45
Mooskie,draenor,2078,druid,balance,78,51,27
Kënzo,ravencrest,2077,druid,balance,326,186,140
Gonyogonyo,blackmoore,2077,druid,balance,99,55,44
Bittebads,stormscale,2075,druid,balance,89,54,35
Saufeb,stormscale,2074,druid,balance,201,111,90
Rootzxx,ravencrest,2072,druid,balance,233,124,109
Gulmi,outland,2069,druid,balance,147,84,63
Bulla,culte-de-la-rive-noire,2068,druid,balance,391,213,178
Justyo,archimonde,2067,druid,balance,145,93,52
Tomyn,burning-legion,2064,druid,balance,196,105,91
Carnivals,twisting-nether,2063,druid,balance,426,224,202
Zaoow,stormscale,2062,druid,balance,263,149,114
Jerrybeans,ravencrest,2061,druid,balance,114,68,46
Рябчиик,blackscar,2061,druid,balance,452,242,210
Kÿara,khaz-modan,2057,druid,balance,149,82,67
Tuttu,kazzak,2057,druid,balance,220,119,101
Dincks,draenor,2054,druid,balance,100,61,39
Mephîs,ravencrest,2053,druid,balance,94,57,37
Грибомания,soulflayer,2053,druid,balance,107,56,51
Ôwlnur,kult-der-verdammten,2051,druid,balance,115,64,51
Win,hellscream,2046,druid,balance,114,65,49
Memphiswhx,drakthul,2046,druid,balance,186,103,83
Shakso,stormscale,2046,druid,balance,250,135,115
Rexonadudu,kazzak,2045,druid,balance,195,110,85
Karvajyrä,stormreaver,2044,druid,balance,431,233,198
Bum,ravencrest,2041,druid,balance,41,32,9
Shivany,twisting-nether,2041,druid,balance,234,118,116
Nutsnack,tarren-mill,2039,druid,balance,78,38,40
Øsbura,silvermoon,2037,druid,balance,90,54,36
Maijs,ravencrest,2037,druid,balance,114,54,60
Slaugh,zuljin,2036,druid,balance,186,100,86
Starsy,frostmane,2034,druid,balance,101,48,53
Navex,blackrock,2029,druid,balance,48,36,12
Høtpøket,ravencrest,2028,druid,balance,54,36,18
Secrägodx,ragnaros,2028,druid,balance,158,88,70
Anéry,ravencrest,2027,druid,balance,112,62,50
Elinaax,outland,2026,druid,balance,166,96,70
Dnblifestyle,zirkel-des-cenarius,2026,druid,balance,282,146,136
Kokslina,sylvanas,2026,druid,balance,89,42,47
Josedudu,twisting-nether,2025,druid,balance,139,80,59
Mmlprox,burning-legion,2024,druid,balance,60,37,23
Zuterlø,ragnaros,2024,druid,balance,328,168,160
Hefnerd,grim-batol,2023,druid,balance,53,39,14
Linkin,azshara,2023,druid,balance,245,136,109
Fullfatcream,stormscale,2022,druid,balance,132,76,56
Nuvemone,stormscale,2022,druid,balance,200,112,88
Izhusky,ravencrest,2019,druid,balance,192,107,85
Hppsr,eredar,2018,druid,balance,137,75,62
Kruwkamilka,burning-legion,2018,druid,balance,409,216,193
Pultsarí,tarren-mill,2017,druid,balance,192,101,91
Ilovestacy,outland,2016,druid,balance,114,71,43
Flanagàn,hyjal,2016,druid,balance,82,41,41
Калкалыч,lich-king,2013,druid,balance,101,58,43
Citróne,blackrock,2012,druid,balance,60,38,22
Orangeterror,stormscale,2011,druid,balance,155,94,61
Lilpumpz,outland,2009,druid,balance,113,58,55
Veganvapex,draenor,2008,druid,balance,181,106,75
Admeliora,ravencrest,2007,druid,balance,83,54,29
Grässoppa,tarren-mill,2004,druid,balance,124,67,57
Sartipus,draenor,2002,druid,balance,276,153,123
Gambós,kazzak,2002,druid,balance,77,41,36
Toxicclones,tarren-mill,2000,druid,balance,54,40,14
Akinimod,ravencrest,2000,druid,balance,120,69,51
Boomjutzu,kazzak,2000,druid,balance,59,33,26
Xqzmybleedz,onyxia,1999,druid,balance,194,121,73
Brovis,sylvanas,1998,druid,balance,145,88,57
Tenzuk,archimonde,1996,druid,balance,48,36,12
Underrated,darksorrow,1996,druid,balance,66,46,20
Zâe,archimonde,1996,druid,balance,58,37,21
Pvekek,stormscale,1996,druid,balance,181,103,78
Disvikz,outland,1995,druid,balance,152,82,70
ßouncy,twisting-nether,1992,druid,balance,83,57,26
Bîjaqt,blackmoore,1992,druid,balance,54,34,20
Greenful,drakthul,1991,druid,balance,126,72,54
Ljóskan,kazzak,1988,druid,balance,93,49,44
Zendda,hyjal,1987,druid,balance,91,48,43
Thelire,silvermoon,1987,druid,balance,539,271,268
Kabòöóm,outland,1985,druid,balance,78,54,24
Punxybear,ravencrest,1984,druid,balance,860,437,423
Zulucat,aegwynn,1983,druid,balance,24,21,3
Transmangodx,tarren-mill,1982,druid,balance,126,73,53
Broflovskii,tarren-mill,1982,druid,balance,105,51,54
Trekkertt,zuljin,1980,druid,balance,77,41,36
Luphrekfurry,ysondre,1979,druid,balance,60,39,21
Knùbz,ravencrest,1979,druid,balance,137,73,64
Detü,blackrock,1978,druid,balance,161,92,69
Mønrøe,ravencrest,1978,druid,balance,89,49,40
Fattydomdom,alakir,1977,druid,balance,36,27,9
Ferraridudux,ravencrest,1977,druid,balance,36,26,10
Boomeris,ravencrest,1977,druid,balance,74,47,27
Oskol,tarren-mill,1977,druid,balance,193,97,96
Lodikum,defias-brotherhood,1975,druid,balance,42,33,9
Sleepystacy,argent-dawn,1975,druid,balance,216,120,96
Rbgkári,draenor,1974,druid,balance,139,82,57
Løo,moonglade,1973,druid,balance,121,75,46
Pikamoo,kazzak,1973,druid,balance,65,39,26
Kankstery,stormscale,1972,druid,balance,83,56,27
Metzarqq,stormscale,1971,druid,balance,96,64,32
Kissachtak,blackrock,1971,druid,balance,81,52,29
Trntydr,senjin,1969,druid,balance,65,44,21
Twitchmoney,archimonde,1969,druid,balance,109,73,36
Anpassad,outland,1968,druid,balance,93,52,41
Millions,tarren-mill,1967,druid,balance,141,90,51
Senzuli,stormscale,1967,druid,balance,165,103,62
Bmybmybmybmy,outland,1965,druid,balance,36,30,6
Taveirasurge,kazzak,1963,druid,balance,125,79,46
Ciucciotutto,nemesis,1962,druid,balance,72,50,22
Starfallkey,dun-modr,1961,druid,balance,219,125,94
Turtleform,blackrock,1961,druid,balance,138,64,74
ßa,blackmoore,1960,druid,balance,59,38,21
Uglyrasputin,blackmoore,1960,druid,balance,156,94,62
Wizzlafa,ravencrest,1960,druid,balance,82,48,34
Kjøttberit,moonglade,1959,druid,balance,84,53,31
Миртлэкшн,gordunni,1959,druid,balance,107,61,46
Исканет,gordunni,1958,druid,balance,72,46,26
Jstdru,ravencrest,1958,druid,balance,150,93,57
Светдру,blackscar,1957,druid,balance,65,40,25
Hotflora,aegwynn,1957,druid,balance,66,39,27
Superchïcken,archimonde,1955,druid,balance,78,43,35
Bastodonte,skullcrusher,1954,druid,balance,379,196,183
Newaccount,kazzak,1953,druid,balance,270,146,124
Ethiqd,aegwynn,1952,druid,balance,66,46,20
Emmdru,silvermoon,1950,druid,balance,195,113,82
Kl,archimonde,1950,druid,balance,318,166,152
Tobid,blackrock,1949,druid,balance,66,47,19
Рейзакх,howling-fjord,1948,druid,balance,324,165,159
Cmfg,blackrock,1947,druid,balance,121,71,50
Kayllie,silvermoon,1947,druid,balance,108,63,45
Coqqbock,blackrock,1947,druid,balance,78,39,39
Néllÿ,elune,1943,druid,balance,168,84,84
Steampigeon,kazzak,1942,druid,balance,54,36,18
Ovérheal,ravencrest,1941,druid,balance,111,69,42
Øhmygød,stormscale,1941,druid,balance,132,71,61
Juicypus,ragnaros,1941,druid,balance,205,110,95
Найттир,gordunni,1940,druid,balance,87,49,38
Melábufes,dun-modr,1940,druid,balance,156,85,71
Soofiaa,ravencrest,1939,druid,balance,44,35,9
Escaa,stormscale,1939,druid,balance,110,61,49
Cassiddyy,draenor,1937,druid,balance,78,45,33
Druvex,blackrock,1936,druid,balance,47,32,15
Ахахахахахх,soulflayer,1936,druid,balance,220,127,93
Hornykarenn,bladefist,1935,druid,balance,106,63,43
Shàal,ysondre,1935,druid,balance,217,117,100
Nythielle,argent-dawn,1935,druid,balance,214,108,106
Даена,razuvious,1934,druid,balance,125,84,41
Rngmåchinéx,ravencrest,1934,druid,balance,178,113,65
Rain,kazzak,1933,druid,balance,196,111,85
Randomnup,sanguino,1933,druid,balance,114,64,50
Rekked,alleria,1931,druid,balance,96,57,39
Gurru,xavius,1931,druid,balance,254,131,123
Lóvebeam,ravencrest,1930,druid,balance,60,36,24
Iloveher,ravencrest,1930,druid,balance,84,49,35
Låsèrpêwpéw,tarren-mill,1930,druid,balance,269,148,121
Druidxburst,malganis,1929,druid,balance,48,32,16
Nóque,ravencrest,1929,druid,balance,130,73,57
Воому,soulflayer,1928,druid,balance,54,35,19
Jerie,silvermoon,1928,druid,balance,102,63,39
Näela,archimonde,1928,druid,balance,60,31,29
Knastx,ravencrest,1927,druid,balance,54,39,15
Captaïn,twisting-nether,1927,druid,balance,84,54,30
Shåmssz,kazzak,1926,druid,balance,44,31,13
Valijaelf,blackrock,1926,druid,balance,80,45,35
Artistdubose,kazzak,1926,druid,balance,168,94,74
Veonski,argent-dawn,1925,druid,balance,105,57,48
Аронэл,blackscar,1924,druid,balance,82,54,28
Legitx,dentarg,1924,druid,balance,109,63,46
Мариантус,greymane,1924,druid,balance,219,116,103
Impmoden,blackrock,1922,druid,balance,61,40,21
Restaidpvs,wildhammer,1922,druid,balance,78,41,37
Gnrio,twisting-nether,1921,druid,balance,149,89,60
Kenzia,stormrage,1921,druid,balance,108,60,48
ßoomin,tarren-mill,1921,druid,balance,60,29,31
Cutiepain,kazzak,1920,druid,balance,104,63,41
Smøkewéed,ravencrest,1920,druid,balance,90,49,41
Kanyevotèrx,ravencrest,1919,druid,balance,96,56,40
Gretathnberg,ravencrest,1919,druid,balance,62,33,29
Ледруд,gordunni,1918,druid,balance,134,67,67
Kabuul,dun-modr,1917,druid,balance,175,109,66
Taurendruid,the-maelstrom,1917,druid,balance,195,110,85
Tommyruin,the-venture-co,1917,druid,balance,197,106,91
Вбг,soulflayer,1917,druid,balance,317,166,151
Peaches,aerie-peak,1916,druid,balance,101,64,37
Mîrxy,outland,1915,druid,balance,90,55,35
Metamoo,tarren-mill,1914,druid,balance,57,43,14
Trytargetme,outland,1914,druid,balance,138,78,60
Dyroxs,twisting-nether,1914,druid,balance,411,210,201
Contrnahruk,kazzak,1913,druid,balance,59,40,19
Evangels,nemesis,1913,druid,balance,54,35,19
Unohanâ,archimonde,1912,druid,balance,97,63,34
Heiden,terokkar,1912,druid,balance,71,41,30
Phobidru,thrall,1911,druid,balance,66,37,29
Malex,auchindoun,1910,druid,balance,114,63,51
Crnkie,sylvanas,1909,druid,balance,72,44,28
Mirynn,elune,1909,druid,balance,211,111,100
Imbadxx,kazzak,1908,druid,balance,66,44,22
Chavinelf,twisting-nether,1908,druid,balance,60,35,25
Ïndrä,arathi,1907,druid,balance,214,112,102
Maladorf,draenor,1906,druid,balance,107,67,40
Msb,the-maelstrom,1906,druid,balance,59,34,25
Øwlkin,ravencrest,1906,druid,balance,57,31,26
Siuo,ravencrest,1906,druid,balance,95,51,44
Andreud,dunemaul,1904,druid,balance,131,67,64
Sentería,sylvanas,1904,druid,balance,96,44,52
Lacÿn,twisting-nether,1903,druid,balance,30,24,6
Superdr,ragnaros,1902,druid,balance,82,56,26
Traickovic,eredar,1902,druid,balance,48,26,22
Máedhros,ravencrest,1901,druid,balance,90,60,30
Когтелёт,soulflayer,1901,druid,balance,77,50,27
Narkiza,blackhand,1901,druid,balance,107,63,44
Eloahdruid,blackhand,1901,druid,balance,129,72,57
Reichpoulet,archimonde,1900,druid,balance,42,30,12
Drcaøs,sanguino,1900,druid,balance,188,106,82
Jenovas,argent-dawn,1900,druid,balance,165,89,76
Euphoríax,ravencrest,1899,druid,balance,112,70,42
Lazermonster,tarren-mill,1899,druid,balance,54,32,22
Starcowx,ragnaros,1899,druid,balance,278,146,132
Månemannen,outland,1898,druid,balance,30,20,10
Хфикс,gordunni,1898,druid,balance,268,163,105
Rlwlwlwrtwo,twisting-nether,1898,druid,balance,60,31,29
Interaktio,ravencrest,1896,druid,balance,34,24,10
Mqs,stormscale,1896,druid,balance,187,110,77
Suomenlorgok,stormreaver,1895,druid,balance,109,67,42
Ezeke,eredar,1895,druid,balance,206,104,102
Boomdruud,tarren-mill,1894,druid,balance,36,22,14
Klappskaft,outland,1894,druid,balance,53,31,22
Thcpositiv,aegwynn,1894,druid,balance,303,155,148
Meowcry,outland,1893,druid,balance,138,78,60
Notsikaan,blackhand,1892,druid,balance,73,38,35
Miaszha,blackmoore,1891,druid,balance,182,106,76
Thràralith,silvermoon,1891,druid,balance,155,90,65
Dràkàn,dethecus,1890,druid,balance,120,64,56
Chacopic,archimonde,1889,druid,balance,43,30,13
Kribie,aegwynn,1889,druid,balance,126,74,52
Fredhqt,tarren-mill,1889,druid,balance,71,41,30
Vamix,aegwynn,1888,druid,balance,30,25,5
Aggroasian,tarren-mill,1888,druid,balance,315,168,147
Vainzxdr,ravencrest,1886,druid,balance,73,48,25
Ayouftcala,ravencrest,1886,druid,balance,45,27,18
Небесныйхант,soulflayer,1886,druid,balance,211,109,102
Madhatterr,kazzak,1884,druid,balance,114,79,35
Raykk,culte-de-la-rive-noire,1883,druid,balance,45,31,14
Hirmo,ragnaros,1882,druid,balance,81,54,27
Narq,sylvanas,1881,druid,balance,90,53,37
Blopstar,stormscale,1879,druid,balance,54,34,20
Luphrekmeow,ravencrest,1879,druid,balance,51,32,19
Flæppy,blackmoore,1879,druid,balance,571,286,285
Valijan,blackrock,1879,druid,balance,64,31,33
Xalio,ravencrest,1878,druid,balance,89,53,36
Balanc,ragnaros,1878,druid,balance,216,121,95
Vermz,tarren-mill,1876,druid,balance,89,51,38
Shakeme,zuljin,1876,druid,balance,102,56,46
Björnskift,tarren-mill,1876,druid,balance,125,66,59
Alessàsavage,nemesis,1875,druid,balance,77,46,31
Gabedru,agamaggan,1874,druid,balance,48,34,14
Yosimoo,draenor,1874,druid,balance,118,75,43
Mopferal,twisting-nether,1873,druid,balance,93,66,27
Bolaballen,stormscale,1873,druid,balance,99,63,36
Triskelion,burning-legion,1873,druid,balance,190,102,88
Shroomdoom,ravencrest,1873,druid,balance,59,29,30
Mikhaili,stormreaver,1872,druid,balance,54,33,21
Eñzo,stormscale,1872,druid,balance,155,89,66
Sifferx,stormscale,1872,druid,balance,129,71,58
Ravneskrig,ravencrest,1870,druid,balance,122,69,53
Nitsou,hyjal,1869,druid,balance,70,43,27
Hammd,kazzak,1868,druid,balance,202,108,94
Èøèøèøèøè,stormscale,1867,druid,balance,36,28,8
Shyoxdr,twisting-nether,1867,druid,balance,107,73,34
Tárzáñ,ravencrest,1867,druid,balance,168,92,76
Hyperbêast,blackrock,1866,druid,balance,41,31,10
Tjillevippen,tarren-mill,1866,druid,balance,42,27,15
Raféékí,outland,1866,druid,balance,80,50,30
Fapmasterx,eredar,1865,druid,balance,54,35,19
Рейтэн,gordunni,1864,druid,balance,76,48,28
Bångebål,the-maelstrom,1863,druid,balance,42,30,12
Rudabaebey,draenor,1863,druid,balance,42,28,14
Gipi,ravencrest,1863,druid,balance,72,37,35
Mahrèz,archimonde,1862,druid,balance,55,33,22
Slahnesh,aegwynn,1859,druid,balance,72,41,31
Vregord,twisting-nether,1857,druid,balance,72,44,28
Uglybettylol,drakthul,1857,druid,balance,54,32,22
Laserchicken,malganis,1857,druid,balance,343,169,174
Pyaw,kazzak,1856,druid,balance,114,69,45
Hymìr,silvermoon,1856,druid,balance,159,88,71
Euphørie,twisting-nether,1856,druid,balance,384,207,177
Сосисосочка,gordunni,1856,druid,balance,114,59,55
Feralenjoyer,drakthul,1855,druid,balance,48,27,21
Embrangle,silvermoon,1854,druid,balance,78,45,33
Dreamdoll,ravencrest,1854,druid,balance,101,55,46
Deadmeøw,outland,1854,druid,balance,70,38,32
Lushe,kazzak,1853,druid,balance,44,27,17
Bearpawzz,kazzak,1852,druid,balance,88,50,38
Commonsense,kazzak,1852,druid,balance,36,20,16
Boomco,stormscale,1850,druid,balance,42,28,14
Cörelly,ravencrest,1850,druid,balance,331,191,140
Divref,tarren-mill,1848,druid,balance,30,24,6
Аласторвов,deathweaver,1848,druid,balance,236,124,112
Crywingz,antonidas,1848,druid,balance,223,114,109
Tzeeni,stormscale,1847,druid,balance,35,28,7
Hollymedx,blackmoore,1847,druid,balance,132,82,50
Zømßie,outland,1847,druid,balance,162,95,67
Shamerika,tarren-mill,1847,druid,balance,238,129,109
Sænxx,blackrock,1846,druid,balance,42,30,12
Xtràza,archimonde,1846,druid,balance,48,33,15
Kivimon,dun-modr,1846,druid,balance,72,45,27
Друлякич,gordunni,1846,druid,balance,49,30,19
Elissian,silvermoon,1846,druid,balance,357,190,167
Teebeidl,tarren-mill,1845,druid,balance,174,101,73
Мягкийвисп,howling-fjord,1845,druid,balance,138,78,60
Xora,kazzak,1845,druid,balance,197,106,91
Yggdru,ragnaros,1844,druid,balance,36,24,12
Dmgtràsh,dun-modr,1844,druid,balance,59,38,21
Sylindra,argent-dawn,1844,druid,balance,148,88,60
Æøøm,blackmoore,1844,druid,balance,339,180,159
Amazed,wildhammer,1843,druid,balance,102,61,41
Vulkayn,ysondre,1843,druid,balance,93,51,42
Hackamore,archimonde,1843,druid,balance,343,186,157
Füllxtrap,hyjal,1842,druid,balance,36,26,10
Synexi,sylvanas,1842,druid,balance,144,85,59
Mudruu,blackrock,1842,druid,balance,66,37,29
Byjiblznuk,kazzak,1841,druid,balance,52,34,18
Угощаюх,howling-fjord,1840,druid,balance,95,57,38
Duridlol,nemesis,1839,druid,balance,35,24,11
Celtixthrash,tarren-mill,1839,druid,balance,30,20,10
Hrz,kazzak,1839,druid,balance,79,50,29
Bàrathrum,blackrock,1839,druid,balance,163,91,72
Nctmé,tarren-mill,1839,druid,balance,142,69,73
Alphadrúid,stormscale,1838,druid,balance,60,37,23
Kalthazar,twisting-nether,1838,druid,balance,60,37,23
Tykè,outland,1838,druid,balance,54,33,21
Skirr,kelthuzad,1838,druid,balance,42,23,19
Replicusowl,doomhammer,1838,druid,balance,60,31,29
Stinkyicky,sylvanas,1837,druid,balance,113,74,39
Nastyclones,kazzak,1837,druid,balance,51,32,19
Clâwdîte,blackrock,1836,druid,balance,65,40,25
Nassii,antonidas,1836,druid,balance,168,102,66
Connydor,stormscale,1836,druid,balance,48,29,19
Shìinx,hyjal,1836,druid,balance,72,43,29
Флаффер,soulflayer,1836,druid,balance,90,51,39
Qtkitty,outland,1836,druid,balance,416,219,197
Atrosity,ravencrest,1835,druid,balance,66,40,26
Муромлянка,blackscar,1835,druid,balance,148,84,64
Sylvy,dun-modr,1835,druid,balance,154,85,69
Adizero,blackrock,1834,druid,balance,61,40,21
Doublesunday,thrall,1834,druid,balance,75,42,33
Gehrkehotter,silvermoon,1833,druid,balance,102,65,37
Elandreth,twisting-nether,1833,druid,balance,49,31,18
Brittmagi,sylvanas,1833,druid,balance,112,68,44
Ipsdray,ysondre,1833,druid,balance,157,93,64
Jøkèr,outland,1833,druid,balance,53,30,23
Хальтенис,gordunni,1833,druid,balance,144,74,70
Кирукхэ,gordunni,1832,druid,balance,36,28,8
Suitti,ravencrest,1832,druid,balance,71,47,24
Бамболони,gordunni,1832,druid,balance,259,150,109
Ghostpaws,ravencrest,1832,druid,balance,165,83,82
Jrdleto,blackrock,1831,druid,balance,209,111,98
Kubzii,archimonde,1830,druid,balance,183,102,81
Cuteteengirl,ravencrest,1829,druid,balance,116,64,52
Swagattori,sylvanas,1829,druid,balance,62,34,28
Tummus,blackrock,1829,druid,balance,60,32,28
Tetdru,blackhand,1828,druid,balance,30,22,8
Joqr,tarren-mill,1828,druid,balance,48,28,20
Moksy,outland,1828,druid,balance,120,69,51
Лёхалепеха,gordunni,1827,druid,balance,84,52,32
Malfurien,magtheridon,1827,druid,balance,65,40,25
Иггдрасиль,gordunni,1827,druid,balance,193,114,79
Azurai,blackmoore,1827,druid,balance,138,80,58
Barneycatz,tarren-mill,1826,druid,balance,93,50,43
Aliyxd,aegwynn,1825,druid,balance,42,28,14
Храш,gordunni,1825,druid,balance,65,39,26
Moonasiahn,hyjal,1825,druid,balance,126,70,56
Мурдермашин,deathguard,1825,druid,balance,333,177,156
Stepgødx,twisting-nether,1825,druid,balance,75,35,40
Güccïmane,twisting-nether,1824,druid,balance,116,80,36
Pluginbaby,stormscale,1824,druid,balance,82,49,33
Valgo,twisting-nether,1824,druid,balance,96,56,40
Jungleghost,sylvanas,1824,druid,balance,175,99,76
Melyssea,argent-dawn,1823,druid,balance,59,35,24
Restromide,ravencrest,1823,druid,balance,36,20,16
Zhof,ravencrest,1823,druid,balance,327,172,155
Pine,aggramar,1822,druid,balance,28,23,5
Faxotium,argent-dawn,1822,druid,balance,30,21,9
Djemdruid,argent-dawn,1822,druid,balance,42,27,15
Owenwilson,twisting-nether,1822,druid,balance,96,58,38
Kaalil,argent-dawn,1822,druid,balance,72,40,32
Ohpfo,outland,1821,druid,balance,41,28,13
Neverpanic,stormscale,1821,druid,balance,78,48,30
Alxzdru,auchindoun,1821,druid,balance,147,89,58
Drøøkîé,antonidas,1821,druid,balance,239,139,100
Phucme,the-maelstrom,1821,druid,balance,144,75,69
Khiree,archimonde,1820,druid,balance,56,32,24
Mahwi,das-konsortium,1819,druid,balance,72,48,24
Айрокси,blackscar,1819,druid,balance,96,51,45
Ganqb,ravencrest,1819,druid,balance,585,309,276
Howgh,destromath,1819,druid,balance,284,145,139
Takemanstwix,ragnaros,1818,druid,balance,102,62,40
Totemdrood,blackmoore,1818,druid,balance,52,30,22
Isuckdruid,aegwynn,1818,druid,balance,163,91,72
Naturez,sylvanas,1818,druid,balance,104,55,49
Sunshinex,silvermoon,1818,druid,balance,96,47,49
Lumi,culte-de-la-rive-noire,1817,druid,balance,54,32,22
Nerem,blackrock,1817,druid,balance,84,44,40
Ventrìx,alleria,1817,druid,balance,102,53,49
Bákhar,ravencrest,1817,druid,balance,148,71,77
Treesus,blackrock,1816,druid,balance,42,25,17
Lunahu,argent-dawn,1816,druid,balance,72,42,30
Bigpûmp,elune,1816,druid,balance,95,53,42
Чупакабра,goldrinn,1816,druid,balance,235,130,105
Shiftcaster,ravencrest,1816,druid,balance,72,35,37
Råichu,kazzak,1815,druid,balance,33,26,7
Astrobazooka,stormreaver,1815,druid,balance,77,48,29
Neirdá,hyjal,1815,druid,balance,197,107,90
Durkdriven,kazzak,1814,druid,balance,87,54,33
Meowmf,silvermoon,1814,druid,balance,101,62,39
Mazalot,kazzak,1813,druid,balance,79,52,27
Ånaðeårmas,outland,1813,druid,balance,83,51,32
Eysnd,blackrock,1813,druid,balance,90,53,37
Мунстрайк,borean-tundra,1813,druid,balance,145,82,63
Kót,kazzak,1813,druid,balance,131,74,57
Pouletqt,archimonde,1813,druid,balance,48,26,22
Gallokiriko,zuljin,1813,druid,balance,195,99,96
Betobalance,blackmoore,1812,druid,balance,30,23,7
Alethorn,twisting-nether,1812,druid,balance,160,96,64
Lifeseed,ravencrest,1812,druid,balance,214,105,109
Bashmac,mugthol,1811,druid,balance,72,49,23
Yarinai,blackmoore,1811,druid,balance,102,59,43
Крейзикет,eversong,1810,druid,balance,36,25,11
Лунорун,blackscar,1810,druid,balance,54,36,18
Owlbum,grim-batol,1810,druid,balance,48,31,17
Solariah,garona,1810,druid,balance,166,96,70
Мэдикейт,gordunni,1810,druid,balance,126,72,54
Bobobobobobo,blackrock,1810,druid,balance,362,194,168
Scaleo,stormreaver,1810,druid,balance,96,51,45
Frenkoz,outland,1809,druid,balance,120,70,50
Bôoze,nathrezim,1809,druid,balance,78,45,33
Núri,lordaeron,1809,druid,balance,80,46,34
Imaginarý,ravencrest,1809,druid,balance,47,26,21
Mochiløxz,tarren-mill,1809,druid,balance,292,160,132
Ashtral,kazzak,1808,druid,balance,33,24,9
Adelåide,silvermoon,1808,druid,balance,60,41,19
Lashketchum,aszune,1808,druid,balance,106,71,35
Minaervea,antonidas,1808,druid,balance,95,57,38
Xerlog,thrall,1808,druid,balance,72,43,29
Awisura,outland,1808,druid,balance,54,32,22
Ferawri,draenor,1808,druid,balance,42,24,18
Vaacku,stormreaver,1808,druid,balance,190,105,85
Maelkan,sanguino,1808,druid,balance,251,138,113
Djsnigel,stormscale,1808,druid,balance,145,79,66
Izzual,tarren-mill,1808,druid,balance,54,28,26
Rasgath,kazzak,1807,druid,balance,333,188,145
Cøntrol,argent-dawn,1807,druid,balance,72,40,32
Câtchmê,archimonde,1806,druid,balance,24,19,5
Icek,outland,1806,druid,balance,54,33,21
Beanery,aegwynn,1806,druid,balance,78,47,31
Калинках,soulflayer,1806,druid,balance,54,32,22
Leletmedie,ravencrest,1806,druid,balance,54,31,23
Moonleaf,burning-steppes,1806,druid,balance,54,29,25
Págánxø,kazzak,1805,druid,balance,65,42,23
Otpboomie,dun-modr,1805,druid,balance,37,23,14
Siajin,frostwolf,1805,druid,balance,108,61,47
Damagebot,tarren-mill,1805,druid,balance,117,66,51
Феориз,howling-fjord,1805,druid,balance,177,99,78
Crunchtime,ragnaros,1805,druid,balance,133,72,61
Âlhajillo,dun-modr,1805,druid,balance,91,48,43
Clonedrood,sylvanas,1804,druid,balance,54,41,13
Akiíra,twisting-nether,1804,druid,balance,54,38,16
Loethen,argent-dawn,1804,druid,balance,110,74,36
Belvrin,argent-dawn,1804,druid,balance,100,66,34
Randyxo,blackhand,1804,druid,balance,48,30,18
Svp,ravencrest,1804,druid,balance,54,33,21
Néxct,stormscale,1804,druid,balance,54,31,23
Elunælle,les-sentinelles,1804,druid,balance,168,93,75
Ashidx,ragnaros,1803,druid,balance,48,30,18
Grafíx,blackrock,1803,druid,balance,48,28,20
Rnkx,sanguino,1803,druid,balance,57,33,24
Delmond,sylvanas,1803,druid,balance,390,210,180
Drkarp,stormreaver,1802,druid,balance,44,32,12
Rozi,draenor,1802,druid,balance,42,25,17
Ampdru,ravencrest,1802,druid,balance,76,44,32
Tøyz,stormscale,1801,druid,balance,29,23,6
Geîl,blackrock,1801,druid,balance,42,24,18
Goagain,silvermoon,1801,druid,balance,196,107,89
Batmòn,stormscale,1801,druid,balance,129,69,60
Krustý,malganis,1801,druid,balance,84,44,40
Bignoober,blackrock,1800,druid,balance,35,25,10
Eselhirte,blackhand,1800,druid,balance,45,27,18
Cønvokê,tarren-mill,1800,druid,balance,121,69,52
Kartaorange,stormscale,1800,druid,balance,151,85,66
Htxo,kazzak,1798,druid,balance,60,33,27
Saqartvelo,tarren-mill,1797,druid,balance,108,64,44
Онличикен,gordunni,1797,druid,balance,150,78,72
Whøðìspélmé,twisting-nether,1796,druid,balance,54,37,17
Starhopper,ravencrest,1796,druid,balance,53,34,19
Utiniutini,thrall,1796,druid,balance,180,102,78
Nevax,blackrock,1795,druid,balance,36,26,10
Vitaex,blackrock,1795,druid,balance,51,35,16
Ахаххаха,howling-fjord,1795,druid,balance,84,54,30
Dudukid,nemesis,1795,druid,balance,212,105,107
Abyssaldepth,ravencrest,1794,druid,balance,126,80,46
Rexadria,blackrock,1794,druid,balance,83,48,35
Likwidator,stormscale,1794,druid,balance,274,155,119
Imperiusx,ravencrest,1794,druid,balance,255,141,114
Ðevilwhite,nemesis,1794,druid,balance,80,36,44
Deepak,nemesis,1793,druid,balance,78,46,32
Speedpoppin,defias-brotherhood,1793,druid,balance,36,19,17
Dizay,xavius,1792,druid,balance,72,45,27
Травкер,howling-fjord,1792,druid,balance,455,225,230
Aionx,ravencrest,1791,druid,balance,70,38,32
ßloöd,archimonde,1790,druid,balance,48,29,19
Snøø,frostwolf,1790,druid,balance,156,82,74
Bearygrylls,sylvanas,1789,druid,balance,50,33,17
Twerkdabooty,azjolnerub,1789,druid,balance,48,31,17
Moonhusky,blackrock,1789,druid,balance,60,36,24
Cyclonejk,blackrock,1788,druid,balance,48,32,16
Yinx,darksorrow,1788,druid,balance,72,42,30
Cryspie,hyjal,1788,druid,balance,48,27,21
Ноунэймбич,blackscar,1788,druid,balance,62,31,31
Teaser,dun-modr,1786,druid,balance,120,68,52
Лсдспайсы,soulflayer,1785,druid,balance,75,47,28
Aleza,tarren-mill,1785,druid,balance,123,66,57
Drooshy,ravencrest,1784,druid,balance,57,35,22
Scars,outland,1784,druid,balance,36,22,14
Longhornjohn,ragnaros,1784,druid,balance,58,33,25
Gelubaboom,ravencrest,1781,druid,balance,42,25,17
Rawr,dun-morogh,1781,druid,balance,42,25,17
Diezzou,ysondre,1780,druid,balance,30,20,10
Owolu,kelthuzad,1779,druid,balance,30,19,11
Gudñ,tarren-mill,1779,druid,balance,83,48,35
Rosskemp,tarren-mill,1778,druid,balance,36,25,11
Jûggerslut,ysondre,1778,druid,balance,93,50,43
Hunkex,frostmane,1778,druid,balance,129,65,64
Nerfmemaybe,blackmoore,1777,druid,balance,38,27,11
Morlán,blackmoore,1777,druid,balance,30,19,11
Klørfem,draenor,1777,druid,balance,91,51,40
Яммаккаасии,grom,1777,druid,balance,97,49,48
Trinket,frostmane,1776,druid,balance,108,68,40
Подпивасникх,gordunni,1776,druid,balance,54,34,20
Daÿdream,ravencrest,1776,druid,balance,110,66,44
Darktigrou,archimonde,1775,druid,balance,30,21,9
Køgèr,kazzak,1775,druid,balance,30,19,11
Evílz,kazzak,1775,druid,balance,54,34,20
Zì,stormscale,1775,druid,balance,119,69,50
Whisker,outland,1774,druid,balance,36,25,11
Сибирячечка,greymane,1774,druid,balance,211,113,98
Yungtrappy,stormscale,1773,druid,balance,45,26,19
Åkømo,aegwynn,1773,druid,balance,54,31,23
Phatbushy,silvermoon,1773,druid,balance,123,70,53
Zuckersüß,twisting-nether,1772,druid,balance,33,24,9
Zapx,hyjal,1772,druid,balance,224,122,102
Rivella,blackrock,1772,druid,balance,93,48,45
Flee,thrall,1771,druid,balance,30,21,9
Pharaah,stormscale,1771,druid,balance,89,56,33
Varokka,aegwynn,1770,druid,balance,48,29,19
Lunel,arathor,1769,druid,balance,115,64,51
Совёнушек,howling-fjord,1769,druid,balance,107,57,50
Óffstér,kazzak,1769,druid,balance,164,72,92
Xoap,kazzak,1768,druid,balance,36,27,9
Moonenjoyer,kazzak,1768,druid,balance,48,31,17
Chøpzjr,blackrock,1768,druid,balance,90,52,38
Skarbowka,burning-legion,1767,druid,balance,42,29,13
Shiftowl,tarren-mill,1766,druid,balance,36,25,11
Mayfury,blackmoore,1766,druid,balance,42,28,14
Hotsincee,stormscale,1764,druid,balance,199,110,89
Ruetinjeri,blackmoore,1764,druid,balance,109,55,54
Clonecity,ravencrest,1763,druid,balance,36,26,10
Грандал,howling-fjord,1763,druid,balance,138,74,64
Fantomasik,drakthul,1762,druid,balance,659,333,326
Deetaa,eredar,1761,druid,balance,72,44,28
Damöb,ravencrest,1761,druid,balance,106,58,48
Pøpp,archimonde,1761,druid,balance,115,62,53
Symbiosa,silvermoon,1760,druid,balance,147,89,58
ßoom,antonidas,1759,druid,balance,292,152,140
Kotaryzi,kazzak,1758,druid,balance,24,19,5
Troc,karazhan,1758,druid,balance,48,26,22
Mjáy,tarren-mill,1758,druid,balance,84,45,39
Bearlylegál,outland,1756,druid,balance,30,19,11
Трэйкотик,blackscar,1756,druid,balance,83,48,35
Yabooni,ravencrest,1754,druid,balance,108,66,42
Felicìty,draenor,1753,druid,balance,54,34,20
Sagezza,draenor,1753,druid,balance,651,336,315
Afret,kazzak,1753,druid,balance,431,216,215
Tallu,das-konsortium,1752,druid,balance,90,51,39
Baboss,chogall,1752,druid,balance,140,76,64
Taylorshîft,burning-legion,1752,druid,balance,86,42,44
Мэдикейт,soulflayer,1751,druid,balance,141,80,61
Louisv,kazzak,1750,druid,balance,123,64,59
Lílpèëpgødx,archimonde,1749,druid,balance,36,24,12
Dabudi,kazzak,1749,druid,balance,187,108,79
Hilom,grim-batol,1748,druid,balance,47,29,18
Blood,frostwolf,1748,druid,balance,96,52,44
Ymagyne,frostmane,1748,druid,balance,56,29,27
Balencìága,sanguino,1747,druid,balance,101,61,40
Borderliner,blackrock,1747,druid,balance,134,79,55
Chimmi,ragnaros,1747,druid,balance,84,44,40
Ðréws,ravencrest,1745,druid,balance,42,29,13
Nzmdruid,burning-legion,1745,druid,balance,42,26,16
Malaprljavca,kazzak,1745,druid,balance,120,72,48
Kylaaz,die-ewige-wacht,1745,druid,balance,183,104,79
Màlàkaii,hyjal,1745,druid,balance,94,51,43
Zkrd,kazzak,1745,druid,balance,67,35,32
Babynaty,ravencrest,1745,druid,balance,188,91,97
Хотдиллер,howling-fjord,1744,druid,balance,54,35,19
Senoxia,antonidas,1744,druid,balance,60,37,23
Cptnclone,blackmoore,1743,druid,balance,126,68,58
Naraia,aegwynn,1743,druid,balance,46,24,22
Dreathqt,twisting-nether,1742,druid,balance,114,55,59
Chavidruid,twisting-nether,1741,druid,balance,38,25,13
Jamzydruid,kazzak,1741,druid,balance,114,61,53
Эрраптор,borean-tundra,1740,druid,balance,77,48,29
Shreddies,the-maelstrom,1740,druid,balance,61,33,28
Qtrly,ravencrest,1739,druid,balance,74,36,38
Ashleyx,antonidas,1738,druid,balance,36,30,6
Worsteux,blackrock,1738,druid,balance,61,41,20
Större,twisting-nether,1738,druid,balance,91,57,34
Kajhan,silvermoon,1738,druid,balance,96,59,37
Masakrelol,sanguino,1738,druid,balance,50,26,24
Арадия,gordunni,1738,druid,balance,167,82,85
Tshungubuäch,eredar,1737,druid,balance,54,37,17
Pewpewflap,kazzak,1737,druid,balance,125,73,52
Fuzzylol,haomarush,1736,druid,balance,41,24,17
Shreedex,blackmoore,1735,druid,balance,78,50,28
Ccoco,aegwynn,1735,druid,balance,108,53,55
Sintdru,rexxar,1734,druid,balance,42,29,13
Jaycutler,archimonde,1734,druid,balance,132,70,62
Sakkrethd,hyjal,1733,druid,balance,36,23,13
Xora,aegwynn,1733,druid,balance,85,49,36
Shyngodx,archimonde,1733,druid,balance,239,129,110
Áäáäáäáäáäáä,ravencrest,1733,druid,balance,101,50,51
Juvencus,twisting-nether,1731,druid,balance,48,27,21
Haanook,ravencrest,1731,druid,balance,241,128,113
Risuoksa,tarren-mill,1730,druid,balance,51,30,21
Slaskêt,tarren-mill,1730,druid,balance,116,64,52
Obrys,tarren-mill,1730,druid,balance,96,48,48
Жизэ,galakrond,1729,druid,balance,122,73,49
Obsessíon,kazzak,1729,druid,balance,101,59,42
Midnightowl,stormscale,1728,druid,balance,30,21,9
Duckiethotx,twisting-nether,1728,druid,balance,48,27,21
Зенза,howling-fjord,1727,druid,balance,150,81,69
Shiffe,argent-dawn,1727,druid,balance,84,43,41
Ахисса,gordunni,1727,druid,balance,78,37,41
Beefsteaxs,thrall,1726,druid,balance,79,56,23
Thundruid,archimonde,1726,druid,balance,59,34,25
Ларунс,blackscar,1725,druid,balance,83,48,35
Séxycàt,ravencrest,1725,druid,balance,439,231,208
Zydrux,outland,1724,druid,balance,48,33,15
Buffmeplz,medivh,1724,druid,balance,44,28,16
Catsareevil,silvermoon,1724,druid,balance,56,33,23
Bashfui,draenor,1724,druid,balance,228,126,102
Kijan,silvermoon,1724,druid,balance,78,42,36
Gorthunx,kazzak,1723,druid,balance,146,88,58
Garffield,ysondre,1722,druid,balance,42,32,10
Elilith,auchindoun,1722,druid,balance,42,28,14
Cihoyw,ragnaros,1722,druid,balance,41,26,15
Píøøx,tarren-mill,1722,druid,balance,84,53,31
Oommis,outland,1722,druid,balance,48,28,20
Кыцко,soulflayer,1722,druid,balance,145,80,65
Liften,blackhand,1722,druid,balance,90,49,41
Cowgurl,stormscale,1722,druid,balance,78,41,37
Pwnylol,teldrassil,1721,druid,balance,70,46,24
Jaiyen,ravencrest,1721,druid,balance,118,71,47
Hugeragê,stormreaver,1721,druid,balance,107,51,56
Iamobito,blackmoore,1719,druid,balance,42,24,18
Softesgirl,blackrock,1719,druid,balance,152,82,70
Goldencat,blackhand,1719,druid,balance,108,56,52
Kalgarm,burning-legion,1719,druid,balance,66,29,37
Canezmvp,blackrock,1718,druid,balance,36,21,15
Bonza,agamaggan,1717,druid,balance,44,26,18
Thielyy,blackmoore,1717,druid,balance,102,58,44
Nyndrà,archimonde,1717,druid,balance,195,92,103
Potatodru,ragnaros,1716,druid,balance,42,28,14
Zulrája,outland,1716,druid,balance,42,25,17
Ñêkø,ravencrest,1715,druid,balance,82,51,31
Khålêd,kazzak,1714,druid,balance,52,38,14
Opathecool,bladefist,1714,druid,balance,71,44,27
Yapyapyapyap,eredar,1713,druid,balance,42,25,17
Hælìñgtøúçh,ysondre,1713,druid,balance,51,28,23
Ævus,outland,1713,druid,balance,74,38,36
Kantai,dalaran,1712,druid,balance,47,27,20
Pradasurge,ravencrest,1712,druid,balance,179,99,80
Владибой,gordunni,1712,druid,balance,36,18,18
Zeaba,ravencrest,1711,druid,balance,24,18,6
Holziger,azshara,1710,druid,balance,100,58,42
Rootalot,blackrock,1710,druid,balance,54,31,23
Mesmerizing,ravencrest,1710,druid,balance,164,82,82
Louieform,outland,1709,druid,balance,48,32,16
Rassia,blackrock,1709,druid,balance,84,54,30
Shaandri,dethecus,1707,druid,balance,42,27,15
Kørra,dun-modr,1707,druid,balance,73,42,31
Bákhar,kazzak,1707,druid,balance,54,26,28
Snax,aggra-português,1706,druid,balance,42,25,17
Mabkferal,ravencrest,1705,druid,balance,30,18,12
Thaeris,outland,1705,druid,balance,58,34,24
Mirâculixx,dethecus,1705,druid,balance,60,34,26
Beefyglutes,moonglade,1705,druid,balance,48,26,22
Asinistar,ravencrest,1705,druid,balance,86,45,41
Shiftbox,blackmoore,1704,druid,balance,30,19,11
Sitruu,zenedar,1704,druid,balance,48,28,20
Jmaz,outland,1704,druid,balance,89,51,38
Ogx,blackmoore,1704,druid,balance,42,23,19
Bøøstèdtréè,ravencrest,1704,druid,balance,197,104,93
Moonfirecow,thrall,1703,druid,balance,120,65,55
Leqt,ravencrest,1703,druid,balance,156,84,72
Whêylon,ragnaros,1703,druid,balance,48,24,24
Quoting,ravencrest,1703,druid,balance,53,26,27
Asoli,aegwynn,1702,druid,balance,24,18,6
Pumpingurass,twisting-nether,1702,druid,balance,60,33,27
Ròb,magtheridon,1702,druid,balance,78,39,39
Hyunâ,dalaran,1701,druid,balance,60,38,22
Yuhor,outland,1701,druid,balance,238,125,113
Антошкапро,howling-fjord,1701,druid,balance,72,36,36
Хрофт,blackscar,1701,druid,balance,99,48,51
Neufcinqq,archimonde,1700,druid,balance,39,26,13
Frodds,grim-batol,1700,druid,balance,147,92,55
Mendorin,stormrage,1700,druid,balance,129,69,60
Brooklynzoo,ravencrest,1699,druid,balance,24,18,6
Pantheraa,twisting-nether,1699,druid,balance,102,70,32
Deßradator,stormscale,1699,druid,balance,48,31,17
Колтрэйнх,fordragon,1699,druid,balance,54,29,25
Vno,ravencrest,1698,druid,balance,42,32,10
Ploho,blackmoore,1698,druid,balance,45,23,22
Saabeq,hyjal,1697,druid,balance,162,91,71
Nizrã,archimonde,1696,druid,balance,43,28,15
Sykzd,hyjal,1696,druid,balance,36,23,13
Chäz,sanguino,1696,druid,balance,128,78,50
Shedzokey,tarren-mill,1696,druid,balance,253,139,114
Wykked,outland,1696,druid,balance,78,39,39
Kolt,rajaxx,1695,druid,balance,139,79,60
Bubadruid,silvermoon,1694,druid,balance,71,50,21
Dullbear,ravencrest,1694,druid,balance,54,34,20
Jory,archimonde,1694,druid,balance,45,28,17
Hakhú,hyjal,1694,druid,balance,31,19,12
Sinalûlz,outland,1694,druid,balance,30,18,12
Vorsaufen,blackhand,1694,druid,balance,81,42,39
Moewegodx,die-aldor,1693,druid,balance,30,18,12
Boomykush,twisting-nether,1693,druid,balance,98,57,41
Mnt,pozzo-delleternità,1692,druid,balance,36,22,14
Бонони,booty-bay,1692,druid,balance,162,84,78
Suprachybre,arathi,1691,druid,balance,54,35,19
Styggtryne,outland,1690,druid,balance,377,198,179
Ryhen,stormscale,1690,druid,balance,146,76,70
Grisdrood,draenor,1690,druid,balance,436,222,214
Добродейтель,soulflayer,1689,druid,balance,306,171,135
Anabola,frostwhisper,1689,druid,balance,83,45,38
Npml,tarren-mill,1689,druid,balance,150,79,71
Tôrmêñtêd,outland,1689,druid,balance,53,23,30
Nuqa,thrall,1688,druid,balance,61,35,26
Nergi,darksorrow,1688,druid,balance,71,40,31
Rapunzel,eredar,1688,druid,balance,36,20,16
Wildkin,twisting-nether,1688,druid,balance,182,98,84
Qumina,azjolnerub,1688,druid,balance,76,35,41
Dematos,forscherliga,1687,druid,balance,126,77,49
Porzi,blackhand,1687,druid,balance,130,76,54
Fiskmåsn,twisting-nether,1687,druid,balance,308,159,149
Gnoobr,ravencrest,1686,druid,balance,24,18,6
Sethdr,hyjal,1686,druid,balance,35,22,13
Cyriaan,eredar,1686,druid,balance,101,55,46
Justtrollîng,twisting-nether,1685,druid,balance,71,42,29
Zerozerosex,archimonde,1685,druid,balance,84,40,44
Blownaway,outland,1684,druid,balance,68,39,29
Featherfeet,kazzak,1684,druid,balance,84,43,41
Avimoo,tarren-mill,1683,druid,balance,54,31,23
Philyoo,blackhand,1682,druid,balance,54,25,29
Boompjeh,chamber-of-aspects,1681,druid,balance,30,18,12
Bigtouch,draenor,1681,druid,balance,71,42,29
Mäismz,hyjal,1680,druid,balance,54,37,17
Ayamiss,outland,1680,druid,balance,66,35,31
Kuraina,the-maelstrom,1679,druid,balance,54,28,26
Sefinana,malganis,1678,druid,balance,229,117,112
Lazerbinks,blackmoore,1677,druid,balance,57,37,20
Ultrapoulet,archimonde,1677,druid,balance,36,21,15
Corrupthz,outland,1677,druid,balance,117,68,49
Cyclonebroo,blackmoore,1676,druid,balance,76,48,28
Kørn,drakthul,1676,druid,balance,188,100,88
Barotz,hyjal,1675,druid,balance,42,26,16
Dotclass,outland,1675,druid,balance,44,25,19
Popadegril,draenor,1675,druid,balance,101,45,56
Mørshac,blackrock,1674,druid,balance,102,56,46
Nexirøs,hyjal,1673,druid,balance,121,74,47
Xirbtihs,stormscale,1672,druid,balance,56,37,19
Wildrice,blackhand,1672,druid,balance,83,46,37
Tiktokstar,blackrock,1671,druid,balance,41,26,15
Sodapop,aszune,1671,druid,balance,191,109,82
Elfsu,ravencrest,1671,druid,balance,233,131,102
Bigwurst,tarren-mill,1671,druid,balance,53,27,26
Турбокалясик,gordunni,1670,druid,balance,91,54,37
Someóne,stormreaver,1670,druid,balance,78,45,33
Гнетея,howling-fjord,1670,druid,balance,137,79,58
Leywä,drekthar,1670,druid,balance,77,42,35
Legyna,ravencrest,1670,druid,balance,129,69,60
Gstahr,taerar,1669,druid,balance,136,75,61
Kiluavi,argent-dawn,1669,druid,balance,42,22,20
Фигарофигаро,gordunni,1669,druid,balance,142,74,68
Happybear,outland,1668,druid,balance,81,60,21
Кашаган,howling-fjord,1668,druid,balance,260,145,115
Pórts,kazzak,1668,druid,balance,90,50,40
Salvagã,outland,1667,druid,balance,54,32,22
Директорх,blackscar,1667,druid,balance,48,28,20
Zenziidruid,blackhand,1666,druid,balance,69,42,27
Carébèar,stormscale,1666,druid,balance,72,40,32
Femboygodx,blackmoore,1665,druid,balance,42,26,16
Мантоя,gordunni,1665,druid,balance,325,177,148
Zeptune,tarren-mill,1665,druid,balance,191,91,100
Tâliah,silvermoon,1664,druid,balance,90,51,39
Thardruid,stormscale,1664,druid,balance,77,43,34
Ahylles,antonidas,1663,druid,balance,69,45,24
Youngdinozzo,dalaran,1663,druid,balance,41,26,15
Wísh,stormscale,1663,druid,balance,88,52,36
Rhaf,argent-dawn,1663,druid,balance,203,115,88
Threesixnìne,dun-morogh,1663,druid,balance,95,44,51
Gløbal,antonidas,1662,druid,balance,71,42,29
Wootbeam,silvermoon,1662,druid,balance,84,45,39
Корбэндетка,deepholm,1662,druid,balance,88,47,41
Treepoloski,stormscale,1661,druid,balance,69,41,28
Buurzalbai,drakthul,1661,druid,balance,221,117,104
Drutro,hellfire,1661,druid,balance,60,31,29
Moffwastaken,kazzak,1661,druid,balance,231,118,113
Uptoyou,defias-brotherhood,1660,druid,balance,161,91,70
Fluffypawz,shattered-hand,1659,druid,balance,48,29,19
Nareeik,tarren-mill,1659,druid,balance,36,21,15
Shapeshift,sanguino,1659,druid,balance,62,34,28
Møømøø,tarren-mill,1658,druid,balance,30,18,12
Abercrombx,thrall,1658,druid,balance,91,54,37
Gentle,tarren-mill,1658,druid,balance,137,72,65
Dikc,twisting-nether,1657,druid,balance,24,21,3
Ícekiss,hyjal,1656,druid,balance,67,43,24
Куколдос,eversong,1656,druid,balance,36,22,14
Deny,stormreaver,1656,druid,balance,83,50,33
Xqtdruid,blackhand,1655,druid,balance,42,22,20
Zwierzyniec,jaedenar,1654,druid,balance,36,26,10
Leathy,eredar,1653,druid,balance,115,67,48
Druidboss,tarren-mill,1653,druid,balance,287,159,128
Devióus,twilights-hammer,1653,druid,balance,41,18,23
Penìsdetable,argent-dawn,1652,druid,balance,69,45,24
Naicy,khaz-modan,1651,druid,balance,54,30,24
Pukkiakkella,burning-legion,1650,druid,balance,77,44,33
Pewpewdruid,blackmoore,1650,druid,balance,144,79,65
Bøllemís,silvermoon,1650,druid,balance,77,42,35
Noballz,blackhand,1650,druid,balance,64,34,30
Shanaiya,silvermoon,1649,druid,balance,38,20,18
Highonfire,grim-batol,1648,druid,balance,66,43,23
Themitch,outland,1648,druid,balance,83,49,34
Macron,terokkar,1648,druid,balance,70,38,32
Nizkul,dun-modr,1648,druid,balance,109,58,51
Xevan,blackrock,1647,druid,balance,36,22,14
Fatfingerx,blackrock,1647,druid,balance,42,23,19
Frikolina,outland,1647,druid,balance,203,106,97
Ninoboyswag,stormscale,1647,druid,balance,48,24,24
Gurudru,tarren-mill,1647,druid,balance,156,76,80
Gibsx,blackmoore,1646,druid,balance,48,33,15
Celitharion,tarren-mill,1646,druid,balance,54,32,22
Hotdóts,outland,1645,druid,balance,36,24,12
Санлесс,howling-fjord,1645,druid,balance,54,32,22
Nancey,auchindoun,1645,druid,balance,42,23,19
Hyac,the-maelstrom,1645,druid,balance,84,44,40
Shaize,dalaran,1644,druid,balance,82,57,25
Вестхем,howling-fjord,1644,druid,balance,32,22,10
Catten,sylvanas,1644,druid,balance,42,26,16
Ykg,twisting-nether,1644,druid,balance,93,52,41
Veyronn,burning-legion,1644,druid,balance,102,54,48
Øffroadz,blackmoore,1643,druid,balance,30,20,10
Feralisser,ravencrest,1643,druid,balance,30,19,11
Zwareshag,ravencrest,1643,druid,balance,48,30,18
Ryuzu,aegwynn,1643,druid,balance,91,52,39
Ajshadz,ravencrest,1643,druid,balance,48,27,21
Redlung,outland,1642,druid,balance,36,23,13
Milantu,antonidas,1642,druid,balance,30,18,12
Hauntie,kazzak,1642,druid,balance,129,74,55
Saltymoo,tarren-mill,1642,druid,balance,98,55,43
Eloomie,rexxar,1642,druid,balance,93,52,41
Starcrash,amanthul,1642,druid,balance,138,71,67
Çhîñêséðrüîð,kazzak,1642,druid,balance,43,22,21
Krathar,kazzak,1642,druid,balance,95,40,55
Cyclønegodxd,dentarg,1641,druid,balance,105,65,40
Caddan,argent-dawn,1641,druid,balance,66,39,27
Shaakm,nerathor,1641,druid,balance,72,41,31
Sanaponic,burning-legion,1641,druid,balance,70,39,31
Winarchikxxl,tarren-mill,1641,druid,balance,259,137,122
Flukeyz,draenor,1640,druid,balance,30,18,12
Drulier,doomhammer,1640,druid,balance,150,85,65
Topfrag,outland,1640,druid,balance,83,45,38
Epicplays,sylvanas,1640,druid,balance,70,35,35
Strix,dun-modr,1640,druid,balance,113,54,59
Exilara,twisting-nether,1639,druid,balance,78,48,30
Chadru,magtheridon,1639,druid,balance,92,52,40
Bobcup,tarren-mill,1639,druid,balance,131,72,59
Loasamdi,tarren-mill,1639,druid,balance,69,37,32
Albás,kazzak,1638,druid,balance,48,35,13
Meganfoxdq,sanguino,1638,druid,balance,82,53,29
Birb,archimonde,1638,druid,balance,131,79,52
Lililili,archimonde,1638,druid,balance,156,89,67
Kikïnøu,garona,1638,druid,balance,48,27,21
Teddyxbear,nefarian,1638,druid,balance,54,30,24
Druidka,grim-batol,1638,druid,balance,99,52,47
Firminoo,ragnaros,1638,druid,balance,66,31,35
Bígbaddruid,blackrock,1637,druid,balance,36,20,16
Däkk,draenor,1637,druid,balance,130,68,62
Nönö,tarren-mill,1637,druid,balance,54,27,27
Kungbore,draenor,1636,druid,balance,36,25,11
Zabraim,blackhand,1636,druid,balance,60,37,23
Druidflight,ravencrest,1636,druid,balance,60,34,26
Ånåphorå,archimonde,1636,druid,balance,45,25,20
Cráfty,blackrock,1635,druid,balance,85,56,29
Cøw,doomhammer,1635,druid,balance,78,42,36
Hottiish,stormscale,1635,druid,balance,194,101,93
Druidïta,dun-modr,1635,druid,balance,66,33,33
Fabuboomy,blackrock,1635,druid,balance,36,18,18
Azdr,ravencrest,1635,druid,balance,60,28,32
Deví,twilights-hammer,1634,druid,balance,48,30,18
Angrychicken,ravencrest,1634,druid,balance,68,42,26
Gsix,blackrock,1634,druid,balance,42,24,18
Niul,aegwynn,1634,druid,balance,172,98,74
Naturalbeef,argent-dawn,1634,druid,balance,40,22,18
Bigbaddream,stormscale,1634,druid,balance,95,48,47
Beamgødx,thrall,1633,druid,balance,28,19,9
Pëchy,aggra-português,1633,druid,balance,72,43,29
Zhroomx,blackmoore,1633,druid,balance,115,66,49
Cowxoxo,twisting-nether,1633,druid,balance,78,37,41
Ittei,korgall,1632,druid,balance,42,27,15
Сансплэш,lich-king,1632,druid,balance,104,60,44
Puppen,alakir,1632,druid,balance,165,93,72
Strinx,ragnaros,1631,druid,balance,129,81,48
Pansarbamse,outland,1631,druid,balance,110,58,52
Andjuga,doomhammer,1631,druid,balance,214,109,105
Felysae,kazzak,1630,druid,balance,24,17,7
Klßa,grim-batol,1630,druid,balance,30,21,9
Dabär,mannoroth,1630,druid,balance,60,36,24
Lazherra,drakthul,1630,druid,balance,50,30,20
Unknownhero,kazzak,1629,druid,balance,64,37,27
Pròtodrù,twisting-nether,1629,druid,balance,232,119,113
Болггар,gordunni,1628,druid,balance,137,78,59
Dharli,stormscale,1628,druid,balance,186,91,95
Malëdictus,tarren-mill,1627,druid,balance,47,37,10
Сицилиец,galakrond,1627,druid,balance,48,32,16
Ðrpressure,blackrock,1627,druid,balance,155,94,61
Surps,ravencrest,1627,druid,balance,48,28,20
Horadruid,silvermoon,1627,druid,balance,343,184,159
Sequisha,tarren-mill,1627,druid,balance,46,24,22
Scamlafsen,ragnaros,1627,druid,balance,48,25,23
Четыреводном,gordunni,1626,druid,balance,24,20,4
Fâucon,eitrigg,1626,druid,balance,40,27,13
Repiite,draenor,1626,druid,balance,47,29,18
Miepie,blackrock,1626,druid,balance,153,83,70
Varunys,blackrock,1626,druid,balance,239,128,111
Valoruk,ravencrest,1626,druid,balance,63,32,31
Hïrøshïmå,malganis,1625,druid,balance,122,64,58
Amøveo,draenor,1625,druid,balance,48,25,23
Bigbrrd,outland,1625,druid,balance,47,24,23
Luckerdog,tarren-mill,1625,druid,balance,136,66,70
Disclaimed,twisting-nether,1624,druid,balance,74,44,30
Сложныйдруид,howling-fjord,1624,druid,balance,82,46,36
Pjuske,silvermoon,1624,druid,balance,48,26,22
Kkona,silvermoon,1624,druid,balance,77,41,36
Couleaf,stormscale,1623,druid,balance,90,60,30
Heldil,chants-éternels,1623,druid,balance,34,18,16
Polymorphler,theradras,1623,druid,balance,84,38,46
Ibuyicecream,outland,1622,druid,balance,196,108,88
Merfje,karazhan,1622,druid,balance,36,17,19
Empi,sanguino,1621,druid,balance,96,51,45
Brandyballix,twisting-nether,1621,druid,balance,303,155,148
Kaïnak,dalaran,1621,druid,balance,66,33,33
Слоич,howling-fjord,1621,druid,balance,300,148,152
Diazepam,draenor,1620,druid,balance,90,52,38
Speegle,kazzak,1620,druid,balance,54,28,26
Moonzysunzy,sylvanas,1620,druid,balance,36,17,19
Landesverrat,kazzak,1619,druid,balance,24,21,3
Maddixx,outland,1619,druid,balance,153,83,70
Ôp,aegwynn,1619,druid,balance,113,56,57
Modruid,eredar,1618,druid,balance,42,25,17
Starcaller,burning-blade,1618,druid,balance,34,20,14
Damigjat,sylvanas,1618,druid,balance,221,126,95
Xenuss,kazzak,1618,druid,balance,48,26,22
Djbéámgódx,ravencrest,1618,druid,balance,99,46,53
Chángé,draenor,1617,druid,balance,91,57,34
Lörex,ravencrest,1617,druid,balance,37,23,14
Hashishi,grim-batol,1617,druid,balance,128,69,59
Elatadru,silvermoon,1617,druid,balance,71,35,36
Blazoor,frostwolf,1616,druid,balance,111,67,44
Кектахан,soulflayer,1616,druid,balance,58,32,26
Боблерсс,gordunni,1616,druid,balance,62,33,29
Degnosaur,outland,1615,druid,balance,54,29,25
Anahots,silvermoon,1615,druid,balance,361,188,173
Aliandrel,teldrassil,1614,druid,balance,102,66,36
Vienkesh,draenor,1614,druid,balance,35,22,13
Woodzey,sylvanas,1614,druid,balance,66,37,29
Pitbull,archimonde,1614,druid,balance,143,74,69
Bloomly,tarren-mill,1614,druid,balance,191,98,93
Rivenx,ravencrest,1613,druid,balance,59,37,22
Gòrgoth,pozzo-delleternità,1613,druid,balance,50,27,23
Karyaga,tarren-mill,1613,druid,balance,69,33,36
Moonwatcher,blackrock,1612,druid,balance,391,207,184
Jamley,tarren-mill,1612,druid,balance,36,19,17
Zonsybtw,blackhand,1611,druid,balance,36,28,8
Rá,outland,1611,druid,balance,32,22,10
Vongihkuhher,blackmoore,1611,druid,balance,42,23,19
Muhz,nathrezim,1611,druid,balance,158,85,73
Rifthy,nemesis,1611,druid,balance,42,22,20
Asimal,eredar,1610,druid,balance,24,17,7
Mianmar,silvermoon,1610,druid,balance,149,92,57
Itadorikun,silvermoon,1610,druid,balance,137,82,55
Angelinax,silvermoon,1609,druid,balance,41,24,17
Wafflecat,outland,1609,druid,balance,36,21,15
Rode,magtheridon,1609,druid,balance,154,88,66
Ralffoosa,auchindoun,1609,druid,balance,65,36,29
Bashloug,archimonde,1609,druid,balance,38,20,18
Epidemic,argent-dawn,1608,druid,balance,91,52,39
Newdudu,draenor,1608,druid,balance,105,58,47
Hiquien,silvermoon,1607,druid,balance,96,57,39
Huxleyys,draenor,1607,druid,balance,30,17,13
Друнуар,gordunni,1607,druid,balance,48,25,23
Fantastix,silvermoon,1607,druid,balance,102,52,50
Doncy,ragnaros,1607,druid,balance,54,24,30
Sqoopy,tarren-mill,1606,druid,balance,36,27,9
Bømping,tarren-mill,1606,druid,balance,36,24,12
Smokahontas,kilrogg,1606,druid,balance,30,17,13
Veyra,dentarg,1606,druid,balance,65,31,34
Suevlaki,ragnaros,1605,druid,balance,114,69,45
Hillarious,blackmoore,1605,druid,balance,123,71,52
Seudoz,silvermoon,1605,druid,balance,129,74,55
Veijari,deathwing,1605,druid,balance,52,29,23
Tokitoc,archimonde,1605,druid,balance,122,66,56
Auches,argent-dawn,1605,druid,balance,42,22,20
Grisdrood,ragnaros,1605,druid,balance,227,117,110
Feign,blackmoore,1605,druid,balance,85,43,42
Isylia,twisting-nether,1605,druid,balance,72,36,36
Emeraldhaze,sylvanas,1604,druid,balance,97,60,37
Kittyperry,blackmoore,1604,druid,balance,69,38,31
Spaceshift,magtheridon,1604,druid,balance,292,157,135
Rachenketzy,stormscale,1604,druid,balance,42,19,23
Drufar,outland,1603,druid,balance,29,18,11
Bearcosby,burning-legion,1603,druid,balance,41,25,16
Kåmen,ravenholdt,1603,druid,balance,103,58,45
Løgbjørnen,tarren-mill,1603,druid,balance,52,29,23
Pneuma,xavius,1603,druid,balance,155,86,69
Druidrighteu,ravencrest,1603,druid,balance,153,84,69
Соникдогх,gordunni,1603,druid,balance,84,45,39
Seysso,silvermoon,1603,druid,balance,266,138,128
Irfrayl,antonidas,1602,druid,balance,30,22,8
Youseemeflap,kazzak,1602,druid,balance,24,17,7
Insanexp,antonidas,1602,druid,balance,37,24,13
Erol,silvermoon,1602,druid,balance,73,47,26
Socialdistnc,silvermoon,1602,druid,balance,54,32,22
Donutella,drakthul,1602,druid,balance,34,18,16
Bears,outland,1602,druid,balance,423,217,206
Varthax,stormscale,1602,druid,balance,36,18,18
Nomilkforyou,steamwheedle-cartel,1601,druid,balance,63,39,24
Китрасх,soulflayer,1601,druid,balance,34,19,15
Rofyx,twisting-nether,1601,druid,balance,36,19,17
Matpear,ravencrest,1601,druid,balance,42,21,21
Aenrolz,hyjal,1600,druid,balance,30,21,9
Ciue,tarren-mill,1600,druid,balance,45,30,15
Goom,rexxar,1600,druid,balance,214,124,90
Viverion,ravencrest,1600,druid,balance,141,77,64
Elrroir,dun-modr,1599,druid,balance,78,45,33
Wildanomaly,argent-dawn,1598,druid,balance,118,64,54
Abbc,stormscale,1597,druid,balance,36,19,17
Zonsy,twisting-nether,1597,druid,balance,60,28,32
Cupoftea,drakthul,1596,druid,balance,156,87,69
Cieniuu,burning-legion,1595,druid,balance,86,57,29
Pento,aggra-português,1595,druid,balance,90,44,46
Ðelix,ysera,1594,druid,balance,110,62,48
Lillevän,tarren-mill,1594,druid,balance,48,27,21
Tôurnesol,khaz-modan,1594,druid,balance,242,132,110
Weisslogia,aegwynn,1594,druid,balance,119,64,55
Schannine,archimonde,1593,druid,balance,161,83,78
Milkywáys,draenor,1593,druid,balance,387,194,193
Hashoar,archimonde,1592,druid,balance,42,28,14
Svend,kazzak,1592,druid,balance,95,52,43
Lastcroptol,dun-modr,1592,druid,balance,106,54,52
Lxz,blackhand,1591,druid,balance,88,47,41
Easypointsx,tarren-mill,1590,druid,balance,30,19,11
Rwq,outland,1590,druid,balance,57,30,27
Matmoo,hyjal,1589,druid,balance,41,25,16
Báco,dun-modr,1589,druid,balance,71,37,34
Czarnykocur,burning-legion,1588,druid,balance,199,111,88
Drugnag,blackmoore,1588,druid,balance,126,70,56
Sonjin,burning-legion,1588,druid,balance,54,28,26
Уба,gordunni,1587,druid,balance,40,25,15
Truffleßuttr,kazzak,1587,druid,balance,30,17,13
Xä,bloodscalp,1587,druid,balance,159,86,73
Døttore,garona,1587,druid,balance,164,83,81
Knuffle,eredar,1586,druid,balance,105,62,43
Magnusson,shadowsong,1585,druid,balance,90,59,31
Notmyfriend,sylvanas,1585,druid,balance,106,62,44
Treenough,drakthul,1585,druid,balance,47,25,22
Tylercatmeow,burning-legion,1585,druid,balance,83,43,40
Laødinay,hyjal,1584,druid,balance,140,75,65
Lisbethqt,nemesis,1583,druid,balance,30,19,11
Esrín,the-maelstrom,1583,druid,balance,274,138,136
Hehehahaha,kazzak,1582,druid,balance,30,20,10
Tuwog,outland,1582,druid,balance,219,113,106
Eärendir,ravencrest,1582,druid,balance,369,190,179
Derfaï,kaelthas,1582,druid,balance,82,39,43
Àspro,hyjal,1581,druid,balance,108,54,54
Malvakten,kazzak,1581,druid,balance,212,102,110
Smashella,pozzo-delleternità,1579,druid,balance,126,80,46
Monkeynight,ambossar,1579,druid,balance,74,38,36
Pissballs,turalyon,1579,druid,balance,102,52,50
Kâllîsto,eredar,1579,druid,balance,80,40,40
Moomat,hyjal,1578,druid,balance,66,42,24
Raízun,blackmoore,1578,druid,balance,54,32,22
Daìs,dalaran,1578,druid,balance,55,31,24
Dropp,colinas-pardas,1577,druid,balance,30,17,13
Bálur,thrall,1577,druid,balance,36,20,16
Gotnaga,silvermoon,1577,druid,balance,96,51,45
Zethane,ragnaros,1576,druid,balance,73,42,31
Duzky,kazzak,1575,druid,balance,54,26,28
Zeromario,draenor,1575,druid,balance,42,19,23
Alamâ,madmortem,1575,druid,balance,54,23,31
Shapeshiptur,argent-dawn,1574,druid,balance,95,52,43
Brainjuice,blackrock,1574,druid,balance,36,19,17
Bizle,stormscale,1574,druid,balance,65,33,32
Amhro,ragnaros,1572,druid,balance,96,55,41
Gretl,blackrock,1572,druid,balance,102,52,50
Algír,argent-dawn,1572,druid,balance,141,71,70
Kittyexpress,arygos,1572,druid,balance,105,52,53
Ylmh,archimonde,1571,druid,balance,30,19,11
Quellwell,outland,1571,druid,balance,122,61,61
Dantet,the-maelstrom,1570,druid,balance,54,24,30
Degentiuso,alakir,1569,druid,balance,96,60,36
Муниня,gordunni,1569,druid,balance,179,94,85
Zlogic,tarren-mill,1568,druid,balance,30,17,13
Morphael,ravencrest,1567,druid,balance,55,33,22
Формун,razuvious,1566,druid,balance,43,34,9
Elodìa,antonidas,1566,druid,balance,36,25,11
Stárburst,auchindoun,1566,druid,balance,227,125,102
Стампид,blackscar,1566,druid,balance,290,157,133
Skadruid,blackmoore,1566,druid,balance,96,50,46
Малфуррион,soulflayer,1565,druid,balance,48,27,21
Myllymatti,frostwhisper,1565,druid,balance,54,28,26
Unoseeme,outland,1565,druid,balance,42,19,23
Mikeem,draenor,1563,druid,balance,38,24,14
Narkosha,kazzak,1563,druid,balance,92,57,35
Ðîwø,blackhand,1563,druid,balance,36,18,18
Underlaay,kazzak,1562,druid,balance,30,19,11
Lemonjohn,outland,1561,druid,balance,38,19,19
Kittenmitten,ragnaros,1560,druid,balance,189,104,85
Ryng,nagrand,1558,druid,balance,96,58,38
Martinesämst,outland,1558,druid,balance,46,24,22
Keynn,kazzak,1558,druid,balance,116,60,56
Alexsandruid,rexxar,1556,druid,balance,33,19,14
Diolives,stormscale,1556,druid,balance,78,40,38
Ìluan,ravencrest,1556,druid,balance,48,23,25
Ashkaxx,ragnaros,1555,druid,balance,165,88,77
Migami,nemesis,1555,druid,balance,72,36,36
Droodstar,archimonde,1554,druid,balance,45,29,16
Rédbull,outland,1554,druid,balance,148,81,67
Pánjav,draenor,1554,druid,balance,48,26,22
Hållkäften,twisting-nether,1554,druid,balance,155,80,75
Curzex,blackmoore,1554,druid,balance,48,23,25
Shenzform,ysondre,1554,druid,balance,47,21,26
Calambius,blackhand,1553,druid,balance,224,112,112
Òniz,hyjal,1552,druid,balance,60,40,20
Lunarveil,draenor,1551,druid,balance,53,29,24
Lasertipu,tarren-mill,1550,druid,balance,131,69,62
Wildmistake,argent-dawn,1550,druid,balance,35,17,18
Chelsealeart,frostmane,1549,druid,balance,139,78,61
Slycey,eredar,1549,druid,balance,54,30,24
Silvix,blackrock,1549,druid,balance,130,67,63
Töÿ,archimonde,1548,druid,balance,29,21,8
Даорион,gordunni,1547,druid,balance,71,42,29
Fishanchips,archimonde,1547,druid,balance,36,20,16
Усыильвиры,soulflayer,1547,druid,balance,70,38,32
Brokul,kazzak,1547,druid,balance,84,44,40
Duis,twilights-hammer,1547,druid,balance,124,64,60
Mercander,draenor,1547,druid,balance,65,32,33
Fluffeh,doomhammer,1546,druid,balance,60,38,22
Yabbah,blackrock,1546,druid,balance,42,26,16
Ратататата,blackscar,1546,druid,balance,50,28,22
Timanuel,ysondre,1546,druid,balance,42,17,25
Posiqtdruid,nemesis,1545,druid,balance,102,58,44
Tulleku,azjolnerub,1545,druid,balance,81,44,37
Shackari,ravencrest,1545,druid,balance,135,67,68
Dëåd,zenedar,1544,druid,balance,36,22,14
Tigerroll,kazzak,1544,druid,balance,66,30,36
Killforpakis,turalyon,1543,druid,balance,54,35,19
Wiligun,archimonde,1543,druid,balance,81,52,29
Diggear,doomhammer,1543,druid,balance,48,30,18
Fruntimmern,sylvanas,1543,druid,balance,48,28,20
Ciaoxøxø,ragnaros,1543,druid,balance,190,103,87
Hotlife,ravencrest,1543,druid,balance,67,35,32
Mcbobb,ravencrest,1541,druid,balance,113,57,56
Magiskeforme,draenor,1540,druid,balance,50,34,16
Boomalot,auchindoun,1540,druid,balance,88,50,38
Maxiturbogay,stormscale,1540,druid,balance,47,26,21
Bruddanature,blackrock,1540,druid,balance,198,108,90
Roidcat,twisting-nether,1540,druid,balance,47,24,23
Nxee,tarren-mill,1539,druid,balance,60,41,19
Karuck,ravencrest,1539,druid,balance,172,90,82
Зетзул,grom,1539,druid,balance,427,214,213
Feralspîrît,outland,1539,druid,balance,168,84,84
Zyune,ravencrest,1539,druid,balance,36,17,19
Фонш,soulflayer,1538,druid,balance,50,26,24
Pawel,defias-brotherhood,1538,druid,balance,215,109,106
Кётре,ashenvale,1538,druid,balance,114,57,57
Larryburns,nathrezim,1538,druid,balance,120,59,61
Экстазиус,borean-tundra,1538,druid,balance,77,32,45
Gibx,ravencrest,1536,druid,balance,36,20,16
Fattydomdom,ahnqiraj,1535,druid,balance,18,16,2
Jazzme,aegwynn,1535,druid,balance,24,16,8
Mokujiin,burning-blade,1535,druid,balance,75,35,40
Trønchetto,nemesis,1534,druid,balance,30,16,14
Arecsne,turalyon,1534,druid,balance,169,85,84
Уэсериктх,blackscar,1534,druid,balance,36,18,18
Noou,aegwynn,1534,druid,balance,52,25,27
Slaughtér,stormscale,1533,druid,balance,78,47,31
Mortagua,kazzak,1533,druid,balance,53,30,23
Flxtn,hyjal,1533,druid,balance,96,43,53
Horpet,silvermoon,1530,druid,balance,66,37,29
Bîte,blackmoore,1529,druid,balance,24,16,8
Meretrizx,kazzak,1529,druid,balance,36,19,17
Bopy,ravencrest,1528,druid,balance,30,17,13
Sheâ,nemesis,1528,druid,balance,282,151,131
Høtbøx,aegwynn,1528,druid,balance,87,45,42
Слоич,gordunni,1528,druid,balance,156,79,77
Mushröøms,nemesis,1528,druid,balance,71,32,39
Renzay,ysondre,1527,druid,balance,24,16,8
Kebapino,kazzak,1527,druid,balance,30,18,12
Iskaarjx,archimonde,1527,druid,balance,77,45,32
Inkibek,burning-blade,1527,druid,balance,155,90,65
Rãpidã,hyjal,1527,druid,balance,54,31,23
Лунныйфилин,deathguard,1527,druid,balance,61,32,29
Wizår,outland,1526,druid,balance,30,19,11
Feyzboom,ysondre,1525,druid,balance,24,16,8
Halouest,archimonde,1524,druid,balance,89,47,42
Cptsponksa,tarren-mill,1524,druid,balance,231,121,110
Tordo,silvermoon,1524,druid,balance,60,31,29
Blackfür,sylvanas,1524,druid,balance,212,107,105
Demonbalance,silvermoon,1523,druid,balance,100,58,42
Amoveo,argent-dawn,1523,druid,balance,74,39,35
Rystafarian,kazzak,1523,druid,balance,74,36,38
Wazam,kazzak,1522,druid,balance,130,77,53
Seboom,outland,1522,druid,balance,129,72,57
Hibo,dun-modr,1522,druid,balance,72,37,35
Crackfat,stormscale,1521,druid,balance,52,34,18
Vasilona,sanguino,1521,druid,balance,87,53,34
Larayne,anubarak,1521,druid,balance,39,22,17
Kosmegpåøra,ravencrest,1521,druid,balance,54,24,30
Kbdd,outland,1521,druid,balance,54,24,30
Kattepis,argent-dawn,1521,druid,balance,60,25,35
Sofiadrood,stormreaver,1520,druid,balance,24,16,8
Massak,aegwynn,1520,druid,balance,37,24,13
Levéltetü,ragnaros,1520,druid,balance,30,18,12
Tahru,blackrock,1520,druid,balance,43,23,20
Анестезий,soulflayer,1519,druid,balance,96,63,33
Xaeia,aegwynn,1519,druid,balance,108,67,41
Asrais,dun-modr,1519,druid,balance,72,38,34
Herns,kazzak,1518,druid,balance,60,26,34
Elødyn,nemesis,1517,druid,balance,92,52,40
Belzara,sanguino,1517,druid,balance,122,68,54
Fransman,sylvanas,1517,druid,balance,84,40,44
Rayðii,archimonde,1516,druid,balance,87,52,35
Nømat,defias-brotherhood,1516,druid,balance,276,152,124
Maaw,tarren-mill,1516,druid,balance,72,38,34
Delly,neptulon,1516,druid,balance,59,30,29
Syremark,silvermoon,1515,druid,balance,55,26,29
Cantdonothig,ravencrest,1514,druid,balance,327,167,160
Zevis,outland,1514,druid,balance,168,84,84
Бонинайтх,gordunni,1514,druid,balance,78,37,41
Shapeit,blackrock,1513,druid,balance,36,25,11
Тираэлюшка,grom,1513,druid,balance,30,19,11
Урркке,soulflayer,1513,druid,balance,114,61,53
Trylune,blackmoore,1513,druid,balance,36,19,17
Jónahfalcon,draenor,1512,druid,balance,24,16,8
Bénjî,khazgoroth,1512,druid,balance,157,89,68
Lèafy,silvermoon,1511,druid,balance,43,26,17
Xyzy,burning-legion,1511,druid,balance,212,104,108
Bareforms,medivh,1510,druid,balance,81,54,27
Iupa,silvermoon,1510,druid,balance,233,128,105
Snedden,silvermoon,1510,druid,balance,97,52,45
Anhoq,silvermoon,1510,druid,balance,216,115,101
Freakyo,blackrock,1509,druid,balance,59,32,27
Димитруа,howling-fjord,1509,druid,balance,48,25,23
Jebga,thrall,1509,druid,balance,115,57,58
Pyqmi,stormscale,1508,druid,balance,60,36,24
Stalkdro,elune,1508,druid,balance,33,18,15
Екфта,gordunni,1508,druid,balance,155,80,75
Хастла,galakrond,1508,druid,balance,72,37,35
Ddggss,ragnaros,1507,druid,balance,49,29,20
Killxhard,ravencrest,1507,druid,balance,36,19,17
Form,burning-legion,1506,druid,balance,24,16,8
Бульбион,gordunni,1506,druid,balance,90,56,34
Craycrays,argent-dawn,1506,druid,balance,67,38,29
Lyø,draenor,1506,druid,balance,154,85,69
Mindruid,kazzak,1506,druid,balance,48,26,22
Szubotaj,ragnaros,1505,druid,balance,36,20,16
Wize,pozzo-delleternità,1505,druid,balance,116,60,56
Rowlet,twisting-nether,1505,druid,balance,213,109,104
Bagginston,nazjatar,1505,druid,balance,86,44,42
Bxxmkin,draenor,1504,druid,balance,42,27,15
Fejgi,stormreaver,1504,druid,balance,104,64,40
Goüsta,archimonde,1504,druid,balance,72,38,34
Neshalry,blackhand,1503,druid,balance,57,32,25
Оудин,blackscar,1502,druid,balance,79,47,32
Eziyet,blackrock,1502,druid,balance,114,62,52
Eaglefôrce,blackmoore,1502,druid,balance,65,35,30
Zaheer,silvermoon,1500,druid,balance,87,45,42
Баттнэйкед,gordunni,1500,druid,balance,89,42,47
Shàarøn,archimonde,1499,druid,balance,52,36,16
Healol,sanguino,1499,druid,balance,123,65,58
Boomzter,frostmane,1499,druid,balance,172,90,82
Ðiàblos,nemesis,1498,druid,balance,88,54,34
Opla,nethersturm,1498,druid,balance,70,42,28
Animalcruelt,silvermoon,1498,druid,balance,74,40,34
Drutiful,outland,1498,druid,balance,89,42,47
Мерлинз,lich-king,1498,druid,balance,48,22,26
Ezkatka,ravencrest,1497,druid,balance,24,16,8
Karodoom,twisting-nether,1497,druid,balance,131,71,60
Darlenee,kazzak,1497,druid,balance,153,80,73
Shuffey,frostmane,1496,druid,balance,67,37,30
Faqbàdi,twisting-nether,1496,druid,balance,48,25,23
Sweetner,outland,1495,druid,balance,64,38,26
Carismatic,blackmoore,1494,druid,balance,224,116,108
Heejåe,archimonde,1494,druid,balance,61,30,31
Fabutwo,blackrock,1494,druid,balance,35,16,19
Krosanx,outland,1493,druid,balance,54,24,30
Ibnform,archimonde,1492,druid,balance,21,17,4
Oxe,malganis,1492,druid,balance,24,19,5
Smuttán,frostmane,1492,druid,balance,24,17,7
Salvaga,outland,1492,druid,balance,47,27,20
Convokeboost,archimonde,1492,druid,balance,273,152,121
Ассайоу,gordunni,1490,druid,balance,102,54,48
Raszcal,blackhand,1489,druid,balance,46,27,19
Deepqt,kargath,1489,druid,balance,75,41,34
Telbo,ravencrest,1489,druid,balance,113,59,54
Mogi,pozzo-delleternità,1489,druid,balance,132,66,66
Aetheris,varimathras,1489,druid,balance,98,48,50
Schneéeule,blackrock,1489,druid,balance,60,29,31
Storpboom,drakthul,1488,druid,balance,129,75,54
Dámøn,stormscale,1488,druid,balance,84,40,44
Qïx,outland,1487,druid,balance,33,21,12
Arrowfáx,kazzak,1486,druid,balance,90,52,38
Ихет,gordunni,1486,druid,balance,167,95,72
Vrill,kazzak,1486,druid,balance,215,117,98
Calume,dun-modr,1486,druid,balance,36,19,17
Meezy,ragnaros,1485,druid,balance,81,48,33
Тётявискас,howling-fjord,1485,druid,balance,64,30,34
Smuktøs,twisting-nether,1484,druid,balance,63,43,20
Stêvé,silvermoon,1484,druid,balance,133,78,55
Vodkavodkaa,tarren-mill,1484,druid,balance,94,49,45
Arkatt,outland,1482,druid,balance,36,24,12
Xërxës,outland,1482,druid,balance,56,33,23
Settembre,ragnaros,1482,druid,balance,110,55,55
Merawr,ravencrest,1482,druid,balance,147,72,75
Gúccî,blackrock,1481,druid,balance,36,26,10
Felyß,outland,1481,druid,balance,96,58,38
Жолудь,gordunni,1480,druid,balance,48,17,31
Rât,blackmoore,1478,druid,balance,54,36,18
Yaaji,archimonde,1478,druid,balance,48,24,24
Hashtagone,ysondre,1477,druid,balance,38,26,12
Bjærky,silvermoon,1477,druid,balance,74,49,25
Aurwen,silvermoon,1477,druid,balance,55,30,25
Nujus,kazzak,1477,druid,balance,36,18,18
Snoxy,wrathbringer,1477,druid,balance,65,32,33
Moonfetamine,silvermoon,1477,druid,balance,54,26,28
Nixhot,blackmoore,1477,druid,balance,88,41,47
Niggler,magtheridon,1476,druid,balance,160,84,76
Mehgyver,ravencrest,1476,druid,balance,55,28,27
Rikiform,ravencrest,1476,druid,balance,59,30,29
Bullchóps,kazzak,1475,druid,balance,78,41,37
Manuka,argent-dawn,1475,druid,balance,90,45,45
Meuhtéki,hyjal,1473,druid,balance,24,16,8
Dingeren,stormscale,1473,druid,balance,30,19,11
Мутаборец,howling-fjord,1473,druid,balance,155,95,60
Ibêx,blackmoore,1473,druid,balance,69,41,28
Бадика,eversong,1473,druid,balance,134,73,61
Coogee,malganis,1473,druid,balance,170,92,78
Phala,outland,1473,druid,balance,53,27,26
Dudana,argent-dawn,1472,druid,balance,60,36,24
Mahist,archimonde,1472,druid,balance,66,38,28
Whiskers,emerald-dream,1472,druid,balance,90,45,45
Baz,nemesis,1471,druid,balance,84,49,35
Imaduck,silvermoon,1471,druid,balance,97,49,48
Everdud,tarren-mill,1470,druid,balance,42,27,15
Джоннчек,gordunni,1470,druid,balance,70,44,26
Ðämøñæ,drekthar,1470,druid,balance,93,45,48
Surinox,blackrock,1469,druid,balance,90,61,29
Wuodd,draenor,1469,druid,balance,30,16,14
Prinzfarming,mugthol,1469,druid,balance,57,29,28
Wallaar,ragnaros,1469,druid,balance,102,46,56
Сейдр,grom,1469,druid,balance,94,42,52
Reed,sylvanas,1469,druid,balance,42,16,26
Edenx,stormscale,1467,druid,balance,17,16,1
Jatto,magtheridon,1467,druid,balance,72,39,33
Неделин,greymane,1466,druid,balance,36,23,13
Древогрут,howling-fjord,1466,druid,balance,43,27,16
Manbearcat,nagrand,1465,druid,balance,44,22,22
Toffyfee,anetheron,1464,druid,balance,68,47,21
Pfandmalle,blackrock,1464,druid,balance,36,24,12
Ðãddy,ravencrest,1463,druid,balance,83,53,30
Winnysfanboy,outland,1463,druid,balance,30,16,14
Vaizier,defias-brotherhood,1462,druid,balance,125,63,62
Whythis,archimonde,1462,druid,balance,250,125,125
Salseo,uldum,1461,druid,balance,84,55,29
Druidere,outland,1461,druid,balance,106,56,50
Chansnax,thrall,1461,druid,balance,82,42,40
Rèchy,blackrock,1461,druid,balance,51,22,29
Syurn,sanguino,1460,druid,balance,42,25,17
Meatwallet,defias-brotherhood,1460,druid,balance,47,27,20
Inghlo,blackmoore,1460,druid,balance,64,36,28
Bubak,deathwing,1460,druid,balance,54,26,28
Entas,kazzak,1459,druid,balance,36,24,12
Jöggel,perenolde,1459,druid,balance,48,29,19
Хоточник,gordunni,1459,druid,balance,144,75,69
Applestrudle,blackrock,1459,druid,balance,96,46,50
Ashirae,drakthul,1458,druid,balance,38,20,18
Fangornn,outland,1458,druid,balance,42,17,25
Arrakiz,sanguino,1457,druid,balance,113,70,43
Yugene,dun-modr,1457,druid,balance,32,16,16
Rocknrollà,doomhammer,1457,druid,balance,42,19,23
Sojiz,outland,1456,druid,balance,33,23,10
Ядостижений,deathguard,1456,druid,balance,28,16,12
Dypas,chogall,1456,druid,balance,60,33,27
Aastal,uldaman,1456,druid,balance,127,63,64
Milknosugar,tarren-mill,1456,druid,balance,65,28,37
Hulhorn,tarren-mill,1455,druid,balance,29,17,12
Verenai,bloodfeather,1454,druid,balance,36,24,12
Braokhull,stormscale,1453,druid,balance,108,62,46
Аррерон,howling-fjord,1453,druid,balance,30,16,14
Jejoueferal,chogall,1453,druid,balance,192,98,94
Endoplazmik,silvermoon,1453,druid,balance,165,83,82
Aègon,ravencrest,1452,druid,balance,137,72,65
Drineh,ravencrest,1452,druid,balance,42,21,21
Malolepszy,burning-legion,1452,druid,balance,82,37,45
Fåtå,archimonde,1452,druid,balance,42,17,25
Fiomy,blackhand,1451,druid,balance,107,66,41
Cagaboliches,sanguino,1451,druid,balance,77,44,33
Fluffykin,defias-brotherhood,1451,druid,balance,102,56,46
Kuhgucci,blackmoore,1451,druid,balance,30,16,14
Yiradur,stormscale,1451,druid,balance,108,55,53
Almastrale,hyjal,1449,druid,balance,28,24,4
Bighike,drakthul,1449,druid,balance,24,17,7
Onè,blackhand,1449,druid,balance,60,32,28
Zhyra,arathor,1449,druid,balance,169,88,81
Traplordgen,outland,1449,druid,balance,56,29,27
Chrevarraige,saurfang,1449,druid,balance,416,215,201
Жибка,howling-fjord,1449,druid,balance,62,32,30
Weregoon,blackmoore,1449,druid,balance,183,92,91
Giaya,turalyon,1448,druid,balance,69,41,28
Fûzzybear,ravencrest,1448,druid,balance,102,53,49
Bigpopp,kazzak,1448,druid,balance,114,59,55
Crazzimus,tarren-mill,1448,druid,balance,144,72,72
Bogahcan,twisting-nether,1448,druid,balance,86,43,43
Wxw,stormscale,1448,druid,balance,36,17,19
Sinyi,arathor,1447,druid,balance,35,19,16
Tongá,draenor,1447,druid,balance,66,34,32
Kénshin,blackhand,1447,druid,balance,90,42,48
Fjry,draenor,1447,druid,balance,35,16,19
Woopi,blackrock,1447,druid,balance,52,23,29
Käldorei,lightbringer,1446,druid,balance,30,16,14
Редмун,soulflayer,1446,druid,balance,140,73,67
Littleneo,ambossar,1446,druid,balance,125,63,62
Hunterkiller,azjolnerub,1446,druid,balance,42,21,21
Owlcápown,ravencrest,1446,druid,balance,36,18,18
Bëndover,uldaman,1445,druid,balance,42,25,17
Stìck,archimonde,1445,druid,balance,107,59,48
Chúcky,twisting-nether,1445,druid,balance,139,76,63
Yomosh,eredar,1445,druid,balance,118,64,54
Fruitdealer,antonidas,1444,druid,balance,78,42,36
Psycloniac,ravencrest,1444,druid,balance,54,28,26
Leechers,silvermoon,1444,druid,balance,72,29,43
Madx,dalaran,1443,druid,balance,39,25,14
Овероний,soulflayer,1443,druid,balance,79,45,34
Chillerin,draenor,1443,druid,balance,138,70,68
Ðæøm,outland,1442,druid,balance,41,32,9
Felischaus,twisting-nether,1442,druid,balance,29,20,9
Moler,hyjal,1442,druid,balance,133,73,60
Buttkin,outland,1442,druid,balance,36,17,19
Freedomm,hyjal,1442,druid,balance,83,39,44
Furiondox,silvermoon,1442,druid,balance,62,29,33
And,arathor,1442,druid,balance,36,16,20
Orazien,ravencrest,1441,druid,balance,36,22,14
Smøuler,sanguino,1441,druid,balance,57,30,27
Sycraim,zirkel-des-cenarius,1438,druid,balance,24,15,9
Hefdgaharald,antonidas,1438,druid,balance,36,18,18
Tonutc,sanguino,1438,druid,balance,99,49,50
Noctilus,steamwheedle-cartel,1437,druid,balance,35,19,16
Elfruidus,chogall,1436,druid,balance,30,22,8
Shumkott,kazzak,1436,druid,balance,34,16,18
Stormspirit,hellscream,1435,druid,balance,66,38,28
Saltilac,ragnaros,1435,druid,balance,80,44,36
Крстлзхс,gordunni,1435,druid,balance,46,24,22
Krtt,tarren-mill,1435,druid,balance,247,121,126
Джасэл,howling-fjord,1434,druid,balance,30,20,10
Néøu,archimonde,1434,druid,balance,24,15,9
Armadroød,hyjal,1434,druid,balance,36,19,17
Бибраа,eversong,1434,druid,balance,84,41,43
Urilmæ,blackmoore,1433,druid,balance,60,30,30
Exca,stormscale,1433,druid,balance,78,37,41
Bandinator,archimonde,1432,druid,balance,24,15,9
Astralbody,auchindoun,1432,druid,balance,36,20,16
Feetpícs,ravencrest,1432,druid,balance,119,65,54
Succee,stormscale,1432,druid,balance,345,182,163
Duskdawn,xavius,1432,druid,balance,78,39,39
Kamzik,drakthul,1432,druid,balance,42,21,21
Sajah,outland,1432,druid,balance,70,30,40
Løö,archimonde,1431,druid,balance,24,15,9
Píps,ravencrest,1431,druid,balance,24,15,9
Maglar,blackmoore,1431,druid,balance,60,37,23
Chouwa,korgall,1431,druid,balance,65,38,27
Dragonforcé,twisting-nether,1431,druid,balance,39,22,17
Môõn,tarren-mill,1431,druid,balance,60,33,27
Xclonedotcom,aegwynn,1430,druid,balance,54,36,18
Fillet,aggra-português,1430,druid,balance,71,47,24
Asterism,stormscale,1430,druid,balance,177,94,83
Кекичшрекич,soulflayer,1430,druid,balance,84,44,40
Kazuid,argent-dawn,1428,druid,balance,38,24,14
Vëgâñgøðx,ragnaros,1428,druid,balance,24,15,9
Fouser,shattered-hand,1428,druid,balance,36,17,19
Carebearlol,frostmane,1428,druid,balance,123,58,65
Rrayed,kazzak,1427,druid,balance,76,49,27
Phesxd,sylvanas,1427,druid,balance,30,16,14
Abralie,kazzak,1426,druid,balance,24,15,9
Kriala,kazzak,1426,druid,balance,36,20,16
Drocos,genjuros,1426,druid,balance,65,35,30
Fortuma,eredar,1426,druid,balance,131,67,64
Yiriy,baelgun,1426,druid,balance,30,15,15
Bababus,blackhand,1425,druid,balance,24,15,9
Doctóras,twisting-nether,1425,druid,balance,36,22,14
Smedoge,outland,1425,druid,balance,30,15,15
Drudd,hellscream,1425,druid,balance,47,20,27
Éatshiftndie,tarren-mill,1424,druid,balance,24,15,9
Этъя,borean-tundra,1424,druid,balance,155,76,79
Ooxx,rashgarroth,1424,druid,balance,99,48,51
Fäcker,blackhand,1423,druid,balance,90,52,38
Natoro,outland,1423,druid,balance,72,38,34
Tawaraki,outland,1423,druid,balance,263,136,127
Phanÿ,garona,1423,druid,balance,74,37,37
Garthel,sylvanas,1423,druid,balance,105,51,54
Polypheme,chogall,1423,druid,balance,240,111,129
Irøñbârk,ravencrest,1423,druid,balance,48,22,26
Moonpoxdru,nerathor,1422,druid,balance,24,15,9
Nøny,gorgonnash,1422,druid,balance,86,45,41
Wildthirst,darkspear,1421,druid,balance,48,30,18
Megaball,sylvanas,1421,druid,balance,132,76,56
Paulskinbak,tarren-mill,1421,druid,balance,60,30,30
Còwgummi,blackhand,1421,druid,balance,30,15,15
Pleasédaddy,azjolnerub,1421,druid,balance,30,15,15
Ilovegrass,kazzak,1421,druid,balance,73,36,37
Petiteorange,archimonde,1420,druid,balance,24,16,8
Koffee,archimonde,1420,druid,balance,60,34,26
Малисеннта,gordunni,1420,druid,balance,42,21,21
Karolg,tyrande,1420,druid,balance,75,35,40
Катяблум,gordunni,1419,druid,balance,39,25,14
Zerofrenzy,hyjal,1419,druid,balance,324,157,167
Kanataka,stormscale,1418,druid,balance,54,32,22
Harrasmoes,ravencrest,1418,druid,balance,50,27,23
Широзоид,howling-fjord,1417,druid,balance,47,28,19
Kroaxs,draenor,1417,druid,balance,248,131,117
Cráck,nagrand,1417,druid,balance,58,30,28
Лардиан,gordunni,1417,druid,balance,30,15,15
Lyøñ,dun-modr,1417,druid,balance,35,16,19
Jabah,silvermoon,1416,druid,balance,36,28,8
Rullader,draenor,1416,druid,balance,102,62,40
Kúpfa,tichondrius,1416,druid,balance,126,68,58
Majokz,ravencrest,1416,druid,balance,152,71,81
Wasïro,zuljin,1416,druid,balance,66,30,36
Mooyagisan,blackhand,1415,druid,balance,65,35,30
Губкобоб,galakrond,1415,druid,balance,58,31,27
Surgeshift,ravencrest,1415,druid,balance,96,41,55
Mallahide,silvermoon,1414,druid,balance,36,23,13
Wartôn,blackhand,1414,druid,balance,136,79,57
Lollipopz,ravencrest,1414,druid,balance,58,29,29
Suedi,frostmane,1413,druid,balance,24,16,8
Gécko,malfurion,1413,druid,balance,34,22,12
Шубаиздуба,howling-fjord,1413,druid,balance,78,42,36
Primdâhl,ravencrest,1413,druid,balance,66,33,33
Quorn,pozzo-delleternità,1413,druid,balance,88,40,48
Liionheart,khaz-modan,1412,druid,balance,36,21,15
Chintawaz,archimonde,1412,druid,balance,35,18,17
Rønnie,ravencrest,1411,druid,balance,24,15,9
Мегасв,gordunni,1411,druid,balance,172,91,81
Artío,the-maelstrom,1411,druid,balance,193,101,92
Dao,aegwynn,1411,druid,balance,38,18,20
Forigiver,draenor,1410,druid,balance,30,19,11
Nyenna,twilights-hammer,1410,druid,balance,28,16,12
Tepni,ragnaros,1410,druid,balance,30,16,14
Альмазар,lich-king,1410,druid,balance,115,61,54
Кортанус,gordunni,1410,druid,balance,58,29,29
Moonscreamz,tarren-mill,1409,druid,balance,59,33,26
Akifumi,archimonde,1409,druid,balance,56,29,27
Billzabub,doomhammer,1409,druid,balance,66,31,35
Ахелез,gordunni,1409,druid,balance,42,17,25
Obois,archimonde,1408,druid,balance,29,16,13
Orchard,silvermoon,1407,druid,balance,94,58,36
Käisur,doomhammer,1407,druid,balance,71,41,30
Leliaen,sylvanas,1407,druid,balance,66,33,33
Опапенелопа,blackscar,1407,druid,balance,30,15,15
Dudmæster,blackmoore,1407,druid,balance,63,31,32
Motry,tarren-mill,1406,druid,balance,37,20,17
Zertyop,arathi,1406,druid,balance,70,37,33
Chispiwini,cthun,1406,druid,balance,121,61,60
Youdog,kazzak,1406,druid,balance,108,47,61
Malfurryon,drakthul,1405,druid,balance,48,32,16
Johnnybims,eredar,1405,druid,balance,24,15,9
Ziele,the-maelstrom,1405,druid,balance,70,36,34
Fantaclause,tarren-mill,1405,druid,balance,358,181,177
Fanboij,kazzak,1405,druid,balance,36,16,20
Yaniayip,blackrock,1404,druid,balance,357,190,167
Lørdfæke,kazzak,1404,druid,balance,59,30,29
Heav,kiljaeden,1403,druid,balance,53,33,20
Ziouk,archimonde,1403,druid,balance,36,21,15
Rbgbear,blackhand,1403,druid,balance,59,32,27
Requinymph,ravencrest,1403,druid,balance,96,47,49
Adelsten,tarren-mill,1403,druid,balance,57,26,31
Yourßâßygîrl,sylvanas,1402,druid,balance,66,39,27
Izzi,arathor,1402,druid,balance,98,53,45
Матумбо,razuvious,1402,druid,balance,647,323,324
Kkthanks,twisting-nether,1402,druid,balance,60,29,31
Murenito,nemesis,1402,druid,balance,130,56,74
Toondog,doomhammer,1401,druid,balance,37,21,16
Cîalîs,blackmoore,1401,druid,balance,41,21,20
Bestboomkin,dun-modr,1401,druid,balance,31,15,16
Животноеыы,howling-fjord,1401,druid,balance,59,27,32
Hëstía,outland,1400,druid,balance,29,19,10
Sephir,shattrath,1400,druid,balance,78,42,36
Âutumn,antonidas,1400,druid,balance,105,45,60
Çãm,magtheridon,1399,druid,balance,24,16,8
Xyiz,ravencrest,1399,druid,balance,80,42,38
Ilovedruid,forscherliga,1399,druid,balance,88,45,43
Møønhorn,nemesis,1398,druid,balance,272,139,133
Rexiehunty,aszune,1398,druid,balance,77,38,39
Azína,kazzak,1397,druid,balance,38,18,20
Ramgis,sanguino,1397,druid,balance,36,17,19
Gajani,stormscale,1395,druid,balance,41,20,21
Pelagius,ravencrest,1394,druid,balance,57,36,21
Кулунхе,soulflayer,1394,druid,balance,96,57,39
Astarhot,cthun,1394,druid,balance,40,22,18
Gullíver,draenor,1394,druid,balance,109,57,52
Hardruid,sanguino,1394,druid,balance,35,18,17
Freefang,dun-modr,1393,druid,balance,40,24,16
Makoes,tarren-mill,1393,druid,balance,32,18,14
Growhoof,kazzak,1393,druid,balance,66,34,32
When,kirin-tor,1393,druid,balance,111,57,54
Ïæzêrçhîçkén,sylvanas,1393,druid,balance,46,20,26
Æsc,cthun,1392,druid,balance,36,19,17
Кеорл,gordunni,1392,druid,balance,75,33,42
Lærken,the-maelstrom,1391,druid,balance,107,58,49
Sháko,dun-modr,1391,druid,balance,62,30,32
Irishdemón,ravencrest,1390,druid,balance,96,51,45
Kalàdin,ysondre,1390,druid,balance,56,23,33
Elonax,eredar,1389,druid,balance,67,39,28
Sløthy,uldum,1389,druid,balance,141,67,74
Hypam,archimonde,1388,druid,balance,66,30,36
Ismackü,stormscale,1387,druid,balance,65,43,22
Gatojuan,dun-modr,1387,druid,balance,30,15,15
Layle,argent-dawn,1387,druid,balance,128,58,70
Venh,forscherliga,1386,druid,balance,93,54,39
Enylasi,hyjal,1386,druid,balance,45,24,21
Catsgomeow,outland,1386,druid,balance,74,38,36
Tugnann,stormscale,1385,druid,balance,55,32,23
Postmaclone,thrall,1385,druid,balance,45,26,19
Старс,gordunni,1385,druid,balance,54,29,25
Hárty,tarren-mill,1384,druid,balance,86,47,39
Pipima,kazzak,1384,druid,balance,85,44,41
Druidskillz,pozzo-delleternità,1383,druid,balance,41,26,15
Wildthing,blackmoore,1383,druid,balance,116,63,53
Pôpcorn,ragnaros,1383,druid,balance,198,106,92
Myex,exodar,1383,druid,balance,61,32,29
Stealthslash,the-maelstrom,1383,druid,balance,86,40,46
Rayko,nemesis,1382,druid,balance,63,37,26
Zedapalha,aggra-português,1382,druid,balance,75,44,31
Stosstange,blackmoore,1382,druid,balance,41,22,19
Proxyy,blackrock,1382,druid,balance,46,22,24
Guthíx,silvermoon,1382,druid,balance,114,52,62
Drazefin,twisting-nether,1382,druid,balance,42,15,27
Mercmydude,ravencrest,1381,druid,balance,111,54,57
Angharradh,arthas,1380,druid,balance,36,18,18
Wîzzp,magtheridon,1380,druid,balance,32,16,16
Naone,silvermoon,1379,druid,balance,147,81,66
Wainl,hyjal,1379,druid,balance,54,28,26
Lucidx,blackrock,1379,druid,balance,120,56,64
Nightingalee,stormscale,1379,druid,balance,54,24,30
Laylie,aegwynn,1379,druid,balance,53,23,30
Srkameltouss,sanguino,1378,druid,balance,24,17,7
Herrencreme,eredar,1378,druid,balance,28,16,12
Uglydruid,drakthul,1378,druid,balance,244,130,114
Doruido,rashgarroth,1378,druid,balance,96,40,56
Pavesino,nemesis,1377,druid,balance,30,18,12
Merî,antonidas,1377,druid,balance,135,80,55
Данилсахарок,soulflayer,1376,druid,balance,47,20,27
Duhdudu,thrall,1375,druid,balance,77,47,30
Сэднхорни,howling-fjord,1375,druid,balance,66,32,34
Raxona,blackmoore,1374,druid,balance,36,20,16
Asklepiøs,blackmoore,1374,druid,balance,36,19,17
Rilak,nordrassil,1374,druid,balance,145,74,71
Schneelol,outland,1374,druid,balance,66,33,33
Superdupa,burning-blade,1374,druid,balance,36,18,18
Farmerone,tarren-mill,1373,druid,balance,102,57,45
Idk,blackhand,1373,druid,balance,74,38,36
Тёмныйзверь,borean-tundra,1373,druid,balance,84,43,41
Антошкез,howling-fjord,1373,druid,balance,72,33,39
Амахасла,deathweaver,1372,druid,balance,121,66,55
Qoællj,dragonmaw,1372,druid,balance,48,22,26
Jarko,ysondre,1372,druid,balance,104,46,58
Drujin,hellfire,1371,druid,balance,155,81,74
Hardí,tarren-mill,1371,druid,balance,120,62,58
Neova,dun-modr,1371,druid,balance,57,29,28
Alterejuv,ravencrest,1371,druid,balance,90,41,49
Pø,blackrock,1371,druid,balance,59,26,33
Cevto,drakthul,1370,druid,balance,66,34,32
Mayhh,ragnaros,1369,druid,balance,143,79,64
Grinnox,outland,1369,druid,balance,42,23,19
Patchlølx,blackmoore,1368,druid,balance,63,37,26
Vandalís,garrosh,1367,druid,balance,34,22,12
Wârden,twisting-nether,1367,druid,balance,113,60,53
Scranton,silvermoon,1367,druid,balance,42,20,22
Maurana,sylvanas,1367,druid,balance,48,21,27
Ghunm,ragnaros,1366,druid,balance,49,26,23
Rinjindin,eredar,1366,druid,balance,138,72,66
Iamramen,blackmoore,1366,druid,balance,245,124,121
Chrîslol,twisting-nether,1366,druid,balance,103,49,54
Elekträ,ravencrest,1366,druid,balance,81,36,45
Arreton,silvermoon,1365,druid,balance,22,15,7
Алендор,deathguard,1365,druid,balance,90,47,43
Convoke,burning-legion,1365,druid,balance,76,34,42
Fallingmoon,ravencrest,1364,druid,balance,48,27,21
Jeesman,sylvanas,1364,druid,balance,128,71,57
Kielorn,stormscale,1364,druid,balance,66,36,30
Kimba,onyxia,1364,druid,balance,227,119,108
Jobberwock,outland,1364,druid,balance,30,15,15
Jaile,burning-legion,1363,druid,balance,28,18,10
Heanra,frostmane,1363,druid,balance,35,22,13
Papacarlo,ravencrest,1363,druid,balance,32,19,13
Yungle,stormscale,1363,druid,balance,102,47,55
Darkillaa,anetheron,1362,druid,balance,83,44,39
Arenshimoon,kazzak,1362,druid,balance,104,55,49
Moujr,draenor,1362,druid,balance,88,46,42
Hoodahij,argent-dawn,1362,druid,balance,48,20,28
Téddý,tarren-mill,1361,druid,balance,73,35,38
Cowárd,blackmoore,1361,druid,balance,44,20,24
Daneyzx,stormscale,1360,druid,balance,33,19,14
Køßÿ,ysondre,1359,druid,balance,60,28,32
Pfíirsich,blackmoore,1359,druid,balance,56,25,31
Oomkin,darkspear,1358,druid,balance,28,15,13
Vulyr,outland,1358,druid,balance,190,98,92
Óok,outland,1358,druid,balance,45,22,23
Эвкалипт,soulflayer,1357,druid,balance,91,48,43
Ronî,arthas,1357,druid,balance,90,47,43
Catmøm,blackmoore,1357,druid,balance,94,47,47
Buikstuk,kilrogg,1356,druid,balance,57,38,19
Thepiemaker,silvermoon,1356,druid,balance,30,18,12
Variolus,dun-modr,1355,druid,balance,83,41,42
Nyetoo,dun-modr,1355,druid,balance,85,38,47
Peardraax,draenor,1354,druid,balance,44,19,25
Släshes,stormreaver,1353,druid,balance,36,22,14
Ennelle,silvermoon,1353,druid,balance,38,23,15
Xarxius,sanguino,1352,druid,balance,79,44,35
Endoth,blackrock,1352,druid,balance,38,20,18
Flippy,blackmoore,1352,druid,balance,336,170,166
Shìrò,kelthuzad,1352,druid,balance,96,48,48
Santoni,conseil-des-ombres,1351,druid,balance,30,17,13
Onemanzoo,drakthul,1350,druid,balance,114,60,54
Buhuu,blackmoore,1350,druid,balance,225,113,112
Ketama,sylvanas,1350,druid,balance,85,42,43
Батлграуннт,soulflayer,1350,druid,balance,76,30,46
Brujo,azjolnerub,1349,druid,balance,93,44,49
Convulsivez,silvermoon,1349,druid,balance,87,38,49
Doncaino,amanthul,1349,druid,balance,48,19,29
Bigpoppaz,tarren-mill,1345,druid,balance,72,34,38
Almrudi,blackrock,1345,druid,balance,86,38,48
Mongwau,blackrock,1344,druid,balance,48,31,17
Waymundo,blackhand,1344,druid,balance,36,16,20
Yshára,darkmoon-faire,1343,druid,balance,18,14,4
Broxisqt,blackrock,1343,druid,balance,24,14,10
Shiftmeow,tarren-mill,1343,druid,balance,24,14,10
Cubir,turalyon,1343,druid,balance,62,34,28
Bolskigg,stormreaver,1343,druid,balance,54,26,28
Piiti,burning-legion,1343,druid,balance,93,44,49
Wenciorek,kazzak,1343,druid,balance,36,17,19
Формен,howling-fjord,1343,druid,balance,30,14,16
Suppencaster,frostwolf,1342,druid,balance,18,14,4
Амераки,blackscar,1342,druid,balance,24,14,10
Shapees,sylvanas,1342,druid,balance,24,14,10
Achre,thunderhorn,1342,druid,balance,41,20,21
Superpoulet,archimonde,1341,druid,balance,30,14,16
Blackdrd,archimonde,1340,druid,balance,24,14,10
Tjann,darksorrow,1340,druid,balance,34,15,19
Santoniq,dun-morogh,1339,druid,balance,162,79,83
Nolak,frostwolf,1338,druid,balance,66,34,32
Claynoe,blackmoore,1337,druid,balance,27,15,12
Kheleñ,blackrock,1336,druid,balance,20,14,6
Sasosins,ravencrest,1336,druid,balance,24,14,10
Illebra,defias-brotherhood,1336,druid,balance,24,14,10
Ninns,draenor,1336,druid,balance,30,17,13
Ecolo,blackrock,1336,druid,balance,26,14,12
Tonie,stormscale,1336,druid,balance,71,34,37
Reeves,lightbringer,1336,druid,balance,42,19,23
Akâmè,blackrock,1336,druid,balance,51,23,28
Éxy,kazzak,1336,druid,balance,36,15,21
Veilath,tarren-mill,1335,druid,balance,30,15,15
Revølter,kazzak,1334,druid,balance,82,38,44
Rankøne,archimonde,1333,druid,balance,24,14,10
Jirenthegrey,antonidas,1333,druid,balance,44,25,19
Фортель,howling-fjord,1332,druid,balance,24,14,10
Мяурицао,howling-fjord,1332,druid,balance,129,74,55
Bærbell,blackrock,1332,druid,balance,48,26,22
Xérà,blackmoore,1332,druid,balance,32,16,16
Timxie,outland,1331,druid,balance,24,14,10
Icetep,sargeras,1331,druid,balance,82,39,43
Mytréx,sylvanas,1331,druid,balance,102,48,54
Laaide,blackmoore,1331,druid,balance,54,25,29
Soward,la-croisade-écarlate,1331,druid,balance,38,17,21
Рагнарианн,gordunni,1330,druid,balance,18,14,4
Barbielolz,archimonde,1330,druid,balance,24,14,10
Mirde,ravencrest,1330,druid,balance,24,14,10
Razorleaf,turalyon,1330,druid,balance,60,29,31
Nëko,chamber-of-aspects,1330,druid,balance,59,23,36
Transformerr,silvermoon,1329,druid,balance,66,32,34
Hansbørge,outland,1329,druid,balance,30,14,16
Lindémann,blackhand,1328,druid,balance,63,41,22
Kâo,frostwolf,1328,druid,balance,24,14,10
Mirikastiko,korgall,1328,druid,balance,24,14,10
Kunya,tarren-mill,1328,druid,balance,412,202,210
Farodiin,blackmoore,1328,druid,balance,69,32,37
Aik,gorgonnash,1328,druid,balance,102,46,56
Torlok,anetheron,1328,druid,balance,40,16,24
Ærîs,garona,1327,druid,balance,76,38,38
Drmz,dalaran,1327,druid,balance,58,27,31
Nerfàd,twisting-nether,1326,druid,balance,18,14,4
Zoozian,antonidas,1326,druid,balance,42,32,10
Bufflock,ravencrest,1326,druid,balance,24,14,10
Trol,malganis,1325,druid,balance,108,56,52
Doomkin,tichondrius,1325,druid,balance,64,33,31
Baracüda,draenor,1325,druid,balance,84,38,46
Coldleans,kazzak,1324,druid,balance,24,15,9
Tankis,dalaran,1324,druid,balance,137,81,56
Soneka,ravencrest,1324,druid,balance,54,30,24
Àkøs,ragnaros,1324,druid,balance,144,78,66
Kazzeria,stormscale,1324,druid,balance,42,21,21
Pewzzd,alexstrasza,1323,druid,balance,27,16,11
Fireinmyhole,hyjal,1323,druid,balance,24,14,10
Nymå,outland,1322,druid,balance,30,14,16
Druul,frostwolf,1322,druid,balance,30,14,16
Ephixa,burning-legion,1321,druid,balance,30,14,16
Коктявзер,deathweaver,1320,druid,balance,60,26,34
Fey,stormrage,1320,druid,balance,65,27,38
Bildukas,ravencrest,1320,druid,balance,40,15,25
Lîndex,sylvanas,1319,druid,balance,30,14,16
Keerook,blackmoore,1318,druid,balance,30,15,15
Ymúmu,sanguino,1318,druid,balance,42,19,23
Limmiited,ravencrest,1316,druid,balance,107,58,49
Neri,shattered-hand,1316,druid,balance,52,24,28
Binks,sylvanas,1315,druid,balance,18,14,4
Challi,nordrassil,1315,druid,balance,65,37,28
Diakamo,frostwolf,1315,druid,balance,36,20,16
Jokizy,burning-legion,1315,druid,balance,114,63,51
Bløødax,hyjal,1315,druid,balance,136,64,72
Schebäb,blackhand,1315,druid,balance,40,15,25
Zindaya,blades-edge,1314,druid,balance,38,20,18
Прит,gordunni,1314,druid,balance,66,29,37
Malyor,archimonde,1313,druid,balance,54,30,24
Antiseptik,ysondre,1313,druid,balance,98,48,50
Matzz,burning-legion,1313,druid,balance,30,14,16
Oxox,defias-brotherhood,1312,druid,balance,37,21,16
Aryitu,blackrock,1312,druid,balance,68,35,33
Bulma,dun-modr,1312,druid,balance,48,23,25
Nefariz,dun-modr,1312,druid,balance,86,38,48
Derrill,hellfire,1311,druid,balance,23,16,7
Jdogger,tarren-mill,1311,druid,balance,30,17,13
Астраджет,gordunni,1311,druid,balance,48,24,24
Madschinken,malganis,1310,druid,balance,73,42,31
Пачкачая,howling-fjord,1310,druid,balance,220,121,99
Albïnøs,arathi,1310,druid,balance,30,15,15
Cylàn,sylvanas,1310,druid,balance,48,22,26
Hideinbushh,ravencrest,1309,druid,balance,20,15,5
Midnightwisp,blackhand,1309,druid,balance,55,30,25
Omegah,bladefist,1309,druid,balance,36,17,19
Zzblaah,archimonde,1309,druid,balance,42,15,27
Putzé,blackrock,1308,druid,balance,41,20,21
Epidruid,stormrage,1307,druid,balance,49,25,24
Abbî,aegwynn,1306,druid,balance,78,52,26
Опаснокрасив,soulflayer,1305,druid,balance,72,42,30
Solarian,ravencrest,1304,druid,balance,42,26,16
Yööi,nemesis,1304,druid,balance,30,14,16
Bsp,khadgar,1303,druid,balance,30,14,16
Cénârion,les-sentinelles,1302,druid,balance,101,48,53
Исмалат,howling-fjord,1301,druid,balance,90,51,39
Drrestospec,tarren-mill,1300,druid,balance,114,66,48
Шадарлогот,gordunni,1300,druid,balance,90,52,38
Видди,soulflayer,1300,druid,balance,60,31,29
Sazo,elune,1300,druid,balance,28,14,14
Swolecat,ravencrest,1300,druid,balance,29,14,15
Чанголист,howling-fjord,1300,druid,balance,67,30,37
Shùrã,archimonde,1299,druid,balance,84,48,36
Мяф,soulflayer,1298,druid,balance,27,17,10
Кроулинг,gordunni,1298,druid,balance,54,29,25
Zeifana,khaz-modan,1297,druid,balance,30,18,12
Madroga,destromath,1297,druid,balance,24,14,10
Ковикхс,soulflayer,1297,druid,balance,74,37,37
Oiseth,tarren-mill,1297,druid,balance,78,36,42
Yolobolo,ragnaros,1295,druid,balance,23,14,9
Àlec,silvermoon,1295,druid,balance,196,105,91
Voorhess,blackmoore,1294,druid,balance,64,29,35
Melyo,blackmoore,1293,druid,balance,66,37,29
Tubi,darksorrow,1293,druid,balance,36,19,17
Druice,tyrande,1292,druid,balance,41,25,16
Dancingrain,ravencrest,1292,druid,balance,35,15,20
Tjeena,grim-batol,1292,druid,balance,55,22,33
Larbre,dalaran,1289,druid,balance,67,45,22
Réalmadruid,archimonde,1289,druid,balance,24,14,10
Roroa,ravencrest,1289,druid,balance,27,14,13
Sokay,doomhammer,1289,druid,balance,114,52,62
Juicý,eredar,1289,druid,balance,35,14,21
Whísperclaw,ravencrest,1288,druid,balance,161,83,78
Heinox,stormscale,1288,druid,balance,138,68,70
Совуф,ashenvale,1288,druid,balance,36,17,19
Irrifurr,the-maelstrom,1288,druid,balance,42,18,24
Forestrun,sylvanas,1287,druid,balance,48,30,18
Frenkiej,pozzo-delleternità,1287,druid,balance,74,41,33
Fhi,antonidas,1286,druid,balance,53,29,24
Ashär,kirin-tor,1286,druid,balance,128,65,63
Quiksx,blackrock,1286,druid,balance,43,20,23
Ralokian,drakthul,1285,druid,balance,53,34,19
Betol,das-konsortium,1285,druid,balance,38,21,17
Jpxoxoq,blackhand,1285,druid,balance,39,19,20
Terrays,the-maelstrom,1284,druid,balance,84,56,28
Ртз,eversong,1283,druid,balance,40,18,22
Scottparker,sylvanas,1282,druid,balance,36,24,12
Dudutrainer,blackmoore,1282,druid,balance,53,31,22
Wherismygold,ravencrest,1281,druid,balance,121,57,64
Илюшастарфол,gordunni,1281,druid,balance,36,16,20
Blark,sylvanas,1281,druid,balance,36,15,21
Tekal,vashj,1280,druid,balance,36,20,16
Velnens,shattered-halls,1280,druid,balance,124,61,63
Xapokin,twisting-nether,1279,druid,balance,22,14,8
Святогор,greymane,1279,druid,balance,36,14,22
Pàws,archimonde,1279,druid,balance,52,18,34
Füsselviech,frostwolf,1278,druid,balance,21,14,7
Medreas,argent-dawn,1278,druid,balance,95,59,36
Getsomefunny,archimonde,1276,druid,balance,54,30,24
Mascraxx,earthen-ring,1276,druid,balance,103,54,49
Droodfarm,hyjal,1276,druid,balance,88,46,42
Jucie,twisting-nether,1276,druid,balance,59,29,30
Dereas,anetheron,1275,druid,balance,30,19,11
Fiagard,antonidas,1275,druid,balance,77,48,29
Kirïllx,silvermoon,1275,druid,balance,33,19,14
Bigdx,blackrock,1275,druid,balance,200,98,102
Edi,twisting-nether,1275,druid,balance,30,14,16
Kittyboomy,burning-blade,1275,druid,balance,75,33,42
Youngjin,ravencrest,1274,druid,balance,36,21,15
Skywíng,stormscale,1274,druid,balance,77,31,46
Æîîs,blackrock,1273,druid,balance,163,82,81
Rektjin,stormscale,1273,druid,balance,42,17,25
Àsúnâ,eredar,1272,druid,balance,42,15,27
Eliar,burning-legion,1271,druid,balance,55,31,24
Linsight,sanguino,1271,druid,balance,66,35,31
Certton,arakarahm,1271,druid,balance,129,65,64
Crazywild,archimonde,1271,druid,balance,74,29,45
ßalmain,nethersturm,1270,druid,balance,88,49,39
Gejtu,the-venture-co,1270,druid,balance,43,19,24
Mûcke,kazzak,1269,druid,balance,35,16,19
Taylorshift,argent-dawn,1268,druid,balance,23,14,9
Balzàc,ravencrest,1268,druid,balance,88,48,40
Corpito,tarren-mill,1268,druid,balance,97,48,49
Trollsona,twisting-nether,1268,druid,balance,30,14,16
Vrillox,blackmoore,1268,druid,balance,33,15,18
Orious,dun-modr,1267,druid,balance,28,14,14
Maniek,defias-brotherhood,1267,druid,balance,42,19,23
Kommarübär,tirion,1266,druid,balance,48,20,28
Caltvalai,ravencrest,1265,druid,balance,28,14,14
Jenelin,silvermoon,1265,druid,balance,48,23,25
Semiflora,silvermoon,1264,druid,balance,70,33,37
Chugs,draenor,1263,druid,balance,52,27,25
Ххансолл,gordunni,1263,druid,balance,243,125,118
Карантини,howling-fjord,1263,druid,balance,63,31,32
Månljuset,outland,1262,druid,balance,39,24,15
Ваандри,gordunni,1262,druid,balance,36,22,14
Petju,darksorrow,1262,druid,balance,48,21,27
Atbõs,stormscale,1261,druid,balance,35,18,17
Hypnosoad,outland,1259,druid,balance,47,20,27
Hushorde,twisting-nether,1259,druid,balance,48,17,31
Kaspurr,ravencrest,1258,druid,balance,18,14,4
Altix,blackmoore,1258,druid,balance,97,52,45
Фераладзе,gordunni,1258,druid,balance,90,45,45
Croudo,ravencrest,1258,druid,balance,36,17,19
Zombrex,blackrock,1258,druid,balance,42,18,24
Bolinette,archimonde,1258,druid,balance,48,17,31
Shehida,silvermoon,1257,druid,balance,36,17,19
Bambøué,khaz-modan,1256,druid,balance,31,19,12
Ednaqt,grim-batol,1256,druid,balance,60,29,31
Raÿz,archimonde,1255,druid,balance,24,15,9
Mööñ,hyjal,1255,druid,balance,43,23,20
Нэйроуз,howling-fjord,1254,druid,balance,95,49,46
Mäo,sylvanas,1254,druid,balance,54,24,30
Vishin,kazzak,1253,druid,balance,137,77,60
Игрог,soulflayer,1252,druid,balance,71,34,37
Tassutan,stormreaver,1252,druid,balance,42,20,22
Tarantinonon,kazzak,1251,druid,balance,202,102,100
Naizoll,doomhammer,1250,druid,balance,42,25,17
Zuldram,uldaman,1249,druid,balance,29,14,15
Tygra,blackrock,1248,druid,balance,18,13,5
Adoodo,argent-dawn,1248,druid,balance,59,38,21
Hadoukan,ravencrest,1248,druid,balance,53,27,26
Tellurr,silvermoon,1247,druid,balance,18,13,5
Renewdex,thrall,1247,druid,balance,18,13,5
Raféekí,stormscale,1247,druid,balance,24,13,11
Bingbe,outland,1246,druid,balance,18,13,5
Mariss25076F,chogall,1246,druid,balance,30,18,12
Freedonnad,alleria,1246,druid,balance,29,17,12
Narai,shadowsong,1246,druid,balance,125,62,63
Жесткая,lich-king,1246,druid,balance,34,16,18
Beutow,archimonde,1246,druid,balance,30,13,17
Kazekengan,draenor,1246,druid,balance,42,18,24
Xkirtach,dun-modr,1245,druid,balance,24,13,11
Luchano,dun-modr,1245,druid,balance,24,13,11
Djràkèâlòt,ravencrest,1244,druid,balance,18,13,5
Bláithín,burning-legion,1244,druid,balance,66,36,30
Kermit,die-aldor,1244,druid,balance,168,77,91
Jubbs,laughing-skull,1244,druid,balance,30,13,17
Eranor,archimonde,1243,druid,balance,18,13,5
Ateli,kazzak,1243,druid,balance,21,14,7
Лякокля,soulflayer,1243,druid,balance,69,38,31
Ríviia,drakthul,1243,druid,balance,24,13,11
Smittly,bloodhoof,1243,druid,balance,36,17,19
Guccicken,garona,1242,druid,balance,18,13,5
Clonorrhea,tarren-mill,1242,druid,balance,24,13,11
Spoco,defias-brotherhood,1242,druid,balance,34,18,16
Aureliusx,drakthul,1242,druid,balance,54,24,30
Rengár,blackrock,1241,druid,balance,18,13,5
Lynnessa,ravencrest,1241,druid,balance,24,13,11
Dremdra,draenor,1241,druid,balance,72,34,38
Skidone,ravencrest,1240,druid,balance,24,13,11
Fossilfuel,ragnaros,1240,druid,balance,71,27,44
Roskajr,archimonde,1239,druid,balance,18,13,5
Nyrrh,blackmoore,1239,druid,balance,24,13,11
Shroomzd,blackmoore,1239,druid,balance,24,13,11
Fattsocow,stormscale,1239,druid,balance,70,34,36
Smilodon,blackrock,1239,druid,balance,30,13,17
Feraline,stormrage,1238,druid,balance,24,13,11
Sàyo,blackmoore,1238,druid,balance,30,14,16
Benzinoid,silvermoon,1237,druid,balance,24,14,10
Madnuzzmoo,draenor,1237,druid,balance,24,13,11
Prettyfunny,ravencrest,1236,druid,balance,18,13,5
Conn,ravencrest,1236,druid,balance,81,45,36
Zytherqt,thrall,1236,druid,balance,24,13,11
Leafsandstuf,ragnaros,1236,druid,balance,24,13,11
Evølvë,burning-blade,1236,druid,balance,30,13,17
Thyrena,argent-dawn,1236,druid,balance,86,37,49
Slyndjur,sylvanas,1235,druid,balance,24,13,11
Moosliman,kazzak,1235,druid,balance,24,13,11
Trollskee,draenor,1235,druid,balance,52,24,28
Jadraeth,tarren-mill,1234,druid,balance,18,13,5
Nefertiti,baelgun,1234,druid,balance,24,13,11
Sinmanos,eredar,1234,druid,balance,30,16,14
Doggerz,aggra-português,1234,druid,balance,102,52,50
Derie,nazjatar,1233,druid,balance,36,21,15
Fakeztwo,eredar,1233,druid,balance,29,14,15
Makelsi,tarren-mill,1233,druid,balance,29,14,15
Thruf,nemesis,1233,druid,balance,60,26,34
Lendron,malygos,1233,druid,balance,35,14,21
Amici,eredar,1232,druid,balance,24,13,11
Tytankon,silvermoon,1232,druid,balance,115,52,63
Друная,gordunni,1232,druid,balance,56,24,32
Irithel,ravencrest,1231,druid,balance,18,13,5
Redyogurt,outland,1231,druid,balance,36,13,23
Abadar,tarren-mill,1230,druid,balance,192,94,98
Sodniss,aggra-português,1230,druid,balance,84,41,43
Alarìy,ravencrest,1230,druid,balance,30,13,17
Kizilbuka,ragnaros,1229,druid,balance,79,49,30
Lynysae,blackmoore,1229,druid,balance,24,13,11
Мунмунмун,gordunni,1229,druid,balance,43,19,24
Drazigo,grim-batol,1228,druid,balance,39,18,21
Ckdruid,frostmane,1227,druid,balance,36,15,21
Pawsitive,sylvanas,1227,druid,balance,36,14,22
Ðoxi,draenor,1226,druid,balance,120,58,62
Atheros,outland,1226,druid,balance,36,17,19
Polimorphism,tarren-mill,1226,druid,balance,78,32,46
Zaratras,arathor,1225,druid,balance,24,13,11
Druidant,sanguino,1224,druid,balance,24,15,9
Freshener,antonidas,1224,druid,balance,62,38,24
Incont,nemesis,1224,druid,balance,262,142,120
Trydru,blackmoore,1223,druid,balance,102,50,52
Zeldaa,antonidas,1223,druid,balance,93,43,50
Werevolf,drakthul,1222,druid,balance,45,16,29
Kelbim,draenor,1221,druid,balance,24,13,11
Demizeub,archimonde,1221,druid,balance,297,142,155
Ritualofmoon,darkmoon-faire,1220,druid,balance,63,31,32
Астралъх,gordunni,1220,druid,balance,152,66,86
Necare,blackmoore,1219,druid,balance,29,18,11
Buzzlîghtyea,outland,1218,druid,balance,24,13,11
Mlyzioz,ahnqiraj,1216,druid,balance,78,46,32
Søfiaa,argent-dawn,1216,druid,balance,149,84,65
Holyconvoke,stormscale,1213,druid,balance,22,14,8
Lözbox,kazzak,1213,druid,balance,77,36,41
Putitimoriri,pozzo-delleternità,1212,druid,balance,140,76,64
Zac,quelthalas,1211,druid,balance,24,13,11
Laiquaril,ravencrest,1211,druid,balance,79,37,42
Druiddamage,the-maelstrom,1210,druid,balance,225,117,108
Biggzl,silvermoon,1208,druid,balance,180,95,85
Ellordann,ravencrest,1208,druid,balance,33,17,16
Kleinii,blackrock,1208,druid,balance,53,22,31
Bearhúg,kazzak,1208,druid,balance,47,17,30
Jevcoh,area-52,1207,druid,balance,18,13,5
Lowcr,ravencrest,1204,druid,balance,61,33,28
Silverriver,ragnaros,1204,druid,balance,36,16,20
Varladór,ravencrest,1203,druid,balance,36,21,15
Пушистаялапа,blackscar,1203,druid,balance,52,29,23
Tílac,eredar,1202,druid,balance,24,13,11
Hengst,laughing-skull,1202,druid,balance,28,15,13
Loum,blackrock,1201,druid,balance,42,18,24
Смизм,gordunni,1201,druid,balance,42,18,24
Croquetoro,sanguino,1200,druid,balance,28,13,15
Monopolying,dentarg,1199,druid,balance,110,58,52
Feraligator,sanguino,1197,druid,balance,249,122,127
Lucianis,drakthul,1197,druid,balance,54,20,34
Herten,tarren-mill,1196,druid,balance,24,15,9
Malammore,burning-legion,1195,druid,balance,77,49,28
Owltoy,frostmane,1195,druid,balance,27,15,12
Arntooth,burning-legion,1194,druid,balance,129,65,64
Trækvinden,ravencrest,1193,druid,balance,63,30,33
Teldrastion,silvermoon,1193,druid,balance,85,32,53
Sarkophag,blackrock,1193,druid,balance,36,13,23
Litany,drakthul,1192,druid,balance,35,16,19
Сейтил,deathguard,1191,druid,balance,97,45,52
Eralon,alleria,1191,druid,balance,40,14,26
Lothadriel,sylvanas,1190,druid,balance,113,62,51
Aÿä,elune,1189,druid,balance,34,14,20
Dêesse,archimonde,1188,druid,balance,42,20,22
Talressian,argent-dawn,1188,druid,balance,72,26,46
Gluqt,outland,1187,druid,balance,114,53,61
Дайтеполено,howling-fjord,1186,druid,balance,94,45,49
Boxosjohnny,ragnaros,1183,druid,balance,35,14,21
Blesya,ravencrest,1182,druid,balance,39,15,24
Chulainn,sylvanas,1181,druid,balance,24,18,6
Alyrion,stormscale,1179,druid,balance,53,20,33
Lyj,dalaran,1178,druid,balance,33,18,15
Deadmorph,ysondre,1178,druid,balance,27,14,13
Tgzy,ravencrest,1177,druid,balance,23,13,10
Split,rexxar,1177,druid,balance,41,22,19
Moder,nemesis,1177,druid,balance,45,24,21
Drúîid,kazzak,1176,druid,balance,17,13,4
Duveldruid,dragonblight,1176,druid,balance,24,17,7
Забурсчу,howling-fjord,1176,druid,balance,32,20,12
Котангис,eversong,1176,druid,balance,41,22,19
Tharae,blackmoore,1176,druid,balance,28,15,13
Budz,bloodfeather,1176,druid,balance,28,14,14
Drubro,ragnaros,1176,druid,balance,66,28,38
Bazikk,kazzak,1174,druid,balance,76,44,32
Eliaster,ysondre,1174,druid,balance,36,20,16
Edorush,nemesis,1174,druid,balance,63,30,33
Captaìncool,auchindoun,1173,druid,balance,119,67,52
Bäärbel,aegwynn,1173,druid,balance,30,13,17
Geizagobble,twisting-nether,1173,druid,balance,96,35,61
Попестовали,gordunni,1172,druid,balance,33,19,14
Trickpotato,terrordar,1172,druid,balance,42,24,18
Dobradoonga,exodar,1172,druid,balance,57,30,27
Starcat,defias-brotherhood,1172,druid,balance,26,13,13
Gardenstate,silvermoon,1171,druid,balance,66,37,29
Spacebéam,ravencrest,1171,druid,balance,36,13,23
Máilo,aegwynn,1170,druid,balance,190,89,101
Suranaelle,argent-dawn,1169,druid,balance,129,68,61
Wolfhealer,blackmoore,1168,druid,balance,60,32,28
Maelinou,archimonde,1168,druid,balance,36,19,17
Yunød,silvermoon,1168,druid,balance,136,56,80
Corkiri,tarren-mill,1167,druid,balance,17,13,4
Kotomer,defias-brotherhood,1167,druid,balance,255,121,134
Ohndankalan,kazzak,1167,druid,balance,167,76,91
Krausz,burning-legion,1166,druid,balance,70,42,28
Drdudu,dun-morogh,1166,druid,balance,61,30,31
Trollisha,mannoroth,1164,druid,balance,38,19,19
Radoo,thrall,1164,druid,balance,60,22,38
Dumbadum,blackmoore,1163,druid,balance,42,19,23
Киллиманжаро,howling-fjord,1162,druid,balance,248,118,130
Eýesburn,silvermoon,1160,druid,balance,76,26,50
Mçgonagall,quelthalas,1159,druid,balance,102,44,58
Вилдвестганс,howling-fjord,1158,druid,balance,42,24,18
Toxida,antonidas,1157,druid,balance,83,41,42
Haginator,twisting-nether,1157,druid,balance,102,48,54
Roxshifter,tarren-mill,1157,druid,balance,28,13,15
Cobradrood,culte-de-la-rive-noire,1157,druid,balance,48,21,27
Erasil,exodar,1157,druid,balance,43,15,28
Northstar,sylvanas,1156,druid,balance,18,13,5
Gnotten,thunderhorn,1154,druid,balance,23,13,10
Царапкатян,gordunni,1154,druid,balance,25,13,12
Camika,antonidas,1154,druid,balance,120,56,64
Morrisona,twisting-nether,1154,druid,balance,28,13,15
Leyarin,argent-dawn,1154,druid,balance,188,85,103
Slurmms,sylvanas,1153,druid,balance,174,96,78
Бигтедико,gordunni,1153,druid,balance,197,102,95
Querasidru,ravencrest,1153,druid,balance,46,17,29
Sopado,draenor,1152,druid,balance,12,12,0
Cryspie,garona,1152,druid,balance,18,12,6
Lêviàthäñ,blackhand,1152,druid,balance,24,12,12
Minado,outland,1151,druid,balance,12,12,0
Nätsügødxqt,archimonde,1151,druid,balance,18,12,6
Vraelyon,nemesis,1151,druid,balance,18,12,6
Vârima,ravencrest,1151,druid,balance,18,12,6
Bigfeeder,ravencrest,1151,druid,balance,20,12,8
Fotmrerollér,darksorrow,1151,druid,balance,50,29,21
Hisoca,tarren-mill,1151,druid,balance,123,63,60
Friidaf,lightbringer,1151,druid,balance,24,12,12
Whelpss,archimonde,1151,druid,balance,27,13,14
Tångfløde,emerald-dream,1150,druid,balance,18,12,6
Mememeow,ravencrest,1150,druid,balance,18,12,6
Därgon,archimonde,1150,druid,balance,24,12,12
Eldi,uldum,1150,druid,balance,24,12,12
Diosreypollo,cthun,1149,druid,balance,21,13,8
Sebikboomie,ravencrest,1148,druid,balance,18,12,6
Deblin,ragnaros,1148,druid,balance,41,23,18
Курумелька,gordunni,1148,druid,balance,24,12,12
Rêidon,antonidas,1147,druid,balance,18,12,6
Armënovitch,ravencrest,1147,druid,balance,24,12,12
Nvy,blackmoore,1147,druid,balance,29,13,16
Rabbalala,twisting-nether,1147,druid,balance,30,12,18
Закарпаття,galakrond,1146,druid,balance,27,20,7
Mnqn,ravencrest,1146,druid,balance,18,12,6
Merq,ravencrest,1146,druid,balance,18,12,6
Фэк,eversong,1146,druid,balance,22,13,9
Lyorn,stormscale,1145,druid,balance,24,12,12
Aestûs,outland,1145,druid,balance,24,12,12
Glumy,silvermoon,1145,druid,balance,54,22,32
Erbaiolo,pozzo-delleternità,1144,druid,balance,48,28,20
Флексим,soulflayer,1144,druid,balance,24,12,12
Mythiaran,argent-dawn,1144,druid,balance,30,12,18
Jengá,nagrand,1143,druid,balance,18,12,6
Klintxweed,hyjal,1143,druid,balance,18,12,6
Krizkat,blackmoore,1143,druid,balance,24,12,12
Criaø,blackrock,1143,druid,balance,24,12,12
Wtcseven,eredar,1143,druid,balance,44,20,24
Catzoro,tarren-mill,1142,druid,balance,24,12,12
Huayhey,the-maelstrom,1141,druid,balance,18,12,6
Mül,blackmoore,1141,druid,balance,24,12,12
Loriann,twisting-nether,1141,druid,balance,75,36,39
Avior,eonar,1141,druid,balance,65,21,44
Two,silvermoon,1140,druid,balance,103,58,45
Sabermoon,argent-dawn,1140,druid,balance,546,265,281
Cotangens,tarren-mill,1140,druid,balance,30,12,18
Discomånkung,stormscale,1139,druid,balance,18,12,6
Blueedood,twisting-nether,1139,druid,balance,24,12,12
Shiotake,hyjal,1139,druid,balance,24,12,12
Ajgreed,grim-batol,1139,druid,balance,24,12,12
Lootmann,die-silberne-hand,1138,druid,balance,62,35,27
Mirelawe,stormscale,1138,druid,balance,41,21,20
Zoxen,nefarian,1138,druid,balance,30,12,18
Bztémor,archimonde,1137,druid,balance,24,12,12
Pogoth,turalyon,1137,druid,balance,24,12,12
Kejî,blackrock,1135,druid,balance,54,19,35
Bägira,sylvanas,1132,druid,balance,18,12,6
Kizerx,garona,1131,druid,balance,60,33,27
Mangékyó,antonidas,1130,druid,balance,19,13,6
Lonedrood,blackrock,1130,druid,balance,24,12,12
Dramweida,eredar,1128,druid,balance,24,12,12
Eldorädo,ravencrest,1127,druid,balance,48,14,34
Sherse,ravencrest,1126,druid,balance,23,16,7
Rumjin,burning-blade,1125,druid,balance,24,12,12
Flagvan,ravencrest,1125,druid,balance,25,12,13
Shag,archimonde,1125,druid,balance,125,55,70
Tjoepert,azjolnerub,1123,druid,balance,126,55,71
Pretender,arathi,1123,druid,balance,40,13,27
Aliiass,drakthul,1121,druid,balance,42,24,18
Negríno,cthun,1118,druid,balance,139,75,64
Blackkray,frostwolf,1118,druid,balance,24,12,12
Forthejoe,stormscale,1118,druid,balance,35,12,23
Cirwen,silvermoon,1115,druid,balance,18,12,6
Serafol,argent-dawn,1115,druid,balance,78,31,47
Bubidiblumdr,twisting-nether,1114,druid,balance,28,13,15
Dôômkin,stormscale,1114,druid,balance,102,41,61
Enolcyc,frostmane,1113,druid,balance,42,12,30
Gôdzîllâ,silvermoon,1112,druid,balance,22,12,10
Codéine,krasus,1112,druid,balance,36,13,23
Morlas,kazzak,1111,druid,balance,50,22,28
Kyth,forscherliga,1110,druid,balance,51,28,23
Gallorath,draenor,1110,druid,balance,28,12,16
Бритаякиска,gordunni,1109,druid,balance,18,12,6
Sorath,aggramar,1109,druid,balance,66,28,38
Plev,chamber-of-aspects,1108,druid,balance,26,13,13
Ghostfurr,silvermoon,1107,druid,balance,36,12,24
Hightotem,hakkar,1104,druid,balance,29,16,13
Taskingoman,twisting-nether,1104,druid,balance,42,17,25
Mauzicek,drakthul,1104,druid,balance,30,12,18
Shandala,ragnaros,1103,druid,balance,17,12,5
Elrox,dunemaul,1103,druid,balance,61,31,30
Rungohar,stormscale,1103,druid,balance,64,26,38
Vangars,shadowsong,1102,druid,balance,102,45,57
Kakaiy,shadowsong,1100,druid,balance,250,131,119
Ðelnôs,destromath,1098,druid,balance,32,12,20
Exactt,blackrock,1098,druid,balance,55,20,35
Amalou,ravencrest,1095,druid,balance,127,64,63
Лидир,blackscar,1095,druid,balance,30,12,18
Вэдэшечка,howling-fjord,1094,druid,balance,59,29,30
Chirnaruk,ravencrest,1093,druid,balance,26,13,13
Fesenjon,blackhand,1093,druid,balance,32,14,18
Ruberg,kazzak,1091,druid,balance,21,12,9
Ambracer,silvermoon,1090,druid,balance,53,25,28
Bullmarkets,kazzak,1089,druid,balance,30,16,14
Athenã,blackmoore,1089,druid,balance,83,38,45
Nakkikastike,magtheridon,1089,druid,balance,82,35,47
Бруан,gordunni,1088,druid,balance,47,23,24
Mâéviss,ysondre,1088,druid,balance,78,29,49
Yaendra,dun-modr,1086,druid,balance,87,48,39
Kxk,blackmoore,1080,druid,balance,35,18,17
Ayven,kazzak,1080,druid,balance,60,26,34
Бсуза,soulflayer,1076,druid,balance,116,47,69
Lychorn,twisting-nether,1075,druid,balance,54,22,32
Idiomatic,stormreaver,1074,druid,balance,18,13,5
Ayanakamurà,archimonde,1074,druid,balance,26,12,14
Покекек,lich-king,1073,druid,balance,57,27,30
Bleati,silvermoon,1071,druid,balance,125,68,57
Seey,thrall,1069,druid,balance,30,13,17
Jibirisong,zuljin,1068,druid,balance,44,18,26
Colibrix,ravencrest,1066,druid,balance,87,36,51
Exiztenz,deathwing,1062,druid,balance,42,21,21
Vigôuróuz,blackmoore,1060,druid,balance,27,14,13
Ellüna,ravencrest,1060,druid,balance,30,14,16
Lazerftw,ravencrest,1056,druid,balance,12,11,1
Dyuuna,hyjal,1056,druid,balance,18,11,7
Stkk,sanguino,1055,druid,balance,12,11,1
Drmoe,blackmoore,1055,druid,balance,15,12,3
Positivity,stormscale,1055,druid,balance,18,11,7
Crittler,forscherliga,1055,druid,balance,18,11,7
Filderah,doomhammer,1055,druid,balance,18,11,7
Maedic,outland,1055,druid,balance,18,11,7
Jopidr,stormreaver,1055,druid,balance,18,11,7
Lunor,kazzak,1055,druid,balance,18,11,7
Ccoco,blackrock,1055,druid,balance,18,11,7
Buckmysallz,archimonde,1055,druid,balance,18,11,7
Nâganalf,hyjal,1055,druid,balance,24,11,13
Réhagen,archimonde,1055,druid,balance,24,11,13
Jac,blackhand,1054,druid,balance,18,11,7
Ðzahtiger,ysondre,1054,druid,balance,18,11,7
Yngboii,twisting-nether,1054,druid,balance,24,11,13
Ghostdoggie,stormscale,1053,druid,balance,18,11,7
Shizeem,malganis,1053,druid,balance,18,11,7
Lechaource,silvermoon,1053,druid,balance,18,11,7
Snyderen,draenor,1053,druid,balance,21,12,9
Shiftyshaft,tarren-mill,1053,druid,balance,24,11,13
Bignunu,silvermoon,1053,druid,balance,24,11,13
Нортикус,soulflayer,1053,druid,balance,24,11,13
Lunairos,archimonde,1053,druid,balance,135,58,77
Aolynk,twisting-nether,1052,druid,balance,18,11,7
Borkusdruid,antonidas,1052,druid,balance,22,12,10
Fofosdru,kazzak,1052,druid,balance,24,11,13
Tàak,hyjal,1052,druid,balance,50,19,31
Cudie,defias-brotherhood,1051,druid,balance,18,11,7
Lifecycle,nemesis,1051,druid,balance,24,11,13
Dèxò,blackmoore,1051,druid,balance,24,11,13
Nicolasdacry,das-syndikat,1050,druid,balance,36,24,12
Røådrunner,tarren-mill,1050,druid,balance,18,11,7
Bloomboom,aegwynn,1050,druid,balance,19,11,8
Gøtten,tarren-mill,1050,druid,balance,24,11,13
Aimwaré,ravencrest,1050,druid,balance,24,11,13
Kajidru,frostmane,1050,druid,balance,24,11,13
Hajukin,ravencrest,1050,druid,balance,24,11,13
Knatch,outland,1049,druid,balance,18,11,7
Wonderbear,blackrock,1049,druid,balance,18,11,7
Soguu,thrall,1049,druid,balance,18,11,7
Fontor,argent-dawn,1049,druid,balance,24,11,13
Wrathofstar,azjolnerub,1048,druid,balance,18,11,7
Skyphi,silvermoon,1048,druid,balance,18,11,7
Napukka,silvermoon,1048,druid,balance,18,11,7
Twandagreat,ravencrest,1048,druid,balance,18,11,7
Psychócat,silvermoon,1047,druid,balance,25,11,14
Nopsu,stormreaver,1047,druid,balance,30,11,19
Iløvechîcken,blackrock,1046,druid,balance,18,11,7
Hecone,los-errantes,1046,druid,balance,24,11,13
Dobitok,blackrock,1045,druid,balance,18,11,7
Shifturpants,defias-brotherhood,1045,druid,balance,18,11,7
Loubna,antonidas,1045,druid,balance,30,11,19
Rorugo,sanguino,1044,druid,balance,18,11,7
Haarbál,tarren-mill,1044,druid,balance,18,11,7
Darisom,alexstrasza,1039,druid,balance,284,148,136
Buckshee,doomhammer,1038,druid,balance,53,27,26
Bluebanana,bronzebeard,1036,druid,balance,94,40,54
Zendrand,sylvanas,1034,druid,balance,85,36,49
Sabresheep,twisting-nether,1034,druid,balance,30,11,19
Amils,twisting-nether,1032,druid,balance,41,14,27
Дайдорогу,blackscar,1031,druid,balance,24,11,13
Diepauline,aegwynn,1030,druid,balance,48,25,23
Elmunia,ravencrest,1030,druid,balance,65,31,34
Dagta,aggra-português,1028,druid,balance,18,11,7
Squirtt,ravencrest,1028,druid,balance,30,11,19
Vorag,dalaran,1027,druid,balance,101,41,60
Вёкс,howling-fjord,1023,druid,balance,14,12,2
Zenkay,naxxramas,1023,druid,balance,56,27,29
Hetalia,culte-de-la-rive-noire,1023,druid,balance,30,14,16
Hiroshimaa,boulderfist,1019,druid,balance,60,23,37
Fx,mazrigos,1018,druid,balance,17,11,6
Boszorka,silvermoon,1018,druid,balance,48,18,30
Sároman,ravencrest,1016,druid,balance,30,11,19
Nocataeth,destromath,1015,druid,balance,27,14,13
Doonttry,outland,1014,druid,balance,23,11,12
Bearhugzz,outland,1011,druid,balance,430,215,215
Happysw,thrall,1009,druid,balance,180,78,102
Mássacré,aegwynn,1007,druid,balance,18,11,7
Higuys,the-maelstrom,1004,druid,balance,17,11,6
Jobbostibi,ragnaros,1003,druid,balance,24,11,13
Kucsmagoomba,ragnaros,1000,druid,balance,214,104,110
Eyune,tarren-mill,991,druid,balance,56,23,33
Shífthappenz,grim-batol,991,druid,balance,42,11,31
Skvll,silvermoon,987,druid,balance,26,11,15
Drdauwg,nazjatar,985,druid,balance,69,27,42
Rockymarci,dalaran,983,druid,balance,30,19,11
Катафей,deathguard,981,druid,balance,60,33,27
Shainá,dun-modr,980,druid,balance,54,22,32
Bulvai,medivh,979,druid,balance,14,11,3
Lemónde,outland,975,druid,balance,88,36,52
Mondino,blackrock,972,druid,balance,48,14,34
Théodên,dalaran,969,druid,balance,218,106,112
Delorithalun,blackhand,966,druid,balance,43,24,19
Потерявшийся,howling-fjord,962,druid,balance,104,44,60
Brbrøyk,tarren-mill,960,druid,balance,12,10,2
Ïmåkêïtråïñ,ravencrest,960,druid,balance,12,10,2
Vizir,stormscale,960,druid,balance,12,10,2
Lovepower,nemesis,960,druid,balance,12,10,2
Djfukface,ravencrest,960,druid,balance,18,10,8
Applecake,defias-brotherhood,960,druid,balance,18,10,8
Locite,blackrock,960,druid,balance,18,10,8
Emidrem,ravencrest,960,druid,balance,24,10,14
Eroxx,blackrock,960,druid,balance,24,10,14
Ruhex,silvermoon,959,druid,balance,18,10,8
Tease,blackrock,959,druid,balance,18,10,8
Zarune,sanguino,959,druid,balance,18,10,8
Littlecok,blackmoore,959,druid,balance,18,10,8
Sün,kazzak,959,druid,balance,18,10,8
Simdruid,stormscale,959,druid,balance,18,10,8
Billsmafia,draenor,959,druid,balance,18,10,8
Focusboomy,archimonde,959,druid,balance,18,10,8
Eftermalm,silvermoon,959,druid,balance,18,10,8
Kissaey,emeriss,959,druid,balance,18,10,8
Mips,silvermoon,959,druid,balance,18,10,8
Häggrä,dalaran,959,druid,balance,18,10,8
Slâkkxz,kazzak,959,druid,balance,18,10,8
Qyoon,argent-dawn,959,druid,balance,18,10,8
Fistíebear,sylvanas,959,druid,balance,24,10,14
Димадубощит,blackscar,959,druid,balance,24,10,14
Thyrazs,blackmoore,958,druid,balance,12,10,2
Thepuma,dun-modr,958,druid,balance,12,10,2
Píssoff,stormscale,958,druid,balance,18,10,8
Sùmmèrz,ravencrest,958,druid,balance,18,10,8
Clone,aegwynn,958,druid,balance,18,10,8
Pèps,dalaran,958,druid,balance,18,10,8
Nelíno,twisting-nether,958,druid,balance,18,10,8
Lilniku,kazzak,958,druid,balance,18,10,8
Mojojojjo,sylvanas,958,druid,balance,18,10,8
Élán,sylvanas,958,druid,balance,24,10,14
Ibroninad,ragnaros,958,druid,balance,24,10,14
Elakpou,twisting-nether,957,druid,balance,18,10,8
Amrul,hyjal,957,druid,balance,18,10,8
Owlaf,magtheridon,957,druid,balance,18,10,8
Damilibi,eredar,957,druid,balance,18,10,8
Gbq,ravencrest,957,druid,balance,18,10,8
Kahar,eredar,957,druid,balance,18,10,8
Jokodo,silvermoon,956,druid,balance,18,10,8
Driu,exodar,956,druid,balance,18,10,8
Toritoso,sanguino,956,druid,balance,24,10,14
Supacat,archimonde,956,druid,balance,30,10,20
Prytek,turalyon,955,druid,balance,18,10,8
Sajlol,doomhammer,955,druid,balance,18,10,8
Feral,mazrigos,955,druid,balance,18,10,8
Moordock,uldum,955,druid,balance,24,10,14
Lyrvaz,ravencrest,955,druid,balance,24,10,14
Thornat,chamber-of-aspects,955,druid,balance,24,10,14
Assterix,sylvanas,954,druid,balance,15,10,5
Tschakadudu,kargath,954,druid,balance,30,10,20
Lazerkito,aegwynn,953,druid,balance,12,10,2
Greatpotato,blackhand,953,druid,balance,18,10,8
Димитрий,ashenvale,953,druid,balance,24,10,14
Menko,trollbane,952,druid,balance,12,10,2
Metamorfurio,arthas,952,druid,balance,82,39,43
Justycare,ragnaros,952,druid,balance,24,10,14
Yeahbuddeh,draenor,951,druid,balance,28,11,17
Calistane,silvermoon,950,druid,balance,89,35,54
Inspira,teldrassil,949,druid,balance,18,10,8
Helguard,silvermoon,949,druid,balance,24,10,14
Tombenuit,tarren-mill,948,druid,balance,24,11,13
Dxerm,colinas-pardas,948,druid,balance,34,10,24
Yepnesse,khaz-modan,946,druid,balance,18,10,8
Kûmo,blackmoore,946,druid,balance,18,10,8
Phanos,twisting-nether,945,druid,balance,24,10,14
Astralarius,argent-dawn,945,druid,balance,124,43,81
Cöyote,hyjal,944,druid,balance,90,47,43
Drude,archimonde,943,druid,balance,24,10,14
Ragingmilker,tarren-mill,941,druid,balance,17,12,5
Chlambak,archimonde,938,druid,balance,24,10,14
Resthunor,draenor,935,druid,balance,18,10,8
Neincat,sylvanas,935,druid,balance,23,10,13
Cholic,twisting-nether,934,druid,balance,71,22,49
Медведяра,howling-fjord,931,druid,balance,179,84,95
Çúç,ravencrest,930,druid,balance,24,10,14
Vendeqt,aegwynn,925,druid,balance,17,10,7
Rawberto,silvermoon,925,druid,balance,17,10,7
Sumbahe,blackrock,925,druid,balance,24,11,13
Puraza,kazzak,925,druid,balance,23,10,13
Papalegba,kilrogg,924,druid,balance,19,11,8
Bidodici,nemesis,920,druid,balance,48,24,24
Saxondale,aszune,918,druid,balance,30,14,16
Fakers,the-maelstrom,917,druid,balance,48,25,23
Суггуторр,howling-fjord,917,druid,balance,105,52,53
Dewis,stormscale,915,druid,balance,30,14,16
Katharo,kult-der-verdammten,912,druid,balance,114,47,67
Tarâkings,outland,911,druid,balance,30,13,17
Nogbraså,frostmane,908,druid,balance,17,10,7
Mafakaclones,archimonde,908,druid,balance,176,91,85
Krakus,twisting-nether,906,druid,balance,18,10,8
Burren,auchindoun,903,druid,balance,37,17,20
Древнина,gordunni,901,druid,balance,21,10,11
Dudukush,eredar,901,druid,balance,83,35,48
Meliissa,hyjal,900,druid,balance,20,11,9
Hilliax,sanguino,897,druid,balance,37,11,26
Flume,chromaggus,896,druid,balance,24,10,14
Durtidikdave,kazzak,895,druid,balance,23,10,13
Barrehealer,sylvanas,893,druid,balance,20,10,10
Anerol,arthas,893,druid,balance,77,34,43
Rønièl,tarren-mill,892,druid,balance,17,10,7
Etoillie,tarren-mill,891,druid,balance,22,10,12
Ribuu,dun-morogh,886,druid,balance,24,11,13
Arms,burning-legion,880,druid,balance,13,10,3
Aloraysoda,doomhammer,879,druid,balance,83,22,61
Smexim,dalaran,876,druid,balance,49,26,23
Aggibääm,blackhand,868,druid,balance,30,15,15
Momaa,neptulon,867,druid,balance,54,19,35
Ahk,outland,864,druid,balance,12,9,3
Ojiw,ragnaros,864,druid,balance,12,9,3
Nazferal,antonidas,864,druid,balance,12,9,3
Vezir,stormscale,864,druid,balance,12,9,3
Lðuv,archimonde,864,druid,balance,12,9,3
Xinthie,antonidas,864,druid,balance,12,9,3
Marynlord,dalaran,864,druid,balance,12,9,3
Daneaa,grim-batol,864,druid,balance,12,9,3
Mâlcøm,archimonde,864,druid,balance,12,9,3
Corkiy,tarren-mill,864,druid,balance,12,9,3
Flopparider,ravencrest,864,druid,balance,12,9,3
Chir,blackrock,864,druid,balance,12,9,3
Qwopeiqpwoid,kazzak,864,druid,balance,12,9,3
Clawlessqtx,outland,864,druid,balance,12,9,3
Sweqt,argent-dawn,864,druid,balance,18,9,9
Nstt,dun-modr,864,druid,balance,18,9,9
Lxstcentury,stormscale,864,druid,balance,18,9,9
Plinplinplon,kazzak,864,druid,balance,18,9,9
Éldudu,ragnaros,864,druid,balance,18,9,9
Окимоно,ashenvale,864,druid,balance,18,9,9
Yseraheal,drakthul,864,druid,balance,18,9,9
Cioban,ravencrest,864,druid,balance,24,9,15
Prÿce,stormscale,863,druid,balance,12,9,3
Hutros,outland,863,druid,balance,12,9,3
Borticow,sanguino,863,druid,balance,12,9,3
Lakersinfive,argent-dawn,863,druid,balance,12,9,3
Siimpa,tarren-mill,863,druid,balance,12,9,3
Pezuñera,sanguino,863,druid,balance,12,9,3
Prayx,dalaran,863,druid,balance,12,9,3
Sweedrood,hyjal,863,druid,balance,16,10,6
Sackzecke,eredar,863,druid,balance,18,9,9
Jesreyna,silvermoon,863,druid,balance,18,9,9
Forthis,frostmane,863,druid,balance,18,9,9
Aewendil,twilights-hammer,863,druid,balance,18,9,9
Deeizm,ravencrest,863,druid,balance,18,9,9
Shíróx,aegwynn,863,druid,balance,18,9,9
Jìkkz,aegwynn,863,druid,balance,18,9,9
Saralya,argent-dawn,863,druid,balance,18,9,9
Buckié,twisting-nether,863,druid,balance,18,9,9
Jæmmy,blackhand,863,druid,balance,18,9,9
Enzymex,burning-blade,863,druid,balance,18,9,9
Gamadruid,tarren-mill,863,druid,balance,18,9,9
Tchoubouléru,throkferoth,863,druid,balance,77,27,50
Ezc,ravencrest,862,druid,balance,12,9,3
Ábomínatíon,draenor,862,druid,balance,18,9,9
Rupali,darksorrow,862,druid,balance,18,9,9
Qocotte,archimonde,862,druid,balance,18,9,9
Metaboss,ravencrest,862,druid,balance,18,9,9
Jabbah,defias-brotherhood,862,druid,balance,18,9,9
Blietmachine,ravencrest,862,druid,balance,18,9,9
Schleckchips,ravencrest,862,druid,balance,18,9,9
Willhealer,outland,862,druid,balance,21,10,11
Astería,kazzak,862,druid,balance,24,9,15
Alenemor,frostmane,861,druid,balance,18,9,9
Saadxd,sanguino,861,druid,balance,18,9,9
Ferdiboo,draenor,861,druid,balance,18,9,9
Quza,lightbringer,861,druid,balance,18,9,9
Zephris,grim-batol,860,druid,balance,24,9,15
Whoaskedyou,twisting-nether,859,druid,balance,18,9,9
Hotmenow,antonidas,859,druid,balance,18,9,9
Viølin,silvermoon,859,druid,balance,24,9,15
Kânjin,stormscale,859,druid,balance,24,9,15
Corias,blackmoore,859,druid,balance,36,9,27
Summertearz,thrall,858,druid,balance,18,9,9
Wildmushroom,drakthul,858,druid,balance,18,9,9
Blazingmoon,twisting-nether,858,druid,balance,24,9,15
Мяокусь,gordunni,857,druid,balance,12,9,3
Rakhajan,twisting-nether,857,druid,balance,18,9,9
Sãmba,pozzo-delleternità,857,druid,balance,28,10,18
Zuldëk,sanguino,856,druid,balance,18,9,9
Shirokaze,argent-dawn,856,druid,balance,18,9,9
Аматэррасу,blackscar,856,druid,balance,24,9,15
Cheeselake,blackmoore,856,druid,balance,24,9,15
Rewus,burning-legion,856,druid,balance,30,9,21
Корбан,howling-fjord,856,druid,balance,36,9,27
Ghoonz,silvermoon,855,druid,balance,24,9,15
Moonkek,hyjal,854,druid,balance,18,9,9
Namelèés,blackhand,854,druid,balance,24,9,15
Centurios,burning-legion,852,druid,balance,108,35,73
Akîra,twisting-nether,848,druid,balance,27,10,17
Bráveukrainé,ravencrest,846,druid,balance,17,9,8
Hogey,kazzak,845,druid,balance,17,9,8
Buffalus,draenor,845,druid,balance,60,28,32
Lodne,defias-brotherhood,843,druid,balance,117,54,63
Spielmann,ravencrest,839,druid,balance,23,9,14
Bloodtank,die-ewige-wacht,836,druid,balance,45,14,31
Сомеваск,deathweaver,830,druid,balance,23,9,14
Eikthyrson,alleria,829,druid,balance,16,10,6
Keltaris,dun-modr,828,druid,balance,36,16,20
Unbeatâbull,kazzak,828,druid,balance,22,9,13
Pegatron,outland,823,druid,balance,91,31,60
Hecaloth,drakthul,816,druid,balance,20,10,10
Outofmyswamp,kazzak,815,druid,balance,14,10,4
Ishaqu,bladefist,815,druid,balance,23,9,14
Donvulcone,stormscale,814,druid,balance,17,9,8
Nuggetspøwa,dalaran,814,druid,balance,17,9,8
Darhours,archimonde,812,druid,balance,22,9,13
Nøboorst,ravencrest,805,druid,balance,21,11,10
Máximus,blades-edge,799,druid,balance,124,47,77
Solgarna,saurfang,798,druid,balance,28,9,19
Druidaldo,blackhand,794,druid,balance,42,18,24
Fréki,ravenholdt,791,druid,balance,20,9,11
Саншаса,booty-bay,780,druid,balance,25,9,16
Ðíør,ravencrest,768,druid,balance,12,8,4
Vìvi,ysondre,768,druid,balance,12,8,4
Everdreamx,arathor,768,druid,balance,12,8,4
Mirlawl,malganis,768,druid,balance,12,8,4
Earl,thrall,768,druid,balance,12,8,4
Alok,blackmoore,768,druid,balance,12,8,4
Луноэльф,gordunni,768,druid,balance,12,8,4
Maxiaz,tarren-mill,768,druid,balance,12,8,4
Telidari,argent-dawn,768,druid,balance,12,8,4
Клыкояр,goldrinn,768,druid,balance,12,8,4
Súçúkbøømíe,aegwynn,768,druid,balance,12,8,4
Tritit,marécage-de-zangar,768,druid,balance,12,8,4
Clonesy,outland,768,druid,balance,12,8,4
Dontlift,stormscale,768,druid,balance,12,8,4
Ormina,aegwynn,768,druid,balance,12,8,4
Luupy,draenor,768,druid,balance,12,8,4
Jimkungtwo,hyjal,768,druid,balance,12,8,4
Hecatos,hyjal,768,druid,balance,12,8,4
Jometatile,hyjal,768,druid,balance,12,8,4
Treeswinger,twisting-nether,768,druid,balance,12,8,4
Oblibark,dalaran,768,druid,balance,12,8,4
Meillaeth,sylvanas,768,druid,balance,12,8,4
Emochicken,silvermoon,768,druid,balance,15,9,6
Cursedmee,blackrock,768,druid,balance,15,9,6
Jp,eredar,768,druid,balance,18,8,10
Harrydòtter,eredar,768,druid,balance,18,8,10
Klêe,blackmoore,768,druid,balance,18,8,10
Crossfaction,blackrock,768,druid,balance,18,8,10
Póllen,magtheridon,768,druid,balance,18,8,10
Varokkâ,aegwynn,767,druid,balance,12,8,4
Ejaculinho,malganis,767,druid,balance,12,8,4
Hardcrits,kazzak,767,druid,balance,12,8,4
Filiduttkatt,ravencrest,767,druid,balance,12,8,4
Xtremeterror,blackmoore,767,druid,balance,12,8,4
Seasexsune,antonidas,767,druid,balance,12,8,4
Nivod,aggramar,767,druid,balance,12,8,4
Belgïanblue,silvermoon,767,druid,balance,12,8,4
Nervious,la-croisade-écarlate,767,druid,balance,18,8,10
Tomäkh,ysondre,767,druid,balance,18,8,10
Isotopîa,antonidas,767,druid,balance,18,8,10
Hugepepega,ravencrest,767,druid,balance,18,8,10
Хеельхеем,gordunni,767,druid,balance,18,8,10
Ilovehannah,laughing-skull,767,druid,balance,18,8,10
Csmedruid,blackrock,767,druid,balance,18,8,10
Буммбом,soulflayer,767,druid,balance,18,8,10
Xkora,cthun,767,druid,balance,18,8,10
Taeldryn,defias-brotherhood,767,druid,balance,18,8,10
Bigsmoké,die-aldor,767,druid,balance,18,8,10
Arydan,quelthalas,767,druid,balance,18,8,10
Milkmefast,magtheridon,767,druid,balance,18,8,10
Yezzízò,ravencrest,767,druid,balance,18,8,10
Nyooxix,blackmoore,767,druid,balance,18,8,10
Bananen,azshara,767,druid,balance,18,8,10
Bellatrx,darksorrow,767,druid,balance,18,8,10
Loswochos,blackmoore,767,druid,balance,18,8,10
Metamø,blackrock,767,druid,balance,18,8,10
Rêdx,archimonde,767,druid,balance,18,8,10
Sùmmêrz,outland,767,druid,balance,24,8,16
Âke,stormscale,766,druid,balance,12,8,4
Humanoidpt,aggra-português,766,druid,balance,12,8,4
Kheluna,the-maelstrom,766,druid,balance,18,8,10
Fuzzykitten,ravencrest,766,druid,balance,18,8,10
Эскоф,gordunni,766,druid,balance,18,8,10
Poonkin,ravencrest,766,druid,balance,24,8,16
Darthiud,outland,765,druid,balance,12,8,4
Narvaløø,hyjal,765,druid,balance,12,8,4
Zjukov,ragnaros,765,druid,balance,18,8,10
Machie,argent-dawn,765,druid,balance,18,8,10
Acwi,dun-morogh,765,druid,balance,18,8,10
Мехнакиске,howling-fjord,765,druid,balance,20,8,12
Droodu,dun-modr,765,druid,balance,30,8,22
Mongobongo,onyxia,764,druid,balance,12,8,4
Fiberpäls,magtheridon,764,druid,balance,18,8,10
Khàra,pozzo-delleternità,764,druid,balance,18,8,10
Zinnform,ragnaros,764,druid,balance,18,8,10
Skìzzy,stormscale,764,druid,balance,18,8,10
Dwaokut,ravencrest,763,druid,balance,12,8,4
Knindza,tarren-mill,763,druid,balance,18,8,10
Anchoring,argent-dawn,763,druid,balance,22,9,13
Mattdrood,kazzak,763,druid,balance,30,8,22
Tartáros,blackrock,762,druid,balance,12,8,4
Moonsama,twisting-nether,762,druid,balance,24,8,16
Gîgî,defias-brotherhood,760,druid,balance,12,8,4
Iproxy,dalaran,759,druid,balance,12,8,4
Celebras,chogall,756,druid,balance,12,8,4
Liegremmah,blackmoore,755,druid,balance,24,8,16
Yeezyhouzou,hyjal,735,druid,balance,11,8,3
Wuki,conseil-des-ombres,735,druid,balance,18,8,10
Vaea,hyjal,731,druid,balance,26,9,17
Ykköseen,frostmane,719,druid,balance,11,8,3
Kutjing,dun-modr,719,druid,balance,11,8,3
Schrims,gorgonnash,719,druid,balance,17,8,9
Maw,hellfire,717,druid,balance,11,8,3
Tsikarde,ravencrest,717,druid,balance,23,8,15
Humizon,silvermoon,714,druid,balance,21,9,12
Хуфра,greymane,714,druid,balance,23,8,15
Elpresidénté,blackmoore,713,druid,balance,12,9,3
Lockied,eredar,713,druid,balance,22,9,13
Lunably,silvermoon,705,druid,balance,18,9,9
Mynilia,blackhand,704,druid,balance,16,8,8
Fôxy,silvermoon,703,druid,balance,16,8,8
Kannzi,draenor,703,druid,balance,16,8,8
Ktn,sanguino,703,druid,balance,17,8,9
Delfin,aerie-peak,702,druid,balance,27,9,18
Bigbadcalf,burning-legion,696,druid,balance,20,8,12
Evenstar,cthun,692,druid,balance,65,20,45
Bönüs,cthun,690,druid,balance,15,8,7
Витясхватки,gordunni,686,druid,balance,17,9,8
Лесбес,fordragon,685,druid,balance,19,8,11
Rootbeamftw,ravencrest,672,druid,balance,12,7,5
Smølboi,ravencrest,672,druid,balance,12,7,5
Noobr,ravencrest,672,druid,balance,12,7,5
Kobbyx,outland,672,druid,balance,12,7,5
Tapex,ravencrest,672,druid,balance,12,7,5
Surlax,defias-brotherhood,672,druid,balance,12,7,5
Emeskay,ravencrest,672,druid,balance,12,7,5
Toy,ragnaros,672,druid,balance,12,7,5
Spatchy,silvermoon,672,druid,balance,12,7,5
Ra,stormscale,672,druid,balance,12,7,5
Kosadoodoo,sylvanas,672,druid,balance,12,7,5
Ryzën,stormscale,672,druid,balance,12,7,5
Actron,blackrock,672,druid,balance,12,7,5
Boomßitch,stormscale,672,druid,balance,12,7,5
Noggelicious,ragnaros,672,druid,balance,12,7,5
Epsona,dun-modr,672,druid,balance,12,7,5
Heartleon,silvermoon,672,druid,balance,12,7,5
Grunka,silvermoon,672,druid,balance,12,7,5
Тохи,howling-fjord,672,druid,balance,12,7,5
Allnatural,cthun,672,druid,balance,12,7,5
Hajlol,sylvanas,672,druid,balance,12,7,5
Travvis,draenor,672,druid,balance,12,7,5
Kimberon,tarren-mill,672,druid,balance,12,7,5
Mommymìlkers,archimonde,672,druid,balance,12,7,5
Akínos,tarren-mill,672,druid,balance,12,7,5
Lunua,thrall,672,druid,balance,12,7,5
Nyzeix,eredar,672,druid,balance,12,7,5
Delarion,nemesis,672,druid,balance,12,7,5
Överskåp,tarren-mill,672,druid,balance,12,7,5
Alysstan,burning-blade,672,druid,balance,12,7,5
Трусырвущая,gordunni,672,druid,balance,12,7,5
Тэддибиар,gordunni,672,druid,balance,12,7,5
Glúingél,tarren-mill,672,druid,balance,12,7,5
Lzo,silvermoon,672,druid,balance,12,7,5
Rallemaister,tarren-mill,672,druid,balance,12,7,5
Lacyn,tarren-mill,672,druid,balance,12,7,5
Røsétte,archimonde,672,druid,balance,12,7,5
Pansaa,stormscale,672,druid,balance,15,8,7
Aelins,twisting-nether,672,druid,balance,16,8,8
Zolduran,archimonde,672,druid,balance,18,7,11
Lèthal,arakarahm,672,druid,balance,18,7,11
Bóómi,outland,672,druid,balance,18,7,11
Væx,rexxar,672,druid,balance,18,7,11
Lilim,culte-de-la-rive-noire,672,druid,balance,18,7,11
Denleende,ravencrest,672,druid,balance,18,7,11
Ravenfang,dun-modr,672,druid,balance,18,7,11
Jrir,argent-dawn,672,druid,balance,18,7,11
Lifty,dun-modr,672,druid,balance,18,7,11
Miyá,sylvanas,672,druid,balance,24,7,17
Rikayn,tarren-mill,671,druid,balance,12,7,5
Najiq,ravencrest,671,druid,balance,12,7,5
Halfback,blackhand,671,druid,balance,12,7,5
Зонкс,gordunni,671,druid,balance,12,7,5
Dräparugglan,sylvanas,671,druid,balance,12,7,5
Найадра,gordunni,671,druid,balance,12,7,5
Myxo,aggra-português,671,druid,balance,12,7,5
Tigrius,defias-brotherhood,671,druid,balance,12,7,5
Elíonora,grim-batol,671,druid,balance,12,7,5
Tanulia,senjin,671,druid,balance,12,7,5
Asura,nozdormu,671,druid,balance,12,7,5
Alexuwu,draenor,671,druid,balance,12,7,5
Maruuk,argent-dawn,671,druid,balance,12,7,5
Faolagan,blackmoore,671,druid,balance,12,7,5
Sollek,sylvanas,671,druid,balance,12,7,5
Freve,sylvanas,671,druid,balance,12,7,5
Hulinka,the-maelstrom,671,druid,balance,15,8,7
Thunderzeus,mazrigos,671,druid,balance,18,7,11
Quin,frostwolf,671,druid,balance,18,7,11
Telära,argent-dawn,671,druid,balance,18,7,11
Legevakten,grim-batol,671,druid,balance,18,7,11
Kivu,blackrock,671,druid,balance,18,7,11
Wolflundgren,ravencrest,671,druid,balance,18,7,11
Fairyx,malfurion,671,druid,balance,18,7,11
Laoust,silvermoon,671,druid,balance,18,7,11
Essaraah,dalaran,671,druid,balance,18,7,11
Drudonja,silvermoon,671,druid,balance,18,7,11
Mvpx,outland,671,druid,balance,18,7,11
Tidevar,wildhammer,671,druid,balance,18,7,11
Forgo,drakthul,671,druid,balance,18,7,11
Picatso,blackrock,671,druid,balance,24,7,17
Psyquallia,hellscream,671,druid,balance,24,7,17
Barniine,sylvanas,670,druid,balance,10,8,2
Ìronsidé,ragnaros,670,druid,balance,18,7,11
Bíerling,antonidas,670,druid,balance,18,7,11
Klatu,doomhammer,670,druid,balance,24,7,17
Garadon,pozzo-delleternità,669,druid,balance,24,7,17
Garudas,eldrethalas,669,druid,balance,24,7,17
Thyanya,blackmoore,668,druid,balance,18,7,11
Thrynitie,les-sentinelles,663,druid,balance,12,7,5
Gróòt,kiljaeden,661,druid,balance,18,7,11
Nightshape,kragjin,661,druid,balance,18,7,11
Qra,area-52,660,druid,balance,12,7,5
Kawaíï,frostwolf,659,druid,balance,26,10,16
Ketash,ragnaros,657,druid,balance,12,7,5
Ciwone,blackrock,654,druid,balance,23,7,16
Yawawe,blackmoore,638,druid,balance,17,7,10
Blytz,ravencrest,638,druid,balance,17,7,10
Asterya,dun-modr,637,druid,balance,14,8,6
Goingfurglad,argent-dawn,623,druid,balance,14,9,5
Øwlïchæt,archimonde,623,druid,balance,15,7,8
Ipossible,kazzak,623,druid,balance,15,7,8
Maartjé,thunderhorn,623,druid,balance,16,7,9
Omijin,chogall,623,druid,balance,21,7,14
Astrøxx,hyjal,622,druid,balance,11,7,4
Nille,tarren-mill,617,druid,balance,14,8,6
Blazek,sylvanas,617,druid,balance,14,8,6
Kidawi,frostwolf,617,druid,balance,16,8,8
Vullija,sylvanas,616,druid,balance,33,8,25
Kamatea,eredar,607,druid,balance,11,7,4
Merisu,ravencrest,607,druid,balance,14,7,7
Avalòn,tarren-mill,607,druid,balance,14,7,7
Speedlebee,malganis,607,druid,balance,16,7,9
Extäzzi,archimonde,606,druid,balance,17,8,9
Músclébéach,silvermoon,605,druid,balance,22,7,15
Собачел,grom,591,druid,balance,13,7,6
Rtfz,ravencrest,591,druid,balance,13,7,6
Chúnnk,kilrogg,584,druid,balance,19,8,11
Qpoof,sylvanas,576,druid,balance,6,6,0
Náiledx,stormscale,576,druid,balance,6,6,0
Starsurge,festung-der-stürme,576,druid,balance,6,6,0
Epikmuhh,kazzak,576,druid,balance,6,6,0
Ealith,sylvanas,576,druid,balance,6,6,0
Skillfall,ravencrest,576,druid,balance,6,6,0
Kindadumb,stormscale,576,druid,balance,6,6,0
Psychopath,sylvanas,576,druid,balance,6,6,0
Flækket,tarren-mill,576,druid,balance,6,6,0
Têll,draenor,576,druid,balance,6,6,0
Mido,la-croisade-écarlate,576,druid,balance,6,6,0
Pròxy,hyjal,576,druid,balance,6,6,0
Kroghelf,tarren-mill,576,druid,balance,6,6,0
Ухухуня,gordunni,576,druid,balance,6,6,0
Shmurda,archimonde,576,druid,balance,6,6,0
Zamans,silvermoon,576,druid,balance,6,6,0
Ghøstavdruid,ravencrest,576,druid,balance,6,6,0
Infêrno,twisting-nether,576,druid,balance,6,6,0
Worali,burning-legion,576,druid,balance,6,6,0
Xirxy,silvermoon,576,druid,balance,6,6,0
Jamieform,ravencrest,576,druid,balance,6,6,0
Høtnrunbruh,archimonde,576,druid,balance,6,6,0
Náye,kazzak,576,druid,balance,6,6,0
Yenaiz,stormreaver,576,druid,balance,12,6,6
Слайкс,soulflayer,576,druid,balance,12,6,6
Catpatroll,burning-blade,576,druid,balance,12,6,6
Naturexbot,silvermoon,576,druid,balance,12,6,6
Shadowmeldgg,stormreaver,576,druid,balance,12,6,6
Seraxi,der-mithrilorden,576,druid,balance,12,6,6
Зулкхаку,soulflayer,576,druid,balance,12,6,6
Bane,dun-modr,576,druid,balance,12,6,6
Ына,gordunni,576,druid,balance,12,6,6
Bleedslolz,colinas-pardas,576,druid,balance,12,6,6
Ashamane,outland,576,druid,balance,12,6,6
Quasarx,ravencrest,576,druid,balance,12,6,6
Wrx,sylvanas,576,druid,balance,12,6,6
Drboomkin,frostmane,576,druid,balance,12,6,6
Yuln,twisting-nether,576,druid,balance,12,6,6
Druikraut,silvermoon,576,druid,balance,12,6,6
Hornyhots,sylvanas,576,druid,balance,12,6,6
Moowfasa,tarren-mill,576,druid,balance,12,6,6
Thornstar,sylvanas,576,druid,balance,12,6,6
Inbml,silvermoon,576,druid,balance,12,6,6
Weedgras,eredar,576,druid,balance,12,6,6
Maníx,tarren-mill,576,druid,balance,12,6,6
Pælter,draenor,576,druid,balance,12,6,6
Fèéli,twisting-nether,576,druid,balance,12,6,6
Quinten,ulduar,576,druid,balance,12,6,6
Nimalâ,antonidas,576,druid,balance,12,6,6
Kamenká,aegwynn,576,druid,balance,12,6,6
Мунпраид,gordunni,576,druid,balance,12,6,6
Совевген,soulflayer,576,druid,balance,12,6,6
Vedee,tarren-mill,576,druid,balance,12,6,6
Elyrias,silvermoon,576,druid,balance,12,6,6
Styxdr,blackhand,576,druid,balance,12,6,6
Shamelêss,stormscale,576,druid,balance,12,6,6
Yulivée,blackmoore,576,druid,balance,12,6,6
Ripthat,silvermoon,576,druid,balance,12,6,6
Teryx,blackmoore,576,druid,balance,12,6,6
Solaria,tichondrius,576,druid,balance,12,6,6
Jokist,zuljin,576,druid,balance,12,6,6
Baldhir,nemesis,576,druid,balance,12,6,6
Lyyâ,blackrock,576,druid,balance,12,6,6
Triplebogey,kazzak,576,druid,balance,12,6,6
Thefudge,silvermoon,576,druid,balance,12,6,6
Mentaldead,tarren-mill,576,druid,balance,12,6,6
Shoca,die-ewige-wacht,576,druid,balance,12,6,6
Daluria,malganis,576,druid,balance,12,6,6
Pataleaqtp,sanguino,576,druid,balance,12,6,6
Knozylg,kazzak,576,druid,balance,12,6,6
Islandbôy,blackrock,576,druid,balance,12,6,6
Juri,blackrock,576,druid,balance,12,6,6
Ghøstform,blackrock,576,druid,balance,12,6,6
Lokkrip,draenor,576,druid,balance,18,6,12
Murmétoile,chants-éternels,576,druid,balance,18,6,12
Axrae,ravencrest,576,druid,balance,18,6,12
Kalypsoo,dun-modr,576,druid,balance,18,6,12
Disney,ragnaros,576,druid,balance,18,6,12
Leslra,agamaggan,576,druid,balance,18,6,12
Robsondruid,twisting-nether,576,druid,balance,18,6,12
Kotkacy,silvermoon,576,druid,balance,18,6,12
Mugwa,blackmoore,575,druid,balance,6,6,0
Zàykz,dragonmaw,575,druid,balance,12,6,6
Stéely,ravencrest,575,druid,balance,12,6,6
Nonamà,nemesis,575,druid,balance,12,6,6
Bigmatty,defias-brotherhood,575,druid,balance,12,6,6
Лицеторг,howling-fjord,575,druid,balance,12,6,6
Syx,conseil-des-ombres,575,druid,balance,12,6,6
Dreäms,ravencrest,575,druid,balance,12,6,6
Oqud,draenor,575,druid,balance,12,6,6
Dinamitko,silvermoon,575,druid,balance,12,6,6
Xlife,silvermoon,575,druid,balance,12,6,6
Eshlana,twisting-nether,575,druid,balance,12,6,6
Gruvkatt,stormscale,575,druid,balance,12,6,6
Qdrood,quelthalas,575,druid,balance,12,6,6
Praythysun,khaz-modan,575,druid,balance,12,6,6
Graffyrre,eonar,575,druid,balance,13,6,7
Barkskin,grim-batol,575,druid,balance,15,6,9
Oxxy,arathor,575,druid,balance,18,6,12
Cosue,malganis,575,druid,balance,18,6,12
Дарзамат,blackscar,575,druid,balance,18,6,12
Feraflux,dragonblight,575,druid,balance,18,6,12
Robinchwän,archimonde,575,druid,balance,18,6,12
Stjärna,kult-der-verdammten,575,druid,balance,18,6,12
Aimïn,sanguino,575,druid,balance,18,6,12
Bunnyxo,outland,575,druid,balance,18,6,12
Wardruíd,outland,575,druid,balance,24,6,18
Penywiser,sylvanas,575,druid,balance,24,6,18
Ancón,silvermoon,575,druid,balance,24,6,18
Lúthiëñ,silvermoon,575,druid,balance,24,6,18
Nikitos,blackrock,575,druid,balance,26,6,20
Apodruid,tarren-mill,574,druid,balance,12,6,6
Raciness,grim-batol,574,druid,balance,12,6,6
Тиликум,goldrinn,574,druid,balance,12,6,6
Tyreek,eredar,574,druid,balance,16,7,9
Cegorach,xavius,574,druid,balance,18,6,12
Жекакотик,eversong,574,druid,balance,24,6,18
Satish,blackmoore,574,druid,balance,24,6,18
Agrodudu,draenor,573,druid,balance,18,6,12
Redberry,eonar,571,druid,balance,24,6,18
Starfalls,turalyon,570,druid,balance,12,6,6
Harryharrt,veknilash,570,druid,balance,18,6,12
Xkenz,archimonde,569,druid,balance,30,8,22
Rédbullz,silvermoon,569,druid,balance,24,6,18
Adonia,kul-tiras,543,druid,balance,14,7,7
Duwaz,blackmoore,543,druid,balance,14,7,7
Ancientix,burning-legion,543,druid,balance,17,6,11
Loceeva,kazzak,540,druid,balance,22,6,16
Saílormoon,nazjatar,528,druid,balance,9,6,3
Blamer,thrall,527,druid,balance,17,6,11
Sketit,grim-batol,527,druid,balance,17,6,11
Zyell,silvermoon,526,druid,balance,17,6,11
Shreddít,tarren-mill,522,druid,balance,27,7,20
Felfran,ravencrest,521,druid,balance,18,7,11
Halyconwings,outland,511,druid,balance,8,6,2
Kissa,blackrock,511,druid,balance,17,6,11
Ultimoos,aggra-português,510,druid,balance,14,6,8
Backroomcast,ravencrest,480,druid,balance,6,5,1
Kmzqt,tyrande,480,druid,balance,6,5,1
Torrixs,blackhand,480,druid,balance,6,5,1
Haxly,ravencrest,480,druid,balance,6,5,1
Staffios,argent-dawn,480,druid,balance,6,5,1
Ohmyboom,twisting-nether,480,druid,balance,6,5,1
Voodoomkinn,frostwhisper,480,druid,balance,6,5,1
Surfingbirdx,ragnaros,480,druid,balance,6,5,1
Murdok,suramar,480,druid,balance,6,5,1
Deepgreen,malganis,480,druid,balance,6,5,1
Änimâls,ysondre,480,druid,balance,6,5,1
Tåylor,laughing-skull,480,druid,balance,6,5,1
Напроломчег,soulflayer,480,druid,balance,6,5,1
Imhiswife,ravencrest,480,druid,balance,6,5,1
Xhifty,ravencrest,480,druid,balance,6,5,1
Smøkyyd,eredar,480,druid,balance,6,5,1
Barsikfjwm,ravencrest,480,druid,balance,6,5,1
Mutaattori,sylvanas,480,druid,balance,6,5,1
Kâgera,ysondre,480,druid,balance,6,5,1
Svartvit,sylvanas,480,druid,balance,6,5,1
Хлайси,gordunni,480,druid,balance,6,5,1
Bk,chamber-of-aspects,480,druid,balance,6,5,1
Skínchanger,draenor,480,druid,balance,6,5,1
Snupyjunior,silvermoon,480,druid,balance,6,5,1
Pevezengin,outland,480,druid,balance,6,5,1
Yalø,blackrock,480,druid,balance,6,5,1
Aurdudu,draenor,480,druid,balance,6,5,1
Pinkpanda,arthas,480,druid,balance,6,5,1
Mooncaki,hyjal,480,druid,balance,6,5,1
Whaazzform,tarren-mill,480,druid,balance,6,5,1
Roral,silvermoon,480,druid,balance,6,5,1
Destrøz,draenor,480,druid,balance,6,5,1
Snupy,outland,480,druid,balance,6,5,1
Jincksdru,anachronos,480,druid,balance,6,5,1
Cháep,kargath,480,druid,balance,6,5,1
Lastbest,draenor,480,druid,balance,6,5,1
Likh,das-konsortium,480,druid,balance,6,5,1
Cowieowie,draenor,480,druid,balance,6,5,1
Tellurr,draenor,480,druid,balance,6,5,1
Boomytunes,silvermoon,480,druid,balance,6,5,1
Öøöøöøöøöøöø,anachronos,480,druid,balance,9,6,3
Daisyx,eredar,480,druid,balance,9,6,3
Ischumekcid,anubarak,480,druid,balance,9,6,3
Karrygen,thrall,480,druid,balance,9,6,3
Zebår,runetotem,480,druid,balance,12,5,7
Heffko,thrall,480,druid,balance,12,5,7
Notdrood,tarren-mill,480,druid,balance,12,5,7
Nasdruu,twisting-nether,480,druid,balance,12,5,7
Theridrax,twisting-nether,480,druid,balance,12,5,7
Tomixdd,stormrage,480,druid,balance,12,5,7
Hussain,silvermoon,480,druid,balance,12,5,7
Balls,ravenholdt,480,druid,balance,12,5,7
Alunjá,chamber-of-aspects,480,druid,balance,12,5,7
Yadon,the-maelstrom,480,druid,balance,12,5,7
Quisp,ravencrest,480,druid,balance,12,5,7
Bafere,twisting-nether,480,druid,balance,12,5,7
Лолэтохег,soulflayer,480,druid,balance,12,5,7
Meowu,twisting-nether,480,druid,balance,12,5,7
Elrandir,tarren-mill,480,druid,balance,12,5,7
Mîraculix,dun-morogh,480,druid,balance,12,5,7
Mammaamu,twisting-nether,480,druid,balance,12,5,7
Feralfrenzy,twisting-nether,480,druid,balance,12,5,7
Dendru,ravencrest,480,druid,balance,12,5,7
Benghie,tarren-mill,480,druid,balance,12,5,7
Rayjin,bronzebeard,480,druid,balance,12,5,7
Hairydøtter,aegwynn,480,druid,balance,12,5,7
Faelwinter,blackhand,480,druid,balance,12,5,7
Vyzir,stormscale,480,druid,balance,12,5,7
Зандэр,blackscar,480,druid,balance,12,5,7
Ragnahr,sanguino,480,druid,balance,12,5,7
Zomgcow,twisting-nether,480,druid,balance,12,5,7
Norwy,kazzak,480,druid,balance,12,5,7
Pøwêr,blackrock,480,druid,balance,12,5,7
Violess,burning-legion,480,druid,balance,12,5,7
Naturina,shattered-hand,480,druid,balance,12,5,7
Assowl,dalaran,480,druid,balance,12,5,7
Doup,alakir,480,druid,balance,12,5,7
Muhlí,malygos,480,druid,balance,12,5,7
Samthael,antonidas,480,druid,balance,12,5,7
Agreus,frostwolf,480,druid,balance,12,5,7
Balanced,blackhand,480,druid,balance,12,5,7
Ysu,silvermoon,480,druid,balance,12,5,7
Baccon,ravencrest,480,druid,balance,12,5,7
Wotahn,antonidas,480,druid,balance,12,5,7
Liiandri,khaz-modan,480,druid,balance,12,5,7
Elayria,blackmoore,480,druid,balance,12,5,7
Goated,stormscale,480,druid,balance,12,5,7
Hardbasior,burning-legion,480,druid,balance,12,5,7
Shawkz,kazzak,480,druid,balance,12,5,7
Grîsh,burning-legion,480,druid,balance,12,5,7
Meowborghini,draenor,480,druid,balance,12,5,7
Bizzi,frostwolf,480,druid,balance,12,5,7
Flowpowder,stormscale,480,druid,balance,12,5,7
Brunogösta,aerie-peak,480,druid,balance,12,5,7
Angrykejton,silvermoon,480,druid,balance,12,5,7
Kovalawa,archimonde,480,druid,balance,12,5,7
Друмания,gordunni,480,druid,balance,12,5,7
Vodibull,aegwynn,480,druid,balance,15,6,9
Sendorac,die-silberne-hand,480,druid,balance,20,7,13
Nyankash,draenor,480,druid,balance,18,5,13
Друличч,blackscar,480,druid,balance,18,5,13
Kotakota,twisting-nether,480,druid,balance,18,5,13
Teog,stormreaver,480,druid,balance,18,5,13
Ilsar,burning-legion,480,druid,balance,18,5,13
Galadhor,nemesis,480,druid,balance,18,5,13
Segundø,archimonde,480,druid,balance,18,5,13
Barley,aegwynn,479,druid,balance,6,5,1
Tribemeister,twisting-nether,479,druid,balance,12,5,7
Willferal,ravenholdt,479,druid,balance,12,5,7
Larsia,nordrassil,479,druid,balance,12,5,7
Qflow,kazzak,479,druid,balance,12,5,7
Khàoticz,draenor,479,druid,balance,12,5,7
Biologie,onyxia,479,druid,balance,12,5,7
Leifbloomin,silvermoon,479,druid,balance,12,5,7
Flãre,antonidas,479,druid,balance,12,5,7
Asanaria,ravencrest,479,druid,balance,18,5,13
Wíllférál,twisting-nether,479,druid,balance,18,5,13
Тахикамару,blackscar,479,druid,balance,18,5,13
Zube,ravencrest,479,druid,balance,18,5,13
Любимоетвое,gordunni,479,druid,balance,24,5,19
Lysende,arathor,478,druid,balance,12,5,7
Druza,draenor,478,druid,balance,12,5,7
Чепенкос,gordunni,478,druid,balance,12,5,7
Барли,grom,478,druid,balance,16,6,10
Kahunasgalor,chamber-of-aspects,478,druid,balance,18,5,13
Druvian,argent-dawn,478,druid,balance,24,5,19
Bøa,twisting-nether,477,druid,balance,12,5,7
Натурка,razuvious,476,druid,balance,12,5,7
Stanjr,archimonde,476,druid,balance,18,5,13
Spellmáster,ravencrest,473,druid,balance,12,5,7
Kocovali,frostmane,468,druid,balance,18,5,13
Drix,frostwolf,463,druid,balance,17,5,12
Chouan,marécage-de-zangar,457,druid,balance,21,7,14
Gurranq,argent-dawn,448,druid,balance,15,7,8
Gatouss,eldrethalas,446,druid,balance,8,6,2
Snec,draenor,431,druid,balance,11,5,6
Rakúsh,thrall,431,druid,balance,15,5,10
Boomlex,defias-brotherhood,426,druid,balance,18,6,12
Hkguy,kazzak,425,druid,balance,18,6,12
Kimiza,hyjal,425,druid,balance,26,6,20
Foxîo,frostmane,415,druid,balance,8,5,3
Narmn,dalaran,415,druid,balance,10,5,5
Cuser,dun-modr,415,druid,balance,14,5,9
Thaiboimbyy,veknilash,408,druid,balance,33,11,22
Irent,argent-dawn,384,druid,balance,6,4,2
Noodledru,tarren-mill,384,druid,balance,6,4,2
Lsdpinkcandy,twisting-nether,384,druid,balance,6,4,2
Stoptheclone,nordrassil,384,druid,balance,6,4,2
Stkk,dun-modr,384,druid,balance,6,4,2
Revivication,aggramar,384,druid,balance,6,4,2
Kattbjörnen,ragnaros,384,druid,balance,6,4,2
Mylanqx,ragnaros,384,druid,balance,6,4,2
Isokukko,stormreaver,384,druid,balance,6,4,2
Bleepl,archimonde,384,druid,balance,6,4,2
Doggydawg,tarren-mill,384,druid,balance,6,4,2
Hyoyoe,stormreaver,384,druid,balance,6,4,2
Sic,quelthalas,384,druid,balance,6,4,2
Bølzki,twisting-nether,384,druid,balance,6,4,2
Эйонар,howling-fjord,384,druid,balance,6,4,2
Badbird,thunderhorn,384,druid,balance,6,4,2
Dolensdudu,argent-dawn,384,druid,balance,6,4,2
Favorable,ysondre,384,druid,balance,6,4,2
Blackhood,ysondre,384,druid,balance,6,4,2
Nevthren,aggra-português,384,druid,balance,6,4,2
Северия,grom,384,druid,balance,6,4,2
Grailer,tarren-mill,384,druid,balance,6,4,2
Supremedruid,twisting-nether,384,druid,balance,6,4,2
Кристтл,howling-fjord,384,druid,balance,6,4,2
Jwifgodx,archimonde,384,druid,balance,6,4,2
Amellian,silvermoon,384,druid,balance,6,4,2
Vèlkan,pozzo-delleternità,384,druid,balance,6,4,2
Vertabrain,twilights-hammer,384,druid,balance,6,4,2
Hîvê,argent-dawn,384,druid,balance,6,4,2
Lolodaad,tarren-mill,384,druid,balance,6,4,2
Kupalinka,nemesis,384,druid,balance,6,4,2
Didgeridru,silvermoon,384,druid,balance,6,4,2
Paatz,aegwynn,384,druid,balance,6,4,2
Tacodudu,ravencrest,384,druid,balance,6,4,2
Ieatbooty,blackrock,384,druid,balance,6,4,2
Zyzk,outland,384,druid,balance,6,4,2
Starqest,blackhand,384,druid,balance,6,4,2
Womzas,blackhand,384,druid,balance,6,4,2
Nyxó,ravencrest,384,druid,balance,6,4,2
Weremyst,outland,384,druid,balance,6,4,2
Imalama,ravencrest,384,druid,balance,6,4,2
Çÿçløñëz,aegwynn,384,druid,balance,6,4,2
Anorixx,outland,384,druid,balance,6,4,2
Esøterix,malganis,384,druid,balance,6,4,2
Dermegon,outland,384,druid,balance,6,4,2
Mêõwmëówxð,hyjal,384,druid,balance,6,4,2
Petypeet,drakthul,384,druid,balance,6,4,2
Kkriss,stormscale,384,druid,balance,6,4,2
Bigbitez,kazzak,384,druid,balance,6,4,2
Delqoo,stormscale,384,druid,balance,6,4,2
Cornowlius,defias-brotherhood,384,druid,balance,6,4,2
Организмхд,soulflayer,384,druid,balance,6,4,2
Ponardo,outland,384,druid,balance,6,4,2
Freshpussyz,ravencrest,384,druid,balance,6,4,2
Izzyb,draenor,384,druid,balance,6,4,2
Wheretowrite,ravencrest,384,druid,balance,6,4,2
Kvalitet,outland,384,druid,balance,6,4,2
Rugsul,kazzak,384,druid,balance,6,4,2
Arkarya,blackmoore,384,druid,balance,6,4,2
Oloreformed,ravencrest,384,druid,balance,6,4,2
Lolaven,turalyon,384,druid,balance,6,4,2
Høt,draenor,384,druid,balance,6,4,2
Cmzdruidxdd,ravencrest,384,druid,balance,6,4,2
Adonbilivit,blackrock,384,druid,balance,6,4,2
Yòò,outland,384,druid,balance,6,4,2
Skavenlol,zuljin,384,druid,balance,6,4,2
Blastakhan,arathor,384,druid,balance,6,4,2
Câlïñøù,hyjal,384,druid,balance,6,4,2
Wílmágødx,ravencrest,384,druid,balance,6,4,2
Xvmon,draenor,384,druid,balance,6,4,2
Андердру,soulflayer,384,druid,balance,6,4,2
Luckidruid,malganis,384,druid,balance,6,4,2
Razorboris,outland,384,druid,balance,6,4,2
Fzx,aegwynn,384,druid,balance,6,4,2
Zootxd,ravencrest,384,druid,balance,6,4,2
Ekologiskxx,outland,384,druid,balance,6,4,2
Warxíz,ravencrest,384,druid,balance,6,4,2
Youngdipper,draenor,384,druid,balance,6,4,2
Ljóskann,kazzak,384,druid,balance,6,4,2
Sunisan,stormscale,384,druid,balance,6,4,2
Cpt,xavius,384,druid,balance,6,4,2
Kefaheden,kazzak,384,druid,balance,6,4,2
Sapheà,burning-legion,384,druid,balance,6,4,2
Fordragos,ravencrest,384,druid,balance,6,4,2
Trèes,outland,384,druid,balance,6,4,2
Dekuul,stormscale,384,druid,balance,6,4,2
Фамай,howling-fjord,384,druid,balance,8,4,4
Viktornado,sylvanas,384,druid,balance,8,4,4
Gonco,blackrock,384,druid,balance,8,4,4
Nehalem,blackrock,384,druid,balance,12,4,8
Manimalia,kazzak,384,druid,balance,12,4,8
Athai,conseil-des-ombres,384,druid,balance,12,4,8
Ppr,stormscale,384,druid,balance,12,4,8
Kiggstar,blackmoore,384,druid,balance,12,4,8
Konvoke,ravencrest,384,druid,balance,12,4,8
Druidytrudy,blackrock,384,druid,balance,12,4,8
Funka,uldum,384,druid,balance,12,4,8
Chugs,blackmoore,384,druid,balance,12,4,8
Galadrys,defias-brotherhood,384,druid,balance,12,4,8
Drujoty,cthun,384,druid,balance,12,4,8
Kasugia,aegwynn,384,druid,balance,12,4,8
Мукару,howling-fjord,384,druid,balance,12,4,8
Rettoo,shadowsong,384,druid,balance,12,4,8
Menance,draenor,384,druid,balance,12,4,8
Drodiax,outland,384,druid,balance,12,4,8
Феразинария,gordunni,384,druid,balance,12,4,8
Pengington,blackrock,384,druid,balance,12,4,8
Ghastxd,aggra-português,384,druid,balance,12,4,8
Spenkdetank,grim-batol,384,druid,balance,12,4,8
Alanpapi,sanguino,384,druid,balance,12,4,8
Sixtyinches,burning-blade,384,druid,balance,12,4,8
Hipnos,sanguino,384,druid,balance,12,4,8
Zitom,kazzak,384,druid,balance,12,4,8
Sâty,draenor,384,druid,balance,12,4,8
Delaghetto,kilrogg,384,druid,balance,12,4,8
Tønychopper,sanguino,384,druid,balance,12,4,8
Kooglaash,kazzak,384,druid,balance,12,4,8
Nighttsorrow,drakthul,384,druid,balance,12,4,8
Xavîos,eredar,384,druid,balance,12,4,8
Tiroxytxz,agamaggan,384,druid,balance,12,4,8
Hypdsbrazz,aegwynn,384,druid,balance,12,4,8
Lorucka,die-nachtwache,384,druid,balance,12,4,8
Allîyâ,archimonde,384,druid,balance,12,4,8
Astracat,korgall,384,druid,balance,12,4,8
Pangurban,alakir,384,druid,balance,12,4,8
Auden,arathor,384,druid,balance,12,4,8
Tvert,dalaran,384,druid,balance,12,4,8
Gymii,blackmoore,384,druid,balance,12,4,8
Zerebrô,mannoroth,384,druid,balance,12,4,8
Dortalon,outland,384,druid,balance,12,4,8
Moonkin,sylvanas,384,druid,balance,12,4,8
Laguna,ravencrest,384,druid,balance,12,4,8
Nelfboyuk,tarren-mill,384,druid,balance,12,4,8
Biebear,sylvanas,384,druid,balance,12,4,8
Yee,twisting-nether,384,druid,balance,12,4,8
Elainx,thrall,384,druid,balance,12,4,8
Faintntt,outland,384,druid,balance,12,4,8
Vard,burning-legion,384,druid,balance,12,4,8
Zerwurster,kazzak,384,druid,balance,12,4,8
Lizziath,ravencrest,384,druid,balance,12,4,8
Çât,kazzak,384,druid,balance,12,4,8
Dimki,kazzak,384,druid,balance,12,4,8
Rastamona,draenor,384,druid,balance,12,4,8
Pathetik,archimonde,384,druid,balance,12,4,8
Kasiopee,hyjal,384,druid,balance,12,4,8
Alillaeth,ravencrest,384,druid,balance,12,4,8
Ralenia,ravencrest,384,druid,balance,12,4,8
Stelthee,silvermoon,384,druid,balance,12,4,8
Foqua,twisting-nether,384,druid,balance,12,4,8
Shalaska,draenor,384,druid,balance,14,4,10
Ênfaktüs,silvermoon,384,druid,balance,14,4,10
Lycîrpar,archimonde,384,druid,balance,16,4,12
Gwendalyr,silvermoon,384,druid,balance,18,4,14
Caatty,silvermoon,384,druid,balance,18,4,14
Lelyssa,burning-legion,384,druid,balance,18,4,14
Leekroom,forscherliga,384,druid,balance,24,4,20
Храмульчик,blackscar,383,druid,balance,6,4,2
Elm,trollbane,383,druid,balance,6,4,2
Fluke,thrall,383,druid,balance,11,4,7
Blablábla,silvermoon,383,druid,balance,12,4,8
Ferlinas,the-maelstrom,383,druid,balance,12,4,8
Limbocheck,tarren-mill,383,druid,balance,12,4,8
Ondope,blackmoore,383,druid,balance,12,4,8
Zedmok,archimonde,383,druid,balance,12,4,8
Rústy,baelgun,383,druid,balance,12,4,8
Moonpouk,archimonde,383,druid,balance,12,4,8
Benduu,doomhammer,383,druid,balance,17,4,13
Brusinho,tyrande,383,druid,balance,18,4,14
Wickser,archimonde,383,druid,balance,18,4,14
Barnea,malfurion,383,druid,balance,18,4,14
Azazumi,silvermoon,383,druid,balance,18,4,14
Xenoovia,silvermoon,383,druid,balance,24,4,20
Manglefury,ravencrest,382,druid,balance,12,4,8
Puuhalí,stormreaver,380,druid,balance,12,4,8
Billybobb,dentarg,377,druid,balance,19,8,11
Ráw,dun-modr,367,druid,balance,11,4,7
Submeplz,archimonde,352,druid,balance,10,4,6
Blakemonster,khaz-modan,351,druid,balance,8,5,3
Zrp,kazzak,351,druid,balance,11,4,7
Zybri,ragnaros,351,druid,balance,11,4,7
Oaeb,stormscale,351,druid,balance,11,4,7
Nightshaðe,argent-dawn,351,druid,balance,11,4,7
Soný,aegwynn,336,druid,balance,9,5,4
Âvane,blackmoore,336,druid,balance,9,4,5
Sjikz,garrosh,336,druid,balance,9,4,5
Азраешль,gordunni,330,druid,balance,10,6,4
Dresten,burning-blade,330,druid,balance,13,5,8
Adhdqt,silvermoon,330,druid,balance,13,5,8
Ueihtam,archimonde,330,druid,balance,17,6,11
Tarîx,aegwynn,330,druid,balance,15,5,10
Andra,alleria,320,druid,balance,10,4,6
Eclipße,silvermoon,319,druid,balance,5,4,1
Blinkmorph,frostmane,319,druid,balance,8,4,4
Shapeshifts,kul-tiras,319,druid,balance,8,4,4
Olula,blackmoore,319,druid,balance,8,4,4
Alligatordru,kazzak,319,druid,balance,20,4,16
Lorèen,argent-dawn,304,druid,balance,7,4,3
Neldoran,outland,304,druid,balance,7,4,3
Casir,burning-legion,304,druid,balance,7,4,3
Tyldormeow,tarren-mill,288,druid,balance,6,3,3
Zagrem,antonidas,288,druid,balance,6,3,3
Pandøøræ,archimonde,288,druid,balance,6,3,3
Duchaliot,nemesis,288,druid,balance,6,3,3
Okboomi,hyjal,288,druid,balance,6,3,3
Barbulloup,hyjal,288,druid,balance,6,3,3
Skailzdruid,hyjal,288,druid,balance,6,3,3
Gourdingodx,archimonde,288,druid,balance,6,3,3
Moolfurian,draenor,288,druid,balance,6,3,3
Moonkyye,hyjal,288,druid,balance,6,3,3
Skiiter,draenor,288,druid,balance,6,3,3
Kärämel,archimonde,288,druid,balance,6,3,3
Graegan,archimonde,288,druid,balance,6,3,3
Sumliy,aegwynn,288,druid,balance,6,3,3
Sÿlph,sylvanas,288,druid,balance,6,3,3
Catgirlx,ravencrest,288,druid,balance,6,3,3
Holographic,ravencrest,288,druid,balance,6,3,3
Veles,hyjal,288,druid,balance,6,3,3
Lorritha,sylvanas,288,druid,balance,6,3,3
Pseudocroup,draenor,288,druid,balance,6,3,3
Hordepwnr,sylvanas,288,druid,balance,6,3,3
Zfaf,hyjal,288,druid,balance,6,3,3
Houwalia,archimonde,288,druid,balance,6,3,3
Treerion,ravencrest,288,druid,balance,6,3,3
Sasabinks,antonidas,288,druid,balance,6,3,3
Ôlm,archimonde,288,druid,balance,6,3,3
Bartax,culte-de-la-rive-noire,288,druid,balance,6,3,3
Junglelist,antonidas,288,druid,balance,6,3,3
Вооми,gordunni,288,druid,balance,6,3,3
Flower,aggramar,288,druid,balance,6,3,3
Framoin,archimonde,288,druid,balance,6,3,3
Splatz,runetotem,288,druid,balance,6,3,3
Radicall,archimonde,288,druid,balance,6,3,3
Treebags,ravencrest,288,druid,balance,6,3,3
Myisan,stormreaver,288,druid,balance,6,3,3
Svantte,stormreaver,288,druid,balance,6,3,3
Solutionx,aegwynn,288,druid,balance,6,3,3
Drdredd,aggramar,288,druid,balance,6,3,3
Porklife,tarren-mill,288,druid,balance,6,3,3
Bloomin,sylvanas,288,druid,balance,6,3,3
Amyblack,aegwynn,288,druid,balance,6,3,3
Why,frostwolf,288,druid,balance,6,3,3
Durlehardu,archimonde,288,druid,balance,6,3,3
Ripmacmiller,grim-batol,288,druid,balance,6,3,3
Dfjguidfg,baelgun,288,druid,balance,6,3,3
Treksta,draenor,288,druid,balance,6,3,3
Bámbí,sylvanas,288,druid,balance,6,3,3
Vícvega,ravencrest,288,druid,balance,6,3,3
Kusho,draenor,288,druid,balance,6,3,3
Kâtsu,ysondre,288,druid,balance,6,3,3
Pèreco,hyjal,288,druid,balance,6,3,3
Stiffýz,archimonde,288,druid,balance,6,3,3
Ilus,outland,288,druid,balance,6,3,3
Shermi,eredar,288,druid,balance,6,3,3
Блинчек,gordunni,288,druid,balance,6,3,3
Сэнтэс,soulflayer,288,druid,balance,6,3,3
Fayn,aggra-português,288,druid,balance,6,3,3
Høtbøt,ysera,288,druid,balance,6,3,3
Sucukk,antonidas,288,druid,balance,6,3,3
Balthazaar,ysera,288,druid,balance,6,3,3
Moonrake,antonidas,288,druid,balance,6,3,3
Sparkex,ravencrest,288,druid,balance,6,3,3
Гимодера,gordunni,288,druid,balance,6,3,3
Gnarrdrood,eredar,288,druid,balance,6,3,3
Qzaaq,tarren-mill,288,druid,balance,6,3,3
Àyóorts,archimonde,288,druid,balance,6,3,3
Дизельпауэр,soulflayer,288,druid,balance,6,3,3
Мегатро,greymane,288,druid,balance,6,3,3
Amakary,blackrock,288,druid,balance,6,3,3
Baubles,ghostlands,288,druid,balance,6,3,3
Flaiq,twisting-nether,288,druid,balance,6,3,3
Jaccz,twisting-nether,288,druid,balance,6,3,3
Ullainho,stormscale,288,druid,balance,6,3,3
Druesafta,ravencrest,288,druid,balance,6,3,3
Cáptnmorgan,blackmoore,288,druid,balance,6,3,3
Weestevie,ragnaros,288,druid,balance,6,3,3
Synthxbird,twisting-nether,288,druid,balance,6,3,3
Djclonebot,kazzak,288,druid,balance,6,3,3
Dízzy,malganis,288,druid,balance,6,3,3
Rbg,dun-modr,288,druid,balance,6,3,3
Exjuggy,twisting-nether,288,druid,balance,6,3,3
Haffro,twisting-nether,288,druid,balance,6,3,3
Hahafun,ravencrest,288,druid,balance,6,3,3
Кибермутация,lich-king,288,druid,balance,6,3,3
Justroot,twisting-nether,288,druid,balance,6,3,3
Liette,dalaran,288,druid,balance,6,3,3
Halown,twisting-nether,288,druid,balance,6,3,3
Djvapelordx,stormscale,288,druid,balance,6,3,3
Quitex,darkspear,288,druid,balance,6,3,3
Drester,blackrock,288,druid,balance,6,3,3
Hð,blackmoore,288,druid,balance,6,3,3
Johndru,kazzak,288,druid,balance,6,3,3
Yeats,blackmoore,288,druid,balance,6,3,3
Galerion,ragnaros,288,druid,balance,6,3,3
Fishe,twisting-nether,288,druid,balance,6,3,3
Bäckey,silvermoon,288,druid,balance,6,3,3
Kropieto,outland,288,druid,balance,6,3,3
Yogui,zuljin,288,druid,balance,6,3,3
Erelieva,silvermoon,288,druid,balance,6,3,3
Llcooljay,ravencrest,288,druid,balance,6,3,3
Trixdudu,emerald-dream,288,druid,balance,6,3,3
Hippycraft,the-maelstrom,288,druid,balance,6,3,3
Shyasiandru,area-52,288,druid,balance,6,3,3
Dabulla,kazzak,288,druid,balance,6,3,3
Дядявадядру,soulflayer,288,druid,balance,6,3,3
Kesismahmut,twisting-nether,288,druid,balance,6,3,3
Ninato,blackmoore,288,druid,balance,6,3,3
Necorine,silvermoon,288,druid,balance,6,3,3
Mikeisbike,ragnaros,288,druid,balance,6,3,3
Maldrýn,stormscale,288,druid,balance,6,3,3
Uníverse,blackmoore,288,druid,balance,6,3,3
Bontenmaru,eldrethalas,288,druid,balance,6,3,3
Peit,blackmoore,288,druid,balance,6,3,3
Mogwaî,arygos,288,druid,balance,6,3,3
Devilmag,twisting-nether,288,druid,balance,6,3,3
Kvngthegoat,kazzak,288,druid,balance,6,3,3
Druidat,kazzak,288,druid,balance,6,3,3
Ropáz,silvermoon,288,druid,balance,6,3,3
Quinteness,silvermoon,288,druid,balance,6,3,3
Wai,ravencrest,288,druid,balance,6,3,3
Panoramiix,throkferoth,288,druid,balance,6,3,3
Aczino,shendralar,288,druid,balance,6,3,3
Testopöllö,ravencrest,288,druid,balance,6,3,3
Gargasina,colinas-pardas,288,druid,balance,6,3,3
Ihatemétoo,stormscale,288,druid,balance,6,3,3
Làzërchicken,stormscale,288,druid,balance,6,3,3
Måckïngsx,the-maelstrom,288,druid,balance,6,3,3
Clonebotxd,kazzak,288,druid,balance,6,3,3
Èspartana,dun-modr,288,druid,balance,6,3,3
Taraka,blackmoore,288,druid,balance,6,3,3
Phike,blackrock,288,druid,balance,6,3,3
Jazeera,ragnaros,288,druid,balance,6,3,3
Jaykerlol,kazzak,288,druid,balance,6,3,3
Yezzir,defias-brotherhood,288,druid,balance,6,3,3
Moonskeng,quelthalas,288,druid,balance,6,3,3
Замакибо,howling-fjord,288,druid,balance,11,5,6
Unerwünscht,silvermoon,288,druid,balance,9,4,5
Furíouz,darksorrow,288,druid,balance,9,4,5
Terompotodo,cthun,288,druid,balance,10,4,6
Bootydrooty,thrall,288,druid,balance,9,3,6
Astralpandas,kazzak,288,druid,balance,15,4,11
Redgreenblue,ravencrest,288,druid,balance,12,3,9
Gotika,blackrock,288,druid,balance,12,3,9
Druidlaba,drakthul,288,druid,balance,12,3,9
Kãrá,argent-dawn,288,druid,balance,12,3,9
Tuathdedann,ravencrest,288,druid,balance,12,3,9
Tayswiftmend,defias-brotherhood,288,druid,balance,12,3,9
Kodislem,grim-batol,288,druid,balance,12,3,9
Leafceld,aggra-português,288,druid,balance,12,3,9
Akkamory,terokkar,288,druid,balance,12,3,9
Хенет,blackscar,288,druid,balance,12,3,9
Balfor,arathor,288,druid,balance,12,3,9
Aiwendil,alakir,288,druid,balance,12,3,9
Иссарил,gordunni,288,druid,balance,12,3,9
Kärmä,eldrethalas,288,druid,balance,12,3,9
Kidow,wrathbringer,288,druid,balance,12,3,9
Yeetingkids,argent-dawn,288,druid,balance,12,3,9
Cosmovibe,terokkar,288,druid,balance,12,3,9
Kíggi,blackmoore,288,druid,balance,12,3,9
Nyomnom,ravencrest,288,druid,balance,12,3,9
Thaneo,blackmoore,288,druid,balance,12,3,9
Loverace,dun-modr,288,druid,balance,12,3,9
Scar,dentarg,288,druid,balance,12,3,9
Groncowski,blackmoore,288,druid,balance,12,3,9
Astralcaller,kazzak,288,druid,balance,12,3,9
Rashtazul,blackmoore,288,druid,balance,12,3,9
Onlycustard,outland,288,druid,balance,12,3,9
Zuwyldxd,blackrock,288,druid,balance,12,3,9
Grizzleh,shattered-halls,288,druid,balance,18,3,15
Ewena,ragnaros,288,druid,balance,18,3,15
Hävefunny,archimonde,288,druid,balance,18,3,15
Зурсага,deathguard,287,druid,balance,6,3,3
Walkao,tarren-mill,287,druid,balance,6,3,3
Dasgrandeur,kazzak,287,druid,balance,6,3,3
Bigcappa,ahnqiraj,287,druid,balance,6,3,3
Slachtafval,twisting-nether,287,druid,balance,14,3,11
Razah,ravencrest,286,druid,balance,12,3,9
Millworgen,norgannon,286,druid,balance,12,3,9
Rahkki,malfurion,284,druid,balance,12,3,9
Шев,blackscar,270,druid,balance,7,4,3
Jhiun,ragnaros,256,druid,balance,4,4,0
Calligenia,antonidas,256,druid,balance,16,3,13
Bóssít,doomhammer,255,druid,balance,11,3,8
Drulius,tarren-mill,240,druid,balance,9,4,5
Yinkxzwo,blackmoore,240,druid,balance,9,3,6
Herdnotseen,stormscale,240,druid,balance,9,3,6
Octul,magtheridon,239,druid,balance,5,3,2
Treebearded,agamaggan,234,druid,balance,7,4,3
Bookashde,frostmane,234,druid,balance,7,4,3
Tmhaikyu,blackhand,234,druid,balance,15,5,10
Tiemyrôpe,outland,223,druid,balance,14,3,11
Блэкфорест,gordunni,211,druid,balance,19,6,13
Morboka,dalaran,208,druid,balance,13,3,10
Qoatazinha,malganis,192,druid,balance,4,3,1
Healingwool,ravencrest,192,druid,balance,6,2,4
Jaffacakeqt,draenor,192,druid,balance,6,2,4
Dinnalia,ravencrest,192,druid,balance,6,2,4
Falorra,draenor,192,druid,balance,6,2,4
Kaamirach,blackmoore,192,druid,balance,6,2,4
Druidbox,ravencrest,192,druid,balance,6,2,4
Hotributionx,ravencrest,192,druid,balance,6,2,4
Имбахилка,lich-king,192,druid,balance,6,2,4
Faetish,hyjal,192,druid,balance,6,2,4
Foxglove,ravencrest,192,druid,balance,6,2,4
Burnsois,draenor,192,druid,balance,6,2,4
Twodaysordie,ravencrest,192,druid,balance,6,2,4
Tuuqa,draenor,192,druid,balance,6,2,4
Halfaway,ravencrest,192,druid,balance,6,2,4
Paskixoxo,ravencrest,192,druid,balance,6,2,4
Svanturken,kazzak,192,druid,balance,6,2,4
Jonnaxø,ravencrest,192,druid,balance,6,2,4
Damnuisance,blackmoore,192,druid,balance,6,2,4
Jordnötssmör,draenor,192,druid,balance,6,2,4
Hotenhope,sylvanas,192,druid,balance,6,2,4
Auntypat,defias-brotherhood,192,druid,balance,6,2,4
Nîppe,ravencrest,192,druid,balance,6,2,4
Chickenrice,blackhand,192,druid,balance,6,2,4
Moonleek,draenor,192,druid,balance,6,2,4
Arzalor,burning-legion,192,druid,balance,6,2,4
Iqqzazagotme,hyjal,192,druid,balance,6,2,4
Versality,lightnings-blade,192,druid,balance,6,2,4
Mmhcharal,voljin,192,druid,balance,6,2,4
Acidbrate,aegwynn,192,druid,balance,6,2,4
Маалир,gordunni,192,druid,balance,6,2,4
Уличныйиисус,azuregos,192,druid,balance,6,2,4
Dzeve,the-maelstrom,192,druid,balance,6,2,4
Trueforms,ravencrest,192,druid,balance,6,2,4
Kwenden,arygos,192,druid,balance,6,2,4
Fevine,arathor,192,druid,balance,6,2,4
Galgaan,burning-legion,192,druid,balance,6,2,4
Zeeqi,draenor,192,druid,balance,6,2,4
Bamso,daggerspine,192,druid,balance,6,2,4
Saliencias,kazzak,192,druid,balance,6,2,4
Ýanux,aegwynn,192,druid,balance,6,2,4
Ahriany,blackmoore,192,druid,balance,6,2,4
Дробовик,soulflayer,192,druid,balance,6,2,4
Kittyclâw,perenolde,192,druid,balance,6,2,4
Natuh,outland,192,druid,balance,6,2,4
Jflow,draenor,192,druid,balance,6,2,4
Jimmyxdd,kazzak,192,druid,balance,6,2,4
Pepenno,draenor,192,druid,balance,6,2,4
Hâyâbusa,antonidas,192,druid,balance,6,2,4
Héryse,hyjal,192,druid,balance,6,2,4
Катали,soulflayer,192,druid,balance,6,2,4
Hicupz,dun-morogh,192,druid,balance,6,2,4
Pawnamera,norgannon,192,druid,balance,6,2,4
Sychlone,ravencrest,192,druid,balance,6,2,4
Exist,kul-tiras,192,druid,balance,6,2,4
Zhu,outland,192,druid,balance,6,2,4
Deezforms,kazzak,192,druid,balance,6,2,4
Lillu,aggramar,192,druid,balance,6,2,4
Kuzka,dun-modr,192,druid,balance,6,2,4
Бабкавтанке,gordunni,192,druid,balance,6,2,4
Brømberry,blackrock,192,druid,balance,6,2,4
Wakanishu,tarren-mill,192,druid,balance,6,2,4
Jambalaja,stormscale,192,druid,balance,6,2,4
Daunt,wrathbringer,192,druid,balance,6,2,4
Elflord,nemesis,192,druid,balance,6,2,4
Vëlînøf,sanguino,192,druid,balance,6,2,4
Panørax,archimonde,192,druid,balance,6,2,4
Seøms,aegwynn,192,druid,balance,6,2,4
Tallbutshort,stormscale,192,druid,balance,6,2,4
Luveena,kazzak,192,druid,balance,6,2,4
Escares,blackrock,192,druid,balance,6,2,4
Lashed,tarren-mill,192,druid,balance,6,2,4
Micifuz,aegwynn,192,druid,balance,6,2,4
Trowbsi,blackmoore,192,druid,balance,6,2,4
Caskas,nemesis,192,druid,balance,6,2,4
Santaana,silvermoon,192,druid,balance,6,2,4
Manymal,chogall,192,druid,balance,6,2,4
Edal,chogall,192,druid,balance,6,2,4
Djkoolaid,frostwolf,192,druid,balance,6,2,4
Scopix,aegwynn,192,druid,balance,6,2,4
Kjappgutt,grim-batol,192,druid,balance,6,2,4
Stuu,nathrezim,192,druid,balance,6,2,4
Voganz,archimonde,192,druid,balance,6,2,4
Deadlydudu,magtheridon,192,druid,balance,6,2,4
Trashgamex,eredar,192,druid,balance,6,2,4
Jéssíé,silvermoon,192,druid,balance,6,2,4
Tadoson,blackmoore,192,druid,balance,6,2,4
Devill,grim-batol,192,druid,balance,6,2,4
Sorkoxd,silvermoon,192,druid,balance,6,2,4
Bossdruid,aegwynn,192,druid,balance,6,2,4
Raïby,archimonde,192,druid,balance,6,2,4
Фингельш,gordunni,192,druid,balance,6,2,4
Metteaglê,blackrock,192,druid,balance,6,2,4
Kätsumï,dun-modr,192,druid,balance,6,2,4
Markuslanz,blackrock,192,druid,balance,6,2,4
Varìx,ysondre,192,druid,balance,6,2,4
Shaulà,blackrock,192,druid,balance,6,2,4
Wonjin,nerathor,192,druid,balance,6,2,4
Meatus,ragnaros,192,druid,balance,6,2,4
Eschatos,argent-dawn,192,druid,balance,6,2,4
Анкарон,howling-fjord,192,druid,balance,6,2,4
Skrewu,silvermoon,192,druid,balance,6,2,4
Xulian,exodar,192,druid,balance,6,2,4
Hîlal,blackrock,192,druid,balance,6,2,4
Gladiata,tarren-mill,192,druid,balance,6,2,4
Successhaver,argent-dawn,192,druid,balance,6,2,4
Borne,aggra-português,192,druid,balance,6,2,4
Lïlara,elune,192,druid,balance,6,2,4
Descarn,nazjatar,192,druid,balance,6,2,4
Venedría,eredar,192,druid,balance,6,2,4
Marryat,argent-dawn,192,druid,balance,6,2,4
Lagiana,zirkel-des-cenarius,192,druid,balance,6,2,4
Roshgar,magtheridon,192,druid,balance,6,2,4
Blacksage,dragonmaw,192,druid,balance,6,2,4
Bokár,blackrock,192,druid,balance,6,2,4
Erkerkerk,twisting-nether,192,druid,balance,6,2,4
Natzuri,lothar,192,druid,balance,6,2,4
Slakkielief,archimonde,192,druid,balance,6,2,4
Nilatsfloda,quelthalas,192,druid,balance,6,2,4
Chupapoya,pozzo-delleternità,192,druid,balance,6,2,4
Entelol,blackrock,192,druid,balance,6,2,4
Natsuheal,drakthul,192,druid,balance,6,2,4
Fripôuille,ysondre,192,druid,balance,6,2,4
Thugcat,tarren-mill,192,druid,balance,6,2,4
Старселлер,gordunni,192,druid,balance,6,2,4
Wheyproteín,dun-modr,192,druid,balance,6,2,4
Layzz,archimonde,192,druid,balance,6,2,4
Shaeliea,argent-dawn,192,druid,balance,6,2,4
Chzycow,twisting-nether,192,druid,balance,6,2,4
Mistic,twisting-nether,192,druid,balance,6,2,4
Amberleaf,chamber-of-aspects,192,druid,balance,6,2,4
Dawzd,archimonde,192,druid,balance,6,2,4
Spidete,sanguino,192,druid,balance,6,2,4
Maxreflect,pozzo-delleternità,192,druid,balance,6,2,4
Hadespool,sanguino,192,druid,balance,6,2,4
Susaru,blackrock,192,druid,balance,6,2,4
Lem,dentarg,192,druid,balance,6,2,4
Fromeden,silvermoon,192,druid,balance,6,2,4
Ляшок,gordunni,192,druid,balance,6,2,4
Sunfeather,silvermoon,192,druid,balance,6,2,4
Timbawe,ragnaros,192,druid,balance,6,2,4
Tregrant,agamaggan,192,druid,balance,6,2,4
Silverdice,thrall,192,druid,balance,6,2,4
Virmire,dun-modr,192,druid,balance,6,2,4
Снэйк,borean-tundra,192,druid,balance,6,2,4
Kawaiiswag,kazzak,192,druid,balance,6,2,4
Mermelijn,argent-dawn,192,druid,balance,6,2,4
Tamburoo,tarren-mill,192,druid,balance,6,2,4
Chickenboss,sanguino,192,druid,balance,6,2,4
Biggestbirdx,stormscale,192,druid,balance,6,2,4
Tranduiil,drakthul,192,druid,balance,6,2,4
Dacat,kazzak,192,druid,balance,6,2,4
Денчикбратиш,soulflayer,192,druid,balance,7,2,5
Energäde,twisting-nether,192,druid,balance,7,2,5
Gortarn,defias-brotherhood,192,druid,balance,8,2,6
Aceeu,dalaran,192,druid,balance,9,2,7
Ostrich,arathor,192,druid,balance,11,2,9
Onmyass,dragonblight,192,druid,balance,12,2,10
Aestecias,blackhand,192,druid,balance,12,2,10
Celainiël,argent-dawn,192,druid,balance,12,2,10
Ãnimal,argent-dawn,192,druid,balance,12,2,10
Newdawn,outland,192,druid,balance,12,2,10
Aastralguard,draenor,192,druid,balance,12,2,10
Druidja,sylvanas,192,druid,balance,12,2,10
Fizzybubelle,blackhand,192,druid,balance,12,2,10
Chiendetalus,ysondre,192,druid,balance,12,2,10
Broasted,stormscale,192,druid,balance,12,2,10
Foxius,outland,192,druid,balance,12,2,10
Aristrea,dun-morogh,192,druid,balance,12,2,10
Nitro,kazzak,192,druid,balance,12,2,10
Dørzz,blackmoore,192,druid,balance,12,2,10
Avanishri,defias-brotherhood,192,druid,balance,12,2,10
Snorlaxza,ravencrest,192,druid,balance,12,2,10
Darksthero,draenor,192,druid,balance,12,2,10
Kramit,ravencrest,192,druid,balance,12,2,10
Wolfverine,dentarg,192,druid,balance,12,2,10
Lunárfall,argent-dawn,192,druid,balance,13,2,11
Catbear,kazzak,191,druid,balance,6,2,4
Сугрик,deathweaver,191,druid,balance,9,2,7
Arrock,malfurion,191,druid,balance,12,2,10
Myrddil,kult-der-verdammten,191,druid,balance,12,2,10
Silvacustos,teldrassil,191,druid,balance,12,2,10
Truebadass,draenor,190,druid,balance,10,4,6
Garbagemonky,amanthul,169,druid,balance,12,5,7
Fabsl,archimonde,159,druid,balance,5,2,3
Forbode,darkspear,159,druid,balance,5,2,3
Yudaqu,thrall,159,druid,balance,5,2,3
Mirtur,kazzak,159,druid,balance,5,2,3
Testoprime,draenor,159,druid,balance,5,2,3
Bellatrx,blackmoore,159,druid,balance,5,2,3
Ацкийдру,gordunni,159,druid,balance,5,2,3
Khachiruloh,zuljin,159,druid,balance,5,2,3
Aerobicgirlx,malganis,159,druid,balance,11,2,9
Aütumn,twisting-nether,144,druid,balance,9,3,6
Иосси,soulflayer,138,druid,balance,9,5,4
Блиденг,gordunni,138,druid,balance,9,3,6
Kôrtêx,blackmoore,138,druid,balance,10,3,7
Chickenlegx,blackmoore,138,druid,balance,16,3,13
Xaahl,archimonde,128,druid,balance,4,2,2
Zaks,drakthul,128,druid,balance,4,2,2
Beere,kazzak,128,druid,balance,4,2,2
Jãy,ravencrest,128,druid,balance,4,2,2
Tekilaz,sanguino,128,druid,balance,4,2,2
Ноатаэль,gordunni,128,druid,balance,4,2,2
Arebia,blackrock,111,druid,balance,7,2,5
Uwina,silvermoon,96,druid,balance,3,2,1
Ligoz,silvermoon,96,druid,balance,3,2,1
Deethra,stormscale,96,druid,balance,3,2,1
Apojeanne,hyjal,96,druid,balance,6,1,5
Твойбарсик,gordunni,96,druid,balance,6,1,5
Waxmepls,outland,96,druid,balance,6,1,5
Leafy,sanguino,96,druid,balance,6,1,5
Редонт,gordunni,96,druid,balance,6,1,5
Treksta,silvermoon,96,druid,balance,6,1,5
Shalysae,silvermoon,96,druid,balance,6,1,5
Maaghera,silvermoon,96,druid,balance,6,1,5
Basz,outland,96,druid,balance,6,1,5
Titurel,zuljin,96,druid,balance,6,1,5
Рублюсук,howling-fjord,96,druid,balance,6,1,5
Freeboo,ragnaros,96,druid,balance,6,1,5
Voodeen,burning-legion,96,druid,balance,6,1,5
Drroger,kazzak,96,druid,balance,6,1,5
Tortugo,dun-modr,96,druid,balance,6,1,5
Ripndip,eredar,96,druid,balance,6,1,5
Jamaicanherb,bronzebeard,96,druid,balance,6,1,5
Lofastfox,ragnaros,96,druid,balance,6,1,5
Котябра,gordunni,96,druid,balance,6,1,5
Sayan,stormscale,96,druid,balance,6,1,5
Aniprimal,auchindoun,96,druid,balance,6,1,5
Druwidess,archimonde,96,druid,balance,6,1,5
Garudax,blackrock,96,druid,balance,6,1,5
Droodzerqt,archimonde,96,druid,balance,6,1,5
Bjaerntass,darksorrow,96,druid,balance,6,1,5
Jænne,ysondre,96,druid,balance,6,1,5
Lilkâzzam,blackrock,96,druid,balance,6,1,5
Fullcyclone,stormscale,96,druid,balance,6,1,5
Karbonaten,draenor,96,druid,balance,6,1,5
Enia,azjolnerub,96,druid,balance,6,1,5
Közel,ragnaros,96,druid,balance,6,1,5
Siahra,khaz-modan,96,druid,balance,6,1,5
Telavie,antonidas,96,druid,balance,6,1,5
Ekxn,archimonde,96,druid,balance,6,1,5
Tigerbalm,ravenholdt,96,druid,balance,6,1,5
Арбузир,howling-fjord,96,druid,balance,6,1,5
Ayatola,conseil-des-ombres,96,druid,balance,6,1,5
Magneziie,drakthul,96,druid,balance,6,1,5
Pöcä,arakarahm,96,druid,balance,6,1,5
Kakoje,burning-legion,96,druid,balance,6,1,5
Arún,nazjatar,96,druid,balance,6,1,5
Skinnyleg,baelgun,96,druid,balance,6,1,5
Druiduis,minahonda,96,druid,balance,6,1,5
Nubsi,aegwynn,96,druid,balance,6,1,5
Scarykejton,draenor,96,druid,balance,6,1,5
Frequentist,ragnaros,96,druid,balance,6,1,5
Kaira,kazzak,96,druid,balance,6,1,5
Avis,dethecus,96,druid,balance,6,1,5
Gracelock,argent-dawn,96,druid,balance,6,1,5
Ashiothie,argent-dawn,96,druid,balance,6,1,5
Lieweheksie,kilrogg,96,druid,balance,6,1,5
Ferdax,outland,96,druid,balance,6,1,5
Brownny,dun-modr,96,druid,balance,6,1,5
Samuelito,ravencrest,96,druid,balance,6,1,5
Blùwe,archimonde,96,druid,balance,6,1,5
Kintàro,nemesis,96,druid,balance,6,1,5
Beatball,aegwynn,96,druid,balance,6,1,5
Гринфрэш,howling-fjord,96,druid,balance,6,1,5
Snigesnige,silvermoon,96,druid,balance,6,1,5
Ösdru,tarren-mill,96,druid,balance,6,1,5
Beginníng,outland,96,druid,balance,6,1,5
Donoz,ravencrest,96,druid,balance,6,1,5
Nayemi,blackmoore,96,druid,balance,6,1,5
Nermax,kazzak,96,druid,balance,6,1,5
Сверххищникк,soulflayer,96,druid,balance,6,1,5
Eredhion,stormscale,96,druid,balance,6,1,5
Mishuka,sylvanas,96,druid,balance,6,1,5
Bullseaman,stormscale,96,druid,balance,6,1,5
Dreathie,kazzak,96,druid,balance,6,1,5
Nøwørnever,ulduar,96,druid,balance,6,1,5
Hotseîdank,blackrock,96,druid,balance,6,1,5
Liunara,nemesis,96,druid,balance,6,1,5
Leronox,blackmoore,96,druid,balance,6,1,5
Blolzz,silvermoon,96,druid,balance,6,1,5
Xwerzz,stormscale,96,druid,balance,6,1,5
Citral,balnazzar,96,druid,balance,6,1,5
Flauschtatze,wrathbringer,96,druid,balance,6,1,5
Jarál,argent-dawn,96,druid,balance,6,1,5
Уахо,howling-fjord,96,druid,balance,6,1,5
Buttercupx,kelthuzad,96,druid,balance,6,1,5
Anahita,emerald-dream,96,druid,balance,6,1,5
Panigale,dun-modr,96,druid,balance,6,1,5
Tàazz,sargeras,96,druid,balance,6,1,5
Пё,howling-fjord,96,druid,balance,6,1,5
Uniquz,sylvanas,96,druid,balance,6,1,5
Ironveins,ravencrest,96,druid,balance,6,1,5
Маминапуська,soulflayer,96,druid,balance,6,1,5
Gyome,sargeras,96,druid,balance,6,1,5
Stuntgirlcat,pozzo-delleternità,96,druid,balance,6,1,5
Herekitykity,frostmane,96,druid,balance,6,1,5
Пасторизсша,soulflayer,96,druid,balance,6,1,5
Владбутират,soulflayer,96,druid,balance,6,1,5
Cattdamon,outland,96,druid,balance,6,1,5
Zaerox,ambossar,96,druid,balance,6,1,5
Crèative,shattrath,96,druid,balance,6,1,5
Reyk,sunstrider,96,druid,balance,6,1,5
Maum,outland,96,druid,balance,6,1,5
Ghxsty,silvermoon,96,druid,balance,6,1,5
Möõ,tarren-mill,96,druid,balance,6,1,5
Patri,ravencrest,96,druid,balance,6,1,5
Pudseytree,doomhammer,96,druid,balance,6,1,5
Psitol,silvermoon,96,druid,balance,6,1,5
Rettnuh,outland,96,druid,balance,6,1,5
Miniours,varimathras,96,druid,balance,6,1,5
Пониджус,howling-fjord,96,druid,balance,26,4,22
Soléda,thrall,96,druid,balance,7,1,6
Búll,aegwynn,96,druid,balance,7,1,6
Convokeuwwu,stormreaver,96,druid,balance,9,1,8
Ghostpaws,doomhammer,96,druid,balance,11,1,10
Grynoth,silvermoon,96,druid,balance,12,1,11
Maßka,terokkar,96,druid,balance,12,1,11
Lïs,the-maelstrom,96,druid,balance,12,1,11
Nissemand,ravencrest,96,druid,balance,12,1,11
Ninmah,quelthalas,96,druid,balance,12,1,11
Tarendil,argent-dawn,96,druid,balance,12,1,11
Bìerchen,antonidas,96,druid,balance,12,1,11
Summër,los-errantes,96,druid,balance,12,1,11
Noiir,malfurion,96,druid,balance,12,1,11
Woolee,area-52,96,druid,balance,12,1,11
Periklasus,antonidas,96,druid,balance,12,1,11
Gawsworth,aerie-peak,95,druid,balance,6,1,5
Träeller,outland,79,druid,balance,5,1,4
Revoidý,blackmoore,79,druid,balance,5,1,4
Qb,blackrock,79,druid,balance,5,1,4
Kodobursto,stormscale,79,druid,balance,6,1,5
Ушастикэ,gordunni,64,druid,balance,4,1,3
Didieex,kazzak,63,druid,balance,2,2,0
Exïlla,archimonde,48,druid,balance,3,1,2
Møønhaven,silvermoon,48,druid,balance,3,1,2
Soofyan,kazzak,48,druid,balance,3,1,2
Detlaff,draenor,48,druid,balance,9,1,8
Ayatosan,antonidas,48,druid,balance,9,1,8
Энокей,gordunni,42,druid,balance,8,2,6
Melonjuicer,argent-dawn,42,druid,balance,9,2,7
Plankface,ravencrest,42,druid,balance,21,3,18
Trànsformer,nemesis,31,druid,balance,2,1,1
Kekferal,eredar,31,druid,balance,2,1,1
Nalreaa,kazzak,31,druid,balance,8,1,7
Sarishi,kazzak,16,druid,balance,1,1,0
Báttlx,blackrock,16,druid,balance,7,1,6
Nèthy,argent-dawn,2244,evoker,preservation,77,47,30
Kankethyr,korgall,2241,evoker,preservation,113,67,46
Néthy,argent-dawn,2191,evoker,preservation,186,105,81
Elcocodrilo,tarren-mill,2180,evoker,preservation,84,44,40
Nesedon,stormscale,2166,evoker,preservation,389,204,185
Gardennewt,ravencrest,2158,evoker,preservation,90,49,41
Jacko,nemesis,2158,evoker,preservation,89,48,41
Gardenewt,ravencrest,2153,evoker,preservation,108,59,49
Бедныйгрузин,howling-fjord,2146,evoker,preservation,72,43,29
Zychodrac,draenor,2145,evoker,preservation,148,74,74
Najikí,tarren-mill,2135,evoker,preservation,149,86,63
Bodytypezero,terenas,2133,evoker,preservation,140,77,63
Dreamwalk,archimonde,2129,evoker,preservation,156,93,63
Sukkmymadnes,draenor,2120,evoker,preservation,79,39,40
Сансетшторм,gordunni,2119,evoker,preservation,88,47,41
Vokedrak,eredar,2118,evoker,preservation,113,58,55
Drogon,shendralar,2114,evoker,preservation,114,67,47
Kronata,sanguino,2112,evoker,preservation,102,45,57
Dn,shattered-hand,2111,evoker,preservation,89,46,43
Драконсила,gordunni,2100,evoker,preservation,131,73,58
Dragonsweat,hyjal,2088,evoker,preservation,120,66,54
Onelastdance,ravencrest,2083,evoker,preservation,89,76,13
Zimbello,nemesis,2064,evoker,preservation,444,238,206
Ms,ravencrest,2056,evoker,preservation,98,49,49
Haxyia,outland,2052,evoker,preservation,138,71,67
Smellybreath,ravencrest,2048,evoker,preservation,54,32,22
Flouzzx,blackmoore,2045,evoker,preservation,98,55,43
Puzikloh,ravencrest,2043,evoker,preservation,54,27,27
Humòngóus,kazzak,2042,evoker,preservation,60,31,29
Flyhacker,blackrock,2039,evoker,preservation,72,37,35
Гачитварь,galakrond,2039,evoker,preservation,317,156,161
Bodytypefour,stormscale,2039,evoker,preservation,126,58,68
Ltmdrgn,ravencrest,2032,evoker,preservation,94,53,41
Dizablise,burning-legion,2011,evoker,preservation,136,71,65
Dragonmeta,kazzak,2011,evoker,preservation,60,31,29
Nerfevøker,ragnaros,2008,evoker,preservation,130,66,64
Podonok,ravencrest,2005,evoker,preservation,251,129,122
Diggidydract,silvermoon,2005,evoker,preservation,68,32,36
Dracthal,blackmoore,2004,evoker,preservation,78,46,32
Sính,ravencrest,1997,evoker,preservation,71,38,33
Krustyvoker,sargeras,1983,evoker,preservation,53,33,20
Sinéstrà,antonidas,1982,evoker,preservation,246,125,121
Xays,ravencrest,1980,evoker,preservation,148,75,73
Шафлэнжоер,fordragon,1977,evoker,preservation,36,23,13
Baddragonn,nemesis,1972,evoker,preservation,47,28,19
Béatér,aegwynn,1965,evoker,preservation,196,112,84
Rvrsl,outland,1948,evoker,preservation,435,219,216
Plogi,twisting-nether,1945,evoker,preservation,84,47,37
Asgá,kazzak,1944,evoker,preservation,73,30,43
Däkuookami,twisting-nether,1941,evoker,preservation,71,42,29
Nivoker,kazzak,1937,evoker,preservation,90,49,41
Asyncgosa,ravencrest,1935,evoker,preservation,107,51,56
Púñterx,kazzak,1934,evoker,preservation,101,54,47
Sindragonk,ravencrest,1931,evoker,preservation,48,33,15
Ipho,twisting-nether,1930,evoker,preservation,120,57,63
Woodý,draenor,1923,evoker,preservation,48,29,19
Matrixslave,tarren-mill,1922,evoker,preservation,133,74,59
Lazey,stormscale,1920,evoker,preservation,213,109,104
Hornyxj,draenor,1920,evoker,preservation,251,124,127
Dragondaddy,eredar,1917,evoker,preservation,114,63,51
Mauül,ravencrest,1912,evoker,preservation,174,102,72
Waifuwu,blackhand,1912,evoker,preservation,229,111,118
Ramfurry,kazzak,1911,evoker,preservation,472,235,237
Seafolk,stormscale,1909,evoker,preservation,291,157,134
Ноубадиаттак,soulflayer,1907,evoker,preservation,144,67,77
Jamesdéan,twisting-nether,1905,evoker,preservation,113,70,43
Mistrßroducr,stormreaver,1905,evoker,preservation,42,21,21
Swainsupp,archimonde,1904,evoker,preservation,75,35,40
Notadvanced,draenor,1904,evoker,preservation,104,46,58
Flipflapflop,twisting-nether,1903,evoker,preservation,101,51,50
Schwañ,twisting-nether,1902,evoker,preservation,150,85,65
Froststraza,chamber-of-aspects,1902,evoker,preservation,72,36,36
Bluesaphir,ravencrest,1897,evoker,preservation,42,23,19
Theories,blackhand,1897,evoker,preservation,145,67,78
Baiyuekui,blackmoore,1896,evoker,preservation,422,212,210
Сайберри,gordunni,1894,evoker,preservation,102,54,48
Mvoker,blackmoore,1892,evoker,preservation,59,35,24
Huxleysroar,draenor,1888,evoker,preservation,54,26,28
Ðåñîq,kazzak,1888,evoker,preservation,89,38,51
Phnx,blackrock,1886,evoker,preservation,246,125,121
Myxiwinxy,archimonde,1885,evoker,preservation,36,23,13
Jakelóng,ravencrest,1883,evoker,preservation,58,29,29
Amadeusx,ravencrest,1881,evoker,preservation,108,53,55
Theories,aegwynn,1880,evoker,preservation,53,29,24
Alusiedrake,ravencrest,1878,evoker,preservation,372,204,168
Jkdrage,stormscale,1874,evoker,preservation,98,45,53
Bümber,stormscale,1867,evoker,preservation,201,102,99
Dragondn,alleria,1865,evoker,preservation,54,37,17
Eccotwogay,frostwhisper,1862,evoker,preservation,112,57,55
Silverwingg,tarren-mill,1859,evoker,preservation,48,28,20
Адоннис,gordunni,1858,evoker,preservation,119,64,55
Titnoute,archimonde,1856,evoker,preservation,60,25,35
Лабирон,blackscar,1854,evoker,preservation,95,47,48
Nahfr,terenas,1852,evoker,preservation,222,118,104
Zaffira,kazzak,1850,evoker,preservation,48,27,21
Lurkî,blackhand,1850,evoker,preservation,354,179,175
Gneltharion,draenor,1849,evoker,preservation,116,57,59
Kapevok,sanguino,1848,evoker,preservation,150,89,61
Conwoker,ravencrest,1847,evoker,preservation,42,22,20
Shroudflight,draenor,1847,evoker,preservation,412,211,201
Myshagini,ravencrest,1846,evoker,preservation,45,27,18
Odiin,dun-modr,1836,evoker,preservation,63,37,26
Ambuy,kazzak,1835,evoker,preservation,83,42,41
Dargenpont,turalyon,1834,evoker,preservation,113,59,54
Голдамбер,gordunni,1834,evoker,preservation,66,30,36
Setraxia,argent-dawn,1833,evoker,preservation,238,141,97
Yulinex,argent-dawn,1833,evoker,preservation,160,92,68
Keñwøød,ysondre,1832,evoker,preservation,66,37,29
Æzorahai,area-52,1830,evoker,preservation,84,38,46
Cellv,kazzak,1829,evoker,preservation,156,88,68
Runewing,turalyon,1827,evoker,preservation,53,30,23
Talim,terrordar,1827,evoker,preservation,90,44,46
Dârys,kazzak,1826,evoker,preservation,70,31,39
Aeste,dun-modr,1825,evoker,preservation,66,41,25
Bòrís,kazzak,1821,evoker,preservation,30,28,2
Malboroasted,archimonde,1820,evoker,preservation,78,38,40
Nakavoker,arygos,1820,evoker,preservation,244,118,126
Cptdrakon,twisting-nether,1815,evoker,preservation,105,58,47
Brynesuge,ragnaros,1813,evoker,preservation,218,117,101
Smâûg,silvermoon,1812,evoker,preservation,48,27,21
Mixn,argent-dawn,1812,evoker,preservation,93,41,52
Nst,zuljin,1811,evoker,preservation,48,27,21
Myshavion,hyjal,1810,evoker,preservation,107,50,57
Puffthemagic,archimonde,1810,evoker,preservation,60,28,32
Nhoru,stormscale,1807,evoker,preservation,64,32,32
Evodorie,ravencrest,1807,evoker,preservation,68,33,35
Wakûwakû,kazzak,1805,evoker,preservation,135,72,63
Thèrèse,hyjal,1805,evoker,preservation,84,42,42
Evokis,tarren-mill,1804,evoker,preservation,71,40,31
Трейш,soulflayer,1804,evoker,preservation,90,42,48
Novvae,hyjal,1802,evoker,preservation,96,55,41
Lerrastrasza,zirkel-des-cenarius,1802,evoker,preservation,48,24,24
Wernøker,archimonde,1800,evoker,preservation,83,40,43
Escaaboy,stormscale,1797,evoker,preservation,58,33,25
Ксенондрейк,gordunni,1793,evoker,preservation,102,55,47
Kalevra,eredar,1791,evoker,preservation,187,98,89
Løcøtømmy,blackrock,1785,evoker,preservation,42,24,18
Justyowxs,archimonde,1782,evoker,preservation,139,74,65
Антошадф,gordunni,1779,evoker,preservation,72,39,33
Notkzii,argent-dawn,1777,evoker,preservation,42,19,23
Udewedu,ravencrest,1775,evoker,preservation,36,19,17
Бунтз,howling-fjord,1775,evoker,preservation,77,39,38
Yayaxoxoxoxo,hyjal,1775,evoker,preservation,54,25,29
Drakela,frostwhisper,1764,evoker,preservation,65,35,30
Chasxstrasza,ravencrest,1756,evoker,preservation,90,31,59
Dragonello,stormscale,1755,evoker,preservation,54,27,27
Detdragetid,zenedar,1751,evoker,preservation,139,64,75
Drookun,outland,1750,evoker,preservation,123,56,67
Evocy,ravencrest,1748,evoker,preservation,96,51,45
Soyd,dun-morogh,1747,evoker,preservation,57,33,24
Branados,argent-dawn,1747,evoker,preservation,66,38,28
Alphabét,ravencrest,1746,evoker,preservation,114,55,59
Cynvoke,twisting-nether,1745,evoker,preservation,60,45,15
Yavak,blackmoore,1745,evoker,preservation,55,30,25
Infidus,ravencrest,1735,evoker,preservation,210,111,99
Flavorion,cthun,1728,evoker,preservation,41,25,16
Jaje,nerathor,1728,evoker,preservation,58,31,27
Drakeadorie,twisting-nether,1723,evoker,preservation,72,36,36
Тирэсплюс,soulflayer,1721,evoker,preservation,36,21,15
Bugdul,twisting-nether,1713,evoker,preservation,74,46,28
Даэдра,gordunni,1712,evoker,preservation,186,94,92
Monftroglou,archimonde,1712,evoker,preservation,41,20,21
Ранкондракон,lich-king,1712,evoker,preservation,95,42,53
Tetrís,blackhand,1712,evoker,preservation,50,21,29
Maxthecar,draenor,1710,evoker,preservation,136,87,49
Launisch,amanthul,1708,evoker,preservation,42,18,24
Häröpallo,stormscale,1703,evoker,preservation,81,48,33
Buqxrawrr,antonidas,1702,evoker,preservation,68,41,27
Dokkàmxk,archimonde,1702,evoker,preservation,48,21,27
Crocodeal,ysondre,1701,evoker,preservation,78,45,33
Zemar,dalaran,1700,evoker,preservation,36,19,17
Nyghtx,sanguino,1698,evoker,preservation,100,45,55
Swooshz,ragnaros,1697,evoker,preservation,78,38,40
Healevoker,aegwynn,1697,evoker,preservation,261,124,137
Dragonsphera,sylvanas,1696,evoker,preservation,84,36,48
Luderx,outland,1695,evoker,preservation,160,95,65
Mìnos,drakthul,1695,evoker,preservation,132,64,68
Kanketo,ravencrest,1695,evoker,preservation,48,23,25
Dragóndééz,draenor,1694,evoker,preservation,66,33,33
Camdaddy,magtheridon,1693,evoker,preservation,191,95,96
Valkroth,argent-dawn,1693,evoker,preservation,365,181,184
Hîppokrates,dethecus,1692,evoker,preservation,143,87,56
Динамика,borean-tundra,1692,evoker,preservation,443,237,206
Thairesse,archimonde,1690,evoker,preservation,66,33,33
Kackaloch,tarren-mill,1689,evoker,preservation,81,46,35
Tombeelee,kazzak,1687,evoker,preservation,36,21,15
Mobidra,twisting-nether,1683,evoker,preservation,64,34,30
Хронолиса,blackscar,1680,evoker,preservation,508,256,252
Adriia,draenor,1680,evoker,preservation,48,24,24
Roth,stormreaver,1679,evoker,preservation,507,255,252
Столаас,gordunni,1677,evoker,preservation,35,19,16
Prevolol,outland,1676,evoker,preservation,90,57,33
Castytopg,blackrock,1673,evoker,preservation,78,37,41
Reska,archimonde,1672,evoker,preservation,84,40,44
Trainsaw,kazzak,1671,evoker,preservation,108,54,54
Dragarius,tarren-mill,1669,evoker,preservation,108,43,65
Carrotz,doomhammer,1668,evoker,preservation,66,29,37
Вексалис,gordunni,1667,evoker,preservation,90,48,42
Ezinice,hyjal,1666,evoker,preservation,137,67,70
Mixoö,throkferoth,1664,evoker,preservation,78,39,39
Ashmoo,archimonde,1663,evoker,preservation,66,35,31
Visage,kul-tiras,1662,evoker,preservation,169,85,84
Nahkiainen,darksorrow,1662,evoker,preservation,108,50,58
Nekrosdrake,tarren-mill,1661,evoker,preservation,305,160,145
Drazor,blackhand,1658,evoker,preservation,101,51,50
Аскми,blackscar,1658,evoker,preservation,130,59,71
Xiarya,draenor,1658,evoker,preservation,41,18,23
Reptak,stormscale,1656,evoker,preservation,60,35,25
Evoxter,twisting-nether,1656,evoker,preservation,147,78,69
Elleavo,tarren-mill,1655,evoker,preservation,122,55,67
Iblvicanfly,stormscale,1654,evoker,preservation,91,52,39
Bònéz,blackmoore,1654,evoker,preservation,267,134,133
Sebek,archimonde,1653,evoker,preservation,33,19,14
Kuubski,ravencrest,1652,evoker,preservation,116,62,54
Draskathyr,sylvanas,1651,evoker,preservation,59,36,23
Holyvoker,aegwynn,1650,evoker,preservation,42,25,17
Jcloud,shattered-hand,1650,evoker,preservation,89,51,38
Панераи,gordunni,1649,evoker,preservation,93,44,49
Rondog,moonglade,1648,evoker,preservation,60,32,28
Snällaldo,bladefist,1646,evoker,preservation,78,51,27
Lycêrâ,antonidas,1644,evoker,preservation,46,25,21
Solutionevok,aegwynn,1642,evoker,preservation,53,29,24
Themasktw,kazzak,1637,evoker,preservation,141,63,78
Silversnakex,ravencrest,1636,evoker,preservation,60,35,25
Malowux,outland,1636,evoker,preservation,47,25,22
Valtion,stormscale,1634,evoker,preservation,48,26,22
Gg,wildhammer,1632,evoker,preservation,101,64,37
Rüllatorsven,stormscale,1631,evoker,preservation,36,21,15
Fearawr,malganis,1631,evoker,preservation,150,68,82
Kajer,nemesis,1630,evoker,preservation,36,19,17
Dart,sanguino,1627,evoker,preservation,90,47,43
Ацидракон,blackscar,1627,evoker,preservation,147,72,75
Cutegirlx,blackrock,1626,evoker,preservation,36,17,19
Nexxà,archimonde,1624,evoker,preservation,153,98,55
Пидрактир,soulflayer,1624,evoker,preservation,101,50,51
Trixle,thrall,1624,evoker,preservation,66,28,38
Kda,die-nachtwache,1623,evoker,preservation,60,23,37
Akly,nemesis,1622,evoker,preservation,100,58,42
Judragon,kazzak,1622,evoker,preservation,56,24,32
Skypov,sylvanas,1621,evoker,preservation,89,53,36
Medeostrasz,throkferoth,1621,evoker,preservation,42,25,17
Sedricae,twisting-nether,1621,evoker,preservation,190,100,90
Drgigapump,blackmoore,1621,evoker,preservation,36,17,19
Sinistrea,conseil-des-ombres,1620,evoker,preservation,147,84,63
Chronowalker,ragnaros,1620,evoker,preservation,41,22,19
Diläw,archimonde,1620,evoker,preservation,56,29,27
Qiasyr,hyjal,1620,evoker,preservation,46,20,26
Zettaflare,nazjatar,1619,evoker,preservation,24,17,7
Methamfetami,kazzak,1619,evoker,preservation,78,43,35
Âspên,archimonde,1619,evoker,preservation,308,151,157
Ariskesh,draenor,1616,evoker,preservation,35,23,12
Mysaldo,sylvanas,1616,evoker,preservation,84,46,38
Kwynus,archimonde,1615,evoker,preservation,36,18,18
Cith,ravencrest,1615,evoker,preservation,66,32,34
Louftarion,ysondre,1614,evoker,preservation,83,38,45
Blueaizu,draenor,1612,evoker,preservation,137,78,59
Gracyn,ravencrest,1612,evoker,preservation,64,34,30
Fartinhaler,ravencrest,1611,evoker,preservation,56,34,22
Drageye,tarren-mill,1611,evoker,preservation,213,120,93
Rawrus,blackrock,1611,evoker,preservation,101,49,52
Parodize,thrall,1610,evoker,preservation,67,37,30
Pcerainer,stormscale,1610,evoker,preservation,113,51,62
Потныйдракон,soulflayer,1608,evoker,preservation,48,23,25
Polzeig,dentarg,1606,evoker,preservation,81,40,41
Srache,frostwolf,1606,evoker,preservation,60,29,31
Berstrasz,frostwolf,1606,evoker,preservation,120,57,63
Rgedrake,blackrock,1605,evoker,preservation,114,67,47
Sysstrasza,archimonde,1604,evoker,preservation,95,55,40
Dracum,kazzak,1604,evoker,preservation,36,19,17
Absoto,dun-morogh,1604,evoker,preservation,113,58,55
Дрейкорг,howling-fjord,1604,evoker,preservation,72,31,41
Hjucen,twisting-nether,1603,evoker,preservation,90,49,41
Бадикабаер,thermaplugg,1602,evoker,preservation,285,150,135
Alamostrasza,doomhammer,1602,evoker,preservation,54,27,27
Bråckie,draenor,1600,evoker,preservation,84,49,35
Zekurm,ragnaros,1600,evoker,preservation,45,26,19
Etier,aegwynn,1597,evoker,preservation,108,61,47
Lytër,sanguino,1596,evoker,preservation,160,86,74
Kaipha,ravencrest,1596,evoker,preservation,89,43,46
Rackelhahn,azshara,1594,evoker,preservation,47,24,23
Eryot,aggra-português,1594,evoker,preservation,221,108,113
Rmplol,twisting-nether,1594,evoker,preservation,48,21,27
Kremost,sylvanas,1593,evoker,preservation,48,19,29
Féféledragon,archimonde,1591,evoker,preservation,134,66,68
Эндемический,soulflayer,1591,evoker,preservation,133,63,70
Syrrah,kazzak,1585,evoker,preservation,60,26,34
Quoz,ragnaros,1585,evoker,preservation,81,33,48
Scarydragôn,draenor,1584,evoker,preservation,152,86,66
Штеци,howling-fjord,1582,evoker,preservation,462,224,238
Крашевокер,soulflayer,1582,evoker,preservation,118,56,62
Odensbest,silvermoon,1580,evoker,preservation,79,48,31
Ystarblaze,tarren-mill,1580,evoker,preservation,103,49,54
Dwagonzuv,the-maelstrom,1578,evoker,preservation,72,40,32
Profdrake,zuluhed,1578,evoker,preservation,84,40,44
Полковниксан,soulflayer,1572,evoker,preservation,342,169,173
Antiflexx,ragnaros,1571,evoker,preservation,82,40,42
Sopollina,draenor,1571,evoker,preservation,60,28,32
Phyrrax,silvermoon,1569,evoker,preservation,94,50,44
Flowerscale,tarren-mill,1569,evoker,preservation,117,48,69
Trellie,die-aldor,1566,evoker,preservation,53,28,25
Devidra,defias-brotherhood,1564,evoker,preservation,308,144,164
Ятромантис,gordunni,1563,evoker,preservation,709,359,350
Detixbae,blackrock,1563,evoker,preservation,53,22,31
Îragnîr,sinstralis,1562,evoker,preservation,90,41,49
Sanktcs,blackhand,1562,evoker,preservation,79,35,44
Vyore,silvermoon,1560,evoker,preservation,66,34,32
Draelaynex,eredar,1560,evoker,preservation,81,40,41
Websensation,twisting-nether,1559,evoker,preservation,102,41,61
Siìre,thrall,1555,evoker,preservation,65,36,29
Blazelt,blackrock,1555,evoker,preservation,37,19,18
Vydrag,der-rat-von-dalaran,1553,evoker,preservation,35,17,18
Tannløsto,kazzak,1547,evoker,preservation,61,25,36
Oldwhiteman,guldan,1545,evoker,preservation,74,39,35
ßëkûsåùrús,ragnaros,1544,evoker,preservation,61,30,31
Zenvoker,silvermoon,1543,evoker,preservation,119,60,59
Sürion,grim-batol,1538,evoker,preservation,90,48,42
Meteo,the-maelstrom,1537,evoker,preservation,74,43,31
Jpeo,blackhand,1537,evoker,preservation,66,33,33
Нежныйболт,howling-fjord,1536,evoker,preservation,134,68,66
Akaos,silvermoon,1536,evoker,preservation,127,53,74
Wokebaren,draenor,1535,evoker,preservation,24,16,8
Bountyk,sanguino,1533,evoker,preservation,24,16,8
Ryujinx,blackhand,1532,evoker,preservation,46,19,27
Wingard,twisting-nether,1531,evoker,preservation,41,25,16
Jayrexx,doomhammer,1531,evoker,preservation,188,109,79
Omac,sylvanas,1531,evoker,preservation,155,73,82
Madbreath,cthun,1530,evoker,preservation,89,35,54
Evizard,nagrand,1529,evoker,preservation,172,94,78
Antouxd,shadowsong,1529,evoker,preservation,67,34,33
Superflyy,kazzak,1528,evoker,preservation,345,170,175
Dracronix,the-maelstrom,1527,evoker,preservation,42,19,23
Rhaenaya,tarren-mill,1526,evoker,preservation,272,143,129
Bubbleblower,stormscale,1524,evoker,preservation,42,27,15
Sissilisko,sylvanas,1524,evoker,preservation,141,83,58
Navilism,kazzak,1523,evoker,preservation,512,271,241
Dragnthsnuts,sylvanas,1523,evoker,preservation,74,35,39
Johnpowell,defias-brotherhood,1522,evoker,preservation,34,17,17
Turbodragon,archimonde,1521,evoker,preservation,18,16,2
Драгонпупс,soulflayer,1519,evoker,preservation,201,106,95
Copíl,stormscale,1519,evoker,preservation,70,35,35
Cuckingsock,drakthul,1518,evoker,preservation,51,24,27
Viseriøn,kazzak,1518,evoker,preservation,171,78,93
Últimdrac,dun-modr,1517,evoker,preservation,36,16,20
Pokemongame,draenor,1516,evoker,preservation,40,25,15
Ivokerz,tarren-mill,1516,evoker,preservation,60,28,32
Auti,draenor,1515,evoker,preservation,240,121,119
Kirivoker,dun-modr,1515,evoker,preservation,89,44,45
Mithrandir,marécage-de-zangar,1515,evoker,preservation,60,29,31
Ностепонснэк,ashenvale,1513,evoker,preservation,42,20,22
Snackyeend,twisting-nether,1513,evoker,preservation,84,34,50
Sakade,archimonde,1512,evoker,preservation,156,78,78
Peppapigsdad,outland,1511,evoker,preservation,36,19,17
Didii,frostwhisper,1509,evoker,preservation,250,120,130
Nanthira,darksorrow,1508,evoker,preservation,145,73,72
Voraxos,silvermoon,1506,evoker,preservation,48,29,19
Indragon,blackmoore,1505,evoker,preservation,108,52,56
Droyle,blackrock,1504,evoker,preservation,51,28,23
Dedx,sylvanas,1504,evoker,preservation,51,24,27
Xexií,blackmoore,1503,evoker,preservation,42,23,19
Sárkány,ravencrest,1501,evoker,preservation,90,43,47
Candicewho,twisting-nether,1500,evoker,preservation,42,21,21
Зирухит,soulflayer,1499,evoker,preservation,151,73,78
Дарконикс,gordunni,1499,evoker,preservation,158,73,85
Kharduk,outland,1498,evoker,preservation,58,26,32
Eagleflow,aszune,1494,evoker,preservation,127,63,64
Kocaina,ravencrest,1492,evoker,preservation,33,20,13
Мефодийевок,howling-fjord,1492,evoker,preservation,102,49,53
Kelzoker,ysondre,1491,evoker,preservation,44,26,18
Tobbebakar,silvermoon,1490,evoker,preservation,48,22,26
Lytër,dun-modr,1488,evoker,preservation,63,28,35
Draxaer,outland,1486,evoker,preservation,471,248,223
Obbwoke,ravencrest,1486,evoker,preservation,120,53,67
Cirøvoke,ravencrest,1485,evoker,preservation,47,16,31
Viodragon,blackrock,1484,evoker,preservation,51,22,29
Snow,ysera,1483,evoker,preservation,101,51,50
Síire,ravencrest,1481,evoker,preservation,48,26,22
Baszz,aegwynn,1481,evoker,preservation,81,41,40
Cheryl,aggra-português,1480,evoker,preservation,54,25,29
Kuramir,twisting-nether,1479,evoker,preservation,174,84,90
Dramarx,dun-modr,1479,evoker,preservation,66,28,38
Minnimoi,zuluhed,1478,evoker,preservation,128,59,69
Th,stormscale,1477,evoker,preservation,78,50,28
Dunderone,kazzak,1476,evoker,preservation,148,69,79
Donns,frostmane,1474,evoker,preservation,111,66,45
Emeraldino,twisting-nether,1474,evoker,preservation,36,16,20
Spánkpróof,kazzak,1473,evoker,preservation,49,30,19
Coarraze,eldrethalas,1470,evoker,preservation,71,37,34
Cokayn,eonar,1468,evoker,preservation,82,41,41
Pflanz,nozdormu,1467,evoker,preservation,48,29,19
Орехдракона,gordunni,1466,evoker,preservation,51,29,22
Rngayzus,ysondre,1466,evoker,preservation,59,30,29
Liliwood,ravencrest,1464,evoker,preservation,335,168,167
Scottpula,tarren-mill,1462,evoker,preservation,41,18,23
Adromed,kazzak,1460,evoker,preservation,114,59,55
Samidr,ravencrest,1460,evoker,preservation,41,16,25
Lazurius,ravencrest,1459,evoker,preservation,107,45,62
Tarecgosa,sanguino,1458,evoker,preservation,270,134,136
Tabalugaqt,eredar,1458,evoker,preservation,75,37,38
Dragoncya,archimonde,1456,evoker,preservation,120,59,61
Драмуся,gordunni,1456,evoker,preservation,96,43,53
Djrabtah,sargeras,1455,evoker,preservation,105,56,49
Benedict,die-ewige-wacht,1455,evoker,preservation,42,19,23
Beefwing,xavius,1454,evoker,preservation,48,21,27
Blokie,silvermoon,1454,evoker,preservation,56,19,37
Драдексн,gordunni,1453,evoker,preservation,30,17,13
Madelynxoxo,draenor,1450,evoker,preservation,30,25,5
Lizardwizard,darksorrow,1450,evoker,preservation,42,23,19
Skatt,aegwynn,1450,evoker,preservation,290,153,137
Miscodevoker,twisting-nether,1450,evoker,preservation,40,21,19
Nerõ,thrall,1449,evoker,preservation,54,28,26
Korialstraz,aegwynn,1447,evoker,preservation,59,33,26
Bigaluga,blackmoore,1447,evoker,preservation,60,25,35
Dazaar,kazzak,1446,evoker,preservation,84,50,34
Ripgódx,bronzebeard,1444,evoker,preservation,372,190,182
Шкуроносец,gordunni,1442,evoker,preservation,36,20,16
Cragheart,ravencrest,1441,evoker,preservation,116,59,57
Sinusiitiis,destromath,1440,evoker,preservation,36,20,16
Dåseskjuul,kazzak,1440,evoker,preservation,94,51,43
Nynnaydoth,drakthul,1440,evoker,preservation,187,101,86
Krayvoker,tarren-mill,1440,evoker,preservation,65,29,36
Nutson,blackrock,1436,evoker,preservation,30,15,15
Zezus,outland,1434,evoker,preservation,54,31,23
Poporaight,archimonde,1432,evoker,preservation,30,15,15
Dreamevoker,draenor,1432,evoker,preservation,41,19,22
Dragonbrx,blackrock,1430,evoker,preservation,55,33,22
Twokgbananas,blackhand,1430,evoker,preservation,36,16,20
Drogon,nordrassil,1429,evoker,preservation,23,16,7
Vimoker,trollbane,1429,evoker,preservation,162,76,86
Vafanede,twisting-nether,1427,evoker,preservation,48,18,30
Natashtrasza,tarren-mill,1427,evoker,preservation,72,26,46
Dmnzz,blackrock,1425,evoker,preservation,34,18,16
Scalo,kazzak,1425,evoker,preservation,143,73,70
Zarisd,tarren-mill,1425,evoker,preservation,165,80,85
Dragonsito,cthun,1424,evoker,preservation,36,24,12
Condrage,grim-batol,1424,evoker,preservation,113,59,54
Dägon,drakthul,1424,evoker,preservation,292,149,143
Arniye,ravencrest,1422,evoker,preservation,175,91,84
Ptipangoevok,dalaran,1422,evoker,preservation,70,32,38
Mirajhti,blackrock,1421,evoker,preservation,118,57,61
Torae,burning-legion,1421,evoker,preservation,168,80,88
Seboker,nemesis,1420,evoker,preservation,55,34,21
Sârmikas,blackhand,1420,evoker,preservation,30,15,15
Àtòmìc,malorne,1419,evoker,preservation,30,15,15
Yeatsa,blackmoore,1417,evoker,preservation,24,15,9
Beetk,tarren-mill,1415,evoker,preservation,44,19,25
Fubukinoryuu,frostwolf,1413,evoker,preservation,147,77,70
Bevoker,tarren-mill,1413,evoker,preservation,30,15,15
Psheetae,kazzak,1413,evoker,preservation,50,23,27
Lichbõrne,outland,1411,evoker,preservation,42,18,24
Baskoter,turalyon,1411,evoker,preservation,65,24,41
Beec,tarren-mill,1408,evoker,preservation,108,55,53
Draevil,emerald-dream,1406,evoker,preservation,89,48,41
Драксинед,howling-fjord,1406,evoker,preservation,129,65,64
Spiragon,ysondre,1406,evoker,preservation,154,76,78
Smrdimipytel,drakthul,1406,evoker,preservation,64,29,35
Caida,stormscale,1405,evoker,preservation,44,17,27
Cryuu,burning-legion,1404,evoker,preservation,36,15,21
Toadyx,eredar,1404,evoker,preservation,48,18,30
Fiiery,deathwing,1403,evoker,preservation,129,62,67
Емари,howling-fjord,1401,evoker,preservation,49,33,16
Karristrasza,silvermoon,1401,evoker,preservation,36,18,18
Horiz,kazzak,1399,evoker,preservation,53,23,30
Evoketing,tarren-mill,1396,evoker,preservation,24,15,9
Ragnai,sunstrider,1396,evoker,preservation,38,18,20
Omnipøtens,silvermoon,1394,evoker,preservation,48,28,20
Faa,ravencrest,1391,evoker,preservation,60,31,29
Adriia,ravencrest,1390,evoker,preservation,24,15,9
Greensmokey,sanguino,1390,evoker,preservation,36,20,16
Dragio,blackrock,1390,evoker,preservation,60,31,29
Nadoney,hyjal,1389,evoker,preservation,67,42,25
Тиншемет,howling-fjord,1387,evoker,preservation,60,25,35
Syrax,burning-blade,1385,evoker,preservation,32,20,12
Ammendorn,blackrock,1384,evoker,preservation,46,27,19
Rustynails,ragnaros,1384,evoker,preservation,48,17,31
Danriedrake,ravencrest,1383,evoker,preservation,41,22,19
Loveheart,die-aldor,1383,evoker,preservation,206,102,104
Azorgaron,outland,1383,evoker,preservation,60,26,34
Ëvølûtïøñ,pozzo-delleternità,1383,evoker,preservation,45,19,26
Skrix,khadgar,1382,evoker,preservation,99,53,46
Asraestrasz,silvermoon,1380,evoker,preservation,38,24,14
Навидх,howling-fjord,1376,evoker,preservation,54,21,33
Cinquanteuro,hyjal,1374,evoker,preservation,107,49,58
Lohis,grim-batol,1373,evoker,preservation,60,26,34
Imperiux,outland,1372,evoker,preservation,119,67,52
Awfultrash,archimonde,1372,evoker,preservation,42,16,26
Suhnrysanti,argent-dawn,1369,evoker,preservation,66,28,38
Hakuzah,terokkar,1367,evoker,preservation,36,19,17
Esalisko,kazzak,1366,evoker,preservation,66,40,26
Schismxx,outland,1363,evoker,preservation,290,143,147
Scarlexo,ravencrest,1361,evoker,preservation,95,49,46
Dragonsimp,archimonde,1360,evoker,preservation,34,20,14
Gissthebuzzy,dun-modr,1358,evoker,preservation,54,31,23
Blúéráý,ravencrest,1358,evoker,preservation,143,68,75
Ydun,blackrock,1358,evoker,preservation,132,61,71
Aêro,malganis,1358,evoker,preservation,79,35,44
Diezzounette,ysondre,1357,evoker,preservation,54,30,24
Parthunáx,blackrock,1357,evoker,preservation,48,26,22
Resectxz,kazzak,1357,evoker,preservation,124,59,65
Eidachsal,antonidas,1357,evoker,preservation,111,39,72
Ludracy,antonidas,1355,evoker,preservation,120,66,54
Kitoed,aegwynn,1355,evoker,preservation,88,41,47
Eedava,argent-dawn,1354,evoker,preservation,60,36,24
Drackarys,tarren-mill,1354,evoker,preservation,72,35,37
Scalie,ravencrest,1353,evoker,preservation,54,31,23
Еваэльфийка,howling-fjord,1351,evoker,preservation,36,18,18
Jamiewing,ravencrest,1348,evoker,preservation,66,36,30
Drakkujjer,twisting-nether,1348,evoker,preservation,53,28,25
Balgardarth,chamber-of-aspects,1348,evoker,preservation,48,24,24
Matysniak,burning-legion,1348,evoker,preservation,139,69,70
Erhvoker,veknilash,1348,evoker,preservation,147,71,76
Rayehm,hyjal,1344,evoker,preservation,54,22,32
Kryselakatos,dun-modr,1343,evoker,preservation,48,25,23
Albifrons,kazzak,1343,evoker,preservation,42,18,24
Zanarian,defias-brotherhood,1343,evoker,preservation,113,48,65
Vastorius,argent-dawn,1342,evoker,preservation,24,14,10
Xdxd,burning-blade,1342,evoker,preservation,96,45,51
Soø,kazzak,1341,evoker,preservation,30,14,16
Dragondznutz,defias-brotherhood,1341,evoker,preservation,110,50,60
Alldru,outland,1341,evoker,preservation,83,31,52
Drdrag,blackmoore,1340,evoker,preservation,48,31,17
Novadrake,blackrock,1340,evoker,preservation,24,14,10
Scrípt,blackmoore,1340,evoker,preservation,30,14,16
Маркзук,gordunni,1340,evoker,preservation,116,54,62
Drarent,hyjal,1340,evoker,preservation,54,24,30
Louiekin,outland,1340,evoker,preservation,54,22,32
Dagruel,exodar,1339,evoker,preservation,48,20,28
Kimwoker,kazzak,1338,evoker,preservation,36,17,19
Xdingo,blackrock,1338,evoker,preservation,36,14,22
Argnir,archimonde,1337,evoker,preservation,30,14,16
Evoris,frostmane,1337,evoker,preservation,108,47,61
Пероник,gordunni,1336,evoker,preservation,204,102,102
Голденджо,gordunni,1336,evoker,preservation,77,31,46
Emberturd,blackmoore,1335,evoker,preservation,74,35,39
Thellon,frostwolf,1334,evoker,preservation,109,56,53
Ривалгодх,blackscar,1332,evoker,preservation,57,36,21
Лесанор,gordunni,1332,evoker,preservation,35,18,17
Druggz,burning-blade,1331,evoker,preservation,54,35,19
Icemushu,twisting-nether,1331,evoker,preservation,24,14,10
Sitdownnow,blackrock,1331,evoker,preservation,111,53,58
Søâ,blackrock,1331,evoker,preservation,71,33,38
Wïligun,archimonde,1330,evoker,preservation,24,15,9
Spyróò,ravencrest,1330,evoker,preservation,88,39,49
Feloñ,blackrock,1328,evoker,preservation,54,26,28
Brxdragon,antonidas,1327,evoker,preservation,77,44,33
Folevo,stormreaver,1327,evoker,preservation,501,252,249
Wrcdragon,drakthul,1325,evoker,preservation,224,109,115
Создать,deathguard,1324,evoker,preservation,55,33,22
Tymían,burning-legion,1324,evoker,preservation,24,14,10
Fetzi,blackhand,1324,evoker,preservation,126,63,63
Wambino,ravencrest,1324,evoker,preservation,60,29,31
Dragonflye,kazzak,1324,evoker,preservation,202,96,106
Chaks,ravencrest,1323,evoker,preservation,48,23,25
Maudragosa,blackmoore,1322,evoker,preservation,111,59,52
Rhaenîra,twisting-nether,1321,evoker,preservation,61,32,29
Ruszymondias,argent-dawn,1319,evoker,preservation,60,26,34
Airwaves,hyjal,1318,evoker,preservation,65,35,30
Nikoo,runetotem,1318,evoker,preservation,102,52,50
Woeisme,blackhand,1317,evoker,preservation,45,21,24
Uroegevoker,twisting-nether,1316,evoker,preservation,68,36,32
Kleftra,stormscale,1315,evoker,preservation,61,29,32
Dodgens,auchindoun,1315,evoker,preservation,30,14,16
Dárnast,draenor,1314,evoker,preservation,24,14,10
Darigo,ravencrest,1313,evoker,preservation,81,39,42
Fredgobrr,tarren-mill,1312,evoker,preservation,126,74,52
Dumbledrogen,ragnaros,1311,evoker,preservation,72,43,29
Drachenlilie,aegwynn,1311,evoker,preservation,99,43,56
Crunktusk,twisting-nether,1310,evoker,preservation,72,27,45
Colacorta,zuljin,1306,evoker,preservation,260,136,124
Breall,tarren-mill,1306,evoker,preservation,995,489,506
Zygumy,hyjal,1306,evoker,preservation,30,14,16
Xerragon,ravencrest,1306,evoker,preservation,60,20,40
Психея,soulflayer,1304,evoker,preservation,114,61,53
Twocats,twisting-nether,1302,evoker,preservation,65,31,34
Burningflo,naxxramas,1301,evoker,preservation,50,30,20
Spudvoker,silvermoon,1300,evoker,preservation,48,23,25
Chronicryder,draenor,1300,evoker,preservation,63,25,38
Dracanus,bronze-dragonflight,1299,evoker,preservation,118,56,62
Mikevoker,aegwynn,1297,evoker,preservation,48,29,19
Ìzànamì,hyjal,1297,evoker,preservation,87,51,36
Nonolildrake,ysondre,1297,evoker,preservation,82,46,36
Vahamut,argent-dawn,1297,evoker,preservation,42,22,20
Saga,aegwynn,1297,evoker,preservation,184,90,94
Rescuegirl,blackrock,1297,evoker,preservation,105,51,54
Ятутглавный,howling-fjord,1297,evoker,preservation,93,45,48
Elenaevoker,stormscale,1296,evoker,preservation,226,117,109
Tjoheii,kazzak,1296,evoker,preservation,48,22,26
Lynastrasza,silvermoon,1295,evoker,preservation,171,91,80
Aphelïon,dun-modr,1295,evoker,preservation,220,105,115
Dragonerr,kiljaeden,1293,evoker,preservation,86,47,39
Burndaddy,dun-modr,1292,evoker,preservation,53,28,25
Thyrke,aegwynn,1289,evoker,preservation,242,122,120
Ricidevo,nerathor,1288,evoker,preservation,60,22,38
Dothemath,blackmoore,1285,evoker,preservation,136,63,73
Pelington,silvermoon,1285,evoker,preservation,77,34,43
Ксдз,soulflayer,1284,evoker,preservation,44,22,22
Drgnokn,silvermoon,1283,evoker,preservation,106,62,44
Riihi,twisting-nether,1283,evoker,preservation,69,33,36
Cothikos,ysondre,1282,evoker,preservation,34,15,19
Lizandros,blackrock,1282,evoker,preservation,66,27,39
Mercoledi,aegwynn,1280,evoker,preservation,42,29,13
Amaterãsu,kazzak,1280,evoker,preservation,137,72,65
Xiomarita,frostmane,1280,evoker,preservation,60,29,31
Draagon,burning-legion,1280,evoker,preservation,42,18,24
Anso,sanguino,1279,evoker,preservation,137,74,63
Pindaar,zenedar,1279,evoker,preservation,114,52,62
Zaoexo,defias-brotherhood,1278,evoker,preservation,60,28,32
Wokevon,ravencrest,1277,evoker,preservation,76,44,32
Varkoth,nemesis,1277,evoker,preservation,118,55,63
Arkene,argent-dawn,1277,evoker,preservation,40,14,26
Dragondisnut,sylvanas,1276,evoker,preservation,54,28,26
Deflamee,draenor,1275,evoker,preservation,62,35,27
Zeigrem,antonidas,1273,evoker,preservation,24,17,7
Dragonspaff,argent-dawn,1273,evoker,preservation,44,23,21
Beharot,silvermoon,1272,evoker,preservation,96,33,63
Ryxenx,stormscale,1272,evoker,preservation,68,23,45
Malfø,exodar,1271,evoker,preservation,145,73,72
Woke,the-venture-co,1271,evoker,preservation,42,17,25
Sondosa,twisting-nether,1270,evoker,preservation,36,18,18
Vyron,amanthul,1270,evoker,preservation,52,22,30
Aphi,frostwolf,1269,evoker,preservation,128,66,62
Discodidling,silvermoon,1269,evoker,preservation,74,37,37
Evokazoran,dentarg,1269,evoker,preservation,90,30,60
Awaboo,draenor,1268,evoker,preservation,30,16,14
Luftwaffel,blackmoore,1267,evoker,preservation,36,16,20
Дрэгтир,lich-king,1266,evoker,preservation,205,112,93
Ithijin,blackmoore,1266,evoker,preservation,113,55,58
Giü,archimonde,1266,evoker,preservation,183,86,97
Bìå,ravencrest,1265,evoker,preservation,23,18,5
Dorkthyr,sylvanas,1264,evoker,preservation,182,93,89
Goalkeeper,ravencrest,1264,evoker,preservation,90,44,46
Mjkevo,tarren-mill,1264,evoker,preservation,60,27,33
Sudrac,antonidas,1263,evoker,preservation,42,21,21
Rsol,kirin-tor,1263,evoker,preservation,50,24,26
Howtodragon,twisting-nether,1262,evoker,preservation,48,26,22
Drashiku,zuljin,1262,evoker,preservation,186,80,106
Aebivoker,dalaran,1261,evoker,preservation,88,48,40
Modini,blackrock,1261,evoker,preservation,78,38,40
Clw,blackrock,1259,evoker,preservation,17,14,3
Firaxis,kazzak,1259,evoker,preservation,48,20,28
Виндигос,soulflayer,1258,evoker,preservation,42,19,23
Эбиб,gordunni,1257,evoker,preservation,160,90,70
Badrig,silvermoon,1256,evoker,preservation,181,88,93
Detdragetid,stormscale,1254,evoker,preservation,36,21,15
Dayandnight,quelthalas,1254,evoker,preservation,127,64,63
Хвзрываюсьх,howling-fjord,1252,evoker,preservation,102,51,51
Nhervo,hyjal,1251,evoker,preservation,83,39,44
Drakhtyr,draenor,1250,evoker,preservation,60,35,25
Dinotron,uldaman,1249,evoker,preservation,54,27,27
Cenca,blackmoore,1248,evoker,preservation,222,105,117
Ecovoker,outland,1247,evoker,preservation,24,13,11
Heilzan,dalaran,1247,evoker,preservation,52,26,26
Drogøn,khaz-modan,1247,evoker,preservation,48,23,25
Smokitor,kazzak,1246,evoker,preservation,54,28,26
Elpolioloco,culte-de-la-rive-noire,1246,evoker,preservation,30,13,17
Nazalath,eonar,1245,evoker,preservation,42,18,24
Tabalugajr,arthas,1245,evoker,preservation,35,14,21
Margouillat,ysondre,1244,evoker,preservation,24,14,10
Rullatorsvên,sylvanas,1244,evoker,preservation,24,13,11
Wildcardbob,draenor,1244,evoker,preservation,56,20,36
Rozugos,blackrock,1243,evoker,preservation,24,13,11
Crottedezen,archimonde,1243,evoker,preservation,30,13,17
Dragonban,tarren-mill,1243,evoker,preservation,93,37,56
Apaçi,ravencrest,1243,evoker,preservation,51,19,32
Jugzie,twisting-nether,1243,evoker,preservation,36,13,23
Coaxoch,thunderhorn,1242,evoker,preservation,24,14,10
Muccavok,stormrage,1242,evoker,preservation,91,51,40
Gloris,aegwynn,1242,evoker,preservation,63,34,29
Släshés,ravencrest,1241,evoker,preservation,30,14,16
Boonvoker,the-maelstrom,1241,evoker,preservation,138,61,77
Ladrieth,hyjal,1239,evoker,preservation,135,62,73
Kymura,archimonde,1239,evoker,preservation,30,13,17
Stjáuni,ravencrest,1238,evoker,preservation,64,33,31
Тектрис,howling-fjord,1238,evoker,preservation,126,58,68
Парадпланет,howling-fjord,1238,evoker,preservation,89,38,51
Teneja,malganis,1237,evoker,preservation,30,13,17
Everdrop,blackmoore,1236,evoker,preservation,42,19,23
Yorfyr,ravencrest,1234,evoker,preservation,43,20,23
Deathwinng,twisting-nether,1234,evoker,preservation,112,52,60
Xorago,guldan,1233,evoker,preservation,106,53,53
Kampe,nemesis,1233,evoker,preservation,102,51,51
Tenibris,die-nachtwache,1233,evoker,preservation,251,109,142
Kujira,draenor,1232,evoker,preservation,63,34,29
Momodragon,draenor,1230,evoker,preservation,54,20,34
Yeetsera,thrall,1229,evoker,preservation,76,35,41
Beenus,doomhammer,1228,evoker,preservation,36,24,12
Shnptyr,ragnaros,1228,evoker,preservation,48,25,23
Nagimurr,kazzak,1228,evoker,preservation,141,71,70
Glouglouti,drekthar,1228,evoker,preservation,90,45,45
Îcekiss,hyjal,1227,evoker,preservation,24,13,11
Драгоблуд,soulflayer,1227,evoker,preservation,54,25,29
Âbs,archimonde,1227,evoker,preservation,99,41,58
Ragnon,blackrock,1226,evoker,preservation,82,41,41
Drachenglas,antonidas,1226,evoker,preservation,72,33,39
Dratheon,dun-modr,1225,evoker,preservation,156,74,82
Ewo,twisting-nether,1222,evoker,preservation,30,17,13
Уфдрактир,howling-fjord,1222,evoker,preservation,39,14,25
Jupezi,sylvanas,1221,evoker,preservation,91,49,42
Distinkd,draenor,1221,evoker,preservation,60,32,28
Уконэ,blackscar,1221,evoker,preservation,83,41,42
Cudius,archimonde,1220,evoker,preservation,128,72,56
Fivebeers,silvermoon,1220,evoker,preservation,24,13,11
Mortlalune,conseil-des-ombres,1220,evoker,preservation,174,85,89
Kalerinozi,blackhand,1219,evoker,preservation,109,49,60
Мвпгуччи,blackscar,1219,evoker,preservation,36,13,23
Drakdilla,tarren-mill,1216,evoker,preservation,24,13,11
Sorextrazy,twisting-nether,1216,evoker,preservation,143,69,74
Tsukiko,archimonde,1216,evoker,preservation,73,35,38
Setoc,blackrock,1215,evoker,preservation,31,15,16
Lojinevo,twisting-nether,1215,evoker,preservation,95,43,52
Tettareddast,kazzak,1214,evoker,preservation,62,29,33
Uztfuzt,blackmoore,1213,evoker,preservation,55,35,20
Drgndeeznuts,dunemaul,1212,evoker,preservation,33,18,15
Ruinastrasza,silvermoon,1212,evoker,preservation,24,13,11
Vaermithor,tarren-mill,1212,evoker,preservation,98,50,48
Fôxxyguard,azshara,1212,evoker,preservation,36,17,19
Shosho,uldaman,1212,evoker,preservation,68,28,40
Varaug,veklor,1211,evoker,preservation,40,25,15
Nordbert,draenor,1211,evoker,preservation,95,45,50
Plexd,alleria,1211,evoker,preservation,83,39,44
Fizzÿbubbele,kazzak,1211,evoker,preservation,54,20,34
Dreamiee,kazzak,1210,evoker,preservation,129,68,61
Lynt,burning-blade,1210,evoker,preservation,90,44,46
Mesarin,eredar,1210,evoker,preservation,30,13,17
Tokidormi,nemesis,1209,evoker,preservation,36,17,19
Flyingaway,tarren-mill,1209,evoker,preservation,42,19,23
Мэриджэин,soulflayer,1209,evoker,preservation,65,28,37
Therzer,drakthul,1208,evoker,preservation,54,25,29
Kutdraak,laughing-skull,1206,evoker,preservation,36,20,16
Khaela,archimonde,1206,evoker,preservation,153,79,74
Drakutyr,defias-brotherhood,1205,evoker,preservation,49,27,22
Draghini,silvermoon,1205,evoker,preservation,48,20,28
Sqedidragon,burning-legion,1203,evoker,preservation,48,15,33
Flawxy,blackmoore,1200,evoker,preservation,30,17,13
Lapaneri,sylvanas,1200,evoker,preservation,36,14,22
Asharys,argent-dawn,1198,evoker,preservation,82,33,49
Wirden,burning-legion,1197,evoker,preservation,30,13,17
Aayala,dalaran,1196,evoker,preservation,44,24,20
Corneflex,chogall,1196,evoker,preservation,27,13,14
Nurilla,twisting-nether,1195,evoker,preservation,47,28,19
Sarapakara,burning-blade,1195,evoker,preservation,68,28,40
Saucy,sanguino,1194,evoker,preservation,85,48,37
Viserione,outland,1194,evoker,preservation,24,13,11
Lagadta,antonidas,1194,evoker,preservation,84,44,40
Kuzzan,blackhand,1193,evoker,preservation,48,23,25
Ogzan,stormscale,1191,evoker,preservation,66,34,32
Tusibi,hyjal,1190,evoker,preservation,83,53,30
Asinitaris,ravencrest,1189,evoker,preservation,116,57,59
Whitelizzard,tarren-mill,1189,evoker,preservation,92,44,48
Sibvoker,kazzak,1188,evoker,preservation,108,52,56
Smoochbumble,argent-dawn,1188,evoker,preservation,27,13,14
Патриотика,howling-fjord,1188,evoker,preservation,206,98,108
Salamanderx,stormscale,1186,evoker,preservation,22,14,8
Fusion,dun-modr,1186,evoker,preservation,84,41,43
Ärt,argent-dawn,1186,evoker,preservation,132,60,72
Dragawn,grim-batol,1185,evoker,preservation,281,145,136
Drakatha,kazzak,1185,evoker,preservation,113,56,57
Markies,chogall,1185,evoker,preservation,92,45,47
Leblon,stormreaver,1182,evoker,preservation,66,33,33
Drackheal,kaelthas,1181,evoker,preservation,71,35,36
Crazylucifer,kazzak,1181,evoker,preservation,32,15,17
Thundermifln,nemesis,1180,evoker,preservation,78,38,40
Filtendragon,stormscale,1179,evoker,preservation,90,38,52
Akaway,hyjal,1178,evoker,preservation,28,14,14
Orocimaaru,pozzo-delleternità,1178,evoker,preservation,76,34,42
Belkavoker,zirkel-des-cenarius,1177,evoker,preservation,42,14,28
Mélagos,ysondre,1176,evoker,preservation,84,41,43
Irvethius,argent-dawn,1175,evoker,preservation,24,13,11
Lînkôs,aegwynn,1174,evoker,preservation,89,47,42
Fumfum,twisting-nether,1174,evoker,preservation,42,19,23
Cynicál,blackmoore,1173,evoker,preservation,32,20,12
Theurdragon,blades-edge,1173,evoker,preservation,115,51,64
Urelix,ragnaros,1172,evoker,preservation,20,14,6
Ohcaralho,outland,1171,evoker,preservation,62,25,37
Dratsch,blackhand,1170,evoker,preservation,24,17,7
Emolion,draenor,1168,evoker,preservation,60,20,40
Dreiwyn,kazzak,1165,evoker,preservation,60,39,21
Siderion,drakthul,1164,evoker,preservation,48,28,20
Iscale,twisting-nether,1164,evoker,preservation,145,73,72
Ámenó,stormscale,1164,evoker,preservation,56,26,30
Meyowuo,doomhammer,1164,evoker,preservation,58,22,36
Choubalo,archimonde,1159,evoker,preservation,266,133,133
Theocean,turalyon,1158,evoker,preservation,301,138,163
Desnø,frostwolf,1157,evoker,preservation,45,24,21
Flygfjås,stormscale,1157,evoker,preservation,222,111,111
Dolphdrago,outland,1157,evoker,preservation,48,23,25
Dracobelli,drakthul,1157,evoker,preservation,30,14,16
Dangai,draenor,1157,evoker,preservation,35,15,20
Molem,defias-brotherhood,1156,evoker,preservation,170,82,88
Yukemaster,drakthul,1156,evoker,preservation,54,15,39
Azwel,khaz-modan,1155,evoker,preservation,88,45,43
Rosestrasza,drakthul,1154,evoker,preservation,34,23,11
Naloqa,frostwolf,1153,evoker,preservation,31,13,18
Jmy,bloodhoof,1152,evoker,preservation,18,12,6
Evyzz,blackmoore,1152,evoker,preservation,18,12,6
Hehehihihaha,ravencrest,1151,evoker,preservation,24,12,12
Flatterhipy,blackrock,1151,evoker,preservation,24,12,12
Wingzy,chogall,1151,evoker,preservation,240,112,128
Лунарфоллс,howling-fjord,1150,evoker,preservation,18,12,6
Iandret,destromath,1150,evoker,preservation,25,12,13
Theflight,ravencrest,1150,evoker,preservation,30,12,18
Kerandina,alleria,1149,evoker,preservation,30,15,15
Dragonkim,draenor,1149,evoker,preservation,30,12,18
Favera,taerar,1149,evoker,preservation,36,14,22
Laurenzos,tarren-mill,1148,evoker,preservation,30,12,18
Veryspikes,twisting-nether,1148,evoker,preservation,30,12,18
Groovyy,hyjal,1145,evoker,preservation,114,61,53
Rhel,the-maelstrom,1145,evoker,preservation,77,41,36
Uwudyret,tarren-mill,1145,evoker,preservation,30,12,18
Råcòoñ,ravencrest,1144,evoker,preservation,24,12,12
Elaijaz,turalyon,1140,evoker,preservation,72,45,27
Drakeish,kazzak,1140,evoker,preservation,35,16,19
Ryujíin,kazzak,1139,evoker,preservation,23,12,11
Blamdrake,blackhand,1139,evoker,preservation,135,60,75
Mfdragon,grim-batol,1138,evoker,preservation,36,13,23
Jimmytrivet,archimonde,1137,evoker,preservation,142,64,78
Ormlol,kazzak,1136,evoker,preservation,39,14,25
Clamtucker,twisting-nether,1135,evoker,preservation,54,16,38
Flymetothemo,twisting-nether,1134,evoker,preservation,75,41,34
Runs,ravencrest,1134,evoker,preservation,186,92,94
Dragonna,argent-dawn,1134,evoker,preservation,123,60,63
Блэкмакарти,soulflayer,1134,evoker,preservation,36,12,24
Nisiris,doomhammer,1133,evoker,preservation,88,44,44
Кровит,soulflayer,1133,evoker,preservation,40,14,26
Darkstrasza,hellfire,1132,evoker,preservation,18,12,6
Cxsmetic,antonidas,1132,evoker,preservation,49,29,20
Bestofriendo,eredar,1132,evoker,preservation,112,59,53
Verithian,kazzak,1131,evoker,preservation,84,39,45
Syccs,blackrock,1130,evoker,preservation,24,12,12
Steeken,haomarush,1130,evoker,preservation,66,32,34
Adnoc,tarren-mill,1127,evoker,preservation,37,17,20
Hyggëê,sanguino,1127,evoker,preservation,70,25,45
Draknr,alakir,1125,evoker,preservation,42,16,26
Djolero,silvermoon,1124,evoker,preservation,60,28,32
Raikirix,silvermoon,1123,evoker,preservation,24,12,12
Awerdoos,burning-legion,1123,evoker,preservation,96,43,53
Raøug,blackmoore,1119,evoker,preservation,126,50,76
Kharalambos,stormscale,1118,evoker,preservation,48,21,27
Юнигоса,soulflayer,1117,evoker,preservation,28,14,14
Pe,dalaran,1117,evoker,preservation,24,12,12
Draktoros,kazzak,1117,evoker,preservation,50,23,27
Dracarysfire,kazzak,1116,evoker,preservation,30,15,15
Eosin,blackrock,1115,evoker,preservation,35,18,17
Geckonen,stormreaver,1114,evoker,preservation,261,125,136
Epicrusii,outland,1114,evoker,preservation,26,12,14
Drogoon,ravencrest,1114,evoker,preservation,29,12,17
Scaleyfurry,azshara,1113,evoker,preservation,34,23,11
Gilgakek,darksorrow,1112,evoker,preservation,134,63,71
Chrisussy,argent-dawn,1111,evoker,preservation,35,12,23
Zethreus,silvermoon,1110,evoker,preservation,76,36,40
Kekvoker,antonidas,1107,evoker,preservation,84,37,47
Huusdrache,outland,1107,evoker,preservation,34,14,20
Hems,bronzebeard,1106,evoker,preservation,157,85,72
Renistra,argent-dawn,1105,evoker,preservation,102,49,53
Zaverion,nathrezim,1103,evoker,preservation,109,58,51
Spïzz,dun-modr,1103,evoker,preservation,72,31,41
Bombrush,ragnaros,1102,evoker,preservation,33,20,13
Adriiaa,dalaran,1102,evoker,preservation,86,40,46
Dracwyn,shattrath,1102,evoker,preservation,43,19,24
Kédragon,archimonde,1102,evoker,preservation,31,13,18
Nagoli,silvermoon,1100,evoker,preservation,76,36,40
Stormwing,twilights-hammer,1098,evoker,preservation,77,35,42
Алекстраса,blackscar,1097,evoker,preservation,30,16,14
Dmn,defias-brotherhood,1097,evoker,preservation,54,24,30
Azdajae,gilneas,1096,evoker,preservation,42,25,17
Kurger,twisting-nether,1096,evoker,preservation,98,42,56
Tennin,thrall,1095,evoker,preservation,63,33,30
Звездобык,borean-tundra,1095,evoker,preservation,89,33,56
Saphirá,hyjal,1094,evoker,preservation,28,13,15
Frreeyya,silvermoon,1094,evoker,preservation,29,13,16
Xidalulz,sylvanas,1093,evoker,preservation,12,12,0
Douevnfly,ravencrest,1093,evoker,preservation,105,52,53
Рептаиль,howling-fjord,1093,evoker,preservation,119,54,65
Nebulai,silvermoon,1093,evoker,preservation,60,25,35
Slimygecko,ravencrest,1090,evoker,preservation,94,44,50
Mugeki,burning-legion,1089,evoker,preservation,68,31,37
Artïa,archimonde,1088,evoker,preservation,84,44,40
Чвкдрагонит,soulflayer,1088,evoker,preservation,66,27,39
Dräcø,dalaran,1087,evoker,preservation,52,30,22
Шадофдрагон,deathweaver,1087,evoker,preservation,115,64,51
Bambusák,draenor,1086,evoker,preservation,242,107,135
Tussyy,exodar,1084,evoker,preservation,60,26,34
Adrasteios,twisting-nether,1083,evoker,preservation,36,21,15
Doriangray,drakthul,1082,evoker,preservation,38,19,19
Targzæ,hyjal,1082,evoker,preservation,36,15,21
Draakoñ,outland,1082,evoker,preservation,29,12,17
Эврилайт,howling-fjord,1082,evoker,preservation,29,12,17
Sefa,drakthul,1080,evoker,preservation,71,36,35
Richterscale,defias-brotherhood,1080,evoker,preservation,96,35,61
Excisionx,silvermoon,1079,evoker,preservation,108,48,60
Blackli,kazzak,1074,evoker,preservation,33,14,19
Pikiscalez,bronzebeard,1073,evoker,preservation,30,15,15
Dontiá,draenor,1072,evoker,preservation,188,95,93
Maverickx,nemesis,1070,evoker,preservation,43,23,20
Dragonpastor,kazzak,1070,evoker,preservation,36,18,18
Iphonetwo,ravencrest,1067,evoker,preservation,50,28,22
Killafoolz,kazzak,1067,evoker,preservation,25,12,13
Rafale,the-maelstrom,1063,evoker,preservation,288,142,146
Cazé,archimonde,1062,evoker,preservation,60,29,31
Guntoker,tarren-mill,1062,evoker,preservation,156,73,83
Bullettail,silvermoon,1061,evoker,preservation,67,24,43
Lusacan,tarren-mill,1058,evoker,preservation,57,28,29
Llwyin,ragnaros,1058,evoker,preservation,62,28,34
Lazorkröte,blackrock,1058,evoker,preservation,72,26,46
Dractarys,arathi,1057,evoker,preservation,104,52,52
Øoøoøoøo,outland,1056,evoker,preservation,12,11,1
Вискписк,soulflayer,1056,evoker,preservation,12,11,1
Berlyvoke,stormscale,1056,evoker,preservation,18,11,7
Fûrý,twisting-nether,1056,evoker,preservation,24,11,13
Огнеметчег,razuvious,1055,evoker,preservation,83,46,37
Drâcarys,destromath,1055,evoker,preservation,116,64,52
Jessamy,ragnaros,1055,evoker,preservation,24,11,13
Tarystrasza,blackrock,1055,evoker,preservation,42,16,26
Lacer,minahonda,1055,evoker,preservation,30,11,19
Elathru,kazzak,1055,evoker,preservation,48,17,31
Enzetrius,argent-dawn,1054,evoker,preservation,24,11,13
Tojodormi,argent-dawn,1054,evoker,preservation,24,11,13
Adrienne,steamwheedle-cartel,1054,evoker,preservation,30,13,17
Alanikus,silvermoon,1052,evoker,preservation,24,11,13
Drdrayk,balnazzar,1051,evoker,preservation,24,11,13
Reolden,stormscale,1048,evoker,preservation,20,11,9
Manegø,eredar,1048,evoker,preservation,24,11,13
Deathwingx,sylvanas,1046,evoker,preservation,24,11,13
Tritiana,blackrock,1046,evoker,preservation,36,11,25
Zenbaka,marécage-de-zangar,1044,evoker,preservation,24,11,13
Deathgodsh,draenor,1043,evoker,preservation,38,16,22
Sixlife,tarren-mill,1043,evoker,preservation,33,12,21
Pyrestra,argent-dawn,1042,evoker,preservation,18,11,7
Zonye,archimonde,1042,evoker,preservation,38,16,22
Alicendre,hyjal,1040,evoker,preservation,18,11,7
Wtwt,draenor,1040,evoker,preservation,36,11,25
Montralkyr,antonidas,1039,evoker,preservation,42,22,20
Predatax,drakthul,1039,evoker,preservation,142,71,71
Iceslinger,stormscale,1036,evoker,preservation,143,69,74
Haawwt,eredar,1035,evoker,preservation,48,20,28
Axuli,blackrock,1035,evoker,preservation,41,17,24
Dioni,sylvanas,1033,evoker,preservation,51,22,29
Pixxell,blackmoore,1031,evoker,preservation,59,32,27
Tyuz,antonidas,1031,evoker,preservation,26,13,13
Zymotîx,stormscale,1031,evoker,preservation,58,18,40
Chrisú,thrall,1029,evoker,preservation,30,12,18
Dracnass,silvermoon,1028,evoker,preservation,24,13,11
Athyrstria,blackmoore,1028,evoker,preservation,65,18,47
Blazeros,sylvanas,1026,evoker,preservation,66,38,28
Shenronox,ragnaros,1026,evoker,preservation,58,25,33
Zathîel,argent-dawn,1026,evoker,preservation,149,64,85
Lizardofoz,argent-dawn,1023,evoker,preservation,42,23,19
Fernasdrake,aggra-português,1023,evoker,preservation,42,21,21
Koristrasza,ravencrest,1022,evoker,preservation,36,15,21
Ovipare,archimonde,1021,evoker,preservation,45,24,21
Kärlethos,dun-modr,1020,evoker,preservation,24,12,12
Nurant,blackmoore,1020,evoker,preservation,209,98,111
Drâker,twisting-nether,1020,evoker,preservation,35,11,24
Baléryon,archimonde,1019,evoker,preservation,23,15,8
Gilarys,silvermoon,1019,evoker,preservation,23,11,12
Aarón,der-mithrilorden,1019,evoker,preservation,23,11,12
Chromatus,azjolnerub,1018,evoker,preservation,57,31,26
Aezthaza,outland,1018,evoker,preservation,26,12,14
Blackwing,twilights-hammer,1018,evoker,preservation,81,37,44
Kamings,outland,1016,evoker,preservation,44,28,16
Драколайт,eversong,1015,evoker,preservation,24,11,13
Nochance,dentarg,1015,evoker,preservation,193,85,108
Offering,ravencrest,1015,evoker,preservation,30,11,19
Klim,temple-noir,1014,evoker,preservation,42,11,31
Zaraten,hyjal,1013,evoker,preservation,86,46,40
Bimbola,sanguino,1013,evoker,preservation,24,12,12
Jurrassic,defias-brotherhood,1013,evoker,preservation,123,61,62
Гопоп,gordunni,1011,evoker,preservation,31,14,17
Ewings,archimonde,1009,evoker,preservation,54,18,36
Hateroll,ravencrest,1008,evoker,preservation,24,13,11
Retyss,twisting-nether,1008,evoker,preservation,390,193,197
Blewjobs,sylvanas,1007,evoker,preservation,137,65,72
Meshuggåh,deathwing,1005,evoker,preservation,150,60,90
Belledejour,magtheridon,1005,evoker,preservation,70,23,47
Лалиса,soulflayer,1003,evoker,preservation,36,12,24
Kiloferus,azjolnerub,1001,evoker,preservation,95,52,43
Xzarak,kazzak,1001,evoker,preservation,30,11,19
Мйлкйвей,deathguard,1000,evoker,preservation,52,32,20
Thedrake,aegwynn,1000,evoker,preservation,53,30,23
Archont,eredar,999,evoker,preservation,42,12,30
Escamosa,exodar,998,evoker,preservation,66,20,46
Morlie,argent-dawn,996,evoker,preservation,82,37,45
Ophois,malygos,995,evoker,preservation,16,12,4
Malougos,ragnaros,994,evoker,preservation,263,119,144
Liane,drakthul,994,evoker,preservation,48,19,29
Lemustache,argent-dawn,994,evoker,preservation,36,12,24
Bufor,sanguino,993,evoker,preservation,24,13,11
Капрал,gordunni,993,evoker,preservation,39,14,25
Evooke,outland,989,evoker,preservation,34,11,23
Shëitan,sinstralis,988,evoker,preservation,47,16,31
Viseron,zuljin,987,evoker,preservation,155,63,92
Deadfyre,dun-modr,986,evoker,preservation,30,15,15
Stuffi,frostwolf,986,evoker,preservation,66,27,39
Hios,twisting-nether,984,evoker,preservation,60,33,27
Kraaznus,ravencrest,984,evoker,preservation,20,11,9
Gantsu,blackhand,984,evoker,preservation,102,50,52
Schenlong,kelthuzad,982,evoker,preservation,114,52,62
Voryax,kirin-tor,981,evoker,preservation,118,56,62
Vicmilo,sanguino,981,evoker,preservation,36,16,20
Kirinde,draenor,978,evoker,preservation,230,100,130
Taynia,stormscale,978,evoker,preservation,28,12,16
Pigioto,silvermoon,973,evoker,preservation,234,116,118
Norgam,chogall,967,evoker,preservation,24,15,9
Adula,azjolnerub,965,evoker,preservation,60,23,37
Алифсе,howling-fjord,965,evoker,preservation,84,23,61
Drazikz,archimonde,964,evoker,preservation,112,58,54
Meruzhan,chamber-of-aspects,964,evoker,preservation,59,23,36
Æwárosaurus,ravencrest,963,evoker,preservation,31,15,16
Voltyrh,antonidas,962,evoker,preservation,25,11,14
Drakares,la-croisade-écarlate,962,evoker,preservation,54,19,35
Drâkarys,khaz-modan,961,evoker,preservation,63,24,39
Cinnamoon,defias-brotherhood,960,evoker,preservation,21,12,9
Konzaa,argent-dawn,960,evoker,preservation,18,10,8
Rexerection,silvermoon,960,evoker,preservation,24,10,14
Gedzon,silvermoon,959,evoker,preservation,18,10,8
Snipy,burning-legion,959,evoker,preservation,18,10,8
Shôrty,ravencrest,959,evoker,preservation,18,10,8
Shaze,zuljin,959,evoker,preservation,24,10,14
Lootharon,blackhand,959,evoker,preservation,24,10,14
Hound,lordaeron,959,evoker,preservation,30,11,19
Sobeki,sanguino,958,evoker,preservation,12,10,2
Азизиус,howling-fjord,958,evoker,preservation,18,10,8
Inspecto,turalyon,956,evoker,preservation,55,32,23
Nebulon,dethecus,956,evoker,preservation,137,62,75
Shenronblue,bloodscalp,956,evoker,preservation,30,10,20
Zalegos,kazzak,955,evoker,preservation,24,10,14
Xorizard,runetotem,954,evoker,preservation,24,10,14
Zahaak,doomhammer,953,evoker,preservation,81,35,46
Jhoanna,grim-batol,951,evoker,preservation,66,32,34
Тафл,blackscar,950,evoker,preservation,24,10,14
Bobonakia,sylvanas,950,evoker,preservation,24,10,14
Ninecloud,executus,949,evoker,preservation,24,15,9
Jamesdouglas,eredar,949,evoker,preservation,72,40,32
Difigiano,blackmoore,948,evoker,preservation,18,10,8
Slashlowe,archimonde,948,evoker,preservation,40,18,22
Palindre,argent-dawn,947,evoker,preservation,107,52,55
Campus,blackrock,947,evoker,preservation,30,10,20
Exacgos,sanguino,946,evoker,preservation,24,15,9
Dragonblade,drakthul,945,evoker,preservation,18,10,8
Gaulavoker,ragnaros,944,evoker,preservation,30,10,20
Vores,norgannon,942,evoker,preservation,94,44,50
Räze,twisting-nether,942,evoker,preservation,24,10,14
Puffdaddyxd,twisting-nether,942,evoker,preservation,24,10,14
Iswíftz,twisting-nether,941,evoker,preservation,42,10,32
Винтер,azuregos,935,evoker,preservation,19,11,8
Evobse,silvermoon,935,evoker,preservation,36,10,26
Vozzat,stormscale,934,evoker,preservation,24,11,13
Suntigi,neptulon,934,evoker,preservation,36,14,22
Draklorn,moonglade,933,evoker,preservation,75,36,39
Touge,varimathras,932,evoker,preservation,36,16,20
Tisik,terokkar,931,evoker,preservation,24,10,14
Evocatrice,nemesis,929,evoker,preservation,18,10,8
Nicholbolas,nordrassil,929,evoker,preservation,29,16,13
Singe,nemesis,928,evoker,preservation,132,45,87
Абьюз,galakrond,926,evoker,preservation,430,220,210
Kalestis,arthas,925,evoker,preservation,38,20,18
Purpledrac,draenor,923,evoker,preservation,50,25,25
Hazizsarkany,ragnaros,919,evoker,preservation,18,12,6
Aevon,blackrock,919,evoker,preservation,179,84,95
Kyrathir,hyjal,919,evoker,preservation,96,40,56
Schüppchên,antonidas,917,evoker,preservation,34,17,17
Ashla,nemesis,917,evoker,preservation,115,56,59
Turmonk,nordrassil,917,evoker,preservation,24,10,14
Shenrøn,garona,913,evoker,preservation,48,12,36
Микрощука,gordunni,911,evoker,preservation,23,10,13
Grizu,die-ewige-wacht,911,evoker,preservation,24,10,14
Ahyllesevok,antonidas,907,evoker,preservation,21,11,10
Psycotrop,illidan,904,evoker,preservation,18,11,7
Лунет,lich-king,903,evoker,preservation,102,48,54
Tf,doomhammer,903,evoker,preservation,70,26,44
Krestrazzos,blackmoore,902,evoker,preservation,60,21,39
Cárried,twilights-hammer,902,evoker,preservation,33,11,22
Canitabravar,cthun,898,evoker,preservation,60,30,30
Daevid,emeriss,896,evoker,preservation,28,10,18
Exxa,tarren-mill,894,evoker,preservation,26,10,16
Minifléx,burning-legion,893,evoker,preservation,22,10,12
Anlong,alakir,893,evoker,preservation,47,20,27
Reddeaddrago,silvermoon,890,evoker,preservation,68,33,35
Morsan,tichondrius,890,evoker,preservation,51,24,27
Domynevoc,hyjal,889,evoker,preservation,126,63,63
Балрогхаоса,gordunni,887,evoker,preservation,54,22,32
Drakars,kazzak,886,evoker,preservation,62,27,35
Калесгоз,howling-fjord,883,evoker,preservation,123,49,74
Drachi,ambossar,880,evoker,preservation,78,35,43
Leonarty,nemesis,879,evoker,preservation,36,16,20
Elvifirerage,twisting-nether,878,evoker,preservation,17,10,7
Quetzalcoâtl,burning-blade,878,evoker,preservation,66,31,35
Mergwahlbark,hyjal,878,evoker,preservation,29,10,19
Верметор,soulflayer,874,evoker,preservation,150,61,89
Antistrasza,argent-dawn,874,evoker,preservation,102,39,63
Drakthur,terenas,874,evoker,preservation,39,11,28
Mariorel,stormscale,872,evoker,preservation,62,21,41
Thenotelmat,twisting-nether,868,evoker,preservation,17,11,6
Pentraktar,pozzo-delleternità,868,evoker,preservation,37,12,25
Antifightx,kazzak,864,evoker,preservation,12,9,3
Flystowardsu,argent-dawn,864,evoker,preservation,12,9,3
Dekaralol,ravencrest,864,evoker,preservation,12,9,3
Dracthyrael,drakthul,864,evoker,preservation,18,9,9
Skytrace,silvermoon,864,evoker,preservation,52,12,40
Мишанячешуя,gordunni,863,evoker,preservation,12,9,3
Nassuada,dalaran,863,evoker,preservation,18,9,9
Arbîter,eredar,863,evoker,preservation,18,9,9
Cupcâke,dalaran,863,evoker,preservation,18,9,9
Wjörm,outland,863,evoker,preservation,18,9,9
Lereena,la-croisade-écarlate,863,evoker,preservation,18,9,9
Rímmer,kazzak,863,evoker,preservation,24,9,15
Myntara,tarren-mill,863,evoker,preservation,24,9,15
Dractharion,blackrock,863,evoker,preservation,30,9,21
Sïmana,aggra-português,862,evoker,preservation,18,9,9
Yesdaddyowo,draenor,862,evoker,preservation,18,9,9
Jondal,kazzak,862,evoker,preservation,24,9,15
Drakkaz,burning-legion,861,evoker,preservation,18,9,9
Mimic,scarshield-legion,861,evoker,preservation,18,9,9
Thymian,ambossar,861,evoker,preservation,195,90,105
Mistvoke,kazzak,860,evoker,preservation,18,9,9
Miruvore,tarren-mill,860,evoker,preservation,24,9,15
Ивдигодх,gordunni,860,evoker,preservation,24,9,15
Paizz,tarren-mill,859,evoker,preservation,18,9,9
Lithnxv,bladefist,859,evoker,preservation,18,9,9
Sysstrazsa,hyjal,859,evoker,preservation,18,9,9
Drakelle,dalaran,858,evoker,preservation,12,9,3
Damssx,medivh,858,evoker,preservation,45,20,25
Evok,deathwing,858,evoker,preservation,24,10,14
Azza,uldum,858,evoker,preservation,45,18,27
Nedflanderss,silvermoon,856,evoker,preservation,18,9,9
Поплавочек,soulflayer,856,evoker,preservation,60,27,33
Fafnîr,stormrage,854,evoker,preservation,18,9,9
Dudebrö,arathor,854,evoker,preservation,18,9,9
Minikuja,culte-de-la-rive-noire,853,evoker,preservation,68,28,40
Ddraig,thunderhorn,853,evoker,preservation,39,12,27
Alulu,ysondre,852,evoker,preservation,52,25,27
Eurydíke,blackhand,852,evoker,preservation,24,9,15
Javåscript,outland,849,evoker,preservation,18,9,9
Marasz,silvermoon,849,evoker,preservation,120,54,66
Аверьятор,fordragon,848,evoker,preservation,18,9,9
Iashiak,silvermoon,848,evoker,preservation,22,10,12
Evÿ,turalyon,846,evoker,preservation,48,19,29
Kaiser,trollbane,845,evoker,preservation,24,9,15
Mefedrone,argent-dawn,845,evoker,preservation,54,19,35
Yadormi,sylvanas,843,evoker,preservation,60,28,32
Skìttlês,antonidas,841,evoker,preservation,303,142,161
Drakmool,ysondre,840,evoker,preservation,54,23,31
Spirow,archimonde,839,evoker,preservation,91,36,55
Eymo,archimonde,836,evoker,preservation,24,9,15
Dazzus,twilights-hammer,833,evoker,preservation,24,9,15
Roastedpig,kazzak,831,evoker,preservation,17,9,8
Zerario,blackhand,827,evoker,preservation,23,9,14
Mendes,kazzak,827,evoker,preservation,84,26,58
Sumo,burning-legion,826,evoker,preservation,58,25,33
Xanthisa,malganis,824,evoker,preservation,57,25,32
Деонтология,blackscar,823,evoker,preservation,42,16,26
Azurewings,argent-dawn,821,evoker,preservation,98,37,61
Myndragosa,varimathras,816,evoker,preservation,21,10,11
Miumyuki,drakthul,815,evoker,preservation,54,21,33
Kàzuée,outland,812,evoker,preservation,50,14,36
Drakelussac,silvermoon,809,evoker,preservation,22,10,12
Uxiono,dun-modr,808,evoker,preservation,38,10,28
Smegma,norgannon,806,evoker,preservation,23,9,14
Terrorwings,twisting-nether,802,evoker,preservation,29,11,18
Vantu,grim-batol,798,evoker,preservation,20,10,10
Lunariëlle,les-sentinelles,794,evoker,preservation,36,14,22
Viseriðn,archimonde,792,evoker,preservation,48,16,32
Cheapdragon,tarren-mill,791,evoker,preservation,45,18,27
Scraier,ravenholdt,789,evoker,preservation,21,11,10
Эфирид,blackscar,779,evoker,preservation,59,22,37
Тирдде,deathweaver,778,evoker,preservation,168,73,95
Høt,nemesis,775,evoker,preservation,19,9,10
Kanketopg,kazzak,768,evoker,preservation,12,8,4
Zendaë,archimonde,768,evoker,preservation,12,8,4
Naicover,kazzak,768,evoker,preservation,12,8,4
Fevy,stormscale,768,evoker,preservation,12,8,4
Mentallyoff,ravencrest,768,evoker,preservation,12,8,4
Lurkarian,stormscale,768,evoker,preservation,12,8,4
Ghettovoke,sylvanas,768,evoker,preservation,12,8,4
Waytwohigh,ravencrest,768,evoker,preservation,18,8,10
Ringil,tarren-mill,768,evoker,preservation,18,8,10
Nastywing,magtheridon,768,evoker,preservation,18,8,10
Nyxion,shattered-halls,768,evoker,preservation,18,8,10
Змеетян,gordunni,768,evoker,preservation,24,8,16
Ancientfire,tarren-mill,768,evoker,preservation,24,8,16
Krazuntus,argent-dawn,767,evoker,preservation,12,8,4
Jormün,dalaran,767,evoker,preservation,12,8,4
Alariath,mannoroth,767,evoker,preservation,18,8,10
Safcøn,eredar,767,evoker,preservation,18,8,10
Ñancey,draenor,767,evoker,preservation,18,8,10
Mundyr,sylvanas,767,evoker,preservation,18,8,10
Дракорэй,gordunni,767,evoker,preservation,24,8,16
Инкуласан,gordunni,767,evoker,preservation,24,8,16
Blakhrua,ragnaros,767,evoker,preservation,24,8,16
Hool,silvermoon,766,evoker,preservation,305,147,158
Nêóô,blackrock,765,evoker,preservation,18,8,10
Daracthyr,arathor,765,evoker,preservation,18,8,10
Toplevel,eredar,765,evoker,preservation,24,8,16
Epicfire,ravencrest,765,evoker,preservation,24,8,16
Уполнамоченн,soulflayer,764,evoker,preservation,12,8,4
Arecibo,tarren-mill,762,evoker,preservation,12,8,4
Qneiden,archimonde,760,evoker,preservation,18,8,10
Turdbreather,kazzak,759,evoker,preservation,24,8,16
Archedify,norgannon,759,evoker,preservation,36,8,28
Sarodari,blackhand,757,evoker,preservation,18,8,10
Dragonrocker,silvermoon,757,evoker,preservation,24,8,16
Sunfyres,frostmane,757,evoker,preservation,37,11,26
Cyclops,zuljin,756,evoker,preservation,24,8,16
Sáróman,ravencrest,755,evoker,preservation,44,16,28
Omnivoker,quelthalas,754,evoker,preservation,18,8,10
Fodom,medivh,744,evoker,preservation,24,8,16
Kathaa,archimonde,740,evoker,preservation,54,16,38
Dracanis,shendralar,739,evoker,preservation,42,17,25
Missnorway,blackmoore,734,evoker,preservation,17,8,9
Dragonpd,ysondre,727,evoker,preservation,23,8,15
Lunarxina,burning-legion,716,evoker,preservation,36,10,26
Moondraka,outland,714,evoker,preservation,18,9,9
Eldiable,dun-modr,713,evoker,preservation,15,9,6
Altairion,dalaran,708,evoker,preservation,42,21,21
Nêrifiel,hyjal,707,evoker,preservation,23,8,15
Grillkylling,outland,702,evoker,preservation,25,9,16
Avizz,tarren-mill,687,evoker,preservation,26,12,14
Àzè,ravencrest,672,evoker,preservation,12,7,5
Zarikus,argent-dawn,672,evoker,preservation,12,7,5
Stormnn,kazzak,672,evoker,preservation,12,7,5
Needstherapy,ravencrest,672,evoker,preservation,12,7,5
Лфграб,howling-fjord,672,evoker,preservation,12,7,5
Selectaa,grim-batol,672,evoker,preservation,18,7,11
Deadwing,eonar,672,evoker,preservation,18,7,11
Spacebreath,ravencrest,672,evoker,preservation,18,7,11
Aleithia,dun-modr,672,evoker,preservation,18,7,11
Iwaavoker,archimonde,672,evoker,preservation,18,7,11
Ðovahkiin,tarren-mill,672,evoker,preservation,18,7,11
Óceiros,silvermoon,672,evoker,preservation,18,7,11
Sulführer,sanguino,672,evoker,preservation,18,7,11
Orazur,hyjal,672,evoker,preservation,22,8,14
Soupmah,silvermoon,672,evoker,preservation,24,7,17
Ybndrake,outland,671,evoker,preservation,12,7,5
Dractera,kazzak,671,evoker,preservation,12,7,5
Flookx,silvermoon,671,evoker,preservation,12,7,5
Porkness,argent-dawn,671,evoker,preservation,12,7,5
Draaxy,twisting-nether,671,evoker,preservation,15,8,7
Fusanabide,kazzak,671,evoker,preservation,14,7,7
Иванза,howling-fjord,671,evoker,preservation,18,7,11
Tse,grim-batol,671,evoker,preservation,18,7,11
Гневиан,eversong,671,evoker,preservation,18,7,11
Myszostrasza,burning-legion,670,evoker,preservation,12,7,5
Liroo,hyjal,670,evoker,preservation,12,7,5
Daxiniti,ragnaros,670,evoker,preservation,24,7,17
Bobbyheal,blackmoore,670,evoker,preservation,30,7,23
Grüenchotz,malygos,669,evoker,preservation,12,7,5
Ilagged,stormscale,669,evoker,preservation,12,7,5
Malfestio,zuljin,669,evoker,preservation,12,7,5
Avemonetemus,silvermoon,669,evoker,preservation,18,7,11
Morddragonx,draenor,669,evoker,preservation,18,7,11
Finnh,kazzak,669,evoker,preservation,24,7,17
Vatiras,magtheridon,669,evoker,preservation,24,7,17
Tamargon,frostwhisper,669,evoker,preservation,24,7,17
Wywill,eitrigg,668,evoker,preservation,12,7,5
Entombevoker,twisting-nether,668,evoker,preservation,12,7,5
Vermithors,ravencrest,668,evoker,preservation,18,7,11
Prikkedøden,grim-batol,668,evoker,preservation,18,7,11
Панкрок,thermaplugg,668,evoker,preservation,21,7,14
Morph,talnivarr,667,evoker,preservation,18,7,11
Zarog,frostwolf,667,evoker,preservation,25,8,17
Hornbeam,tarren-mill,666,evoker,preservation,18,7,11
Acnologîa,ysondre,665,evoker,preservation,12,7,5
Gihzmo,tarren-mill,664,evoker,preservation,12,7,5
Ignisaureus,silvermoon,659,evoker,preservation,30,7,23
Папугайка,gordunni,655,evoker,preservation,18,7,11
Gimmetheloop,blackrock,655,evoker,preservation,20,7,13
Charezard,draenor,638,evoker,preservation,17,7,10
Nurazar,azuremyst,618,evoker,preservation,15,8,7
Blyatcuka,kazzak,617,evoker,preservation,17,8,9
Quewl,blackmoore,606,evoker,preservation,11,7,4
Spyrobaby,burning-legion,605,evoker,preservation,11,7,4
Ekko,nethersturm,605,evoker,preservation,31,7,24
Khêstrel,der-rat-von-dalaran,596,evoker,preservation,38,9,29
Büsselberg,blackmoore,595,evoker,preservation,27,8,19
Младодуб,soulflayer,588,evoker,preservation,51,8,43
Drakovitch,archimonde,576,evoker,preservation,12,6,6
Rømmegrøt,tarren-mill,576,evoker,preservation,12,6,6
Krakadayle,archimonde,576,evoker,preservation,12,6,6
Asrwea,draenor,576,evoker,preservation,12,6,6
Lasissi,dragonblight,576,evoker,preservation,12,6,6
Ritoplis,cthun,576,evoker,preservation,12,6,6
Darkevokoul,conseil-des-ombres,576,evoker,preservation,12,6,6
Oceirós,draenor,576,evoker,preservation,12,6,6
Talynn,sylvanas,576,evoker,preservation,12,6,6
Glefs,stormscale,576,evoker,preservation,12,6,6
Djsnake,twisting-nether,576,evoker,preservation,12,6,6
Sonderprice,blackhand,576,evoker,preservation,12,6,6
Luu,the-maelstrom,576,evoker,preservation,12,6,6
Dréegon,hyjal,576,evoker,preservation,12,6,6
Drakarroar,ragnaros,576,evoker,preservation,12,6,6
Arfedar,kazzak,576,evoker,preservation,12,6,6
Dizatwo,silvermoon,576,evoker,preservation,12,6,6
Lorixia,argent-dawn,576,evoker,preservation,18,6,12
Eliteena,kazzak,576,evoker,preservation,18,6,12
Lolprevoker,outland,576,evoker,preservation,18,6,12
Khaliy,blackrock,576,evoker,preservation,18,6,12
Nosnipeofc,blackmoore,576,evoker,preservation,18,6,12
Discodraken,stormscale,576,evoker,preservation,18,6,12
Lìssàndra,argent-dawn,576,evoker,preservation,24,6,18
Invinite,blackrock,576,evoker,preservation,24,6,18
Дэзвинк,gordunni,576,evoker,preservation,24,6,18
Drakuin,ravencrest,576,evoker,preservation,30,6,24
Drakeó,kazzak,575,evoker,preservation,12,6,6
Nevara,ragnaros,575,evoker,preservation,12,6,6
Timyst,outland,575,evoker,preservation,12,6,6
Сулистраза,blackscar,575,evoker,preservation,12,6,6
Dragonlet,twisting-nether,575,evoker,preservation,12,6,6
Draccaris,silvermoon,575,evoker,preservation,12,6,6
Pasqvoker,ravencrest,575,evoker,preservation,12,6,6
Dragonzo,arathor,575,evoker,preservation,12,6,6
Drachenbeton,blackhand,575,evoker,preservation,12,6,6
Raegos,ravencrest,575,evoker,preservation,12,6,6
Nexevo,blackmoore,575,evoker,preservation,18,6,12
Iplanspie,stormreaver,575,evoker,preservation,18,6,12
Lykine,blackrock,575,evoker,preservation,18,6,12
Dreamdoll,tarren-mill,575,evoker,preservation,24,6,18
Vaporesso,dun-modr,574,evoker,preservation,12,6,6
Dikkedraak,dentarg,574,evoker,preservation,12,6,6
Drakpojke,stormscale,574,evoker,preservation,12,6,6
Etherwood,bronze-dragonflight,573,evoker,preservation,12,6,6
Apolerion,ragnaros,573,evoker,preservation,12,6,6
Blainedragon,arathor,573,evoker,preservation,18,6,12
Drunkvoker,stormscale,573,evoker,preservation,18,6,12
Yodrago,kazzak,572,evoker,preservation,12,6,6
Fandango,silvermoon,572,evoker,preservation,12,6,6
Seldar,steamwheedle-cartel,572,evoker,preservation,12,6,6
Нирт,gordunni,572,evoker,preservation,18,6,12
Jaratitz,dun-modr,572,evoker,preservation,18,6,12
Synpho,ahnqiraj,571,evoker,preservation,12,6,6
Фульфикс,soulflayer,571,evoker,preservation,18,6,12
Wosabivoker,stormscale,570,evoker,preservation,12,6,6
Evocae,blackmoore,570,evoker,preservation,12,6,6
Mjoke,the-maelstrom,570,evoker,preservation,30,6,24
Aevnon,sylvanas,569,evoker,preservation,12,6,6
Adônis,malorne,569,evoker,preservation,31,6,25
Адалдракулий,howling-fjord,568,evoker,preservation,18,6,12
Sowinger,ragnaros,566,evoker,preservation,12,6,6
Synhtol,ragnaros,564,evoker,preservation,18,6,12
Zearux,kazzak,559,evoker,preservation,23,6,17
Donevoker,blackrock,542,evoker,preservation,17,6,11
Атенри,gordunni,526,evoker,preservation,9,6,3
Giangiungiua,pozzo-delleternità,526,evoker,preservation,17,6,11
Rasalhague,uldum,522,evoker,preservation,15,6,9
Tizuki,twisting-nether,522,evoker,preservation,22,7,15
Dracarysx,grim-batol,520,evoker,preservation,15,7,8
Drakinas,outland,511,evoker,preservation,11,6,5
Nemrák,blackmoore,495,evoker,preservation,13,6,7
Hungryhank,ragnaros,480,evoker,preservation,6,5,1
Ralfferion,auchindoun,480,evoker,preservation,6,5,1
Chilledx,tarren-mill,480,evoker,preservation,6,5,1
Stêwpit,blackhand,480,evoker,preservation,6,5,1
Hàzinette,sargeras,480,evoker,preservation,6,5,1
Tsunamì,ysondre,480,evoker,preservation,6,5,1
Patatrake,sanguino,480,evoker,preservation,6,5,1
Jàcè,antonidas,480,evoker,preservation,6,5,1
Jmyzard,tarren-mill,480,evoker,preservation,10,6,4
Soläryx,hyjal,480,evoker,preservation,12,6,6
Feddra,twisting-nether,480,evoker,preservation,12,5,7
Emeraldcomun,twisting-nether,480,evoker,preservation,12,5,7
Frozenblast,archimonde,480,evoker,preservation,12,5,7
Necorínexx,silvermoon,480,evoker,preservation,12,5,7
Morkek,dun-modr,480,evoker,preservation,12,5,7
Mistime,twisting-nether,480,evoker,preservation,12,5,7
Trillebårtöm,outland,480,evoker,preservation,12,5,7
Evolié,ravencrest,480,evoker,preservation,12,5,7
Bigreddragon,outland,480,evoker,preservation,12,5,7
Interféctá,aegwynn,480,evoker,preservation,12,5,7
Aegón,uldum,480,evoker,preservation,12,5,7
Катяламизил,howling-fjord,480,evoker,preservation,12,5,7
Murato,nemesis,480,evoker,preservation,12,5,7
Evokoloko,outland,480,evoker,preservation,12,5,7
Dzin,burning-legion,480,evoker,preservation,12,5,7
Monkeyvoker,archimonde,480,evoker,preservation,12,5,7
Aryv,ragnaros,480,evoker,preservation,12,5,7
Dragonbreak,nemesis,480,evoker,preservation,12,5,7
Belzevoker,blackrock,480,evoker,preservation,12,5,7
Fnom,hyjal,480,evoker,preservation,12,5,7
Paarthursnax,tarren-mill,480,evoker,preservation,12,5,7
Драгонкокс,gordunni,480,evoker,preservation,12,5,7
Vizdraken,tarren-mill,480,evoker,preservation,12,5,7
Twøførms,twisting-nether,480,evoker,preservation,15,6,9
Xyphoo,kazzak,480,evoker,preservation,18,5,13
Miraas,burning-blade,480,evoker,preservation,18,5,13
Siipiveíkko,stormreaver,480,evoker,preservation,18,5,13
Rise,tarren-mill,480,evoker,preservation,24,5,19
Néphrekh,archimonde,479,evoker,preservation,6,5,1
Chunlooi,baelgun,479,evoker,preservation,12,5,7
Scaleflux,argent-dawn,479,evoker,preservation,12,5,7
Ptidrake,hyjal,479,evoker,preservation,12,5,7
Loveyoudaddy,sylvanas,479,evoker,preservation,12,5,7
Darksaider,draenor,479,evoker,preservation,12,5,7
Shosk,chamber-of-aspects,479,evoker,preservation,12,5,7
Rex,stormreaver,479,evoker,preservation,12,5,7
Dractopelle,garona,479,evoker,preservation,12,5,7
Whelp,antonidas,479,evoker,preservation,18,5,13
Chizy,aegwynn,479,evoker,preservation,18,5,13
Миме,howling-fjord,479,evoker,preservation,18,5,13
Effrt,ravencrest,479,evoker,preservation,24,5,19
Tatsuki,arthas,479,evoker,preservation,24,5,19
Alèd,hyjal,478,evoker,preservation,12,5,7
Widow,chromaggus,478,evoker,preservation,12,5,7
Bbuszek,outland,478,evoker,preservation,18,5,13
Vereeza,draenor,477,evoker,preservation,15,6,9
Exelott,ravencrest,477,evoker,preservation,14,5,9
Suicidel,silvermoon,477,evoker,preservation,18,5,13
Dragomi,kazzak,477,evoker,preservation,18,5,13
Dragorasi,frostwolf,476,evoker,preservation,24,5,19
Гарил,grom,475,evoker,preservation,12,5,7
Ensîmîst,twisting-nether,475,evoker,preservation,12,5,7
Gladdrake,doomhammer,474,evoker,preservation,18,5,13
Ngaokoang,khaz-modan,473,evoker,preservation,24,5,19
Traumflügel,teldrassil,472,evoker,preservation,12,5,7
Fricandela,sanguino,472,evoker,preservation,18,5,13
Valasthor,argent-dawn,469,evoker,preservation,18,5,13
Ormqt,ravencrest,468,evoker,preservation,25,8,17
Incarnevoke,ravencrest,463,evoker,preservation,11,5,6
Thyriån,kazzak,447,evoker,preservation,11,5,6
Яссон,howling-fjord,447,evoker,preservation,14,6,8
Kássadaín,the-maelstrom,447,evoker,preservation,16,5,11
Sentos,blackmoore,447,evoker,preservation,16,5,11
Elrycx,tarren-mill,431,evoker,preservation,21,6,15
Сяоки,howling-fjord,425,evoker,preservation,17,6,11
Uwulogie,tarren-mill,425,evoker,preservation,26,6,20
Veridius,lightbringer,425,evoker,preservation,28,6,22
Grajade,dun-modr,422,evoker,preservation,15,6,9
Hazes,blackmoore,415,evoker,preservation,10,5,5
Alrakis,kragjin,415,evoker,preservation,16,5,11
Darhgon,archimonde,414,evoker,preservation,14,5,9
Bindrasz,ahnqiraj,384,evoker,preservation,6,4,2
Snàx,aggra-português,384,evoker,preservation,6,4,2
Variandre,ravencrest,384,evoker,preservation,6,4,2
Kyu,die-nachtwache,384,evoker,preservation,6,4,2
Killmeifucan,twisting-nether,384,evoker,preservation,6,4,2
Dragneel,ravenholdt,384,evoker,preservation,6,4,2
Нэйджи,borean-tundra,384,evoker,preservation,6,4,2
Evossy,tarren-mill,384,evoker,preservation,6,4,2
Aymoreth,argent-dawn,384,evoker,preservation,6,4,2
Drangonildo,turalyon,384,evoker,preservation,6,4,2
Kuve,stormscale,384,evoker,preservation,6,4,2
Bumforce,ravencrest,384,evoker,preservation,6,4,2
Zankthorx,stormscale,384,evoker,preservation,6,4,2
Aoryx,dun-modr,384,evoker,preservation,6,4,2
Похмуррий,gordunni,384,evoker,preservation,6,4,2
Creaxx,kirin-tor,384,evoker,preservation,6,4,2
Grumes,blackmoore,384,evoker,preservation,6,4,2
Тимтс,gordunni,384,evoker,preservation,6,4,2
Lìzardboi,draenor,384,evoker,preservation,6,4,2
Barven,die-nachtwache,384,evoker,preservation,6,4,2
Quasarized,ravencrest,384,evoker,preservation,6,4,2
Wyrovoker,ragnaros,384,evoker,preservation,6,4,2
Ahnë,archimonde,384,evoker,preservation,6,4,2
Rhaeghal,hyjal,384,evoker,preservation,6,4,2
Rbgdragon,silvermoon,384,evoker,preservation,6,4,2
Tömmöfwarrs,archimonde,384,evoker,preservation,12,4,8
Feradely,thrall,384,evoker,preservation,12,4,8
Ninhursag,hyjal,384,evoker,preservation,12,4,8
Drachis,tarren-mill,384,evoker,preservation,12,4,8
Whatisthis,archimonde,384,evoker,preservation,12,4,8
Ch,ghostlands,384,evoker,preservation,12,4,8
Kryyzq,hyjal,384,evoker,preservation,12,4,8
Галактиг,thermaplugg,384,evoker,preservation,12,4,8
Fomoerectus,eredar,384,evoker,preservation,12,4,8
Yaraxes,outland,384,evoker,preservation,12,4,8
Azdaja,blackmoore,384,evoker,preservation,12,4,8
Odahvïing,ravencrest,384,evoker,preservation,12,4,8
Toílet,blackmoore,384,evoker,preservation,12,4,8
Evokker,antonidas,384,evoker,preservation,12,4,8
Gryrdrid,draenor,384,evoker,preservation,12,4,8
Slaskenyah,tarren-mill,384,evoker,preservation,12,4,8
Darker,garrosh,384,evoker,preservation,12,4,8
Boynuzlandim,outland,384,evoker,preservation,12,4,8
Floats,arathor,384,evoker,preservation,12,4,8
Tokvoker,tarren-mill,384,evoker,preservation,12,4,8
Feyrbrand,ysera,384,evoker,preservation,12,4,8
Larmédrio,archimonde,384,evoker,preservation,15,4,11
Belzilian,dalaran,384,evoker,preservation,18,4,14
Quixzzr,blackrock,384,evoker,preservation,18,4,14
Dragonboi,archimonde,384,evoker,preservation,18,4,14
Dragønlord,blackrock,384,evoker,preservation,18,4,14
Multytür,antonidas,384,evoker,preservation,18,4,14
Wiskeryon,ravencrest,384,evoker,preservation,18,4,14
Aldien,antonidas,384,evoker,preservation,18,4,14
Draginmsxo,tarren-mill,384,evoker,preservation,18,4,14
Boostedape,ahnqiraj,384,evoker,preservation,18,4,14
Fogwing,ravencrest,384,evoker,preservation,18,4,14
Firelizardxd,archimonde,384,evoker,preservation,24,4,20
Dwakey,azshara,383,evoker,preservation,6,4,2
Timeshifter,stormscale,383,evoker,preservation,6,4,2
Iove,zirkel-des-cenarius,383,evoker,preservation,6,4,2
Nicnacx,stormscale,383,evoker,preservation,6,4,2
Amarisnex,ragnaros,383,evoker,preservation,6,4,2
Кефтыме,soulflayer,383,evoker,preservation,6,4,2
Ekardd,draenor,383,evoker,preservation,6,4,2
Killarnie,draenor,383,evoker,preservation,12,4,8
Dracarÿs,outland,383,evoker,preservation,12,4,8
Pureshot,archimonde,383,evoker,preservation,12,4,8
Сантанико,grom,383,evoker,preservation,12,4,8
Pavel,steamwheedle-cartel,383,evoker,preservation,12,4,8
Batmanjasii,eredar,383,evoker,preservation,12,4,8
Astridae,kirin-tor,383,evoker,preservation,12,4,8
Evozilla,blackrock,383,evoker,preservation,12,4,8
Yaldthion,dun-modr,383,evoker,preservation,18,4,14
Zuvie,ravencrest,383,evoker,preservation,18,4,14
Steadyop,doomhammer,382,evoker,preservation,6,4,2
Dolceprada,stormscale,381,evoker,preservation,12,4,8
Dragonboss,doomhammer,380,evoker,preservation,12,4,8
Wirenth,chogall,380,evoker,preservation,18,4,14
Мизурион,gordunni,379,evoker,preservation,12,4,8
Rãptør,tarren-mill,367,evoker,preservation,11,4,7
Pixenen,ravencrest,367,evoker,preservation,17,4,13
Friggr,defias-brotherhood,367,evoker,preservation,23,4,19
Nevagonafly,archimonde,351,evoker,preservation,10,6,4
Kynirà,magtheridon,351,evoker,preservation,11,4,7
Sinastral,sanguino,350,evoker,preservation,11,4,7
Rhäegal,kaelthas,350,evoker,preservation,17,4,13
Breathkiller,stormscale,330,evoker,preservation,10,6,4
Zynx,kelthuzad,319,evoker,preservation,14,4,10
Dbrckfrmwish,outland,304,evoker,preservation,7,4,3
Dokkamok,hyjal,288,evoker,preservation,6,3,3
Ceroxs,aegwynn,288,evoker,preservation,6,3,3
Biggtuna,grim-batol,288,evoker,preservation,6,3,3
Mushux,grim-batol,288,evoker,preservation,6,3,3
Evokimag,grim-batol,288,evoker,preservation,6,3,3
Barbrastraza,hyjal,288,evoker,preservation,6,3,3
Saphiraa,lightnings-blade,288,evoker,preservation,6,3,3
Мэйо,soulflayer,288,evoker,preservation,6,3,3
Знамядрак,soulflayer,288,evoker,preservation,6,3,3
Espâgnøl,hyjal,288,evoker,preservation,6,3,3
Моралдракон,soulflayer,288,evoker,preservation,6,3,3
Konstraz,kazzak,288,evoker,preservation,6,3,3
Trixvoke,ragnaros,288,evoker,preservation,6,3,3
Botomforgold,ravencrest,288,evoker,preservation,6,3,3
Snackthyr,silvermoon,288,evoker,preservation,6,3,3
Petleg,sanguino,288,evoker,preservation,6,3,3
Meezyevo,ragnaros,288,evoker,preservation,6,3,3
Cauter,draenor,288,evoker,preservation,6,3,3
Nezruslfarm,cthun,288,evoker,preservation,6,3,3
Speckjarrow,blackrock,288,evoker,preservation,6,3,3
Ramilbest,ravencrest,288,evoker,preservation,6,3,3
Renalia,blackrock,288,evoker,preservation,6,3,3
Iso,ravencrest,288,evoker,preservation,6,3,3
Yeahhoe,ravencrest,288,evoker,preservation,6,3,3
Zordrach,quelthalas,288,evoker,preservation,6,3,3
Drachenbeton,antonidas,288,evoker,preservation,6,3,3
Keizal,twisting-nether,288,evoker,preservation,6,3,3
Gigabreath,ravencrest,288,evoker,preservation,6,3,3
Noogon,outland,288,evoker,preservation,6,3,3
Flâneur,ysondre,288,evoker,preservation,6,3,3
Pruttburk,draenor,288,evoker,preservation,6,3,3
Møndaychest,stormscale,288,evoker,preservation,6,3,3
Clawdragon,colinas-pardas,288,evoker,preservation,6,3,3
Pfuffi,steamwheedle-cartel,288,evoker,preservation,6,3,3
Tactician,stormreaver,288,evoker,preservation,6,3,3
Griefgodx,draenor,288,evoker,preservation,6,3,3
Rippo,tarren-mill,288,evoker,preservation,6,3,3
Jackarlys,outland,288,evoker,preservation,6,3,3
Jmý,tarren-mill,288,evoker,preservation,6,3,3
Limbimpi,twilights-hammer,288,evoker,preservation,6,3,3
Niffdra,twisting-nether,288,evoker,preservation,6,3,3
Suirz,sanguino,288,evoker,preservation,9,4,5
Flygpajk,kazzak,288,evoker,preservation,10,4,6
Кунидракон,gordunni,288,evoker,preservation,10,4,6
Krozuk,hyjal,288,evoker,preservation,9,3,6
Reelona,silvermoon,288,evoker,preservation,12,3,9
Evildrake,twisting-nether,288,evoker,preservation,12,3,9
Edgybeb,archimonde,288,evoker,preservation,12,3,9
Bemil,twisting-nether,288,evoker,preservation,12,3,9
Zenda,turalyon,288,evoker,preservation,12,3,9
Siigge,draenor,288,evoker,preservation,12,3,9
Clênas,kazzak,288,evoker,preservation,12,3,9
Vaníliasodó,ragnaros,288,evoker,preservation,12,3,9
Dràcøfeugødx,archimonde,288,evoker,preservation,12,3,9
Buuf,sanguino,288,evoker,preservation,12,3,9
Taktcik,archimonde,288,evoker,preservation,12,3,9
Viscervanthe,tarren-mill,288,evoker,preservation,12,3,9
Cadwalader,blades-edge,288,evoker,preservation,12,3,9
Боевойхомякд,howling-fjord,288,evoker,preservation,12,3,9
Elderruan,shattered-hand,288,evoker,preservation,12,3,9
Phillip,tarren-mill,288,evoker,preservation,12,3,9
Brevsparven,ravencrest,288,evoker,preservation,12,3,9
Falkoria,drakthul,288,evoker,preservation,12,3,9
Moltenazo,dun-modr,288,evoker,preservation,13,3,10
Голденстарс,gordunni,288,evoker,preservation,18,3,15
Extintor,silvermoon,288,evoker,preservation,18,3,15
Милеис,soulflayer,287,evoker,preservation,6,3,3
Gelu,burning-legion,287,evoker,preservation,6,3,3
Delta,blackhand,287,evoker,preservation,6,3,3
Elexatra,hyjal,287,evoker,preservation,12,3,9
Broocklyn,blackrock,287,evoker,preservation,12,3,9
Silberdorn,rexxar,286,evoker,preservation,12,3,9
Drackial,zuljin,286,evoker,preservation,12,3,9
Òhrabzack,blackmoore,286,evoker,preservation,24,3,21
Valystrá,die-aldor,285,evoker,preservation,24,3,21
Kelisthrasa,antonidas,284,evoker,preservation,12,3,9
Норыч,soulflayer,284,evoker,preservation,26,3,23
Quarsilly,frostwolf,271,evoker,preservation,11,3,8
Draginy,blackrock,255,evoker,preservation,8,4,4
Axüra,nemesis,240,evoker,preservation,9,3,6
Agnî,sanguino,240,evoker,preservation,9,3,6
Goldenshower,bladefist,234,evoker,preservation,14,4,10
Zelenobelata,neptulon,234,evoker,preservation,16,4,12
Calise,kazzak,231,evoker,preservation,15,4,11
Provôker,tarren-mill,223,evoker,preservation,8,3,5
Baranzion,twisting-nether,207,evoker,preservation,8,3,5
Protesturken,shadowsong,192,evoker,preservation,4,3,1
Exitelolx,blackrock,192,evoker,preservation,4,3,1
Dragonlol,stormscale,192,evoker,preservation,6,2,4
Rngmåchinè,ravencrest,192,evoker,preservation,6,2,4
Sleazi,shattered-hand,192,evoker,preservation,6,2,4
Puzzles,ravencrest,192,evoker,preservation,6,2,4
Notdasilva,twisting-nether,192,evoker,preservation,6,2,4
Chíliena,ravencrest,192,evoker,preservation,6,2,4
Dno,archimonde,192,evoker,preservation,6,2,4
Глорунг,howling-fjord,192,evoker,preservation,6,2,4
Glurak,stormscale,192,evoker,preservation,6,2,4
Voldermort,ravencrest,192,evoker,preservation,6,2,4
Chamustrasza,sanguino,192,evoker,preservation,6,2,4
Oontäälihis,ravencrest,192,evoker,preservation,6,2,4
Ysgrin,argent-dawn,192,evoker,preservation,6,2,4
Popelka,shattered-halls,192,evoker,preservation,6,2,4
Nooshy,burning-legion,192,evoker,preservation,6,2,4
Maysiesthraz,ravencrest,192,evoker,preservation,6,2,4
Freesckretx,archimonde,192,evoker,preservation,6,2,4
Norpineto,ravencrest,192,evoker,preservation,6,2,4
Lauroruft,blackmoore,192,evoker,preservation,6,2,4
Shinad,ravencrest,192,evoker,preservation,6,2,4
Zendervish,draenor,192,evoker,preservation,6,2,4
Garussy,draenor,192,evoker,preservation,6,2,4
Sénkú,silvermoon,192,evoker,preservation,6,2,4
Nutbuzza,frostmane,192,evoker,preservation,6,2,4
Neomswosj,kazzak,192,evoker,preservation,6,2,4
Ræyna,blackmoore,192,evoker,preservation,6,2,4
Asunarion,silvermoon,192,evoker,preservation,6,2,4
Cousinbetty,defias-brotherhood,192,evoker,preservation,6,2,4
Язычник,thermaplugg,192,evoker,preservation,6,2,4
Lacostelogo,frostwolf,192,evoker,preservation,6,2,4
Azurog,blackmoore,192,evoker,preservation,6,2,4
Nordomu,silvermoon,192,evoker,preservation,6,2,4
Chanceflared,defias-brotherhood,192,evoker,preservation,6,2,4
Zelëph,archimonde,192,evoker,preservation,6,2,4
Soondeleted,eredar,192,evoker,preservation,6,2,4
Chalgoumax,ysondre,192,evoker,preservation,6,2,4
Überflieger,blackmoore,192,evoker,preservation,6,2,4
Tacthyr,blackrock,192,evoker,preservation,6,2,4
Fuoco,wrathbringer,192,evoker,preservation,6,2,4
Kafrineslim,ysondre,192,evoker,preservation,6,2,4
Matyas,tarren-mill,192,evoker,preservation,6,2,4
Rooskey,sylvanas,192,evoker,preservation,6,2,4
Frogzey,kazzak,192,evoker,preservation,6,2,4
Змийх,gordunni,192,evoker,preservation,6,2,4
Sheràqt,blackrock,192,evoker,preservation,6,2,4
Glurakk,aegwynn,192,evoker,preservation,6,2,4
Magmarôs,argent-dawn,192,evoker,preservation,6,2,4
Braitnezdrag,blackrock,192,evoker,preservation,6,2,4
Chronogosa,argent-dawn,192,evoker,preservation,6,2,4
Ogshadezz,blackmoore,192,evoker,preservation,6,2,4
Timotheus,draenor,192,evoker,preservation,6,2,4
Sloeez,kazzak,192,evoker,preservation,6,2,4
Youzfull,blackrock,192,evoker,preservation,6,2,4
Mêleys,tyrande,192,evoker,preservation,12,2,10
Pico,madmortem,192,evoker,preservation,12,2,10
Gibefigg,antonidas,192,evoker,preservation,12,2,10
Teyvoker,blackmoore,192,evoker,preservation,12,2,10
Zeraphïne,eredar,192,evoker,preservation,12,2,10
Flametender,silvermoon,192,evoker,preservation,12,2,10
Wuschwuscha,thrall,192,evoker,preservation,12,2,10
Raeinar,tyrande,192,evoker,preservation,12,2,10
Saphyroth,blackmoore,192,evoker,preservation,12,2,10
Lììn,hyjal,192,evoker,preservation,12,2,10
Chocodragon,blackmoore,192,evoker,preservation,12,2,10
Dragaras,twisting-nether,192,evoker,preservation,12,2,10
Reworkedmage,twisting-nether,192,evoker,preservation,12,2,10
Margouillax,archimonde,192,evoker,preservation,12,2,10
Dráthír,blackrock,192,evoker,preservation,12,2,10
Thunderthorn,blackrock,192,evoker,preservation,12,2,10
Mylittlepony,conseil-des-ombres,192,evoker,preservation,12,2,10
Atotheerawr,kazzak,192,evoker,preservation,12,2,10
Djage,kazzak,192,evoker,preservation,14,2,12
Dracipsouk,drakthul,192,evoker,preservation,18,2,16
Macdrac,area-52,192,evoker,preservation,18,2,16
Copíum,silvermoon,192,evoker,preservation,18,2,16
Muraki,ysondre,191,evoker,preservation,6,2,4
Ясосалочка,howling-fjord,191,evoker,preservation,6,2,4
Droeffel,antonidas,191,evoker,preservation,6,2,4
Morpheuzx,tarren-mill,191,evoker,preservation,6,2,4
Yuyux,sanguino,191,evoker,preservation,6,2,4
Flameclaw,argent-dawn,191,evoker,preservation,12,2,10
Viorias,argent-dawn,191,evoker,preservation,27,2,25
Wardrache,nerathor,190,evoker,preservation,18,2,16
Тримони,soulflayer,175,evoker,preservation,11,4,7
Kronosk,colinas-pardas,159,evoker,preservation,5,2,3
Dandrake,shattered-hand,159,evoker,preservation,5,2,3
Eldrax,emerald-dream,159,evoker,preservation,5,2,3
Zulthyr,sargeras,159,evoker,preservation,5,2,3
Outsider,aegwynn,144,evoker,preservation,3,3,0
Stinka,blackmoore,138,evoker,preservation,9,5,4
Primepewpew,ragnaros,138,evoker,preservation,15,3,12
Zzaazaa,argent-dawn,137,evoker,preservation,10,3,7
Zuhana,twisting-nether,127,evoker,preservation,4,2,2
Azzazed,dun-modr,127,evoker,preservation,4,2,2
Marcelproust,burning-legion,127,evoker,preservation,4,2,2
Эйвия,soulflayer,106,evoker,preservation,7,4,3
Рбгсвинья,howling-fjord,96,evoker,preservation,3,2,1
Asdkmelkm,stormscale,96,evoker,preservation,6,1,5
Leandrini,ravencrest,96,evoker,preservation,6,1,5
Азивокер,howling-fjord,96,evoker,preservation,6,1,5
Freyrn,drakthul,96,evoker,preservation,6,1,5
Connorbigboi,ragnaros,96,evoker,preservation,6,1,5
Hojoker,twisting-nether,96,evoker,preservation,6,1,5
Huangzhang,burning-legion,96,evoker,preservation,6,1,5
Ibexphénix,conseil-des-ombres,96,evoker,preservation,6,1,5
Louzard,draenor,96,evoker,preservation,6,1,5
Mulqahdiiv,archimonde,96,evoker,preservation,6,1,5
Rickastley,ragnaros,96,evoker,preservation,6,1,5
Varyse,stormscale,96,evoker,preservation,6,1,5
Tarecgos,sanguino,96,evoker,preservation,6,1,5
Ajjemen,outland,96,evoker,preservation,6,1,5
Eurasia,ravenholdt,96,evoker,preservation,6,1,5
Woasid,outland,96,evoker,preservation,6,1,5
Kedel,tarren-mill,96,evoker,preservation,6,1,5
Oogabuga,outland,96,evoker,preservation,6,1,5
Cattiche,draenor,96,evoker,preservation,6,1,5
Lumberdrake,stormscale,96,evoker,preservation,6,1,5
Spyroe,aegwynn,96,evoker,preservation,6,1,5
Pikemiz,sanguino,96,evoker,preservation,6,1,5
Dragonboi,auchindoun,96,evoker,preservation,6,1,5
Raché,blackmoore,96,evoker,preservation,6,1,5
Dragonpro,kazzak,96,evoker,preservation,6,1,5
Drakenballen,ragnaros,96,evoker,preservation,6,1,5
Drachenlord,alakir,96,evoker,preservation,6,1,5
Awienz,kazzak,96,evoker,preservation,6,1,5
Pavelito,ysondre,96,evoker,preservation,6,1,5
Drgn,blackhand,96,evoker,preservation,6,1,5
Kroqmoo,drekthar,96,evoker,preservation,6,1,5
Yaboismok,burning-legion,96,evoker,preservation,6,1,5
Хафр,deathguard,96,evoker,preservation,6,1,5
Смехокрыл,deathguard,96,evoker,preservation,6,1,5
Tantfrilla,ravencrest,96,evoker,preservation,6,1,5
Jouke,dentarg,96,evoker,preservation,6,1,5
Charovoker,blackmoore,96,evoker,preservation,6,1,5
Dewi,anachronos,96,evoker,preservation,6,1,5
Mazzdrake,sylvanas,96,evoker,preservation,6,1,5
Breathpitt,blackrock,96,evoker,preservation,6,1,5
Bisxcuit,dun-modr,96,evoker,preservation,6,1,5
Kaezmasterx,blackrock,96,evoker,preservation,6,1,5
Foldoudoune,archimonde,96,evoker,preservation,6,1,5
Gwindora,azjolnerub,96,evoker,preservation,6,1,5
Brystrasza,quelthalas,96,evoker,preservation,6,1,5
Nezruslfarm,dun-modr,96,evoker,preservation,6,1,5
Xqa,hyjal,96,evoker,preservation,6,1,5
Viserys,nerathor,96,evoker,preservation,6,1,5
Pipe,sanguino,96,evoker,preservation,6,1,5
Larrykoopa,hyjal,96,evoker,preservation,6,1,5
Ceerdrogo,twisting-nether,96,evoker,preservation,9,1,8
Baddragonxxl,sylvanas,96,evoker,preservation,12,1,11
Hizzo,burning-legion,96,evoker,preservation,12,1,11
Vänesiä,sylvanas,96,evoker,preservation,12,1,11
Vullgred,sylvanas,96,evoker,preservation,12,1,11
Duveloker,dragonblight,96,evoker,preservation,12,1,11
Salvadracane,thrall,96,evoker,preservation,12,1,11
Bigusdickus,ysondre,96,evoker,preservation,12,1,11
Heidrun,ravenholdt,95,evoker,preservation,6,1,5
Fluffykoi,silvermoon,95,evoker,preservation,12,1,11
Imend,stormscale,79,evoker,preservation,5,1,4
Hnsons,earthen-ring,64,evoker,preservation,10,1,9
Floofboi,ravencrest,63,evoker,preservation,2,2,0
Dopëshow,drakthul,48,evoker,preservation,3,1,2
Faijer,blackmoore,42,evoker,preservation,10,3,7
Nickydragonx,stormscale,42,evoker,preservation,10,3,7
Flyvern,kazzak,42,evoker,preservation,8,2,6
Sinnkra,argent-dawn,41,evoker,preservation,6,2,4
Кеннокс,soulflayer,2225,evoker,devastation,144,78,66
Hehehihihaha,ravencrest,2179,evoker,devastation,130,67,63
Дракшотик,blackscar,2146,evoker,devastation,89,52,37
Rexzstrasza,eredar,2132,evoker,devastation,143,81,62
Animenorgam,alakir,2126,evoker,devastation,254,151,103
Sârmikas,blackhand,2124,evoker,devastation,302,159,143
Babodrake,blackhand,2122,evoker,devastation,121,61,60
Judda,stormscale,2118,evoker,devastation,227,118,109
Brokz,twisting-nether,2116,evoker,devastation,172,95,77
Meust,blackrock,2111,evoker,devastation,66,42,24
Heõ,twisting-nether,2102,evoker,devastation,369,183,186
Пивнаябошка,soulflayer,2099,evoker,devastation,96,49,47
Carlospapa,lothar,2074,evoker,devastation,113,75,38
Diznutz,kazzak,2066,evoker,devastation,185,97,88
Drakenyasha,tarren-mill,2060,evoker,devastation,261,130,131
Dracohfeu,archimonde,2055,evoker,devastation,100,58,42
Soondeleted,eredar,2032,evoker,devastation,72,40,32
Sindras,frostmane,2031,evoker,devastation,71,40,31
Дракшотик,soulflayer,2031,evoker,devastation,54,30,24
Twodeep,blackrock,1999,evoker,devastation,183,94,89
Zmej,twisting-nether,1990,evoker,devastation,138,70,68
Kamehaméha,outland,1975,evoker,devastation,105,59,46
Silvior,outland,1969,evoker,devastation,78,38,40
Uglylizard,stormscale,1968,evoker,devastation,66,42,24
Crueh,outland,1967,evoker,devastation,60,33,27
Darkssoul,outland,1967,evoker,devastation,144,77,67
Lesgrossman,ravencrest,1965,evoker,devastation,90,47,43
Edvoker,twisting-nether,1960,evoker,devastation,174,92,82
Claxy,ragnaros,1952,evoker,devastation,72,38,34
Balthinar,argent-dawn,1951,evoker,devastation,108,54,54
Dracofeuxd,archimonde,1936,evoker,devastation,99,55,44
Wexvoker,darksorrow,1936,evoker,devastation,109,59,50
Ryujíin,kazzak,1929,evoker,devastation,101,61,40
Myxker,burning-legion,1922,evoker,devastation,77,36,41
Ipanicsoar,tarren-mill,1921,evoker,devastation,158,81,77
Evodraxx,hyjal,1911,evoker,devastation,72,32,40
Дреадди,soulflayer,1908,evoker,devastation,163,85,78
Sloeez,kazzak,1903,evoker,devastation,60,30,30
Lurkî,blackhand,1902,evoker,devastation,132,69,63
Jeannedebruj,ravencrest,1902,evoker,devastation,231,120,111
Jibobo,the-maelstrom,1900,evoker,devastation,65,31,34
Нерфсрочно,gordunni,1897,evoker,devastation,240,117,123
Salk,stormscale,1891,evoker,devastation,36,20,16
Ønce,durotan,1888,evoker,devastation,111,57,54
Advancedboy,archimonde,1887,evoker,devastation,75,35,40
Korvi,ravencrest,1886,evoker,devastation,56,31,25
Драгонтьма,gordunni,1877,evoker,devastation,131,68,63
Juhadormu,stormreaver,1875,evoker,devastation,143,74,69
Kàido,ravencrest,1874,evoker,devastation,765,381,384
Jamzyevoker,emerald-dream,1873,evoker,devastation,79,43,36
Lidldragon,argent-dawn,1862,evoker,devastation,38,28,10
Uwusaurus,burning-legion,1862,evoker,devastation,39,21,18
Enzetrius,argent-dawn,1861,evoker,devastation,36,22,14
Whaazzdragon,tarren-mill,1858,evoker,devastation,42,24,18
Atoll,scarshield-legion,1858,evoker,devastation,55,29,26
Swapxyevo,ravencrest,1857,evoker,devastation,58,34,24
Lizardbøi,blackhand,1855,evoker,devastation,72,37,35
Hëroinhenry,tarren-mill,1853,evoker,devastation,66,44,22
Xzvoker,kazzak,1848,evoker,devastation,134,67,67
Ryuu,mazrigos,1848,evoker,devastation,65,30,35
Calygosa,antonidas,1843,evoker,devastation,36,23,13
Фиамниэль,gordunni,1838,evoker,devastation,72,34,38
Sagrax,silvermoon,1835,evoker,devastation,68,40,28
Гиперзверь,gordunni,1831,evoker,devastation,68,35,33
Аксиомх,soulflayer,1831,evoker,devastation,76,39,37
Mizamiza,blackrock,1829,evoker,devastation,160,84,76
Keñwøød,ysondre,1829,evoker,devastation,56,27,29
Tetsú,tarren-mill,1826,evoker,devastation,272,148,124
Draxxys,blackmoore,1826,evoker,devastation,156,84,72
Viscervanthe,tarren-mill,1826,evoker,devastation,78,38,40
Voklath,kazzak,1822,evoker,devastation,217,114,103
Irvethius,argent-dawn,1822,evoker,devastation,203,103,100
Tremmérz,outland,1821,evoker,devastation,72,37,35
Apacstrasza,ragnaros,1818,evoker,devastation,203,102,101
Ларенил,gordunni,1817,evoker,devastation,90,44,46
Krazuntus,argent-dawn,1816,evoker,devastation,93,51,42
Jamiewing,ravencrest,1815,evoker,devastation,243,128,115
Pinacóladaqt,stormscale,1815,evoker,devastation,78,38,40
Ryuujin,outland,1815,evoker,devastation,66,30,36
Avë,kazzak,1814,evoker,devastation,89,46,43
Âspên,archimonde,1813,evoker,devastation,80,47,33
Shimmerscale,blackhand,1811,evoker,devastation,173,101,72
Amadeusx,ravencrest,1810,evoker,devastation,55,30,25
Frozendragon,twisting-nether,1810,evoker,devastation,155,82,73
Ðø,antonidas,1810,evoker,devastation,59,28,31
Ízma,ravencrest,1808,evoker,devastation,216,108,108
Sleyvoker,draenor,1806,evoker,devastation,42,26,16
Дарратель,gordunni,1806,evoker,devastation,195,106,89
Merkels,blackmoore,1804,evoker,devastation,832,423,409
Nerfmeplze,outland,1804,evoker,devastation,140,67,73
Zephlas,sunstrider,1803,evoker,devastation,49,27,22
Meust,destromath,1803,evoker,devastation,54,28,26
Dracoli,eredar,1800,evoker,devastation,125,71,54
Zendaÿa,silvermoon,1800,evoker,devastation,120,60,60
Elbozo,kazzak,1799,evoker,devastation,110,59,51
Azorgaron,outland,1796,evoker,devastation,42,24,18
Jaimery,ravencrest,1796,evoker,devastation,54,29,25
Merqury,ravencrest,1795,evoker,devastation,42,29,13
Ralygos,ravencrest,1795,evoker,devastation,138,79,59
Rahzk,twisting-nether,1788,evoker,devastation,48,28,20
Saintly,kult-der-verdammten,1785,evoker,devastation,122,67,55
Obbwoke,ravencrest,1782,evoker,devastation,132,69,63
Infopaki,stormscale,1781,evoker,devastation,94,53,41
Valdrakon,doomhammer,1778,evoker,devastation,139,75,64
Yimvoker,blackrock,1770,evoker,devastation,36,21,15
Zyndigos,ravencrest,1762,evoker,devastation,61,31,30
Notadvanced,draenor,1761,evoker,devastation,72,38,34
Митокада,soulflayer,1757,evoker,devastation,71,40,31
Juicyjeffe,blackrock,1755,evoker,devastation,54,30,24
Oontäälihis,ravencrest,1755,evoker,devastation,222,112,110
Дракарус,soulflayer,1754,evoker,devastation,60,30,30
Archdragon,argent-dawn,1751,evoker,devastation,201,109,92
Eldunaries,argent-dawn,1749,evoker,devastation,197,99,98
Верестраз,howling-fjord,1746,evoker,devastation,72,34,38
Wuiflyta,dun-modr,1746,evoker,devastation,131,60,71
Bigmacfrite,ysondre,1744,evoker,devastation,136,66,70
Lagerstrasza,stormreaver,1742,evoker,devastation,105,59,46
Emiltate,ravencrest,1740,evoker,devastation,58,35,23
Hollowbreath,sanguino,1737,evoker,devastation,262,130,132
Ceerdrogo,twisting-nether,1736,evoker,devastation,77,41,36
Matrixslave,tarren-mill,1732,evoker,devastation,144,80,64
Shaze,zuljin,1731,evoker,devastation,65,40,25
Devictxd,ragnaros,1730,evoker,devastation,59,34,25
Strangedog,ravencrest,1727,evoker,devastation,74,43,31
Homeoffice,zenedar,1727,evoker,devastation,108,57,51
Ralfferion,auchindoun,1724,evoker,devastation,60,30,30
Melodio,outland,1722,evoker,devastation,78,46,32
Cinnannoe,tarren-mill,1719,evoker,devastation,197,110,87
Dragonlia,blackrock,1717,evoker,devastation,42,28,14
Rzektwo,eredar,1717,evoker,devastation,106,53,53
Kymaíra,hyjal,1716,evoker,devastation,48,22,26
Kôlaghan,archimonde,1709,evoker,devastation,71,38,33
Skùzito,ysondre,1706,evoker,devastation,140,71,69
Famouszorc,sanguino,1704,evoker,devastation,168,96,72
Notomorrow,twisting-nether,1702,evoker,devastation,42,22,20
Инсейнмэн,soulflayer,1697,evoker,devastation,253,134,119
Elitedraach,tarren-mill,1697,evoker,devastation,35,18,17
Bubbleblower,stormscale,1695,evoker,devastation,54,35,19
Psheetae,kazzak,1694,evoker,devastation,66,40,26
Гневиан,eversong,1694,evoker,devastation,186,96,90
Cybraxq,kazzak,1692,evoker,devastation,30,18,12
Sawk,archimonde,1690,evoker,devastation,114,66,48
Duvahkahr,ragnaros,1689,evoker,devastation,81,39,42
Azulade,stormscale,1689,evoker,devastation,64,28,36
Nazyr,blackhand,1688,evoker,devastation,73,41,32
Polbiwe,silvermoon,1688,evoker,devastation,170,85,85
Zexiø,blackmoore,1688,evoker,devastation,60,24,36
Telepathy,ravencrest,1683,evoker,devastation,71,43,28
Углекислот,howling-fjord,1683,evoker,devastation,90,44,46
Woasid,outland,1682,evoker,devastation,123,73,50
Sintharion,ravencrest,1678,evoker,devastation,247,125,122
Спайрок,gordunni,1677,evoker,devastation,242,123,119
Pesoo,kazzak,1673,evoker,devastation,30,20,10
Dispelgodx,eredar,1673,evoker,devastation,60,30,30
Rokki,blackrock,1672,evoker,devastation,100,53,47
Amnevoker,dalaran,1671,evoker,devastation,30,18,12
Galanix,argent-dawn,1667,evoker,devastation,60,29,31
Bigbaddragen,stormscale,1666,evoker,devastation,54,32,22
Draakoñ,outland,1666,evoker,devastation,78,42,36
Evøkergøðx,ravencrest,1665,evoker,devastation,317,158,159
Tamargon,frostwhisper,1664,evoker,devastation,64,32,32
Хетсв,gordunni,1663,evoker,devastation,102,57,45
Flâneur,ysondre,1663,evoker,devastation,107,53,54
Mekverath,stormscale,1661,evoker,devastation,312,158,154
Tezkaz,blackmoore,1657,evoker,devastation,343,176,167
Capybaro,blackrock,1656,evoker,devastation,48,31,17
Batmanwing,draenor,1654,evoker,devastation,48,27,21
Schismxx,outland,1652,evoker,devastation,158,89,69
Филлид,gordunni,1649,evoker,devastation,61,26,35
Ксдз,soulflayer,1648,evoker,devastation,153,86,67
Скорукх,gordunni,1647,evoker,devastation,159,86,73
Badrig,silvermoon,1647,evoker,devastation,405,214,191
Paarthursnax,tarren-mill,1646,evoker,devastation,59,35,24
Spýröo,kazzak,1646,evoker,devastation,293,164,129
Hanoostrasz,tarren-mill,1646,evoker,devastation,129,70,59
Ольменго,fordragon,1646,evoker,devastation,81,41,40
Iíiìl,silvermoon,1643,evoker,devastation,60,40,20
Serulyon,draenor,1643,evoker,devastation,102,53,49
Sürion,grim-batol,1642,evoker,devastation,72,39,33
Zaralek,stormscale,1641,evoker,devastation,54,34,20
Ruinastrasza,silvermoon,1641,evoker,devastation,235,118,117
Släshés,ravencrest,1641,evoker,devastation,125,60,65
Charocharo,silvermoon,1640,evoker,devastation,66,39,27
Ясъелинеры,gordunni,1640,evoker,devastation,54,31,23
Aesstrass,hyjal,1640,evoker,devastation,170,89,81
Trntyxdr,senjin,1639,evoker,devastation,30,21,9
Devoxz,tarren-mill,1639,evoker,devastation,144,78,66
Aclysia,outland,1639,evoker,devastation,118,62,56
Dragonide,draenor,1638,evoker,devastation,59,31,28
Hyperan,twisting-nether,1635,evoker,devastation,82,40,42
Дракарион,ashenvale,1632,evoker,devastation,78,46,32
Niddhøgg,ragnaros,1632,evoker,devastation,36,21,15
Bal,arakarahm,1630,evoker,devastation,48,26,22
Drakeoo,twisting-nether,1630,evoker,devastation,69,35,34
Papayoyo,draenor,1630,evoker,devastation,156,75,81
Côle,blackrock,1627,evoker,devastation,33,19,14
Drôgon,archimonde,1627,evoker,devastation,83,42,41
Deathdream,stormscale,1627,evoker,devastation,36,17,19
Хаззаш,gordunni,1626,evoker,devastation,38,22,16
Øseria,khaz-modan,1626,evoker,devastation,230,129,101
Hömeöffice,sylvanas,1624,evoker,devastation,110,59,51
Кунидракон,gordunni,1624,evoker,devastation,175,91,84
Eskavoker,kazzak,1623,evoker,devastation,36,22,14
Mørningstãr,ragnaros,1622,evoker,devastation,113,56,57
Nydolir,hyjal,1620,evoker,devastation,83,48,35
Thorhygos,sinstralis,1620,evoker,devastation,65,35,30
Kiwí,antonidas,1619,evoker,devastation,30,17,13
Грринч,deathweaver,1619,evoker,devastation,94,49,45
Hyperflexx,blackrock,1617,evoker,devastation,36,21,15
Lecutos,sunstrider,1616,evoker,devastation,47,28,19
Xtdrakaris,uldum,1616,evoker,devastation,879,445,434
Балерия,blackscar,1615,evoker,devastation,36,23,13
Nisper,ravencrest,1615,evoker,devastation,54,30,24
Ludwoker,tarren-mill,1614,evoker,devastation,100,61,39
Камиороти,borean-tundra,1613,evoker,devastation,33,19,14
Mazaw,burning-legion,1613,evoker,devastation,72,41,31
Batsquatch,argent-dawn,1612,evoker,devastation,36,23,13
Zapaflap,silvermoon,1612,evoker,devastation,119,65,54
Màlakir,chogall,1612,evoker,devastation,142,72,70
Bakspek,kilrogg,1611,evoker,devastation,48,30,18
Zkrdrgn,kazzak,1610,evoker,devastation,104,56,48
Mommystrasza,dentarg,1610,evoker,devastation,110,59,51
Denegos,sylvanas,1606,evoker,devastation,66,40,26
Drakshoff,khaz-modan,1606,evoker,devastation,265,142,123
Xendragon,kazzak,1606,evoker,devastation,86,45,41
Solandor,kazzak,1605,evoker,devastation,48,31,17
Lizarduck,tarren-mill,1605,evoker,devastation,52,26,26
Eldu,outland,1604,evoker,devastation,24,17,7
Boostedape,ahnqiraj,1604,evoker,devastation,194,106,88
Voldermort,ravencrest,1603,evoker,devastation,89,52,37
Hørnythyria,hyjal,1603,evoker,devastation,103,54,49
Skywitch,ragnaros,1603,evoker,devastation,144,74,70
Hästdrake,the-maelstrom,1603,evoker,devastation,42,20,22
Delorraine,burning-legion,1602,evoker,devastation,30,17,13
Nalî,dethecus,1600,evoker,devastation,42,23,19
Мнякуня,howling-fjord,1600,evoker,devastation,46,24,22
Zirra,ravencrest,1600,evoker,devastation,82,38,44
Drakeflaps,lightnings-blade,1599,evoker,devastation,30,18,12
Soleric,drakthul,1599,evoker,devastation,127,60,67
Lilpooper,bloodhoof,1598,evoker,devastation,115,63,52
Bigaluga,blackmoore,1598,evoker,devastation,54,26,28
Nagoli,silvermoon,1594,evoker,devastation,168,90,78
Rise,tarren-mill,1593,evoker,devastation,60,33,27
Sadlylate,dentarg,1593,evoker,devastation,120,58,62
Krothus,outland,1590,evoker,devastation,124,67,57
Ishtaro,ysondre,1588,evoker,devastation,35,21,14
Kaskala,dun-morogh,1587,evoker,devastation,90,48,42
Калесгоз,howling-fjord,1586,evoker,devastation,52,23,29
Evojøa,tarren-mill,1584,evoker,devastation,42,19,23
Фаламэйн,soulflayer,1582,evoker,devastation,90,50,40
Bindrasz,ahnqiraj,1579,evoker,devastation,42,19,23
Emayra,argent-dawn,1578,evoker,devastation,41,29,12
Dèéz,ravencrest,1574,evoker,devastation,51,34,17
Shumma,frostmane,1572,evoker,devastation,93,42,51
Enzospatalo,nemesis,1568,evoker,devastation,65,39,26
Fededorit,kazzak,1565,evoker,devastation,36,17,19
Aegón,uldum,1565,evoker,devastation,114,51,63
Rootzdx,ravencrest,1564,evoker,devastation,54,35,19
Øxyom,archimonde,1563,evoker,devastation,63,35,28
Glennett,silvermoon,1563,evoker,devastation,91,48,43
Lifetime,ravencrest,1562,evoker,devastation,34,19,15
Touchmywings,ravencrest,1560,evoker,devastation,24,17,7
Gämeovêrkïd,archimonde,1559,evoker,devastation,95,54,41
Dikkondrus,twisting-nether,1559,evoker,devastation,195,102,93
Саммеракс,gordunni,1556,evoker,devastation,114,50,64
Yol,bladefist,1554,evoker,devastation,165,83,82
Paizz,tarren-mill,1553,evoker,devastation,30,19,11
Эндемический,soulflayer,1553,evoker,devastation,42,26,16
Stefanosxios,bloodfeather,1551,evoker,devastation,161,84,77
Roth,stormreaver,1551,evoker,devastation,59,25,34
Yuhabahha,kazzak,1550,evoker,devastation,178,89,89
Ysterja,darkspear,1549,evoker,devastation,78,47,31
Skyrés,dalaran,1548,evoker,devastation,34,20,14
Cûddles,hyjal,1548,evoker,devastation,171,87,84
Draguzee,draenor,1546,evoker,devastation,66,37,29
Ch,ghostlands,1546,evoker,devastation,47,22,25
Emeraldino,twisting-nether,1546,evoker,devastation,89,36,53
Arbîter,eredar,1544,evoker,devastation,36,21,15
Burnrate,draenor,1544,evoker,devastation,110,54,56
Choubalo,archimonde,1543,evoker,devastation,54,31,23
Drazam,blackrock,1543,evoker,devastation,111,61,50
Mushü,kazzak,1542,evoker,devastation,107,57,50
Kayly,twisting-nether,1540,evoker,devastation,42,29,13
Abyssfyre,sylvanas,1540,evoker,devastation,99,53,46
Леерустан,howling-fjord,1537,evoker,devastation,62,32,30
Tiganj,silvermoon,1536,evoker,devastation,48,31,17
Bodytypechad,ravencrest,1534,evoker,devastation,84,46,38
Dragonandyy,blackrock,1534,evoker,devastation,189,97,92
Flaminghot,stormreaver,1530,evoker,devastation,552,297,255
Gle,ragnaros,1530,evoker,devastation,90,40,50
Lùñe,hyjal,1528,evoker,devastation,18,16,2
Chck,ragnaros,1528,evoker,devastation,78,41,37
Beeragos,deathwing,1528,evoker,devastation,60,31,29
Tõyz,tarren-mill,1527,evoker,devastation,72,40,32
Gypsydrake,tarren-mill,1525,evoker,devastation,61,35,26
Pêengei,blackrock,1525,evoker,devastation,94,48,46
Tecalagos,ragnaros,1523,evoker,devastation,46,23,23
Простокоршун,howling-fjord,1521,evoker,devastation,129,72,57
Dractaris,khaz-modan,1520,evoker,devastation,186,90,96
Darksmouke,forscherliga,1519,evoker,devastation,38,18,20
Arbylegion,outland,1518,evoker,devastation,136,74,62
Evokimag,grim-batol,1518,evoker,devastation,48,20,28
Flawxy,blackmoore,1516,evoker,devastation,36,20,16
Dreamfyrez,dun-modr,1515,evoker,devastation,87,48,39
Drákon,dalaran,1515,evoker,devastation,241,121,120
Tigurius,onyxia,1514,evoker,devastation,83,49,34
Trellie,die-aldor,1513,evoker,devastation,24,16,8
Temeraire,argent-dawn,1513,evoker,devastation,60,32,28
Savaithnir,draenor,1513,evoker,devastation,30,16,14
Schmoker,stormscale,1513,evoker,devastation,36,16,20
Drakodêd,drakthul,1512,evoker,devastation,52,27,25
Уфдрактир,howling-fjord,1510,evoker,devastation,102,52,50
Paintballhd,kazzak,1510,evoker,devastation,66,32,34
Emptynuts,ravencrest,1507,evoker,devastation,36,20,16
Lazurius,ravencrest,1507,evoker,devastation,54,26,28
Dratsch,blackhand,1506,evoker,devastation,30,19,11
Dracyan,taerar,1506,evoker,devastation,54,31,23
Голденджо,gordunni,1506,evoker,devastation,94,51,43
Draghad,blackmoore,1506,evoker,devastation,75,37,38
Dragønlord,blackrock,1502,evoker,devastation,60,29,31
Firebutt,argent-dawn,1501,evoker,devastation,106,67,39
Fyndassil,blackrock,1501,evoker,devastation,161,67,94
Shenlongoat,ravencrest,1500,evoker,devastation,76,45,31
Kuve,stormscale,1500,evoker,devastation,101,53,48
Rfid,perenolde,1499,evoker,devastation,36,22,14
Ironwing,sanguino,1493,evoker,devastation,617,314,303
Orrub,azshara,1493,evoker,devastation,47,21,26
Tilwahlzok,pozzo-delleternità,1492,evoker,devastation,72,37,35
Lumberdrake,stormscale,1490,evoker,devastation,58,29,29
Onsirion,argent-dawn,1489,evoker,devastation,90,44,46
Kaynyxia,argent-dawn,1487,evoker,devastation,45,25,20
Caliss,archimonde,1487,evoker,devastation,124,66,58
Drunkino,aegwynn,1487,evoker,devastation,132,70,62
Syraxxes,sanguino,1486,evoker,devastation,57,25,32
Dratheon,dun-modr,1485,evoker,devastation,51,30,21
Draconz,stormrage,1485,evoker,devastation,66,36,30
Юнигоса,soulflayer,1484,evoker,devastation,179,94,85
Malfoyer,arathor,1483,evoker,devastation,107,58,49
Йормунгандка,soulflayer,1482,evoker,devastation,55,30,25
Gaargaveko,blackmoore,1482,evoker,devastation,60,29,31
Childofdawn,blackmoore,1481,evoker,devastation,117,68,49
Ghiscar,dentarg,1481,evoker,devastation,134,67,67
Shroomzthyr,blackmoore,1481,evoker,devastation,96,48,48
Лабриса,galakrond,1475,evoker,devastation,337,167,170
Kroqmoo,drekthar,1474,evoker,devastation,279,141,138
Алексатэтсуя,ashenvale,1473,evoker,devastation,95,55,40
Dragorus,stormscale,1472,evoker,devastation,81,41,40
Magmarôs,argent-dawn,1471,evoker,devastation,152,84,68
Tályn,twisting-nether,1470,evoker,devastation,66,37,29
Feuerspuckii,blackrock,1468,evoker,devastation,42,25,17
Kuhi,twisting-nether,1468,evoker,devastation,126,65,61
Dreadnés,runetotem,1468,evoker,devastation,48,24,24
Maladrake,archimonde,1468,evoker,devastation,51,24,27
Deskölorio,shendralar,1467,evoker,devastation,120,74,46
Shenronblue,bloodscalp,1465,evoker,devastation,30,16,14
Madeinhæven,ravencrest,1465,evoker,devastation,82,39,43
Ken,la-croisade-écarlate,1464,evoker,devastation,376,191,185
Ninhursag,hyjal,1462,evoker,devastation,42,26,16
Волккейн,soulflayer,1462,evoker,devastation,58,28,30
Эралир,gordunni,1461,evoker,devastation,104,48,56
Storhorn,silvermoon,1461,evoker,devastation,66,28,38
Dreek,emerald-dream,1460,evoker,devastation,60,37,23
Galakrond,auchindoun,1460,evoker,devastation,48,21,27
Phanex,bloodhoof,1459,evoker,devastation,126,56,70
Grillkylling,outland,1458,evoker,devastation,104,56,48
Baroqs,antonidas,1456,evoker,devastation,24,18,6
Shyke,draenor,1455,evoker,devastation,90,54,36
Норимида,soulflayer,1455,evoker,devastation,109,61,48
Iscale,twisting-nether,1455,evoker,devastation,82,45,37
Mölnlycke,twisting-nether,1455,evoker,devastation,60,32,28
Potéto,rashgarroth,1455,evoker,devastation,129,64,65
Fireandash,draenor,1453,evoker,devastation,59,33,26
Yála,anetheron,1453,evoker,devastation,335,170,165
Drãco,auchindoun,1453,evoker,devastation,108,43,65
Smegma,norgannon,1452,evoker,devastation,72,38,34
Abehethan,archimonde,1452,evoker,devastation,58,29,29
Grougale,archimonde,1452,evoker,devastation,75,36,39
Kaìdo,tarren-mill,1451,evoker,devastation,72,36,36
Varenion,sylvanas,1451,evoker,devastation,54,25,29
Emmagosa,argent-dawn,1448,evoker,devastation,222,112,110
Tibimbo,blackrock,1446,evoker,devastation,104,55,49
Shenrøn,defias-brotherhood,1446,evoker,devastation,109,47,62
Скозложёп,ashenvale,1446,evoker,devastation,55,22,33
Axro,ravencrest,1445,evoker,devastation,78,48,30
Fogwing,ravencrest,1444,evoker,devastation,151,77,74
Snoby,onyxia,1442,evoker,devastation,248,121,127
Nuvese,tarren-mill,1438,evoker,devastation,78,34,44
Chuckyy,archimonde,1437,evoker,devastation,116,60,56
Dimethyr,silvermoon,1436,evoker,devastation,130,66,64
Лечулечу,blackscar,1436,evoker,devastation,180,83,97
Phyx,talnivarr,1436,evoker,devastation,66,30,36
Паунфаунд,eversong,1435,evoker,devastation,96,45,51
Tayrona,sanguino,1434,evoker,devastation,38,21,17
Piyuli,silvermoon,1434,evoker,devastation,64,34,30
Motloh,ravencrest,1434,evoker,devastation,112,56,56
Erenhan,archimonde,1434,evoker,devastation,54,19,35
Drakea,sanguino,1432,evoker,devastation,98,49,49
Echadication,tarren-mill,1431,evoker,devastation,30,15,15
Дыханиеочка,howling-fjord,1430,evoker,devastation,83,40,43
Альтэфчетыре,blackscar,1428,evoker,devastation,54,34,20
Drâker,twisting-nether,1427,evoker,devastation,24,15,9
Drevo,nemesis,1424,evoker,devastation,24,16,8
Movoker,twisting-nether,1424,evoker,devastation,42,19,23
Zamolx,ragnaros,1422,evoker,devastation,30,20,10
Albinuaric,tarren-mill,1422,evoker,devastation,24,15,9
Flügelnix,blackmoore,1422,evoker,devastation,65,32,33
Drokki,burning-legion,1420,evoker,devastation,35,19,16
Chadnosa,sylvanas,1420,evoker,devastation,33,17,16
Raagnar,kazzak,1419,evoker,devastation,99,54,45
Héaven,nemesis,1419,evoker,devastation,113,60,53
Varagon,rexxar,1418,evoker,devastation,106,55,51
Ocanada,draenor,1418,evoker,devastation,182,89,93
Grymvild,earthen-ring,1417,evoker,devastation,24,15,9
Freaksy,blackmoore,1417,evoker,devastation,27,16,11
Lektar,eredar,1416,evoker,devastation,77,37,40
Lknubraosanu,sylvanas,1415,evoker,devastation,30,16,14
Eldraegosa,argent-dawn,1415,evoker,devastation,36,16,20
Ljudigusteri,kazzak,1413,evoker,devastation,71,40,31
Cenca,blackmoore,1413,evoker,devastation,65,35,30
Rufistraz,burning-legion,1413,evoker,devastation,211,109,102
Scalo,kazzak,1412,evoker,devastation,55,33,22
Zweibek,stormscale,1411,evoker,devastation,41,18,23
Ромадрактир,howling-fjord,1410,evoker,devastation,29,16,13
Marvok,bloodfeather,1410,evoker,devastation,145,66,79
Ssjblack,archimonde,1409,evoker,devastation,47,24,23
Xéíoín,kazzak,1407,evoker,devastation,120,64,56
Deadlyvok,zenedar,1407,evoker,devastation,47,24,23
Pippomale,nemesis,1407,evoker,devastation,60,30,30
Valdrakk,argent-dawn,1407,evoker,devastation,43,21,22
Мусье,soulflayer,1407,evoker,devastation,48,19,29
Hellvarg,twisting-nether,1406,evoker,devastation,66,34,32
Dragondeezs,silvermoon,1405,evoker,devastation,66,36,30
Thavion,forscherliga,1402,evoker,devastation,42,20,22
Feyrbrand,ysera,1400,evoker,devastation,104,53,51
Billyhassan,stormscale,1399,evoker,devastation,23,15,8
Dschíses,malganis,1395,evoker,devastation,30,19,11
Cocardona,zuljin,1395,evoker,devastation,53,29,24
Vagar,garona,1394,evoker,devastation,66,33,33
Yaboismok,burning-legion,1394,evoker,devastation,59,28,31
Haltorr,ravencrest,1394,evoker,devastation,90,37,53
Snitties,tarren-mill,1393,evoker,devastation,82,41,41
Elrycx,tarren-mill,1393,evoker,devastation,56,28,28
Wjörm,outland,1391,evoker,devastation,48,34,14
Avizz,tarren-mill,1391,evoker,devastation,51,27,24
Dragonaked,silvermoon,1390,evoker,devastation,144,75,69
Gasparievok,sylvanas,1388,evoker,devastation,217,106,111
Skyfire,stormscale,1386,evoker,devastation,73,37,36
Ouaitamaman,draenor,1386,evoker,devastation,30,15,15
Murrakhan,ravencrest,1385,evoker,devastation,125,57,68
Agnî,sanguino,1384,evoker,devastation,128,60,68
Darktempest,onyxia,1383,evoker,devastation,102,53,49
Rytoshi,medivh,1383,evoker,devastation,369,181,188
Гекаш,soulflayer,1383,evoker,devastation,112,54,58
Фелсейер,gordunni,1383,evoker,devastation,136,65,71
Wingit,frostmane,1382,evoker,devastation,159,90,69
Geckonen,stormreaver,1381,evoker,devastation,127,70,57
Dracsona,twisting-nether,1378,evoker,devastation,72,35,37
Yoshinora,archimonde,1377,evoker,devastation,69,34,35
Gendowyn,draenor,1377,evoker,devastation,48,23,25
Razthyr,twisting-nether,1376,evoker,devastation,106,57,49
Nathraakhza,argent-dawn,1376,evoker,devastation,54,29,25
Skabaluga,blackrock,1376,evoker,devastation,126,65,61
Dramec,dun-morogh,1375,evoker,devastation,64,39,25
Malfø,exodar,1375,evoker,devastation,64,36,28
Dragruf,aegwynn,1374,evoker,devastation,30,15,15
Jeremiah,earthen-ring,1374,evoker,devastation,66,30,36
Nurilla,twisting-nether,1370,evoker,devastation,60,30,30
Zárelyón,ragnaros,1368,evoker,devastation,31,23,8
Zelëph,archimonde,1366,evoker,devastation,119,61,58
Minikuja,culte-de-la-rive-noire,1365,evoker,devastation,853,442,411
Batmanjasii,eredar,1364,evoker,devastation,47,26,21
Wircea,kazzak,1363,evoker,devastation,42,27,15
Conservion,silvermoon,1363,evoker,devastation,93,49,44
Llael,blackhand,1361,evoker,devastation,144,69,75
Drackial,zuljin,1361,evoker,devastation,78,33,45
Chronoalis,nemesis,1359,evoker,devastation,50,34,16
Sakade,archimonde,1359,evoker,devastation,66,22,44
Yaldthion,dun-modr,1358,evoker,devastation,107,53,54
Hodunormu,argent-dawn,1356,evoker,devastation,53,27,26
Parisinka,silvermoon,1356,evoker,devastation,490,248,242
Димадракон,gordunni,1350,evoker,devastation,94,56,38
Keeqo,silvermoon,1350,evoker,devastation,60,35,25
Seryphys,blackhand,1350,evoker,devastation,94,48,46
Aììzen,khaz-modan,1350,evoker,devastation,30,15,15
Ðovahkiin,tarren-mill,1350,evoker,devastation,39,17,22
Cuufizix,silvermoon,1349,evoker,devastation,76,40,36
Gosuvoker,eredar,1348,evoker,devastation,65,29,36
Zyevoker,silvermoon,1347,evoker,devastation,37,19,18
Bloodspiral,tarren-mill,1346,evoker,devastation,54,26,28
Ferante,ragnaros,1346,evoker,devastation,131,60,71
Thyriån,kazzak,1344,evoker,devastation,42,19,23
Aeryz,burning-legion,1344,evoker,devastation,83,29,54
Flypzz,stormscale,1343,evoker,devastation,48,24,24
Oudwood,onyxia,1343,evoker,devastation,42,16,26
Echoker,stormscale,1342,evoker,devastation,61,34,27
Zsyntra,blackmoore,1342,evoker,devastation,73,29,44
Dractyr,korgall,1341,evoker,devastation,30,14,16
Lizzar,ravencrest,1340,evoker,devastation,84,40,44
Abcxqt,hyjal,1337,evoker,devastation,106,60,46
Steeken,haomarush,1337,evoker,devastation,183,89,94
Йеле,soulflayer,1336,evoker,devastation,60,28,32
Kyliejenner,azjolnerub,1334,evoker,devastation,34,20,14
Hornytail,doomhammer,1334,evoker,devastation,100,48,52
Mekez,draenor,1332,evoker,devastation,24,14,10
Mezoudormu,argent-dawn,1332,evoker,devastation,84,28,56
Lynt,burning-blade,1331,evoker,devastation,61,34,27
Draqthyr,frostmane,1331,evoker,devastation,143,70,73
Magalàs,pozzo-delleternità,1328,evoker,devastation,36,18,18
Zhabrina,silvermoon,1328,evoker,devastation,42,15,27
Karnâks,silvermoon,1326,evoker,devastation,30,16,14
Wôpz,archimonde,1326,evoker,devastation,191,100,91
Drdrake,aszune,1325,evoker,devastation,48,24,24
Xendrag,silvermoon,1324,evoker,devastation,155,78,77
Алыйкиви,howling-fjord,1323,evoker,devastation,92,53,39
Evokíng,argent-dawn,1323,evoker,devastation,336,170,166
Rowzy,sylvanas,1323,evoker,devastation,263,130,133
Füjür,dun-modr,1323,evoker,devastation,78,38,40
Rófyx,twisting-nether,1322,evoker,devastation,24,14,10
Dracofion,ravencrest,1320,evoker,devastation,24,14,10
Cazé,archimonde,1320,evoker,devastation,43,19,24
Henvokah,ravencrest,1318,evoker,devastation,47,26,21
Драгс,razuvious,1318,evoker,devastation,59,31,28
Darthagos,outland,1317,evoker,devastation,24,14,10
Zenda,turalyon,1316,evoker,devastation,114,57,57
Yantaî,hyjal,1315,evoker,devastation,48,30,18
Ayders,khaz-modan,1315,evoker,devastation,208,103,105
Tenshà,nemesis,1314,evoker,devastation,71,35,36
Lînk,chromaggus,1314,evoker,devastation,54,25,29
Barneyxx,tarren-mill,1314,evoker,devastation,42,14,28
Dakir,blackmoore,1312,evoker,devastation,38,26,12
Camilis,archimonde,1312,evoker,devastation,109,54,55
Dopëshow,drakthul,1311,evoker,devastation,60,37,23
Kárás,silvermoon,1311,evoker,devastation,60,29,31
Bruhwhat,ravencrest,1308,evoker,devastation,63,29,34
Akaitzu,blackmoore,1307,evoker,devastation,54,30,24
Kelebron,bloodscalp,1307,evoker,devastation,30,14,16
Nochance,dentarg,1305,evoker,devastation,102,51,51
Nazalath,eonar,1304,evoker,devastation,118,56,62
Tokzestra,hyjal,1301,evoker,devastation,141,70,71
Tremola,twisting-nether,1301,evoker,devastation,49,24,25
Tendoker,ragnaros,1300,evoker,devastation,28,18,10
Драгтир,blackscar,1298,evoker,devastation,112,61,51
Sharaxis,blackmoore,1298,evoker,devastation,111,58,53
Mijähh,taerar,1298,evoker,devastation,30,14,16
Draxone,malfurion,1297,evoker,devastation,109,61,48
Loveheart,die-aldor,1297,evoker,devastation,132,64,68
Alèd,hyjal,1296,evoker,devastation,30,16,14
Shoggoth,chogall,1296,evoker,devastation,551,272,279
Iordred,kazzak,1294,evoker,devastation,48,27,21
Ryújín,blackhand,1294,evoker,devastation,35,15,20
Kklur,twisting-nether,1284,evoker,devastation,30,15,15
Душнот,fordragon,1281,evoker,devastation,93,49,44
Saratharion,argent-dawn,1280,evoker,devastation,160,78,82
Airbourne,sanguino,1280,evoker,devastation,38,18,20
Honz,antonidas,1275,evoker,devastation,85,38,47
Ceenaastra,ragnaros,1274,evoker,devastation,23,14,9
Shmog,stormscale,1272,evoker,devastation,41,15,26
Dyrokan,blackhand,1271,evoker,devastation,35,17,18
Ziqqispyro,thrall,1269,evoker,devastation,48,21,27
Ppiaxx,dalaran,1263,evoker,devastation,30,15,15
Tazouu,marécage-de-zangar,1262,evoker,devastation,60,37,23
Starblazed,defias-brotherhood,1258,evoker,devastation,98,62,36
Коляомон,gordunni,1256,evoker,devastation,71,38,33
Kirinde,draenor,1256,evoker,devastation,54,27,27
Dragonppl,kazzak,1252,evoker,devastation,60,32,28
Drakô,festung-der-stürme,1252,evoker,devastation,101,48,53
Rafale,the-maelstrom,1251,evoker,devastation,96,48,48
Thebigsmoke,lightbringer,1250,evoker,devastation,192,98,94
Metadrak,kazzak,1250,evoker,devastation,60,28,32
Aerodractyr,blackmoore,1250,evoker,devastation,66,26,40
Чешуеплет,grom,1249,evoker,devastation,54,20,34
Orazur,hyjal,1247,evoker,devastation,18,13,5
Mesmerìze,khaz-modan,1247,evoker,devastation,60,30,30
Эллъис,gordunni,1246,evoker,devastation,70,22,48
Malithyr,blackmoore,1245,evoker,devastation,36,21,15
Speedwägon,blackhand,1245,evoker,devastation,30,17,13
Hodnsak,blackmoore,1244,evoker,devastation,24,13,11
Nerõ,thrall,1244,evoker,devastation,30,13,17
Kássadaín,the-maelstrom,1243,evoker,devastation,102,48,54
Amneziavoker,hyjal,1242,evoker,devastation,21,14,7
Натссу,borean-tundra,1241,evoker,devastation,98,50,48
Rzre,stormscale,1241,evoker,devastation,72,32,40
Kelistrasza,die-aldor,1240,evoker,devastation,124,61,63
Veiv,tarren-mill,1240,evoker,devastation,32,14,18
Nyedrak,kilrogg,1239,evoker,devastation,18,13,5
Dowaa,tarren-mill,1239,evoker,devastation,57,21,36
Archidrake,ravencrest,1233,evoker,devastation,79,37,42
Flyingaway,tarren-mill,1231,evoker,devastation,18,13,5
Abragan,aegwynn,1231,evoker,devastation,75,37,38
Ignisaureus,silvermoon,1229,evoker,devastation,36,17,19
Zalizopuz,tarren-mill,1229,evoker,devastation,36,13,23
Craichead,defias-brotherhood,1228,evoker,devastation,36,19,17
Favill,blackhand,1228,evoker,devastation,93,39,54
Ahiresegyfej,ragnaros,1227,evoker,devastation,129,71,58
Naömi,archimonde,1227,evoker,devastation,24,13,11
Itisabuse,antonidas,1227,evoker,devastation,78,38,40
Кровит,soulflayer,1225,evoker,devastation,42,17,25
Шотнутый,soulflayer,1224,evoker,devastation,68,35,33
Доракарис,deathweaver,1224,evoker,devastation,82,39,43
Leyca,outland,1221,evoker,devastation,180,83,97
Mâhýo,rexxar,1221,evoker,devastation,30,13,17
Серцедраконн,gordunni,1219,evoker,devastation,113,51,62
Scraier,ravenholdt,1218,evoker,devastation,25,14,11
Умгак,gordunni,1218,evoker,devastation,29,13,16
Ryuniss,argent-dawn,1217,evoker,devastation,48,23,25
Лимисар,gordunni,1217,evoker,devastation,71,29,42
Рептилойдина,howling-fjord,1216,evoker,devastation,166,83,83
Veo,aggra-português,1216,evoker,devastation,54,25,29
Sleepnot,argent-dawn,1215,evoker,devastation,24,15,9
Hyunastraza,dalaran,1215,evoker,devastation,57,28,29
Fullyndra,archimonde,1213,evoker,devastation,120,55,65
Нирт,gordunni,1212,evoker,devastation,24,13,11
Dragoncloak,blackrock,1209,evoker,devastation,106,59,47
Франкич,fordragon,1203,evoker,devastation,34,14,20
Лавеон,gordunni,1199,evoker,devastation,30,13,17
Babbendrakar,grim-batol,1193,evoker,devastation,72,29,43
Spyyrø,sanguino,1192,evoker,devastation,121,53,68
Cørvus,silvermoon,1192,evoker,devastation,43,17,26
Xfckd,ragnaros,1180,evoker,devastation,77,36,41
Папиич,soulflayer,1176,evoker,devastation,59,21,38
Azzul,teldrassil,1175,evoker,devastation,90,45,45
Firaxis,kazzak,1173,evoker,devastation,66,35,31
Bæxo,blackrock,1170,evoker,devastation,106,45,61
Terenus,hellfire,1164,evoker,devastation,36,14,22
Kalep,kazzak,1163,evoker,devastation,33,16,17
Lugarius,gilneas,1162,evoker,devastation,77,41,36
Gharløk,outland,1162,evoker,devastation,110,54,56
Jelboen,draenor,1161,evoker,devastation,52,30,22
Lago,gorgonnash,1161,evoker,devastation,122,65,57
Klim,temple-noir,1160,evoker,devastation,41,15,26
Заднс,howling-fjord,1154,evoker,devastation,42,16,26
Noky,aegwynn,1153,evoker,devastation,72,35,37
Kmzi,twisting-nether,1151,evoker,devastation,24,12,12
Spicylizard,stormscale,1151,evoker,devastation,24,12,12
Draclight,nemesis,1151,evoker,devastation,54,23,31
Deny,frostmane,1150,evoker,devastation,18,12,6
Maru,outland,1150,evoker,devastation,18,12,6
Хичпокс,soulflayer,1150,evoker,devastation,24,12,12
Spyro,bloodfeather,1150,evoker,devastation,24,12,12
Isizzu,draenor,1149,evoker,devastation,115,56,59
Luu,the-maelstrom,1148,evoker,devastation,24,12,12
Tömmöfwarrs,archimonde,1145,evoker,devastation,27,13,14
Haligos,the-maelstrom,1145,evoker,devastation,36,12,24
Imwhite,doomhammer,1144,evoker,devastation,48,22,26
Aintnospyro,silvermoon,1143,evoker,devastation,114,49,65
Туймаада,soulflayer,1141,evoker,devastation,18,12,6
Bigcharizard,kazzak,1141,evoker,devastation,18,12,6
Crygon,outland,1140,evoker,devastation,57,26,31
Dàenérys,hyjal,1139,evoker,devastation,74,46,28
Gissthebuzzy,dun-modr,1138,evoker,devastation,24,12,12
Scathethrel,draenor,1135,evoker,devastation,24,12,12
Hazzèr,blackrock,1135,evoker,devastation,313,152,161
Arella,mannoroth,1134,evoker,devastation,622,319,303
Wurm,shadowsong,1132,evoker,devastation,18,12,6
Mfull,thrall,1132,evoker,devastation,43,17,26
Krithdow,terokkar,1131,evoker,devastation,40,23,17
Antistrasza,argent-dawn,1125,evoker,devastation,33,15,18
Rhel,the-maelstrom,1123,evoker,devastation,65,31,34
Mirazare,khadgar,1122,evoker,devastation,126,63,63
Hijeon,ravencrest,1121,evoker,devastation,30,12,18
Deathdula,draenor,1117,evoker,devastation,30,14,16
Dranke,silvermoon,1115,evoker,devastation,85,45,40
Dragônslayer,amanthul,1113,evoker,devastation,78,43,35
Dragomakry,blackmoore,1113,evoker,devastation,84,45,39
Provoker,die-arguswacht,1113,evoker,devastation,60,31,29
Trëp,draenor,1113,evoker,devastation,63,20,43
Clueless,nemesis,1112,evoker,devastation,29,12,17
Theredpepper,outland,1104,evoker,devastation,30,12,18
Tescegos,stormscale,1100,evoker,devastation,29,17,12
Oldlizard,blackrock,1100,evoker,devastation,39,12,27
Rîncêwind,uldum,1099,evoker,devastation,100,57,43
Flapant,archimonde,1098,evoker,devastation,37,15,22
Эфирид,blackscar,1096,evoker,devastation,115,64,51
Верникс,gordunni,1094,evoker,devastation,27,13,14
Ferdibaba,aegwynn,1092,evoker,devastation,139,62,77
Morsan,tichondrius,1089,evoker,devastation,31,16,15
Spikydragon,ysondre,1089,evoker,devastation,24,12,12
Vucashi,blackhand,1089,evoker,devastation,70,33,37
Dragis,die-aldor,1088,evoker,devastation,36,17,19
Dovakin,arathi,1087,evoker,devastation,26,15,11
Iolite,dun-modr,1087,evoker,devastation,152,75,77
Kubae,ravencrest,1087,evoker,devastation,39,19,20
Nebulai,silvermoon,1086,evoker,devastation,91,41,50
Sethos,dalaran,1082,evoker,devastation,54,21,33
Fruhans,tarren-mill,1080,evoker,devastation,29,15,14
Ekko,nethersturm,1079,evoker,devastation,84,43,41
Padrepì,nemesis,1078,evoker,devastation,18,13,5
Syraxis,shadowsong,1074,evoker,devastation,28,12,16
Kvothe,malygos,1072,evoker,devastation,54,22,32
Ластнейм,blackscar,1071,evoker,devastation,32,13,19
Zhannezza,kazzak,1070,evoker,devastation,23,12,11
Akúda,blackhand,1069,evoker,devastation,42,20,22
Монархдракон,eversong,1068,evoker,devastation,49,19,30
Jkrowlingxox,ravencrest,1067,evoker,devastation,60,34,26
Дархо,goldrinn,1062,evoker,devastation,48,27,21
Рагира,gordunni,1060,evoker,devastation,110,42,68
Gekogax,thrall,1060,evoker,devastation,34,12,22
Stuffi,frostwolf,1059,evoker,devastation,92,42,50
Rhegal,auchindoun,1056,evoker,devastation,18,11,7
Fabrizios,blackrock,1055,evoker,devastation,24,11,13
Predictrash,archimonde,1054,evoker,devastation,24,11,13
Pandagos,archimonde,1053,evoker,devastation,18,11,7
Zerotales,turalyon,1053,evoker,devastation,30,18,12
Pêrcevâl,archimonde,1053,evoker,devastation,24,11,13
Lonte,hyjal,1052,evoker,devastation,18,11,7
Vanima,forscherliga,1052,evoker,devastation,70,42,28
Алрад,gordunni,1051,evoker,devastation,21,12,9
Vagar,dun-modr,1051,evoker,devastation,80,37,43
Daboc,tarren-mill,1051,evoker,devastation,74,30,44
Orangechkn,ravencrest,1050,evoker,devastation,24,11,13
Rodolpho,malganis,1049,evoker,devastation,24,11,13
Bot,arathor,1046,evoker,devastation,24,11,13
Kirkgon,terokkar,1043,evoker,devastation,66,27,39
Cxsmetic,antonidas,1042,evoker,devastation,24,11,13
Hateroll,ravencrest,1041,evoker,devastation,24,11,13
Draganeel,frostwolf,1038,evoker,devastation,89,34,55
Otr,draenor,1035,evoker,devastation,90,38,52
Büsselberg,blackmoore,1034,evoker,devastation,42,20,22
Vrèsh,blackrock,1032,evoker,devastation,87,35,52
Драганайт,gordunni,1026,evoker,devastation,163,84,79
Alberdo,outland,1022,evoker,devastation,90,35,55
Scalash,drakthul,1020,evoker,devastation,115,63,52
Мизурион,gordunni,1019,evoker,devastation,66,38,28
Pedogos,outland,1016,evoker,devastation,75,31,44
Dragonhero,arygos,1014,evoker,devastation,138,74,64
Rieper,twisting-nether,1009,evoker,devastation,223,106,117
Валказар,gordunni,1004,evoker,devastation,106,48,58
Drakridarn,kazzak,999,evoker,devastation,29,11,18
Flyingfak,ravencrest,994,evoker,devastation,30,19,11
Капрал,gordunni,988,evoker,devastation,14,11,3
Séràs,bloodfeather,986,evoker,devastation,24,13,11
Raktoy,frostwolf,986,evoker,devastation,106,43,63
Julerion,draenor,984,evoker,devastation,42,26,16
Драконилья,azuregos,982,evoker,devastation,26,11,15
Котик,greymane,974,evoker,devastation,82,33,49
Disizmaju,silvermoon,967,evoker,devastation,122,65,57
Dragonsweat,hyjal,960,evoker,devastation,12,10,2
Bläckrow,tarren-mill,960,evoker,devastation,12,10,2
Azustraza,ysondre,960,evoker,devastation,24,10,14
Jinthyr,anachronos,959,evoker,devastation,12,10,2
Terradòr,die-aldor,959,evoker,devastation,18,10,8
Canitabravar,cthun,959,evoker,devastation,150,75,75
Ewoky,ravencrest,959,evoker,devastation,57,25,32
Safcøn,eredar,959,evoker,devastation,30,10,20
Danaval,blackhand,955,evoker,devastation,18,10,8
Maccen,twisting-nether,955,evoker,devastation,18,10,8
Grajade,dun-modr,954,evoker,devastation,18,10,8
Smaugbril,argent-dawn,954,evoker,devastation,18,10,8
Xatures,twisting-nether,953,evoker,devastation,36,21,15
Stalkhyr,elune,953,evoker,devastation,24,10,14
Drakkisat,archimonde,952,evoker,devastation,40,21,19
Boulior,defias-brotherhood,952,evoker,devastation,24,10,14
Mallor,kirin-tor,952,evoker,devastation,47,18,29
Lizzardhero,kazzak,948,evoker,devastation,24,10,14
Synhtol,ragnaros,947,evoker,devastation,12,10,2
Azza,uldum,947,evoker,devastation,72,30,42
Evokraut,silvermoon,938,evoker,devastation,30,15,15
Shenrøn,garona,937,evoker,devastation,41,18,23
Zpartadraga,ragnaros,928,evoker,devastation,38,20,18
Leskano,aegwynn,923,evoker,devastation,30,14,16
Acedragniir,khaz-modan,920,evoker,devastation,62,32,30
Speedoflight,ragnaros,916,evoker,devastation,57,21,36
Deimong,khaz-modan,913,evoker,devastation,35,16,19
Stormydude,doomhammer,907,evoker,devastation,24,13,11
Аверьятор,fordragon,906,evoker,devastation,24,10,14
Elorand,ulduar,900,evoker,devastation,156,64,92
Ashlàr,earthen-ring,896,evoker,devastation,139,62,77
Evosker,zuljin,891,evoker,devastation,101,35,66
Blazinamazin,korgall,884,evoker,devastation,22,10,12
Быковскии,howling-fjord,882,evoker,devastation,96,49,47
Dragotar,malygos,880,evoker,devastation,133,66,67
Дракариса,eversong,879,evoker,devastation,49,21,28
Tenkenfutsu,elune,879,evoker,devastation,100,41,59
Donairian,doomhammer,878,evoker,devastation,134,67,67
Lifestrasza,drakthul,868,evoker,devastation,13,10,3
Drataniel,draenor,864,evoker,devastation,18,9,9
Xnazelou,hyjal,864,evoker,devastation,18,9,9
Zettaflare,nazjatar,864,evoker,devastation,18,9,9
Selectaa,grim-batol,864,evoker,devastation,18,9,9
Drachenwut,aegwynn,864,evoker,devastation,24,9,15
Сойлизард,gordunni,864,evoker,devastation,24,9,15
Brxdragon,antonidas,863,evoker,devastation,12,9,3
Killrogos,thrall,863,evoker,devastation,12,9,3
Пласедусакс,soulflayer,863,evoker,devastation,12,9,3
Kylor,zuljin,863,evoker,devastation,12,9,3
Féféledragon,archimonde,863,evoker,devastation,18,9,9
Рогатыйдебик,gordunni,863,evoker,devastation,18,9,9
Setutekh,argent-dawn,863,evoker,devastation,24,9,15
Dracoumel,silvermoon,862,evoker,devastation,12,9,3
Tholanía,baelgun,862,evoker,devastation,12,9,3
Akumaryu,blackrock,862,evoker,devastation,12,9,3
Ernesti,draenor,862,evoker,devastation,18,9,9
Runednmf,kazzak,862,evoker,devastation,18,9,9
Хэлтарион,howling-fjord,862,evoker,devastation,18,9,9
Zoskinipon,frostmane,862,evoker,devastation,19,9,10
Nanderoza,the-maelstrom,861,evoker,devastation,12,9,3
Rekinn,tarren-mill,861,evoker,devastation,18,9,9
Bronkek,drakthul,860,evoker,devastation,30,9,21
Copíum,silvermoon,859,evoker,devastation,30,9,21
Звездобык,borean-tundra,856,evoker,devastation,24,9,15
Karistrasza,sylvanas,854,evoker,devastation,24,9,15
Azzazed,dun-modr,853,evoker,devastation,20,9,11
Дрэгшторм,gordunni,851,evoker,devastation,12,9,3
Sleipnyr,garrosh,845,evoker,devastation,72,31,41
Xarshar,dragonblight,844,evoker,devastation,17,9,8
Флардикас,gordunni,842,evoker,devastation,24,9,15
Sebiker,ravencrest,830,evoker,devastation,18,11,7
Syccs,blackrock,828,evoker,devastation,23,11,12
Thebabayag,kazzak,816,evoker,devastation,48,21,27
Crynerf,ravencrest,814,evoker,devastation,168,81,87
Dragneêl,nozdormu,803,evoker,devastation,27,10,17
Драгур,fordragon,802,evoker,devastation,25,10,15
Calonddraig,turalyon,795,evoker,devastation,79,36,43
Chrysaetor,argent-dawn,788,evoker,devastation,18,9,9
Dahwi,blackmoore,779,evoker,devastation,68,27,41
Dromar,malganis,768,evoker,devastation,12,8,4
Alusiedrake,ravencrest,768,evoker,devastation,12,8,4
Tsunamì,ysondre,768,evoker,devastation,12,8,4
Moondragoon,ravencrest,768,evoker,devastation,12,8,4
Gloombloom,emeriss,768,evoker,devastation,13,8,5
Súnny,archimonde,768,evoker,devastation,15,8,7
Ancientfire,tarren-mill,768,evoker,devastation,18,8,10
Ettox,darksorrow,768,evoker,devastation,18,8,10
Bossen,magtheridon,768,evoker,devastation,18,8,10
Lulvoker,blackrock,768,evoker,devastation,18,8,10
Mazakqt,draenor,768,evoker,devastation,18,8,10
Zp,kazzak,768,evoker,devastation,18,8,10
Nekrosdrake,tarren-mill,768,evoker,devastation,18,8,10
Malowux,outland,768,evoker,devastation,18,8,10
Garussy,draenor,768,evoker,devastation,18,8,10
Cptjambon,archimonde,767,evoker,devastation,12,8,4
Elastrasza,burning-blade,767,evoker,devastation,12,8,4
Iblvicanfly,stormscale,767,evoker,devastation,12,8,4
Balerioon,draenor,767,evoker,devastation,12,8,4
Fetzi,blackhand,767,evoker,devastation,12,8,4
Bramvoker,outland,767,evoker,devastation,18,8,10
Fayral,blackmoore,767,evoker,devastation,18,8,10
Shazag,ragnaros,767,evoker,devastation,18,8,10
Tooltipshow,ragnaros,767,evoker,devastation,18,8,10
Deathwingx,sylvanas,767,evoker,devastation,18,8,10
Knööz,antonidas,767,evoker,devastation,18,8,10
Gelth,zuljin,767,evoker,devastation,27,9,18
Chatyr,kazzak,766,evoker,devastation,12,8,4
Aiakès,marécage-de-zangar,766,evoker,devastation,12,8,4
Мутаре,borean-tundra,766,evoker,devastation,18,8,10
Koris,arakarahm,765,evoker,devastation,12,8,4
Чвкдрагонит,soulflayer,765,evoker,devastation,18,8,10
Raché,blackmoore,763,evoker,devastation,12,8,4
Ogienoddech,silvermoon,762,evoker,devastation,18,8,10
Oeos,dragonblight,757,evoker,devastation,118,42,76
Drakenballen,ragnaros,755,evoker,devastation,15,8,7
Slyrax,nemesis,755,evoker,devastation,30,8,22
Viorias,argent-dawn,751,evoker,devastation,24,8,16
Davioncz,thunderhorn,749,evoker,devastation,12,8,4
Reptilebrain,twisting-nether,743,evoker,devastation,25,10,15
Joeyshelby,sylvanas,736,evoker,devastation,16,8,8
Sakrifizér,kazzak,735,evoker,devastation,23,8,15
Sivaas,arathi,724,evoker,devastation,72,31,41
Dantex,ravencrest,719,evoker,devastation,15,8,7
Argentrenard,twilights-hammer,716,evoker,devastation,17,8,9
Ominobari,silvermoon,699,evoker,devastation,31,9,22
Snookicooki,stormscale,692,evoker,devastation,16,8,8
Xiarya,draenor,672,evoker,devastation,12,7,5
Эбиб,gordunni,672,evoker,devastation,12,7,5
Arecibo,tarren-mill,672,evoker,devastation,12,7,5
Zezus,outland,672,evoker,devastation,12,7,5
Sebek,archimonde,672,evoker,devastation,12,7,5
Styxev,blackhand,672,evoker,devastation,12,7,5
Taoheat,blackrock,672,evoker,devastation,12,7,5
Gonzalo,dun-modr,672,evoker,devastation,12,7,5
Flythe,silvermoon,672,evoker,devastation,12,7,5
Cascadia,deathwing,672,evoker,devastation,15,8,7
Voguez,burning-legion,672,evoker,devastation,15,8,7
Zaradreth,grim-batol,672,evoker,devastation,18,7,11
Glurakk,aegwynn,672,evoker,devastation,18,7,11
Jrmdragik,kaelthas,672,evoker,devastation,18,7,11
Furah,thrall,672,evoker,devastation,18,7,11
Kda,die-nachtwache,672,evoker,devastation,18,7,11
Ziibah,outland,672,evoker,devastation,18,7,11
Scalewind,twisting-nether,672,evoker,devastation,18,7,11
Drexxe,boulderfist,672,evoker,devastation,24,7,17
Ayon,frostwhisper,671,evoker,devastation,12,7,5
Kábutø,antonidas,671,evoker,devastation,12,7,5
Jarhys,draenor,671,evoker,devastation,12,7,5
Evoslaps,norgannon,671,evoker,devastation,12,7,5
Vemian,ravencrest,671,evoker,devastation,12,7,5
Ciranazus,twisting-nether,671,evoker,devastation,18,7,11
Manegø,eredar,671,evoker,devastation,18,7,11
Mishecgos,kazzak,671,evoker,devastation,18,7,11
Rizato,kazzak,671,evoker,devastation,24,7,17
Holdya,archimonde,670,evoker,devastation,18,7,11
Plexd,alleria,670,evoker,devastation,18,7,11
Bullseiye,silvermoon,670,evoker,devastation,18,7,11
Enemi,twisting-nether,669,evoker,devastation,14,9,5
Антиброник,gordunni,666,evoker,devastation,12,7,5
Firestârtêr,dun-morogh,663,evoker,devastation,12,7,5
Kayizer,archimonde,657,evoker,devastation,12,7,5
Flameclaw,argent-dawn,657,evoker,devastation,12,7,5
Evokah,der-abyssische-rat,655,evoker,devastation,23,7,16
Draknil,ysondre,640,evoker,devastation,16,7,9
Auchedrax,argent-dawn,639,evoker,devastation,14,8,6
Otøgí,antonidas,638,evoker,devastation,17,7,10
Zharas,nemesis,623,evoker,devastation,11,7,4
Adônis,malorne,617,evoker,devastation,23,8,15
Kharon,garrosh,609,evoker,devastation,41,9,32
Drastenk,hyjal,607,evoker,devastation,17,7,10
Kallistian,argent-dawn,576,evoker,devastation,6,6,0
Mérkèls,alakir,576,evoker,devastation,6,6,0
Henmon,defias-brotherhood,576,evoker,devastation,6,6,0
Ewwoker,stormreaver,576,evoker,devastation,6,6,0
Needstherapy,ravencrest,576,evoker,devastation,12,6,6
Terrorclaw,ragnaros,576,evoker,devastation,12,6,6
Lìzardboi,draenor,576,evoker,devastation,12,6,6
Gwamalak,archimonde,576,evoker,devastation,12,6,6
Глорунг,howling-fjord,576,evoker,devastation,12,6,6
Skipity,ravencrest,576,evoker,devastation,12,6,6
Apexpredator,terokkar,576,evoker,devastation,12,6,6
Awadrake,ysondre,576,evoker,devastation,12,6,6
Mattyastrasz,hyjal,576,evoker,devastation,12,6,6
Tizuki,twisting-nether,576,evoker,devastation,12,6,6
Gorgonn,cthun,576,evoker,devastation,12,6,6
Nahida,terokkar,576,evoker,devastation,12,6,6
Nørgan,die-aldor,576,evoker,devastation,12,6,6
Khimari,xavius,576,evoker,devastation,12,6,6
Charezard,draenor,576,evoker,devastation,12,6,6
Puffdaddyxd,twisting-nether,576,evoker,devastation,12,6,6
Dracalos,silvermoon,576,evoker,devastation,14,6,8
Croker,ravencrest,576,evoker,devastation,18,6,12
Adriia,draenor,576,evoker,devastation,18,6,12
Monstrosity,proudmoore,576,evoker,devastation,18,6,12
Империа,howling-fjord,576,evoker,devastation,24,6,18
Kelygos,argent-dawn,576,evoker,devastation,24,6,18
Полумъя,soulflayer,575,evoker,devastation,6,6,0
Sandakari,kazzak,575,evoker,devastation,12,6,6
Ágarosz,sanguino,575,evoker,devastation,12,6,6
Prismari,burning-legion,575,evoker,devastation,12,6,6
Mefedrone,argent-dawn,575,evoker,devastation,12,6,6
Chunlooi,baelgun,575,evoker,devastation,12,6,6
Zuhana,twisting-nether,575,evoker,devastation,12,6,6
Meyowuo,doomhammer,575,evoker,devastation,14,6,8
Uprover,kazzak,575,evoker,devastation,18,6,12
Малесиндра,gordunni,575,evoker,devastation,18,6,12
Lubellion,kelthuzad,575,evoker,devastation,18,6,12
Jetfqds,archimonde,575,evoker,devastation,24,6,18
Mazzg,blackmoore,574,evoker,devastation,21,7,14
Dragonpastor,kazzak,574,evoker,devastation,18,6,12
Morph,talnivarr,574,evoker,devastation,18,6,12
Faijer,blackmoore,572,evoker,devastation,12,6,6
Dragorona,kult-der-verdammten,572,evoker,devastation,12,6,6
Voraxe,draenor,568,evoker,devastation,12,6,6
Нелдарий,grom,567,evoker,devastation,12,6,6
Sheego,anetheron,565,evoker,devastation,12,6,6
Torrik,drakthul,565,evoker,devastation,12,6,6
Molem,defias-brotherhood,543,evoker,devastation,11,6,5
Lilvorki,silvermoon,543,evoker,devastation,17,6,11
Hekatonshire,hyjal,539,evoker,devastation,11,6,5
Icyy,stormrage,528,evoker,devastation,9,7,2
Aéras,blackhand,527,evoker,devastation,11,6,5
Snàx,aggra-português,527,evoker,devastation,17,6,11
Jaykvoker,kazzak,522,evoker,devastation,14,7,7
Somntersu,argent-dawn,511,evoker,devastation,14,7,7
Spýró,tarren-mill,480,evoker,devastation,6,5,1
Streetspyro,ravencrest,480,evoker,devastation,6,5,1
Chronougi,ravencrest,480,evoker,devastation,6,5,1
Zenvoker,silvermoon,480,evoker,devastation,6,5,1
Zendervish,draenor,480,evoker,devastation,6,5,1
Tovaro,xavius,480,evoker,devastation,6,5,1
Fizzÿbubbele,kazzak,480,evoker,devastation,6,5,1
Côlt,twisting-nether,480,evoker,devastation,6,5,1
Elvarg,ragnaros,480,evoker,devastation,6,5,1
Hösh,elune,480,evoker,devastation,6,5,1
Ðragonite,frostmane,480,evoker,devastation,10,6,4
Ripgódx,bronzebeard,480,evoker,devastation,12,5,7
Niddhog,antonidas,480,evoker,devastation,12,5,7
Yongmun,hyjal,480,evoker,devastation,12,5,7
Cooperevoker,blackrock,480,evoker,devastation,12,5,7
Dedwing,silvermoon,480,evoker,devastation,12,5,7
Chürbis,blackmoore,480,evoker,devastation,12,5,7
Skulblakas,blackmoore,480,evoker,devastation,12,5,7
Béhème,dalaran,480,evoker,devastation,12,5,7
Icyevoker,ravencrest,480,evoker,devastation,12,5,7
Dracnass,silvermoon,480,evoker,devastation,12,5,7
Arqeltzha,ravencrest,480,evoker,devastation,12,5,7
Trocken,blackmoore,480,evoker,devastation,12,5,7
Chàrizàd,archimonde,480,evoker,devastation,12,5,7
Ràzox,kazzak,480,evoker,devastation,12,5,7
Piecemaker,malganis,480,evoker,devastation,12,5,7
Lyssa,stormreaver,480,evoker,devastation,12,5,7
Wuschwuscha,thrall,480,evoker,devastation,12,5,7
Drgndeznuts,kazzak,480,evoker,devastation,12,5,7
Сансетшторм,gordunni,480,evoker,devastation,12,5,7
Pavelito,ysondre,480,evoker,devastation,12,5,7
Keltrasz,los-errantes,480,evoker,devastation,18,5,13
Nelatharius,argent-dawn,480,evoker,devastation,18,5,13
Rikji,blackmoore,480,evoker,devastation,18,5,13
Невердракон,howling-fjord,480,evoker,devastation,18,5,13
Vermithors,ravencrest,479,evoker,devastation,12,5,7
Polithyr,tarren-mill,479,evoker,devastation,12,5,7
Magicae,drakthul,479,evoker,devastation,12,5,7
Кайрэс,gordunni,479,evoker,devastation,12,5,7
Драккалис,eversong,479,evoker,devastation,12,5,7
Untuvapilvi,silvermoon,479,evoker,devastation,12,5,7
Bombrush,ragnaros,479,evoker,devastation,15,6,9
Lagarkrizos,zuljin,479,evoker,devastation,18,5,13
Кмандр,gordunni,479,evoker,devastation,18,5,13
Meruzhan,chamber-of-aspects,479,evoker,devastation,18,5,13
Aegonis,archimonde,477,evoker,devastation,18,5,13
Граукасия,soulflayer,456,evoker,devastation,23,7,16
Martosaurus,ravencrest,426,evoker,devastation,16,6,10
Caomanjin,silvermoon,398,evoker,devastation,7,5,2
Theralon,tarren-mill,384,evoker,devastation,6,4,2
Mjkevo,tarren-mill,384,evoker,devastation,6,4,2
Drominus,die-silberne-hand,384,evoker,devastation,6,4,2
Blamdrake,blackhand,384,evoker,devastation,6,4,2
Flyawaay,stormscale,384,evoker,devastation,6,4,2
Hungryhank,ragnaros,384,evoker,devastation,6,4,2
Штеци,howling-fjord,384,evoker,devastation,6,4,2
Lonte,archimonde,384,evoker,devastation,6,4,2
Skiora,argent-dawn,384,evoker,devastation,6,4,2
Gulimvoker,aegwynn,384,evoker,devastation,6,4,2
Draebe,kazzak,384,evoker,devastation,6,4,2
Dragonhead,zuljin,384,evoker,devastation,6,4,2
Arractas,blackhand,384,evoker,devastation,9,5,4
Dragondisnut,sylvanas,384,evoker,devastation,12,4,8
Darkshadow,eldrethalas,384,evoker,devastation,12,4,8
Kalki,twisting-nether,384,evoker,devastation,12,4,8
Draceon,argent-dawn,384,evoker,devastation,12,4,8
Nadrenion,argent-dawn,384,evoker,devastation,12,4,8
Голденстарс,gordunni,384,evoker,devastation,12,4,8
Automizez,draenor,384,evoker,devastation,12,4,8
Broocklyn,blackrock,384,evoker,devastation,12,4,8
Nynnaydoth,drakthul,384,evoker,devastation,12,4,8
Ãbl,silvermoon,384,evoker,devastation,12,4,8
Dralija,sylvanas,384,evoker,devastation,12,4,8
Pentraktar,pozzo-delleternità,384,evoker,devastation,12,4,8
Ärt,argent-dawn,384,evoker,devastation,12,4,8
Huangzhang,burning-legion,384,evoker,devastation,12,4,8
Spyróò,ravencrest,384,evoker,devastation,12,4,8
Gazunkle,draenor,384,evoker,devastation,12,4,8
Shirim,tarren-mill,384,evoker,devastation,12,4,8
Lyncry,draenor,384,evoker,devastation,12,4,8
Bolgrod,dun-modr,384,evoker,devastation,12,4,8
Nózdormuwu,argent-dawn,384,evoker,devastation,12,4,8
Fueu,draenor,384,evoker,devastation,12,4,8
Jamesdouglas,eredar,383,evoker,devastation,6,4,2
Лериостраз,howling-fjord,383,evoker,devastation,10,5,5
Lafaevo,alakir,383,evoker,devastation,24,4,20
Raszageth,aegwynn,382,evoker,devastation,12,4,8
Хурипро,soulflayer,382,evoker,devastation,18,4,14
Quicksmoke,argent-dawn,379,evoker,devastation,21,6,15
Dracsamdi,tarren-mill,367,evoker,devastation,11,4,7
Crispywingz,draenor,366,evoker,devastation,11,4,7
Renalia,blackrock,351,evoker,devastation,14,5,9
Krestrazzos,blackmoore,335,evoker,devastation,11,4,7
Escaaboy,stormscale,330,evoker,devastation,13,5,8
Raydrak,antonidas,330,evoker,devastation,14,5,9
Belkavoker,zirkel-des-cenarius,319,evoker,devastation,5,4,1
Spyrothedrag,outland,319,evoker,devastation,8,4,4
Evoxir,draenor,288,evoker,devastation,6,3,3
Chronolight,draenor,288,evoker,devastation,6,3,3
Clênas,kazzak,288,evoker,devastation,6,3,3
Griefgodx,draenor,288,evoker,devastation,6,3,3
Madbreath,cthun,288,evoker,devastation,6,3,3
Nakavoker,arygos,288,evoker,devastation,6,3,3
Nijo,alleria,288,evoker,devastation,6,3,3
Iswíftz,twisting-nether,288,evoker,devastation,6,3,3
Mollÿ,sanguino,288,evoker,devastation,6,3,3
Drdrayk,balnazzar,288,evoker,devastation,6,3,3
Keltullis,archimonde,288,evoker,devastation,6,3,3
Barney,korgall,288,evoker,devastation,6,3,3
Shåmsse,kazzak,288,evoker,devastation,6,3,3
Iëemanjâä,dalaran,288,evoker,devastation,6,3,3
Lajra,ragnaros,288,evoker,devastation,6,3,3
Lìshrá,baelgun,288,evoker,devastation,6,3,3
Louzard,draenor,288,evoker,devastation,6,3,3
Aviseth,draenor,288,evoker,devastation,6,3,3
Silverscale,ragnaros,288,evoker,devastation,6,3,3
Shroudflight,draenor,288,evoker,devastation,6,3,3
Vyore,silvermoon,288,evoker,devastation,6,3,3
Merrius,der-rat-von-dalaran,288,evoker,devastation,6,3,3
Dragondo,aegwynn,288,evoker,devastation,6,3,3
Навидх,howling-fjord,288,evoker,devastation,6,3,3
Dracpal,senjin,288,evoker,devastation,6,3,3
Тектрис,howling-fjord,288,evoker,devastation,6,3,3
Rosiash,auchindoun,288,evoker,devastation,6,3,3
Драмуся,gordunni,288,evoker,devastation,6,3,3
Kitoed,aegwynn,288,evoker,devastation,6,3,3
Purplelizard,twisting-nether,288,evoker,devastation,6,3,3
Whysera,sylvanas,288,evoker,devastation,6,3,3
Аркеникс,gordunni,288,evoker,devastation,6,3,3
Dragenlul,tarren-mill,288,evoker,devastation,6,3,3
Норус,howling-fjord,288,evoker,devastation,6,3,3
Drakdilla,tarren-mill,288,evoker,devastation,6,3,3
Màlfar,tarren-mill,288,evoker,devastation,6,3,3
Kalathyr,argent-dawn,288,evoker,devastation,6,3,3
Dragonbrx,blackrock,288,evoker,devastation,6,3,3
Talim,terrordar,288,evoker,devastation,6,3,3
Karmagos,hyjal,288,evoker,devastation,6,3,3
Fivebeers,silvermoon,288,evoker,devastation,6,3,3
Feldrac,ravencrest,288,evoker,devastation,6,3,3
Ughvoker,kazzak,288,evoker,devastation,6,3,3
Dalsath,silvermoon,288,evoker,devastation,6,3,3
Xceqt,blackrock,288,evoker,devastation,6,3,3
Brovoker,sylvanas,288,evoker,devastation,6,3,3
Лордмакс,gordunni,288,evoker,devastation,6,3,3
Ðragøn,argent-dawn,288,evoker,devastation,6,3,3
Ursinne,ravencrest,288,evoker,devastation,6,3,3
Feinerkerl,blackmoore,288,evoker,devastation,6,3,3
Bestofriendo,eredar,288,evoker,devastation,6,3,3
Flippmoker,argent-dawn,288,evoker,devastation,6,3,3
Azurog,blackmoore,288,evoker,devastation,6,3,3
Necrodrake,voljin,288,evoker,devastation,6,3,3
Dragonfish,grim-batol,288,evoker,devastation,11,3,8
Dundrion,outland,288,evoker,devastation,12,3,9
Gailliade,archimonde,288,evoker,devastation,12,3,9
Dragondagger,stormreaver,288,evoker,devastation,12,3,9
Valdrakken,anubarak,288,evoker,devastation,12,3,9
Raøug,blackmoore,288,evoker,devastation,12,3,9
Shindragøsa,ysondre,288,evoker,devastation,12,3,9
Twinkillerx,dun-morogh,288,evoker,devastation,12,3,9
Purge,sporeggar,288,evoker,devastation,12,3,9
Vynestria,argent-dawn,288,evoker,devastation,12,3,9
Имбапвп,lich-king,288,evoker,devastation,12,3,9
Абьюз,galakrond,288,evoker,devastation,12,3,9
Duveloker,dragonblight,288,evoker,devastation,12,3,9
Sáróman,ravencrest,288,evoker,devastation,13,3,10
Òhrabzack,blackmoore,288,evoker,devastation,18,3,15
Fågelskräma,silvermoon,288,evoker,devastation,18,3,15
Nybxx,frostmane,288,evoker,devastation,18,3,15
Sliimshady,dalaran,287,evoker,devastation,6,3,3
Drakonovic,blackrock,287,evoker,devastation,6,3,3
Belianf,silvermoon,287,evoker,devastation,6,3,3
Sneakyjiwoo,kazzak,287,evoker,devastation,6,3,3
Drks,draenor,287,evoker,devastation,12,4,8
Wardrache,nerathor,287,evoker,devastation,18,3,15
Драгоблуд,soulflayer,271,evoker,devastation,14,4,10
Monkeyvoker,archimonde,256,evoker,devastation,10,3,7
Drakoonz,ravencrest,256,evoker,devastation,10,3,7
Unwoker,draenor,256,evoker,devastation,16,3,13
Kirien,blackhand,234,evoker,devastation,22,4,18
Färsia,drakthul,223,evoker,devastation,8,3,5
Астрена,gordunni,223,evoker,devastation,8,3,5
Kekeri,blackhand,208,evoker,devastation,13,3,10
Yohkii,eredar,192,evoker,devastation,6,2,4
Deeha,antonidas,192,evoker,devastation,6,2,4
Listigrlurch,antonidas,192,evoker,devastation,6,2,4
Kandragor,antonidas,192,evoker,devastation,6,2,4
Keristrsa,argent-dawn,192,evoker,devastation,6,2,4
Майтимаус,goldrinn,192,evoker,devastation,6,2,4
Hühnchen,alexstrasza,192,evoker,devastation,6,2,4
Drogoon,ravencrest,192,evoker,devastation,6,2,4
Безлад,gordunni,192,evoker,devastation,6,2,4
Evøcado,blackmoore,192,evoker,devastation,6,2,4
Dragthraz,blackhand,192,evoker,devastation,6,2,4
Malydra,blackhand,192,evoker,devastation,6,2,4
Polzeig,dentarg,192,evoker,devastation,6,2,4
Hahahahalolx,twisting-nether,192,evoker,devastation,6,2,4
Kethrir,blackhand,192,evoker,devastation,6,2,4
Drevoker,daggerspine,192,evoker,devastation,6,2,4
Twokgbananas,blackhand,192,evoker,devastation,6,2,4
Natrixx,tarren-mill,192,evoker,devastation,6,2,4
Niluslangbal,stormscale,192,evoker,devastation,6,2,4
Draconir,stormscale,192,evoker,devastation,6,2,4
Liljonson,stormscale,192,evoker,devastation,6,2,4
Flookx,silvermoon,192,evoker,devastation,6,2,4
Blazeion,stormscale,192,evoker,devastation,6,2,4
Feloñ,blackrock,192,evoker,devastation,6,2,4
Ellphi,illidan,192,evoker,devastation,6,2,4
Airplanepeek,draenor,192,evoker,devastation,6,2,4
Reddeaddrago,silvermoon,192,evoker,devastation,6,2,4
Shalizir,silvermoon,192,evoker,devastation,6,2,4
Drakary,chogall,192,evoker,devastation,6,2,4
Drakela,frostwhisper,192,evoker,devastation,6,2,4
Draaxy,twisting-nether,192,evoker,devastation,6,2,4
Gelamk,twisting-nether,192,evoker,devastation,6,2,4
Gòhà,tirion,192,evoker,devastation,6,2,4
Kavreel,draenor,192,evoker,devastation,6,2,4
Evokelution,twisting-nether,192,evoker,devastation,6,2,4
Exitelolx,blackrock,192,evoker,devastation,6,2,4
Zalegos,kazzak,192,evoker,devastation,6,2,4
Iyaiya,draenor,192,evoker,devastation,6,2,4
Pawthyr,dun-modr,192,evoker,devastation,6,2,4
Shenronn,zuljin,192,evoker,devastation,6,2,4
Moodyevo,kazzak,192,evoker,devastation,6,2,4
Azzaanan,kirin-tor,192,evoker,devastation,6,2,4
Timotheus,draenor,192,evoker,devastation,6,2,4
Drazaru,sanguino,192,evoker,devastation,6,2,4
Авидогх,gordunni,192,evoker,devastation,6,2,4
Ezinice,hyjal,192,evoker,devastation,6,2,4
Oogabuga,outland,192,evoker,devastation,6,2,4
Blewjobs,sylvanas,192,evoker,devastation,6,2,4
Draagon,burning-legion,192,evoker,devastation,6,2,4
Lelemion,arathor,192,evoker,devastation,6,2,4
Norskairline,kazzak,192,evoker,devastation,6,2,4
Grogar,hellfire,192,evoker,devastation,6,2,4
Draknr,alakir,192,evoker,devastation,6,2,4
Frogzey,kazzak,192,evoker,devastation,6,2,4
Adamâs,archimonde,192,evoker,devastation,6,2,4
Bittewhyally,grim-batol,192,evoker,devastation,6,2,4
Lubyan,pozzo-delleternità,192,evoker,devastation,18,3,15
Andragosa,confrérie-du-thorium,192,evoker,devastation,12,2,10
Czerwonooki,turalyon,192,evoker,devastation,12,2,10
Дракомант,eversong,192,evoker,devastation,12,2,10
Amaterasu,aggra-português,192,evoker,devastation,12,2,10
Redwing,pozzo-delleternità,192,evoker,devastation,12,2,10
Jpeo,blackhand,192,evoker,devastation,12,2,10
Shellfire,twisting-nether,192,evoker,devastation,12,2,10
Mireu,twisting-nether,192,evoker,devastation,12,2,10
Dargonboy,draenor,192,evoker,devastation,12,2,10
Erazias,draenor,192,evoker,devastation,12,2,10
Órdnung,mannoroth,192,evoker,devastation,12,2,10
Jacra,twisting-nether,192,evoker,devastation,12,2,10
Obsidiana,argent-dawn,192,evoker,devastation,16,2,14
Генне,gordunni,192,evoker,devastation,17,2,15
Tatsuki,arthas,192,evoker,devastation,18,2,16
Réku,ragnaros,192,evoker,devastation,18,2,16
Marconubsii,wrathbringer,191,evoker,devastation,6,2,4
Fuecunizzu,pozzo-delleternità,191,evoker,devastation,6,2,4
Kraakraa,turalyon,191,evoker,devastation,6,2,4
Calise,kazzak,191,evoker,devastation,12,2,10
Вжухкия,gordunni,159,evoker,devastation,5,2,3
Bàz,thrall,138,evoker,devastation,6,3,3
Rock,darkspear,138,evoker,devastation,11,4,7
Acientone,kelthuzad,128,evoker,devastation,10,2,8
Tneen,stormscale,96,evoker,devastation,3,2,1
Гадзандопало,soulflayer,96,evoker,devastation,6,1,5
Redemp,kazzak,96,evoker,devastation,6,1,5
Белыйдракон,greymane,96,evoker,devastation,6,1,5
Shlea,kazzak,96,evoker,devastation,6,1,5
Психея,soulflayer,96,evoker,devastation,6,1,5
Тренакса,soulflayer,96,evoker,devastation,6,1,5
Dracarysfire,kazzak,96,evoker,devastation,6,1,5
Feyrê,frostmourne,96,evoker,devastation,6,1,5
Silrains,silvermoon,96,evoker,devastation,6,1,5
Vinczeform,silvermoon,96,evoker,devastation,6,1,5
Zørix,hyjal,96,evoker,devastation,6,1,5
Xahal,hyjal,96,evoker,devastation,6,1,5
Daragnarag,aegwynn,96,evoker,devastation,6,1,5
Kwynus,archimonde,96,evoker,devastation,6,1,5
Terrorwings,twisting-nether,96,evoker,devastation,6,1,5
Чобыш,gordunni,96,evoker,devastation,6,1,5
Ronmanarmy,blackrock,96,evoker,devastation,6,1,5
Пухлыйхиллер,gordunni,96,evoker,devastation,6,1,5
Dreamwing,ravencrest,96,evoker,devastation,6,1,5
Uxiono,dun-modr,96,evoker,devastation,6,1,5
Retyss,twisting-nether,96,evoker,devastation,6,1,5
Jugzie,twisting-nether,96,evoker,devastation,6,1,5
Charovoker,blackmoore,96,evoker,devastation,6,1,5
Rawrdragon,twisting-nether,96,evoker,devastation,6,1,5
Àndre,rexxar,96,evoker,devastation,6,1,5
Erones,burning-blade,96,evoker,devastation,6,1,5
Stormfury,ragnaros,96,evoker,devastation,6,1,5
Kalipszó,ragnaros,96,evoker,devastation,6,1,5
Парадпланет,howling-fjord,96,evoker,devastation,6,1,5
Gabbabomb,blackrock,96,evoker,devastation,6,1,5
Møndaychest,stormscale,96,evoker,devastation,6,1,5
Jkdrage,stormscale,96,evoker,devastation,6,1,5
Dägon,drakthul,96,evoker,devastation,6,1,5
Zerario,blackhand,96,evoker,devastation,6,1,5
Amarzu,tarren-mill,96,evoker,devastation,6,1,5
Sléêpy,blackmoore,96,evoker,devastation,6,1,5
Мельхиор,booty-bay,96,evoker,devastation,6,1,5
Suba,tarren-mill,96,evoker,devastation,6,1,5
Rhaenyra,twilights-hammer,96,evoker,devastation,6,1,5
Vahamut,argent-dawn,96,evoker,devastation,6,1,5
Gigabreath,ravencrest,96,evoker,devastation,6,1,5
Gacky,ysondre,96,evoker,devastation,6,1,5
Craycry,argent-dawn,96,evoker,devastation,6,1,5
Devanthar,argent-dawn,96,evoker,devastation,6,1,5
Kerzayn,argent-dawn,96,evoker,devastation,6,1,5
Asharys,argent-dawn,96,evoker,devastation,6,1,5
Manadrake,silvermoon,96,evoker,devastation,12,1,11
Spioche,burning-legion,96,evoker,devastation,12,1,11
Eosin,blackrock,96,evoker,devastation,12,1,11
Setur,outland,96,evoker,devastation,12,1,11
Exitexit,hellscream,96,evoker,devastation,12,1,11
Effrt,ravencrest,96,evoker,devastation,12,1,11
Provokerx,ravencrest,96,evoker,devastation,14,1,13
Evobse,silvermoon,79,evoker,devastation,5,1,4
Xidalulz,sylvanas,63,evoker,devastation,2,2,0
Gortthan,defias-brotherhood,48,evoker,devastation,3,1,2
ßingo,drakthul,48,evoker,devastation,3,1,2
Bulydracguir,kazzak,42,evoker,devastation,7,2,5
Grakthyr,runetotem,31,evoker,devastation,2,1,1
Kàzuée,outland,31,evoker,devastation,8,1,7
Jincksevoker,anachronos,16,evoker,devastation,1,1,0
Thundermifln,nemesis,16,evoker,devastation,7,1,6
Yasuohasagi,archimonde,2211,hunter,marksmanship,90,49,41
Ceitronox,argent-dawn,2201,hunter,marksmanship,119,63,56
Olyleskotch,ravencrest,2171,hunter,marksmanship,96,49,47
Ancalarion,tarren-mill,2151,hunter,marksmanship,84,45,39
Nidaliyae,archimonde,2108,hunter,marksmanship,143,70,73
Yezzu,sylvanas,2106,hunter,marksmanship,131,71,60
Cenaa,ragnaros,2064,hunter,marksmanship,49,32,17
Deuterium,stormscale,2031,hunter,marksmanship,104,69,35
Ynv,argent-dawn,1998,hunter,marksmanship,78,47,31
Harrianlar,ravenholdt,1974,hunter,marksmanship,314,152,162
Chindala,zuljin,1964,hunter,marksmanship,73,34,39
Stavfel,kazzak,1959,hunter,marksmanship,158,81,77
Techpoint,silvermoon,1952,hunter,marksmanship,89,50,39
Nennimi,ravencrest,1948,hunter,marksmanship,135,67,68
Арамор,blackscar,1946,hunter,marksmanship,99,54,45
Drxta,blackrock,1943,hunter,marksmanship,138,69,69
Matasso,burning-legion,1940,hunter,marksmanship,377,188,189
Wruck,echsenkessel,1929,hunter,marksmanship,126,71,55
Bøgs,the-maelstrom,1926,hunter,marksmanship,54,28,26
Эксп,ashenvale,1922,hunter,marksmanship,97,48,49
Gukéx,stormscale,1921,hunter,marksmanship,60,30,30
Trashcarlito,eredar,1902,hunter,marksmanship,66,41,25
Мартидэн,howling-fjord,1897,hunter,marksmanship,451,222,229
Mogwai,stormscale,1892,hunter,marksmanship,128,64,64
Trapmanager,kazzak,1887,hunter,marksmanship,94,49,45
Pjållistani,ravencrest,1887,hunter,marksmanship,236,121,115
Душнила,razuvious,1885,hunter,marksmanship,299,152,147
Gorethaur,twisting-nether,1880,hunter,marksmanship,96,64,32
Xawai,ragnaros,1880,hunter,marksmanship,129,65,64
Dexter,ravencrest,1877,hunter,marksmanship,512,261,251
Stylez,emeriss,1873,hunter,marksmanship,117,58,59
Cadvan,nagrand,1870,hunter,marksmanship,87,40,47
Samuru,auchindoun,1861,hunter,marksmanship,77,37,40
Заллара,booty-bay,1850,hunter,marksmanship,64,35,29
Passalaqua,aegwynn,1849,hunter,marksmanship,106,63,43
Hollyz,auchindoun,1844,hunter,marksmanship,64,37,27
Medgical,outland,1844,hunter,marksmanship,60,27,33
Skillzone,silvermoon,1843,hunter,marksmanship,54,25,29
Klarix,outland,1840,hunter,marksmanship,134,72,62
Aimywinehaus,drakthul,1840,hunter,marksmanship,60,31,29
Spirys,drakthul,1838,hunter,marksmanship,60,28,32
Buffrøgues,ravencrest,1835,hunter,marksmanship,287,148,139
Johnreapèr,sylvanas,1832,hunter,marksmanship,149,75,74
Onlystuns,sylvanas,1831,hunter,marksmanship,89,46,43
Trapsfordays,tarren-mill,1827,hunter,marksmanship,70,41,29
Maverz,blackhand,1827,hunter,marksmanship,63,35,28
Evacuatur,argent-dawn,1826,hunter,marksmanship,66,33,33
Играсломана,howling-fjord,1824,hunter,marksmanship,87,48,39
Dis,twilights-hammer,1824,hunter,marksmanship,65,32,33
Wildheárt,aegwynn,1822,hunter,marksmanship,108,56,52
Kittykite,thunderhorn,1820,hunter,marksmanship,114,53,61
Аккулэйд,blackscar,1819,hunter,marksmanship,107,48,59
Drakona,outland,1818,hunter,marksmanship,35,23,12
Spoonfingers,ravencrest,1817,hunter,marksmanship,56,30,26
Rashoumon,zuljin,1816,hunter,marksmanship,52,35,17
Crôwley,twisting-nether,1816,hunter,marksmanship,54,30,24
Sizemattersx,kazzak,1816,hunter,marksmanship,216,113,103
Huntrag,tarren-mill,1816,hunter,marksmanship,277,141,136
Jodd,ragnaros,1814,hunter,marksmanship,48,23,25
Moonzsu,ravencrest,1813,hunter,marksmanship,46,30,16
Sindorian,aggra-português,1811,hunter,marksmanship,172,92,80
Iceyx,stormscale,1810,hunter,marksmanship,60,27,33
Лесбиянюсь,gordunni,1809,hunter,marksmanship,30,19,11
Warmus,auchindoun,1808,hunter,marksmanship,75,32,43
Zulthos,kazzak,1806,hunter,marksmanship,133,67,66
Eenel,twisting-nether,1805,hunter,marksmanship,96,53,43
Warbringerx,stormscale,1805,hunter,marksmanship,76,37,39
Noobsnatcher,draenor,1804,hunter,marksmanship,279,149,130
Áñmy,ravencrest,1804,hunter,marksmanship,53,28,25
Khregan,aerie-peak,1802,hunter,marksmanship,66,32,34
Aimshotx,stormscale,1801,hunter,marksmanship,48,28,20
Skadè,silvermoon,1801,hunter,marksmanship,66,36,30
Hï,eitrigg,1801,hunter,marksmanship,189,93,96
Outkást,sylvanas,1796,hunter,marksmanship,71,34,37
Murtagh,khaz-modan,1795,hunter,marksmanship,120,63,57
Suchskill,stormreaver,1790,hunter,marksmanship,83,39,44
Huprah,ravencrest,1788,hunter,marksmanship,161,77,84
Skilachi,stormscale,1787,hunter,marksmanship,102,46,56
Ледо,deathguard,1779,hunter,marksmanship,110,58,52
Triggery,ravencrest,1778,hunter,marksmanship,71,39,32
Åíøñs,kazzak,1778,hunter,marksmanship,35,19,16
Самокаратель,gordunni,1772,hunter,marksmanship,78,50,28
Misstrap,drakthul,1771,hunter,marksmanship,71,44,27
Myice,twisting-nether,1771,hunter,marksmanship,66,36,30
Xoarqt,aegwynn,1768,hunter,marksmanship,168,76,92
Миссклик,soulflayer,1766,hunter,marksmanship,149,88,61
Mousysnok,ravencrest,1762,hunter,marksmanship,103,49,54
Lègolas,sylvanas,1751,hunter,marksmanship,84,38,46
Gernoqz,frostwolf,1750,hunter,marksmanship,60,31,29
Jamesie,ravencrest,1745,hunter,marksmanship,47,29,18
Gunfroor,the-maelstrom,1744,hunter,marksmanship,94,46,48
Мюльфинштейн,howling-fjord,1741,hunter,marksmanship,65,31,34
Naid,lordaeron,1739,hunter,marksmanship,58,34,24
Мунгардина,blackscar,1739,hunter,marksmanship,48,22,26
Lîs,kargath,1735,hunter,marksmanship,92,52,40
Podroto,tyrande,1733,hunter,marksmanship,112,50,62
Luzivarus,malganis,1731,hunter,marksmanship,48,25,23
Velrox,blackmoore,1731,hunter,marksmanship,132,68,64
Imfiné,outland,1729,hunter,marksmanship,72,40,32
Eldrekou,kazzak,1729,hunter,marksmanship,60,26,34
Лотариель,howling-fjord,1728,hunter,marksmanship,66,34,32
Alêx,outland,1725,hunter,marksmanship,186,85,101
Barrybigtoe,tarren-mill,1720,hunter,marksmanship,36,20,16
Setyouintrap,ravencrest,1717,hunter,marksmanship,60,34,26
Xzmiq,outland,1716,hunter,marksmanship,203,104,99
Maticshorter,blackmoore,1716,hunter,marksmanship,92,44,48
Hallé,frostmane,1714,hunter,marksmanship,84,46,38
Filizvogel,aegwynn,1713,hunter,marksmanship,35,19,16
Sipsomewater,ravencrest,1711,hunter,marksmanship,30,18,12
Mógwaí,stormscale,1710,hunter,marksmanship,72,36,36
Amistat,kazzak,1708,hunter,marksmanship,219,108,111
Nirn,ravencrest,1707,hunter,marksmanship,47,25,22
Dragnial,kazzak,1703,hunter,marksmanship,53,26,27
Géeked,ravencrest,1702,hunter,marksmanship,42,21,21
Sãnsãs,archimonde,1701,hunter,marksmanship,95,51,44
Килофвратх,gordunni,1701,hunter,marksmanship,278,141,137
Адвентурер,howling-fjord,1697,hunter,marksmanship,120,66,54
Kirimbald,blackmoore,1697,hunter,marksmanship,54,28,26
Wêskêr,tarren-mill,1696,hunter,marksmanship,60,28,32
Natchell,ysondre,1695,hunter,marksmanship,59,29,30
Xanter,blackrock,1695,hunter,marksmanship,86,41,45
Bestregards,ravencrest,1695,hunter,marksmanship,166,77,89
Ðeüterium,outland,1692,hunter,marksmanship,60,32,28
Strikke,archimonde,1692,hunter,marksmanship,114,52,62
Kalimdoar,blackhand,1689,hunter,marksmanship,108,53,55
Swaggercatx,stormscale,1685,hunter,marksmanship,42,19,23
Jêsslíne,ravencrest,1684,hunter,marksmanship,36,20,16
Тайв,deepholm,1683,hunter,marksmanship,68,32,36
Huntsmart,kazzak,1682,hunter,marksmanship,78,34,44
Lowcaskor,turalyon,1678,hunter,marksmanship,47,26,21
Murkek,drakthul,1676,hunter,marksmanship,66,39,27
Хальвеген,gordunni,1672,hunter,marksmanship,415,213,202
Mdmalol,malganis,1671,hunter,marksmanship,39,21,18
Sandchaton,ragnaros,1671,hunter,marksmanship,42,22,20
Pewpewstuff,draenor,1669,hunter,marksmanship,42,22,20
Birdemic,stormscale,1668,hunter,marksmanship,68,35,33
Jabela,eredar,1668,hunter,marksmanship,78,35,43
Desudi,tarren-mill,1664,hunter,marksmanship,113,60,53
Spacenøub,archimonde,1664,hunter,marksmanship,58,24,34
Crudeconzept,talnivarr,1663,hunter,marksmanship,36,20,16
Pandanero,ravencrest,1660,hunter,marksmanship,36,20,16
Сашатетива,gordunni,1658,hunter,marksmanship,90,45,45
Tidèz,aegwynn,1657,hunter,marksmanship,84,39,45
Meetyour,stormscale,1652,hunter,marksmanship,54,26,28
Speedhack,argent-dawn,1650,hunter,marksmanship,63,35,28
Xqzmytrapz,blackrock,1650,hunter,marksmanship,36,18,18
Lenooby,blades-edge,1649,hunter,marksmanship,144,69,75
Jayri,ravencrest,1646,hunter,marksmanship,96,49,47
Weilerz,drakthul,1645,hunter,marksmanship,71,31,40
Maroxy,ragnaros,1644,hunter,marksmanship,59,23,36
Mfbloom,blackmoore,1643,hunter,marksmanship,90,45,45
Slÿzqx,archimonde,1640,hunter,marksmanship,46,26,20
Elonyr,sanguino,1640,hunter,marksmanship,500,251,249
Rizlay,the-maelstrom,1640,hunter,marksmanship,108,50,58
Triggaz,stormscale,1637,hunter,marksmanship,83,39,44
Шотнес,gordunni,1636,hunter,marksmanship,138,68,70
Sùnzí,alakir,1633,hunter,marksmanship,30,21,9
Pointnclick,the-maelstrom,1633,hunter,marksmanship,56,32,24
Deathshots,ravencrest,1633,hunter,marksmanship,36,20,16
Everya,ravencrest,1632,hunter,marksmanship,69,41,28
Srsbsnshunta,kazzak,1632,hunter,marksmanship,43,24,19
Biggusdickuz,tarren-mill,1632,hunter,marksmanship,205,114,91
Yolo,drakthul,1632,hunter,marksmanship,42,23,19
Smekminbåge,tarren-mill,1632,hunter,marksmanship,92,49,43
Nyjal,archimonde,1629,hunter,marksmanship,30,20,10
Дарктеххно,howling-fjord,1629,hunter,marksmanship,36,18,18
Амореселф,gordunni,1629,hunter,marksmanship,59,25,34
Куфачка,soulflayer,1627,hunter,marksmanship,36,17,19
Unreachable,dethecus,1626,hunter,marksmanship,36,20,16
Роктджана,deathguard,1625,hunter,marksmanship,130,72,58
Мизэрица,soulflayer,1625,hunter,marksmanship,91,47,44
Nelf,shattered-hand,1625,hunter,marksmanship,42,17,25
Thysalee,hyjal,1624,hunter,marksmanship,61,29,32
Jeeves,outland,1624,hunter,marksmanship,72,34,38
Exquisitor,silvermoon,1624,hunter,marksmanship,49,23,26
Zirilan,nemesis,1623,hunter,marksmanship,348,180,168
Evengance,dragonblight,1620,hunter,marksmanship,96,58,38
Streetxpres,nethersturm,1620,hunter,marksmanship,71,33,38
Elywiél,frostwolf,1616,hunter,marksmanship,107,50,57
Ixxmhunt,blackrock,1616,hunter,marksmanship,54,24,30
Бипбип,galakrond,1615,hunter,marksmanship,35,20,15
Хжв,ashenvale,1615,hunter,marksmanship,202,107,95
Doubletap,ysondre,1613,hunter,marksmanship,36,28,8
Metak,auchindoun,1611,hunter,marksmanship,44,26,18
Memehunter,aegwynn,1609,hunter,marksmanship,83,59,24
Loretta,ragnaros,1609,hunter,marksmanship,47,27,20
Crétin,archimonde,1605,hunter,marksmanship,44,23,21
Salderyo,silvermoon,1605,hunter,marksmanship,73,33,40
Blackbane,ravencrest,1604,hunter,marksmanship,91,46,45
Legosoldaten,stormscale,1604,hunter,marksmanship,53,21,32
Breezhunt,twisting-nether,1604,hunter,marksmanship,53,21,32
Çryneth,ravencrest,1602,hunter,marksmanship,92,49,43
Короткиствол,gordunni,1601,hunter,marksmanship,90,47,43
Mönster,ravenholdt,1600,hunter,marksmanship,194,105,89
Hesuss,kazzak,1600,hunter,marksmanship,39,19,20
Mycélium,outland,1598,hunter,marksmanship,52,21,31
Xrey,ragnaros,1596,hunter,marksmanship,132,69,63
Griffithstew,blackmoore,1596,hunter,marksmanship,54,19,35
Slmao,tarren-mill,1594,hunter,marksmanship,100,56,44
Rêmøórsêlês,outland,1594,hunter,marksmanship,39,19,20
Brk,dun-modr,1592,hunter,marksmanship,35,19,16
Nätzz,dun-modr,1590,hunter,marksmanship,73,31,42
Hotshòt,silvermoon,1588,hunter,marksmanship,150,80,70
Крой,howling-fjord,1588,hunter,marksmanship,83,40,43
Scheixanter,drakthul,1587,hunter,marksmanship,191,95,96
Draktron,blackmoore,1587,hunter,marksmanship,48,22,26
Bekrepál,outland,1587,hunter,marksmanship,90,37,53
Boulaax,ysondre,1585,hunter,marksmanship,71,41,30
Эвилтар,soulflayer,1584,hunter,marksmanship,50,27,23
Cryneth,twisting-nether,1583,hunter,marksmanship,63,35,28
Beletor,medivh,1582,hunter,marksmanship,36,23,13
Hõth,kazzak,1582,hunter,marksmanship,78,37,41
Prodanhunts,frostmane,1580,hunter,marksmanship,286,152,134
Arung,ravencrest,1580,hunter,marksmanship,60,27,33
Nutshotx,stormscale,1580,hunter,marksmanship,144,61,83
Трольболь,eversong,1579,hunter,marksmanship,36,17,19
Hurion,sanguino,1579,hunter,marksmanship,52,24,28
Ravensoulz,stormscale,1576,hunter,marksmanship,150,81,69
Ремонтлицаа,gordunni,1575,hunter,marksmanship,139,74,65
Riflur,stormscale,1574,hunter,marksmanship,42,20,22
Джоуе,ashenvale,1574,hunter,marksmanship,42,18,24
Nmrd,archimonde,1573,hunter,marksmanship,36,19,17
Melriya,ravencrest,1573,hunter,marksmanship,118,61,57
Vangeroth,kazzak,1573,hunter,marksmanship,413,213,200
Андреймвп,galakrond,1573,hunter,marksmanship,60,28,32
Cryneth,ravencrest,1572,hunter,marksmanship,223,115,108
Inayah,outland,1571,hunter,marksmanship,137,73,64
Hävenofün,archimonde,1565,hunter,marksmanship,64,36,28
Littlerat,kult-der-verdammten,1565,hunter,marksmanship,48,23,25
Nêzz,tarren-mill,1565,hunter,marksmanship,117,52,65
Лисатия,gordunni,1562,hunter,marksmanship,48,22,26
Yarnvid,twisting-nether,1559,hunter,marksmanship,165,85,80
Daela,elune,1558,hunter,marksmanship,148,71,77
Klinksz,ysondre,1556,hunter,marksmanship,73,34,39
Ekz,twisting-nether,1555,hunter,marksmanship,100,51,49
Rattentäter,alexstrasza,1554,hunter,marksmanship,66,36,30
Mclooving,runetotem,1554,hunter,marksmanship,36,19,17
Bonjwa,aegwynn,1553,hunter,marksmanship,42,21,21
Рэмпейджшот,soulflayer,1552,hunter,marksmanship,68,31,37
Травок,gordunni,1548,hunter,marksmanship,70,34,36
Jetay,silvermoon,1547,hunter,marksmanship,125,63,62
Hylzen,outland,1546,hunter,marksmanship,83,49,34
Dafhel,hyjal,1546,hunter,marksmanship,126,64,62
Recrent,kazzak,1544,hunter,marksmanship,153,80,73
Kariss,khaz-modan,1543,hunter,marksmanship,245,123,122
Kanzlerkohl,frostwolf,1542,hunter,marksmanship,46,31,15
Ravator,azshara,1542,hunter,marksmanship,129,57,72
Rex,chamber-of-aspects,1541,hunter,marksmanship,57,35,22
Miladinorc,azjolnerub,1540,hunter,marksmanship,54,32,22
Zeanoff,ravencrest,1540,hunter,marksmanship,96,53,43
Donfabio,norgannon,1540,hunter,marksmanship,36,18,18
Будкусломаю,grom,1536,hunter,marksmanship,111,55,56
Sinplify,emeriss,1536,hunter,marksmanship,96,46,50
Jup,elune,1536,hunter,marksmanship,67,27,40
Ileira,blackmoore,1535,hunter,marksmanship,38,21,17
Lookmyezzy,ravencrest,1535,hunter,marksmanship,32,17,15
Lebalaffré,arathi,1535,hunter,marksmanship,125,64,61
Snuupz,kazzak,1534,hunter,marksmanship,96,45,51
Brake,kelthuzad,1533,hunter,marksmanship,46,20,26
Elja,laughing-skull,1531,hunter,marksmanship,73,40,33
Cpflex,arthas,1531,hunter,marksmanship,160,77,83
Jamzyhunter,emerald-dream,1530,hunter,marksmanship,42,17,25
Draveric,drakthul,1528,hunter,marksmanship,83,43,40
Bearmane,tarren-mill,1528,hunter,marksmanship,130,61,69
Focushunter,outland,1527,hunter,marksmanship,124,61,63
Bapt,blackrock,1527,hunter,marksmanship,101,49,52
Surtfire,alonsus,1526,hunter,marksmanship,259,133,126
Pargz,auchindoun,1525,hunter,marksmanship,72,41,31
Luuszapfae,aegwynn,1524,hunter,marksmanship,35,19,16
Darts,outland,1521,hunter,marksmanship,150,73,77
Ditbjrapex,chants-éternels,1520,hunter,marksmanship,48,28,20
Jurá,perenolde,1520,hunter,marksmanship,150,78,72
Trytoconnect,ravencrest,1518,hunter,marksmanship,90,47,43
Keskolica,outland,1518,hunter,marksmanship,116,60,56
Lore,hyjal,1518,hunter,marksmanship,54,27,27
Bluffmakarn,silvermoon,1518,hunter,marksmanship,42,17,25
Jahunter,aggra-português,1517,hunter,marksmanship,42,23,19
Ezpwnfml,aegwynn,1515,hunter,marksmanship,65,32,33
Манаррия,soulflayer,1514,hunter,marksmanship,134,61,73
Gugenot,tarren-mill,1512,hunter,marksmanship,78,41,37
Thallia,todeswache,1509,hunter,marksmanship,60,31,29
Ôrïøn,archimonde,1508,hunter,marksmanship,42,24,18
Crowsza,archimonde,1508,hunter,marksmanship,35,19,16
Mînérvá,blackhand,1506,hunter,marksmanship,96,55,41
Дисконнэктор,soulflayer,1505,hunter,marksmanship,77,31,46
Xesty,twisting-nether,1503,hunter,marksmanship,60,27,33
Minisay,magtheridon,1502,hunter,marksmanship,390,193,197
Kayvaal,kaelthas,1502,hunter,marksmanship,59,29,30
Hunsed,sanguino,1501,hunter,marksmanship,54,34,20
Vyana,sylvanas,1501,hunter,marksmanship,47,23,24
Mantinell,hellfire,1496,hunter,marksmanship,42,21,21
Länika,ravencrest,1495,hunter,marksmanship,90,46,44
Gunlaugr,defias-brotherhood,1495,hunter,marksmanship,87,41,46
Хемари,eversong,1490,hunter,marksmanship,54,27,27
Executéqt,frostmourne,1490,hunter,marksmanship,41,20,21
Kalima,malfurion,1490,hunter,marksmanship,95,42,53
Poatan,outland,1489,hunter,marksmanship,411,219,192
Mindgap,pozzo-delleternità,1489,hunter,marksmanship,217,110,107
Coxxie,ragnaros,1489,hunter,marksmanship,48,20,28
Bæst,elune,1488,hunter,marksmanship,71,41,30
Tigér,arathor,1488,hunter,marksmanship,36,17,19
Rikishot,ravencrest,1487,hunter,marksmanship,70,37,33
Hardscoped,tarren-mill,1487,hunter,marksmanship,88,40,48
Rzeezznik,burning-legion,1487,hunter,marksmanship,46,20,26
Антисерт,ashenvale,1485,hunter,marksmanship,66,25,41
Ронингуд,gordunni,1484,hunter,marksmanship,131,67,64
Carnificis,sanguino,1484,hunter,marksmanship,110,52,58
Ärrow,malganis,1483,hunter,marksmanship,30,16,14
Vruh,antonidas,1483,hunter,marksmanship,66,34,32
Doomhorg,quelthalas,1482,hunter,marksmanship,204,110,94
Glad,argent-dawn,1480,hunter,marksmanship,207,103,104
Meinkoenig,frostwolf,1479,hunter,marksmanship,54,34,20
Barnabaz,skullcrusher,1478,hunter,marksmanship,111,56,55
Tudjuk,arathor,1478,hunter,marksmanship,43,18,25
Deatharow,ravencrest,1476,hunter,marksmanship,281,141,140
Enfinici,eitrigg,1475,hunter,marksmanship,60,31,29
Оверман,azuregos,1475,hunter,marksmanship,42,20,22
Killitoss,blackmoore,1475,hunter,marksmanship,51,23,28
Nharul,blackmoore,1475,hunter,marksmanship,48,16,32
Шимэйла,gordunni,1474,hunter,marksmanship,97,51,46
Смотрюанимэ,gordunni,1474,hunter,marksmanship,66,26,40
Pínnen,draenor,1473,hunter,marksmanship,36,19,17
Афигеннски,ashenvale,1473,hunter,marksmanship,66,31,35
Migro,sylvanas,1469,hunter,marksmanship,56,26,30
Marcher,aggra-português,1468,hunter,marksmanship,44,19,25
Mervyl,burning-legion,1467,hunter,marksmanship,42,21,21
Epheso,daggerspine,1467,hunter,marksmanship,36,16,20
Fantus,sylvanas,1464,hunter,marksmanship,42,22,20
Iliketraps,blackmoore,1464,hunter,marksmanship,47,19,28
Narziel,die-todeskrallen,1463,hunter,marksmanship,148,80,68
Jimbow,blackrock,1462,hunter,marksmanship,64,33,31
Fixel,pozzo-delleternità,1461,hunter,marksmanship,186,96,90
Trapeure,archimonde,1461,hunter,marksmanship,33,16,17
Jocitwitch,ragnaros,1460,hunter,marksmanship,33,17,16
Poman,azjolnerub,1459,hunter,marksmanship,83,40,43
Shedzargo,twisting-nether,1458,hunter,marksmanship,48,23,25
Вееном,gordunni,1458,hunter,marksmanship,111,51,60
Deathshots,aggra-português,1456,hunter,marksmanship,144,71,73
Скартэкс,howling-fjord,1455,hunter,marksmanship,62,39,23
Stripedcani,kelthuzad,1455,hunter,marksmanship,42,24,18
Djidawn,ysondre,1454,hunter,marksmanship,42,21,21
Valkhen,boulderfist,1453,hunter,marksmanship,54,31,23
Ozzaty,drekthar,1452,hunter,marksmanship,83,41,42
Setis,uldaman,1452,hunter,marksmanship,72,29,43
Darksmoky,forscherliga,1452,hunter,marksmanship,60,21,39
Øßlíck,ysondre,1451,hunter,marksmanship,58,28,30
Emnia,argent-dawn,1449,hunter,marksmanship,95,45,50
Chaussons,kazzak,1448,hunter,marksmanship,222,111,111
Koratoz,blackmoore,1445,hunter,marksmanship,120,68,52
Snipèr,blackmoore,1444,hunter,marksmanship,67,36,31
Swïtchz,hyjal,1443,hunter,marksmanship,141,70,71
Эльк,gordunni,1442,hunter,marksmanship,105,57,48
Reyst,moonglade,1441,hunter,marksmanship,60,31,29
Fiveshøt,blackmoore,1440,hunter,marksmanship,42,19,23
Хантвкроксах,gordunni,1438,hunter,marksmanship,52,29,23
Hiðe,archimonde,1438,hunter,marksmanship,92,48,44
Watchouttah,the-maelstrom,1438,hunter,marksmanship,36,15,21
Mspt,archimonde,1438,hunter,marksmanship,36,15,21
Tavira,zuljin,1436,hunter,marksmanship,368,189,179
Velites,aggra-português,1436,hunter,marksmanship,54,17,37
Bøøgy,silvermoon,1435,hunter,marksmanship,234,122,112
Nagu,antonidas,1435,hunter,marksmanship,30,15,15
Angelcr,uldum,1434,hunter,marksmanship,42,17,25
Räguel,ravencrest,1433,hunter,marksmanship,75,40,35
Masthuhn,blackmoore,1432,hunter,marksmanship,24,15,9
Ønske,azjolnerub,1432,hunter,marksmanship,179,91,88
Eferos,quelthalas,1432,hunter,marksmanship,120,54,66
Owyea,kazzak,1432,hunter,marksmanship,60,27,33
Jachtorc,kazzak,1431,hunter,marksmanship,54,27,27
Rísu,argent-dawn,1429,hunter,marksmanship,86,49,37
Soupsoupsòup,blackmoore,1429,hunter,marksmanship,60,30,30
Длинноемоджо,soulflayer,1429,hunter,marksmanship,924,458,466
Shieryu,archimonde,1428,hunter,marksmanship,92,47,45
Babclaar,culte-de-la-rive-noire,1426,hunter,marksmanship,72,40,32
Xalaar,frostwolf,1426,hunter,marksmanship,98,54,44
Mckie,chromaggus,1425,hunter,marksmanship,24,15,9
Féliché,elune,1425,hunter,marksmanship,138,69,69
Begøne,draenor,1423,hunter,marksmanship,42,28,14
Lennyx,quelthalas,1423,hunter,marksmanship,55,25,30
Anschy,ambossar,1423,hunter,marksmanship,113,49,64
Poppson,magtheridon,1422,hunter,marksmanship,120,65,55
Tackleberry,ysondre,1422,hunter,marksmanship,48,21,27
Ahrtemís,destromath,1422,hunter,marksmanship,36,15,21
Агелетка,gordunni,1421,hunter,marksmanship,24,15,9
Yoúmad,draenor,1421,hunter,marksmanship,34,17,17
Keritos,outland,1420,hunter,marksmanship,34,18,16
Bluelol,ravencrest,1420,hunter,marksmanship,147,67,80
Chizuko,ravencrest,1419,hunter,marksmanship,32,16,16
Мейрелис,blackscar,1417,hunter,marksmanship,24,15,9
Jàsøn,ravencrest,1417,hunter,marksmanship,33,16,17
Kyudo,ravencrest,1416,hunter,marksmanship,148,74,74
Longblow,outland,1416,hunter,marksmanship,51,21,30
Белыйатомщик,howling-fjord,1416,hunter,marksmanship,54,22,32
Zulthat,thrall,1415,hunter,marksmanship,42,23,19
Valarixx,twisting-nether,1415,hunter,marksmanship,42,16,26
Shootingbob,blackrock,1413,hunter,marksmanship,68,35,33
Аскентр,gordunni,1411,hunter,marksmanship,67,31,36
Tupalax,outland,1410,hunter,marksmanship,147,71,76
Starborne,draenor,1410,hunter,marksmanship,51,23,28
Qapheze,silvermoon,1409,hunter,marksmanship,127,61,66
Capball,kelthuzad,1409,hunter,marksmanship,42,20,22
Fitzgerald,ragnaros,1409,hunter,marksmanship,102,48,54
Enerhunt,ysondre,1406,hunter,marksmanship,123,70,53
Гефесте,gordunni,1404,hunter,marksmanship,30,15,15
Хантнерюга,gordunni,1404,hunter,marksmanship,74,33,41
Eledryn,bronze-dragonflight,1403,hunter,marksmanship,50,27,23
Ahpwall,archimonde,1403,hunter,marksmanship,132,67,65
Wielok,burning-legion,1402,hunter,marksmanship,80,41,39
Zrogan,archimonde,1402,hunter,marksmanship,36,17,19
Pekkoe,khaz-modan,1401,hunter,marksmanship,108,61,47
Hedinen,the-venture-co,1401,hunter,marksmanship,36,15,21
Krypzit,garona,1398,hunter,marksmanship,273,129,144
Darm,sunstrider,1398,hunter,marksmanship,36,15,21
Skyttelaj,stormscale,1396,hunter,marksmanship,90,49,41
Dezmoinez,twisting-nether,1395,hunter,marksmanship,78,37,41
Lobos,ravencrest,1394,hunter,marksmanship,66,29,37
Iniduhr,dalaran,1394,hunter,marksmanship,39,17,22
Jalu,die-aldor,1393,hunter,marksmanship,48,30,18
Rèyz,blackhand,1393,hunter,marksmanship,117,58,59
Nanns,silvermoon,1393,hunter,marksmanship,120,58,62
Ashimaru,sylvanas,1393,hunter,marksmanship,69,33,36
Firescorpion,onyxia,1392,hunter,marksmanship,48,27,21
Wowkulaka,kazzak,1392,hunter,marksmanship,218,110,108
Selynne,grim-batol,1391,hunter,marksmanship,24,16,8
Muddí,ravencrest,1391,hunter,marksmanship,24,15,9
Encore,sylvanas,1391,hunter,marksmanship,72,37,35
Гернриета,gordunni,1389,hunter,marksmanship,41,23,18
Ëluna,burning-legion,1389,hunter,marksmanship,148,79,69
Plzdontrun,sylvanas,1389,hunter,marksmanship,47,24,23
Gwalëndil,hyjal,1389,hunter,marksmanship,108,55,53
Курунирка,gordunni,1388,hunter,marksmanship,42,18,24
Tiidus,burning-legion,1387,hunter,marksmanship,94,48,46
Bollo,malganis,1387,hunter,marksmanship,102,48,54
Полития,azuregos,1387,hunter,marksmanship,63,29,34
Anjeschka,nemesis,1386,hunter,marksmanship,66,36,30
Milhambré,ysondre,1385,hunter,marksmanship,42,19,23
Mânhunt,blackhand,1383,hunter,marksmanship,76,40,36
Tntabsotrap,silvermoon,1383,hunter,marksmanship,88,44,44
Aimnfire,anachronos,1382,hunter,marksmanship,92,47,45
Ashrîel,outland,1382,hunter,marksmanship,94,44,50
Treyzzor,blackmoore,1381,hunter,marksmanship,36,15,21
Bgxd,tarren-mill,1381,hunter,marksmanship,42,17,25
Vethan,die-aldor,1381,hunter,marksmanship,68,27,41
Amortên,silvermoon,1380,hunter,marksmanship,29,15,14
Balamut,aegwynn,1379,hunter,marksmanship,104,53,51
Zushji,ysondre,1378,hunter,marksmanship,480,235,245
Nékfeu,hyjal,1377,hunter,marksmanship,42,23,19
Lincolne,ravencrest,1375,hunter,marksmanship,41,17,24
Имбакласс,howling-fjord,1373,hunter,marksmanship,104,53,51
Kbesagrillo,sanguino,1372,hunter,marksmanship,42,18,24
Scatshot,grim-batol,1370,hunter,marksmanship,60,32,28
Samhunt,blackrock,1370,hunter,marksmanship,35,15,20
Kértor,die-aldor,1370,hunter,marksmanship,52,21,31
Giwtus,blackmoore,1369,hunter,marksmanship,40,15,25
Enfaktüs,silvermoon,1367,hunter,marksmanship,60,30,30
Doncar,stormscale,1367,hunter,marksmanship,99,44,55
Sivoh,silvermoon,1366,hunter,marksmanship,217,112,105
Adariana,archimonde,1366,hunter,marksmanship,120,58,62
Summa,silvermoon,1366,hunter,marksmanship,100,45,55
Джинксан,blackscar,1366,hunter,marksmanship,60,27,33
Ensomnia,silvermoon,1365,hunter,marksmanship,34,23,11
Elmadre,arthas,1365,hunter,marksmanship,84,43,41
Ofortuna,silvermoon,1364,hunter,marksmanship,78,42,36
Athel,moonglade,1364,hunter,marksmanship,42,16,26
Луврен,deepholm,1363,hunter,marksmanship,52,15,37
Absolutnoob,blackrock,1362,hunter,marksmanship,38,21,17
Souljâh,ravencrest,1361,hunter,marksmanship,83,38,45
Crar,frostwolf,1360,hunter,marksmanship,94,50,44
Kokowawaa,kazzak,1360,hunter,marksmanship,114,54,60
Duckling,argent-dawn,1360,hunter,marksmanship,60,27,33
Majuli,stormrage,1359,hunter,marksmanship,36,16,20
Aguerex,alleria,1358,hunter,marksmanship,30,20,10
Амобарбиталх,gordunni,1357,hunter,marksmanship,129,62,67
Jeddaj,stormscale,1356,hunter,marksmanship,42,16,26
Llaz,silvermoon,1355,hunter,marksmanship,28,15,13
Argahnim,azjolnerub,1354,hunter,marksmanship,463,229,234
Szybky,defias-brotherhood,1354,hunter,marksmanship,60,25,35
Халикер,soulflayer,1353,hunter,marksmanship,30,15,15
Robingood,alexstrasza,1353,hunter,marksmanship,91,36,55
Phillon,blackrock,1351,hunter,marksmanship,36,28,8
Itenik,frostwolf,1350,hunter,marksmanship,30,16,14
Тантрабой,howling-fjord,1348,hunter,marksmanship,30,18,12
Гусецап,gordunni,1348,hunter,marksmanship,144,65,79
Prokh,twisting-nether,1347,hunter,marksmanship,26,15,11
Langerlauf,alexstrasza,1346,hunter,marksmanship,42,18,24
Vavabxl,ysondre,1345,hunter,marksmanship,114,52,62
Booskihunter,burning-legion,1345,hunter,marksmanship,35,15,20
Iòvól,azuremyst,1344,hunter,marksmanship,121,63,58
Meskette,ravencrest,1344,hunter,marksmanship,36,18,18
Еввнух,gordunni,1342,hunter,marksmanship,138,62,76
Zhao,zenedar,1342,hunter,marksmanship,44,18,26
Aneji,hyjal,1341,hunter,marksmanship,166,87,79
Евилик,gordunni,1341,hunter,marksmanship,30,14,16
Laskoo,tarren-mill,1340,hunter,marksmanship,178,91,87
Deadfire,hyjal,1340,hunter,marksmanship,54,27,27
Ghostriders,archimonde,1340,hunter,marksmanship,65,28,37
Lofiv,turalyon,1340,hunter,marksmanship,40,17,23
Ðøper,hyjal,1339,hunter,marksmanship,18,14,4
Warkum,zuljin,1339,hunter,marksmanship,47,24,23
Øtemløol,sanguino,1339,hunter,marksmanship,30,14,16
Muckel,area-52,1339,hunter,marksmanship,42,19,23
Enÿo,ysondre,1339,hunter,marksmanship,48,16,32
Noxxen,burning-legion,1338,hunter,marksmanship,45,25,20
Допустимхант,howling-fjord,1337,hunter,marksmanship,35,17,18
Stevienícks,draenor,1336,hunter,marksmanship,47,19,28
Легчайшийбот,gordunni,1336,hunter,marksmanship,42,14,28
Headshott,agamaggan,1335,hunter,marksmanship,24,14,10
Barrex,guldan,1335,hunter,marksmanship,64,32,32
Jeston,amanthul,1335,hunter,marksmanship,90,40,50
Xesih,twisting-nether,1333,hunter,marksmanship,112,56,56
Lennylynx,garrosh,1333,hunter,marksmanship,66,29,37
Moschtix,forscherliga,1333,hunter,marksmanship,48,20,28
Огнеборик,howling-fjord,1333,hunter,marksmanship,71,28,43
Selaesa,chamber-of-aspects,1332,hunter,marksmanship,81,41,40
Høøli,nethersturm,1331,hunter,marksmanship,66,40,26
Оути,azuregos,1331,hunter,marksmanship,24,14,10
Nezekielle,drekthar,1331,hunter,marksmanship,66,27,39
Chrishyh,blackrock,1330,hunter,marksmanship,60,28,32
Gramyr,ysondre,1329,hunter,marksmanship,24,14,10
Opî,eldrethalas,1328,hunter,marksmanship,190,95,95
Kolgrim,temple-noir,1328,hunter,marksmanship,64,31,33
Incompetence,argent-dawn,1328,hunter,marksmanship,44,19,25
Skaedi,silvermoon,1327,hunter,marksmanship,25,16,9
Elyar,eredar,1327,hunter,marksmanship,58,31,27
Azmena,silvermoon,1327,hunter,marksmanship,29,15,14
Huntseeker,draenor,1327,hunter,marksmanship,37,17,20
Ashide,dun-modr,1327,hunter,marksmanship,36,16,20
Chrysantes,forscherliga,1326,hunter,marksmanship,30,14,16
Carpante,nemesis,1326,hunter,marksmanship,96,42,54
Antiork,doomhammer,1325,hunter,marksmanship,132,64,68
Diapositiv,draenor,1325,hunter,marksmanship,30,14,16
Механямка,gordunni,1323,hunter,marksmanship,41,15,26
Zendar,blackmoore,1322,hunter,marksmanship,174,89,85
Bizzrip,kazzak,1320,hunter,marksmanship,48,28,20
Amphi,stormscale,1320,hunter,marksmanship,66,36,30
Сентуслип,fordragon,1320,hunter,marksmanship,189,87,102
Saejku,archimonde,1319,hunter,marksmanship,34,21,13
Evelhunter,kargath,1318,hunter,marksmanship,24,15,9
Boarthrills,ravencrest,1317,hunter,marksmanship,47,18,29
Stingarrow,stormscale,1316,hunter,marksmanship,90,46,44
Zelira,boulderfist,1316,hunter,marksmanship,142,68,74
Heísenberg,ragnaros,1316,hunter,marksmanship,49,22,27
Blackmood,twisting-nether,1315,hunter,marksmanship,54,32,22
Snipekill,bronze-dragonflight,1315,hunter,marksmanship,36,20,16
Virdirthera,silvermoon,1315,hunter,marksmanship,66,33,33
Psychlolzxr,burning-legion,1315,hunter,marksmanship,53,26,27
Avaîo,ysondre,1315,hunter,marksmanship,64,24,40
Abraxan,twisting-nether,1314,hunter,marksmanship,58,34,24
Snípér,blackhand,1314,hunter,marksmanship,53,17,36
Minerva,malfurion,1313,hunter,marksmanship,142,75,67
Thedoors,twisting-nether,1312,hunter,marksmanship,60,25,35
Найтхантишка,gordunni,1312,hunter,marksmanship,36,14,22
Arrowdoxx,silvermoon,1310,hunter,marksmanship,117,51,66
Asthorio,stormscale,1309,hunter,marksmanship,106,44,62
Exstri,sargeras,1309,hunter,marksmanship,71,29,42
Turtíe,argent-dawn,1308,hunter,marksmanship,48,28,20
Фузег,deathguard,1308,hunter,marksmanship,36,18,18
Xaotsu,ravencrest,1308,hunter,marksmanship,51,24,27
Silvyina,todeswache,1307,hunter,marksmanship,98,49,49
Insanepvper,argent-dawn,1307,hunter,marksmanship,60,24,36
Lrr,grim-batol,1306,hunter,marksmanship,30,19,11
Lillynahh,argent-dawn,1306,hunter,marksmanship,223,113,110
Воуб,gordunni,1304,hunter,marksmanship,108,51,57
Narawinger,silvermoon,1303,hunter,marksmanship,54,30,24
Sarblade,bronze-dragonflight,1302,hunter,marksmanship,35,17,18
Àfpro,hyjal,1302,hunter,marksmanship,128,56,72
Rickgrimés,silvermoon,1302,hunter,marksmanship,42,18,24
Coft,sargeras,1301,hunter,marksmanship,42,23,19
Sanhunter,eredar,1301,hunter,marksmanship,54,23,31
Clouder,blackhand,1300,hunter,marksmanship,36,20,16
Hunterbeck,ravencrest,1299,hunter,marksmanship,128,68,60
Buzzle,sylvanas,1298,hunter,marksmanship,54,32,22
Kaktus,shattered-hand,1298,hunter,marksmanship,30,16,14
Travels,tarren-mill,1298,hunter,marksmanship,179,84,95
Зуллден,soulflayer,1298,hunter,marksmanship,43,16,27
Neldrassil,blackmoore,1297,hunter,marksmanship,203,107,96
Wmaximoff,tarren-mill,1296,hunter,marksmanship,86,34,52
Тамирка,deathguard,1295,hunter,marksmanship,23,14,9
Amogustroll,burning-blade,1295,hunter,marksmanship,42,21,21
Bobleearrow,darkspear,1295,hunter,marksmanship,71,34,37
Casey,zuluhed,1295,hunter,marksmanship,42,19,23
Serihu,cthun,1294,hunter,marksmanship,171,82,89
Нереальнно,blackscar,1294,hunter,marksmanship,120,57,63
Aurah,les-clairvoyants,1292,hunter,marksmanship,54,26,28
Rydén,pozzo-delleternità,1291,hunter,marksmanship,48,19,29
Loca,twilights-hammer,1290,hunter,marksmanship,135,69,66
Booms,eonar,1290,hunter,marksmanship,99,49,50
Hollybuster,perenolde,1287,hunter,marksmanship,63,34,29
Aerieshan,ravencrest,1286,hunter,marksmanship,88,41,47
Piit,elune,1286,hunter,marksmanship,102,41,61
Sïrrys,nemesis,1285,hunter,marksmanship,64,32,32
Sharpeyezz,ravencrest,1285,hunter,marksmanship,97,38,59
Gromaya,elune,1284,hunter,marksmanship,65,30,35
Куников,booty-bay,1284,hunter,marksmanship,36,14,22
Elisande,die-aldor,1284,hunter,marksmanship,60,23,37
Autoturret,eredar,1283,hunter,marksmanship,118,53,65
Silvyn,pozzo-delleternità,1282,hunter,marksmanship,88,44,44
Smitheye,argent-dawn,1282,hunter,marksmanship,183,89,94
Neuwi,stormreaver,1282,hunter,marksmanship,54,26,28
Røxxilia,blackmoore,1280,hunter,marksmanship,72,30,42
Ксидре,eversong,1279,hunter,marksmanship,78,39,39
Orcarevolver,tarren-mill,1279,hunter,marksmanship,48,23,25
Fränko,ravencrest,1279,hunter,marksmanship,186,82,104
Götthunter,antonidas,1277,hunter,marksmanship,74,35,39
Narøs,blackhand,1277,hunter,marksmanship,111,51,60
Silverinn,turalyon,1277,hunter,marksmanship,39,17,22
Kimia,pozzo-delleternità,1276,hunter,marksmanship,30,18,12
Shïndh,archimonde,1276,hunter,marksmanship,30,14,16
Waltuhwhite,teldrassil,1275,hunter,marksmanship,20,14,6
Kyßa,uldum,1275,hunter,marksmanship,81,39,42
Mainblu,nemesis,1275,hunter,marksmanship,64,30,34
Pulsaðenura,dun-modr,1275,hunter,marksmanship,85,33,52
Ihateyoumore,ravencrest,1274,hunter,marksmanship,48,18,30
Vanstro,ragnaros,1274,hunter,marksmanship,38,14,24
Дайпострелят,gordunni,1273,hunter,marksmanship,36,15,21
Atiyêsh,arthas,1272,hunter,marksmanship,42,17,25
Soviectk,aggra-português,1271,hunter,marksmanship,66,32,34
Rupeebtw,stormscale,1271,hunter,marksmanship,168,79,89
Rmnsbm,blackmoore,1271,hunter,marksmanship,30,14,16
Shaib,kazzak,1270,hunter,marksmanship,28,15,13
Kaminôr,antonidas,1270,hunter,marksmanship,59,29,30
Deathchoice,azshara,1270,hunter,marksmanship,36,14,22
Tokkie,burning-blade,1268,hunter,marksmanship,24,14,10
Zajebantip,sylvanas,1268,hunter,marksmanship,111,51,60
Scark,tarren-mill,1267,hunter,marksmanship,55,33,22
Andtamed,thunderhorn,1264,hunter,marksmanship,90,44,46
Gødzftw,kazzak,1264,hunter,marksmanship,46,18,28
Mmaaee,ravencrest,1263,hunter,marksmanship,81,41,40
Skyren,defias-brotherhood,1262,hunter,marksmanship,80,35,45
Gilgharsh,rajaxx,1262,hunter,marksmanship,70,30,40
Nightshäde,aggra-português,1261,hunter,marksmanship,94,42,52
Honzu,silvermoon,1260,hunter,marksmanship,48,25,23
Khajiizu,frostwolf,1260,hunter,marksmanship,72,35,37
Ililivillumi,tarren-mill,1259,hunter,marksmanship,54,26,28
Kaliistda,blackmoore,1259,hunter,marksmanship,62,29,33
Джантига,howling-fjord,1259,hunter,marksmanship,50,20,30
Арийская,gordunni,1258,hunter,marksmanship,116,55,61
Шамагута,gordunni,1258,hunter,marksmanship,30,14,16
Yunalèsca,eredar,1258,hunter,marksmanship,40,15,25
Яриона,galakrond,1257,hunter,marksmanship,189,99,90
Ixlxlxlxl,kazzak,1257,hunter,marksmanship,128,66,62
Феорика,grom,1257,hunter,marksmanship,66,33,33
Пулемётчик,eversong,1257,hunter,marksmanship,61,29,32
Bazrzokh,elune,1256,hunter,marksmanship,42,21,21
Pickaboo,defias-brotherhood,1256,hunter,marksmanship,363,174,189
Fugass,ragnaros,1255,hunter,marksmanship,57,31,26
Mizumo,burning-legion,1254,hunter,marksmanship,151,77,74
Sinequanon,mannoroth,1254,hunter,marksmanship,54,21,33
Niwariell,silvermoon,1253,hunter,marksmanship,102,54,48
Skohal,draenor,1250,hunter,marksmanship,114,56,58
Bulseye,kilrogg,1250,hunter,marksmanship,30,14,16
Арктиум,gordunni,1249,hunter,marksmanship,20,14,6
Lonewolfe,ravencrest,1247,hunter,marksmanship,577,290,287
Sallina,blutkessel,1247,hunter,marksmanship,30,15,15
Magmageul,archimonde,1247,hunter,marksmanship,105,50,55
Ruffixvs,blackrock,1246,hunter,marksmanship,18,13,5
Fetts,silvermoon,1246,hunter,marksmanship,68,37,31
Avyo,tichondrius,1246,hunter,marksmanship,24,13,11
Curtiss,sanguino,1246,hunter,marksmanship,118,60,58
Kendow,blackrock,1246,hunter,marksmanship,126,63,63
Фанатшла,gordunni,1245,hunter,marksmanship,24,13,11
Cutehuntér,ragnaros,1245,hunter,marksmanship,143,64,79
Eilyn,quelthalas,1245,hunter,marksmanship,53,19,34
Lísy,hyjal,1244,hunter,marksmanship,24,13,11
Swáy,twisting-nether,1244,hunter,marksmanship,317,157,160
Деллвиш,howling-fjord,1244,hunter,marksmanship,30,13,17
Animäl,stormscale,1244,hunter,marksmanship,160,67,93
Stormwrath,kul-tiras,1244,hunter,marksmanship,60,23,37
Enablee,lightbringer,1244,hunter,marksmanship,42,15,27
Iilac,argent-dawn,1242,hunter,marksmanship,184,104,80
Tinlop,ragnaros,1242,hunter,marksmanship,169,83,86
Huntatard,silvermoon,1241,hunter,marksmanship,28,16,12
Рбг,blackscar,1241,hunter,marksmanship,30,13,17
Zurzok,blackrock,1239,hunter,marksmanship,60,24,36
Hantdown,defias-brotherhood,1238,hunter,marksmanship,29,14,15
Costner,darksorrow,1238,hunter,marksmanship,38,15,23
Khâ,garona,1237,hunter,marksmanship,105,55,50
Sylvina,todeswache,1237,hunter,marksmanship,36,16,20
Calibrë,dun-modr,1237,hunter,marksmanship,30,13,17
Blazingshot,lightbringer,1236,hunter,marksmanship,30,13,17
Jðsi,dalaran,1235,hunter,marksmanship,83,38,45
Металшот,blackscar,1234,hunter,marksmanship,74,36,38
Birgitta,jaedenar,1234,hunter,marksmanship,30,13,17
Beyzworld,antonidas,1233,hunter,marksmanship,24,13,11
Hunntte,ravencrest,1233,hunter,marksmanship,54,27,27
Corrupth,outland,1233,hunter,marksmanship,33,14,19
Huntaloko,outland,1232,hunter,marksmanship,35,17,18
Bousillator,archimonde,1228,hunter,marksmanship,42,23,19
Qiruun,draenor,1228,hunter,marksmanship,24,13,11
Barneyarrow,tarren-mill,1227,hunter,marksmanship,24,13,11
Huntazt,draenor,1225,hunter,marksmanship,24,13,11
Corrwus,argent-dawn,1225,hunter,marksmanship,111,54,57
Colm,kirin-tor,1223,hunter,marksmanship,42,19,23
Zajaczek,burning-legion,1223,hunter,marksmanship,67,30,37
Rediction,ravencrest,1222,hunter,marksmanship,90,39,51
Viséeauto,confrérie-du-thorium,1221,hunter,marksmanship,72,36,36
Oatmeal,dun-morogh,1219,hunter,marksmanship,263,139,124
Amaziing,sanguino,1219,hunter,marksmanship,81,37,44
Gorá,dethecus,1218,hunter,marksmanship,36,20,16
Oneeyed,kazzak,1218,hunter,marksmanship,30,14,16
Elektrô,blackmoore,1218,hunter,marksmanship,51,19,32
Blutack,stormscale,1217,hunter,marksmanship,36,15,21
Kravên,anubarak,1216,hunter,marksmanship,138,62,76
Yanger,burning-legion,1216,hunter,marksmanship,72,31,41
Aqpa,twisting-nether,1215,hunter,marksmanship,64,32,32
Ромажиробас,gordunni,1215,hunter,marksmanship,54,27,27
Elladiel,blackmoore,1215,hunter,marksmanship,31,15,16
Pappous,kul-tiras,1215,hunter,marksmanship,124,57,67
Хакаар,grom,1214,hunter,marksmanship,134,69,65
Faenor,arygos,1212,hunter,marksmanship,102,40,62
Emti,outland,1212,hunter,marksmanship,54,20,34
Sàclak,ysondre,1211,hunter,marksmanship,126,59,67
Deneja,kilrogg,1211,hunter,marksmanship,48,20,28
Skynner,blackrock,1210,hunter,marksmanship,42,24,18
Elyxa,ysondre,1210,hunter,marksmanship,74,40,34
Girithsirion,stormscale,1210,hunter,marksmanship,66,29,37
Urith,les-clairvoyants,1209,hunter,marksmanship,26,14,12
Donneraàn,blackrock,1209,hunter,marksmanship,107,53,54
Îratus,blackmoore,1208,hunter,marksmanship,30,16,14
Overhït,hyjal,1208,hunter,marksmanship,191,95,96
Rabiate,blackrock,1208,hunter,marksmanship,68,30,38
Gintønic,blackmoore,1207,hunter,marksmanship,42,13,29
Laara,khaz-modan,1206,hunter,marksmanship,314,162,152
Sindeerolla,magtheridon,1206,hunter,marksmanship,108,48,60
Rosiee,dun-modr,1205,hunter,marksmanship,18,13,5
Redneckjoe,draenor,1204,hunter,marksmanship,58,26,32
Lightarròw,nordrassil,1203,hunter,marksmanship,54,21,33
Lunnaae,stormscale,1203,hunter,marksmanship,53,16,37
Milandria,antonidas,1200,hunter,marksmanship,92,54,38
Vïcødïnë,sinstralis,1199,hunter,marksmanship,113,52,61
Эннабонни,gordunni,1198,hunter,marksmanship,36,16,20
Fanstwo,tarren-mill,1198,hunter,marksmanship,42,14,28
Mike,medivh,1197,hunter,marksmanship,36,20,16
Løløsifredo,ysondre,1197,hunter,marksmanship,49,26,23
Blacksyo,elune,1195,hunter,marksmanship,127,57,70
Gigashot,nemesis,1193,hunter,marksmanship,21,14,7
Jablaka,blackhand,1193,hunter,marksmanship,107,52,55
Оленнька,howling-fjord,1191,hunter,marksmanship,84,44,40
Ríffraff,silvermoon,1190,hunter,marksmanship,36,19,17
Bigfoot,argent-dawn,1189,hunter,marksmanship,129,56,73
Aaryel,outland,1188,hunter,marksmanship,53,26,27
Mackiemax,defias-brotherhood,1188,hunter,marksmanship,29,13,16
Opsi,area-52,1187,hunter,marksmanship,144,67,77
Salomone,nerathor,1187,hunter,marksmanship,33,14,19
Вилежанин,ashenvale,1186,hunter,marksmanship,30,15,15
Оркистор,eversong,1186,hunter,marksmanship,84,30,54
Breier,argent-dawn,1185,hunter,marksmanship,137,69,68
Napa,kazzak,1185,hunter,marksmanship,30,13,17
Kakadoo,twisting-nether,1184,hunter,marksmanship,93,47,46
Panfilmaaj,burning-legion,1183,hunter,marksmanship,66,34,32
Zion,kul-tiras,1182,hunter,marksmanship,34,13,21
Meläna,ysondre,1180,hunter,marksmanship,48,21,27
Каизик,soulflayer,1180,hunter,marksmanship,48,19,29
Blueredfox,ravencrest,1180,hunter,marksmanship,35,13,22
Cxc,dun-modr,1179,hunter,marksmanship,55,27,28
Zerkarok,draenor,1179,hunter,marksmanship,42,17,25
Darilli,wildhammer,1179,hunter,marksmanship,72,28,44
Omixloua,ragnaros,1178,hunter,marksmanship,141,72,69
Bgkrasavec,stormscale,1178,hunter,marksmanship,81,40,41
Blackas,dun-modr,1178,hunter,marksmanship,96,45,51
Nivada,sylvanas,1178,hunter,marksmanship,29,13,16
Rndhunt,shattrath,1177,hunter,marksmanship,28,13,15
Banemonkey,kazzak,1176,hunter,marksmanship,107,49,58
Ruger,hyjal,1176,hunter,marksmanship,55,24,31
Hoody,culte-de-la-rive-noire,1175,hunter,marksmanship,41,24,17
Sâetha,dun-modr,1175,hunter,marksmanship,57,24,33
Survivr,frostmane,1174,hunter,marksmanship,42,23,19
Одисенс,eversong,1173,hunter,marksmanship,115,57,58
Пуллятель,borean-tundra,1171,hunter,marksmanship,87,43,44
Hunterdream,aszune,1171,hunter,marksmanship,52,21,31
Krothga,blackrock,1169,hunter,marksmanship,63,31,32
Azaella,tarren-mill,1169,hunter,marksmanship,58,27,31
Madtony,aegwynn,1169,hunter,marksmanship,50,23,27
Soppatorsk,shadowsong,1168,hunter,marksmanship,48,19,29
Chizuna,dun-morogh,1167,hunter,marksmanship,26,13,13
Tingly,grim-batol,1167,hunter,marksmanship,32,14,18
Isohunt,alakir,1167,hunter,marksmanship,66,28,38
Celtya,archimonde,1166,hunter,marksmanship,135,69,66
Linneâ,blackmoore,1166,hunter,marksmanship,32,15,17
Skitari,draenor,1165,hunter,marksmanship,48,14,34
Dahunter,blackmoore,1164,hunter,marksmanship,36,19,17
Лерочкалиса,gordunni,1162,hunter,marksmanship,42,17,25
Ártemide,pozzo-delleternità,1160,hunter,marksmanship,75,41,34
Rayzør,eitrigg,1158,hunter,marksmanship,35,16,19
Rubbler,ravencrest,1158,hunter,marksmanship,89,36,53
Cooroona,stormrage,1157,hunter,marksmanship,78,36,42
Chaydee,stormscale,1157,hunter,marksmanship,73,32,41
Naven,minahonda,1157,hunter,marksmanship,47,20,27
Watty,chogall,1156,hunter,marksmanship,154,77,77
Чизано,deathguard,1156,hunter,marksmanship,47,22,25
Naizoo,doomhammer,1156,hunter,marksmanship,30,14,16
Wasteoftimee,silvermoon,1156,hunter,marksmanship,78,30,48
Tiph,argent-dawn,1155,hunter,marksmanship,30,18,12
Крипа,gordunni,1155,hunter,marksmanship,98,47,51
Anpaytoo,antonidas,1155,hunter,marksmanship,54,24,30
Жабра,gordunni,1155,hunter,marksmanship,58,24,34
Jozsiur,ragnaros,1152,hunter,marksmanship,30,18,12
Påtrîckbátém,ravencrest,1152,hunter,marksmanship,24,12,12
Bøost,stormscale,1151,hunter,marksmanship,18,12,6
Feelmyfurý,tarren-mill,1151,hunter,marksmanship,18,12,6
Focüs,les-sentinelles,1150,hunter,marksmanship,24,12,12
Docchr,doomhammer,1149,hunter,marksmanship,114,54,60
Анхантэй,lich-king,1148,hunter,marksmanship,458,231,227
Olamay,blackmoore,1148,hunter,marksmanship,36,18,18
Zirgoo,outland,1148,hunter,marksmanship,81,31,50
Guevnerm,outland,1148,hunter,marksmanship,80,30,50
Hxnk,argent-dawn,1147,hunter,marksmanship,18,12,6
Farmerjoee,alakir,1147,hunter,marksmanship,24,13,11
Bobihunt,argent-dawn,1147,hunter,marksmanship,53,27,26
Сынсема,blackscar,1147,hunter,marksmanship,133,62,71
Freexkite,aegwynn,1147,hunter,marksmanship,26,12,14
Lamenob,neptulon,1147,hunter,marksmanship,78,31,47
Ätea,hyjal,1147,hunter,marksmanship,53,16,37
Jiton,grim-batol,1144,hunter,marksmanship,42,15,27
Taveon,turalyon,1144,hunter,marksmanship,42,15,27
Üx,hyjal,1141,hunter,marksmanship,30,16,14
Kundra,ravencrest,1141,hunter,marksmanship,24,12,12
Berk,kragjin,1141,hunter,marksmanship,59,25,34
Alluan,blackrock,1138,hunter,marksmanship,30,12,18
Artémíss,kazzak,1138,hunter,marksmanship,30,12,18
Ruppig,nozdormu,1137,hunter,marksmanship,66,30,36
Sylphie,dalaran,1136,hunter,marksmanship,30,12,18
Iziz,stormscale,1136,hunter,marksmanship,36,12,24
Heavenlyx,area-52,1135,hunter,marksmanship,72,32,40
Nym,eitrigg,1135,hunter,marksmanship,41,18,23
Кривоватый,galakrond,1134,hunter,marksmanship,29,15,14
Partouche,sargeras,1134,hunter,marksmanship,30,12,18
Bobeck,blackrock,1134,hunter,marksmanship,59,20,39
Kilölek,ragnaros,1133,hunter,marksmanship,24,12,12
Zrijad,draenor,1133,hunter,marksmanship,24,12,12
Dramin,defias-brotherhood,1132,hunter,marksmanship,42,16,26
Обнимуха,soulflayer,1132,hunter,marksmanship,36,12,24
Matarmeya,los-errantes,1131,hunter,marksmanship,58,30,28
Slayné,silvermoon,1131,hunter,marksmanship,24,12,12
Thelasiel,aerie-peak,1130,hunter,marksmanship,79,41,38
Jyzoro,stormscale,1130,hunter,marksmanship,35,15,20
Aszasi,azjolnerub,1130,hunter,marksmanship,31,13,18
Vardnev,dun-modr,1128,hunter,marksmanship,23,13,10
Штейн,greymane,1127,hunter,marksmanship,24,12,12
Hanzolo,uldum,1127,hunter,marksmanship,60,28,32
Foxhunt,turalyon,1127,hunter,marksmanship,56,23,33
Tránsphobic,kilrogg,1125,hunter,marksmanship,78,37,41
Showdown,hellscream,1124,hunter,marksmanship,125,54,71
Jägarbröje,kazzak,1123,hunter,marksmanship,42,24,18
Juliã,dalaran,1122,hunter,marksmanship,36,17,19
Nastytraps,blackrock,1120,hunter,marksmanship,44,18,26
Травмаопасен,gordunni,1120,hunter,marksmanship,42,13,29
Ролингуд,galakrond,1117,hunter,marksmanship,30,15,15
Réja,norgannon,1117,hunter,marksmanship,61,28,33
Qqc,burning-legion,1116,hunter,marksmanship,135,65,70
Анреал,gordunni,1112,hunter,marksmanship,62,32,30
Ruxu,drakthul,1112,hunter,marksmanship,48,16,32
Kilshot,burning-legion,1111,hunter,marksmanship,48,28,20
Nathah,burning-legion,1108,hunter,marksmanship,24,13,11
Áragorn,frostmane,1108,hunter,marksmanship,60,30,30
Ðepleter,outland,1108,hunter,marksmanship,30,12,18
Ashkabous,kazzak,1107,hunter,marksmanship,75,42,33
Wlndrunner,ravencrest,1107,hunter,marksmanship,30,12,18
Bélier,hyjal,1105,hunter,marksmanship,56,31,25
Hollabackgrl,outland,1105,hunter,marksmanship,42,18,24
Leílah,kazzak,1105,hunter,marksmanship,127,52,75
Arkhantos,anetheron,1104,hunter,marksmanship,33,13,20
Barbrady,nethersturm,1103,hunter,marksmanship,36,16,20
Akyra,runetotem,1102,hunter,marksmanship,216,101,115
Aimeddead,doomhammer,1100,hunter,marksmanship,24,13,11
Hntard,stormscale,1100,hunter,marksmanship,26,13,13
Talcaliste,archimonde,1100,hunter,marksmanship,101,46,55
Aratoxx,blackmoore,1099,hunter,marksmanship,101,53,48
Missingno,sporeggar,1099,hunter,marksmanship,48,24,24
Хапмьюзик,howling-fjord,1099,hunter,marksmanship,102,41,61
Elcouche,draenor,1099,hunter,marksmanship,54,18,36
Bloodfallen,onyxia,1097,hunter,marksmanship,61,18,43
Airelina,kazzak,1095,hunter,marksmanship,42,16,26
Quinty,durotan,1093,hunter,marksmanship,38,18,20
Yrtja,minahonda,1090,hunter,marksmanship,73,41,32
Брухлянка,gordunni,1089,hunter,marksmanship,49,27,22
Лорбан,gordunni,1089,hunter,marksmanship,44,20,24
Halvarr,ulduar,1088,hunter,marksmanship,42,20,22
Flintenwilly,die-aldor,1088,hunter,marksmanship,60,26,34
Harmonía,outland,1088,hunter,marksmanship,76,32,44
Nezuqo,archimonde,1087,hunter,marksmanship,42,16,26
Blowplac,moonglade,1085,hunter,marksmanship,153,69,84
Йошумитсу,howling-fjord,1084,hunter,marksmanship,56,29,27
Mántîs,argent-dawn,1084,hunter,marksmanship,73,32,41
Voitelka,terokkar,1083,hunter,marksmanship,128,64,64
Nigmatulin,burning-legion,1082,hunter,marksmanship,108,39,69
Æthelflæd,nathrezim,1081,hunter,marksmanship,60,22,38
Robìnhood,nemesis,1080,hunter,marksmanship,42,22,20
Shubichou,illidan,1080,hunter,marksmanship,36,16,20
Hunterixx,outland,1079,hunter,marksmanship,54,23,31
Glockzs,auchindoun,1078,hunter,marksmanship,54,16,38
Sinsé,conseil-des-ombres,1077,hunter,marksmanship,58,27,31
Retroxia,stormreaver,1075,hunter,marksmanship,26,12,14
Slicer,arthas,1074,hunter,marksmanship,103,48,55
Towknee,tarren-mill,1072,hunter,marksmanship,24,15,9
Touscahunter,kazzak,1072,hunter,marksmanship,288,141,147
Leafstorm,vashj,1068,hunter,marksmanship,84,33,51
Myplague,darkmoon-faire,1067,hunter,marksmanship,54,33,21
Snaped,malganis,1067,hunter,marksmanship,81,32,49
Hkizzler,kazzak,1066,hunter,marksmanship,115,53,62
Fistiecuff,auchindoun,1066,hunter,marksmanship,48,21,27
Nycto,norgannon,1065,hunter,marksmanship,24,14,10
Sekeh,ragnaros,1064,hunter,marksmanship,90,37,53
Apolix,ragnaros,1064,hunter,marksmanship,48,17,31
Moyraina,tarren-mill,1063,hunter,marksmanship,42,15,27
Thauana,los-errantes,1060,hunter,marksmanship,30,14,16
Nutzz,ragnaros,1059,hunter,marksmanship,59,26,33
Гилара,soulflayer,1059,hunter,marksmanship,34,12,22
Noobhuntress,norgannon,1058,hunter,marksmanship,68,22,46
Sazak,draenor,1056,hunter,marksmanship,54,31,23
Серргио,soulflayer,1056,hunter,marksmanship,36,17,19
Vèreesa,azjolnerub,1056,hunter,marksmanship,72,29,43
Кукито,goldrinn,1056,hunter,marksmanship,30,11,19
Lyanne,amanthul,1055,hunter,marksmanship,18,11,7
Jungletime,outland,1055,hunter,marksmanship,18,11,7
Änglatrumpet,stormreaver,1055,hunter,marksmanship,18,11,7
Bicepz,azjolnerub,1055,hunter,marksmanship,23,12,11
Axran,ravencrest,1055,hunter,marksmanship,24,11,13
Ðõt,ravencrest,1055,hunter,marksmanship,24,11,13
Frágile,drakthul,1055,hunter,marksmanship,24,11,13
Othellö,kazzak,1055,hunter,marksmanship,30,11,19
Енвина,gordunni,1054,hunter,marksmanship,29,13,16
Eliune,silvermoon,1053,hunter,marksmanship,18,11,7
Kissmyaxé,draenor,1053,hunter,marksmanship,18,11,7
Uncø,kazzak,1053,hunter,marksmanship,18,11,7
Medûse,stormscale,1053,hunter,marksmanship,24,11,13
Dunkenmere,kazzak,1053,hunter,marksmanship,24,11,13
Bladewing,archimonde,1053,hunter,marksmanship,30,11,19
Fìnwë,varimathras,1052,hunter,marksmanship,18,11,7
Blàdê,blackrock,1052,hunter,marksmanship,18,11,7
Bomshot,frostmane,1052,hunter,marksmanship,24,11,13
Zøk,stormscale,1051,hunter,marksmanship,18,11,7
Dolwen,argent-dawn,1051,hunter,marksmanship,24,11,13
Twak,kilrogg,1050,hunter,marksmanship,24,13,11
Хихихихх,gordunni,1050,hunter,marksmanship,24,11,13
Cøbrâ,hyjal,1050,hunter,marksmanship,33,15,18
Nìsalle,argent-dawn,1050,hunter,marksmanship,32,13,19
Funkemarie,blackmoore,1050,hunter,marksmanship,30,11,19
Слезыотлука,howling-fjord,1048,hunter,marksmanship,18,11,7
Ramela,sanguino,1047,hunter,marksmanship,30,11,19
Pøca,kaelthas,1045,hunter,marksmanship,18,11,7
Tomtus,aggramar,1044,hunter,marksmanship,94,49,45
Mijnoke,antonidas,1044,hunter,marksmanship,24,11,13
Armoredtiger,grim-batol,1043,hunter,marksmanship,140,73,67
Bloodhøund,draenor,1043,hunter,marksmanship,30,12,18
Переферия,galakrond,1043,hunter,marksmanship,30,11,19
Seariko,draenor,1043,hunter,marksmanship,37,13,24
Jonayhunter,dun-modr,1042,hunter,marksmanship,24,11,13
Ямакасси,thermaplugg,1042,hunter,marksmanship,124,52,72
Винтаж,deepholm,1041,hunter,marksmanship,59,26,33
Cêdric,alleria,1041,hunter,marksmanship,28,12,16
Ninmul,quelthalas,1040,hunter,marksmanship,42,23,19
Ричардн,howling-fjord,1040,hunter,marksmanship,24,11,13
Jaggatee,senjin,1039,hunter,marksmanship,82,38,44
Diosteayuda,dun-modr,1038,hunter,marksmanship,24,14,10
Argato,eredar,1038,hunter,marksmanship,93,41,52
Mortess,drakthul,1038,hunter,marksmanship,30,11,19
Nyri,drakthul,1038,hunter,marksmanship,30,11,19
Djzntrap,outland,1035,hunter,marksmanship,30,12,18
Madida,ravencrest,1034,hunter,marksmanship,88,49,39
Eéilin,the-maelstrom,1033,hunter,marksmanship,18,11,7
Weridia,der-rat-von-dalaran,1033,hunter,marksmanship,22,12,10
Saccä,ysondre,1030,hunter,marksmanship,115,57,58
Jisila,ravencrest,1030,hunter,marksmanship,183,90,93
Artexxia,kazzak,1030,hunter,marksmanship,66,27,39
Gilgalat,drakthul,1029,hunter,marksmanship,47,20,27
Ispo,frostwolf,1028,hunter,marksmanship,100,48,52
Илюшааимшот,gordunni,1028,hunter,marksmanship,30,11,19
Chase,wildhammer,1027,hunter,marksmanship,66,17,49
Kerrveros,ravencrest,1025,hunter,marksmanship,42,20,22
Miezuu,ravencrest,1025,hunter,marksmanship,63,27,36
Falenwing,blackmoore,1024,hunter,marksmanship,34,16,18
Olnàk,ysondre,1023,hunter,marksmanship,60,32,28
Eskubar,burning-legion,1022,hunter,marksmanship,150,67,83
Mendinar,sylvanas,1020,hunter,marksmanship,83,26,57
Fèhn,krasus,1019,hunter,marksmanship,24,14,10
Noobatala,tarren-mill,1018,hunter,marksmanship,42,20,22
Odyzeus,drakthul,1018,hunter,marksmanship,28,12,16
Ygrittéé,blackrock,1018,hunter,marksmanship,32,13,19
Zlejkadlec,burning-blade,1018,hunter,marksmanship,28,11,17
Maríschká,amanthul,1016,hunter,marksmanship,81,41,40
Jomerin,thrall,1016,hunter,marksmanship,28,11,17
Эолиана,borean-tundra,1012,hunter,marksmanship,87,40,47
Конар,soulflayer,1012,hunter,marksmanship,24,11,13
Sisilianno,khaz-modan,1012,hunter,marksmanship,182,82,100
Thebalrog,korgall,1010,hunter,marksmanship,36,14,22
Nimrod,norgannon,1009,hunter,marksmanship,45,19,26
Trillu,madmortem,1009,hunter,marksmanship,59,24,35
Nonamenoskil,sylvanas,1008,hunter,marksmanship,24,13,11
Кикто,gordunni,1007,hunter,marksmanship,18,11,7
Bobbers,ravencrest,1006,hunter,marksmanship,36,14,22
Венгс,howling-fjord,1005,hunter,marksmanship,39,14,25
Irïna,arakarahm,1004,hunter,marksmanship,162,88,74
Gorett,kazzak,1004,hunter,marksmanship,36,12,24
Siike,tarren-mill,1004,hunter,marksmanship,47,15,32
Speedofpain,kazzak,1003,hunter,marksmanship,119,55,64
Waresfido,nordrassil,1003,hunter,marksmanship,50,21,29
Whitehor,ragnaros,1001,hunter,marksmanship,54,23,31
Banshees,sylvanas,1000,hunter,marksmanship,36,20,16
Basìcs,nemesis,998,hunter,marksmanship,24,12,12
Naghtel,die-silberne-hand,998,hunter,marksmanship,128,63,65
Boomkillshot,zuljin,996,hunter,marksmanship,259,126,133
Bulhumt,draenor,992,hunter,marksmanship,29,16,13
Шикаа,gordunni,992,hunter,marksmanship,29,13,16
Jaýlah,draenor,991,hunter,marksmanship,54,24,30
Bonquiesha,tarren-mill,991,hunter,marksmanship,25,11,14
Dropthunthun,argent-dawn,991,hunter,marksmanship,56,16,40
Dentaar,draenor,988,hunter,marksmanship,213,103,110
Ашмадей,eversong,988,hunter,marksmanship,30,13,17
Мальберна,eversong,984,hunter,marksmanship,70,34,36
Tungusta,defias-brotherhood,984,hunter,marksmanship,72,33,39
Aidsmacka,shattered-hand,982,hunter,marksmanship,20,11,9
Robros,dentarg,982,hunter,marksmanship,55,28,27
Nawwaf,tarren-mill,981,hunter,marksmanship,68,21,47
Ядрис,gordunni,980,hunter,marksmanship,54,23,31
Kliantra,wildhammer,979,hunter,marksmanship,248,120,128
Honilsom,thunderhorn,979,hunter,marksmanship,90,33,57
Bendit,eredar,978,hunter,marksmanship,81,35,46
Faelhorn,archimonde,976,hunter,marksmanship,42,22,20
Neosmoke,shadowsong,976,hunter,marksmanship,207,93,114
Фломидзе,gordunni,975,hunter,marksmanship,19,11,8
Olendor,blackmoore,974,hunter,marksmanship,24,14,10
Krøsh,blackmoore,967,hunter,marksmanship,130,65,65
Chassfurax,hyjal,965,hunter,marksmanship,96,39,57
Euphellius,darkmoon-faire,961,hunter,marksmanship,101,50,51
Nyxìa,shattered-halls,960,hunter,marksmanship,18,10,8
Imonér,frostmane,960,hunter,marksmanship,18,10,8
Îløvémêld,kazzak,960,hunter,marksmanship,24,10,14
Квит,blackscar,960,hunter,marksmanship,24,10,14
Gíggí,malganis,960,hunter,marksmanship,30,10,20
Dregor,nemesis,959,hunter,marksmanship,18,10,8
Srédder,defias-brotherhood,959,hunter,marksmanship,18,10,8
Cill,ravencrest,959,hunter,marksmanship,18,10,8
Scartet,blackmoore,959,hunter,marksmanship,24,10,14
Bãbas,sargeras,959,hunter,marksmanship,24,10,14
Sazox,blackrock,959,hunter,marksmanship,24,10,14
Pennymarks,blackhand,959,hunter,marksmanship,24,10,14
Metalbaci,sylvanas,958,hunter,marksmanship,18,10,8
Therakal,culte-de-la-rive-noire,958,hunter,marksmanship,18,10,8
Jibolad,stormreaver,958,hunter,marksmanship,72,37,35
Muxilina,ravencrest,958,hunter,marksmanship,24,10,14
Tyrone,saurfang,958,hunter,marksmanship,33,11,22
Yelanna,argent-dawn,957,hunter,marksmanship,18,10,8
Dasimir,blackrock,957,hunter,marksmanship,24,10,14
Thrund,burning-legion,956,hunter,marksmanship,25,14,11
Väärä,stormscale,956,hunter,marksmanship,36,15,21
Multigodx,draenor,956,hunter,marksmanship,24,10,14
Chaoticshot,ravencrest,955,hunter,marksmanship,24,10,14
Johnydep,silvermoon,955,hunter,marksmanship,30,10,20
Quasar,arakarahm,954,hunter,marksmanship,120,51,69
Dúnknóé,nordrassil,953,hunter,marksmanship,18,10,8
Isarnexx,dun-modr,953,hunter,marksmanship,47,22,25
Makaxx,stormscale,952,hunter,marksmanship,30,10,20
Абунай,soulflayer,952,hunter,marksmanship,30,10,20
Deathtrapper,bronzebeard,949,hunter,marksmanship,18,10,8
Lani,talnivarr,949,hunter,marksmanship,19,10,9
Azsräel,dalaran,948,hunter,marksmanship,270,130,140
Broodhar,hyjal,948,hunter,marksmanship,30,10,20
Aureboby,hyjal,946,hunter,marksmanship,36,10,26
Freezyshinkn,blackrock,945,hunter,marksmanship,18,11,7
Titanx,sylvanas,945,hunter,marksmanship,72,32,40
Primator,argent-dawn,942,hunter,marksmanship,15,11,4
Shibai,outland,939,hunter,marksmanship,24,10,14
Aspéct,ravencrest,939,hunter,marksmanship,24,10,14
Løssen,outland,938,hunter,marksmanship,23,10,13
Лордввт,howling-fjord,937,hunter,marksmanship,78,41,37
Ayshæ,tarren-mill,937,hunter,marksmanship,41,21,20
Коватори,borean-tundra,934,hunter,marksmanship,48,14,34
Mhood,dun-morogh,931,hunter,marksmanship,56,27,29
Sogoru,dun-modr,927,hunter,marksmanship,69,37,32
Мокку,howling-fjord,925,hunter,marksmanship,54,24,30
Arkell,los-errantes,924,hunter,marksmanship,30,12,18
Джимуха,soulflayer,922,hunter,marksmanship,48,26,22
Vérfarkas,arathor,920,hunter,marksmanship,34,15,19
Wìndrunner,malfurion,919,hunter,marksmanship,125,61,64
Cilia,suramar,913,hunter,marksmanship,60,23,37
Ratwithgat,argent-dawn,913,hunter,marksmanship,28,10,18
Adventures,darkmoon-faire,912,hunter,marksmanship,60,31,29
Sloe,sylvanas,911,hunter,marksmanship,26,11,15
Petardas,outland,910,hunter,marksmanship,68,33,35
Сандабар,borean-tundra,909,hunter,marksmanship,85,37,48
Hnut,kazzak,908,hunter,marksmanship,59,23,36
Selini,bloodfeather,906,hunter,marksmanship,48,22,26
Koørai,outland,905,hunter,marksmanship,62,26,36
Шумогон,gordunni,903,hunter,marksmanship,66,18,48
Гекагека,gordunni,902,hunter,marksmanship,36,15,21
Agnõr,chants-éternels,897,hunter,marksmanship,41,21,20
Storphunt,drakthul,897,hunter,marksmanship,23,10,13
Bloópy,silvermoon,895,hunter,marksmanship,22,10,12
Thieuu,twisting-nether,894,hunter,marksmanship,17,10,7
Umani,lightnings-blade,894,hunter,marksmanship,23,10,13
Ранбоу,howling-fjord,893,hunter,marksmanship,121,57,64
Kælan,grim-batol,893,hunter,marksmanship,35,10,25
Rivery,azjolnerub,892,hunter,marksmanship,48,24,24
Deadyeyez,doomhammer,892,hunter,marksmanship,27,12,15
Pulica,the-maelstrom,891,hunter,marksmanship,30,14,16
Burondeya,twisting-nether,888,hunter,marksmanship,36,16,20
Chapiru,burning-legion,888,hunter,marksmanship,36,13,23
Belkane,elune,883,hunter,marksmanship,24,10,14
Kenshinhu,turalyon,879,hunter,marksmanship,59,27,32
Wicmex,les-sentinelles,879,hunter,marksmanship,25,10,15
Grinfall,archimonde,879,hunter,marksmanship,77,26,51
Erdna,khaz-modan,877,hunter,marksmanship,66,33,33
Gyldain,argent-dawn,874,hunter,marksmanship,137,54,83
Ходилипадал,borean-tundra,870,hunter,marksmanship,30,13,17
Aliyah,blackmoore,867,hunter,marksmanship,66,33,33
Robinho,cthun,867,hunter,marksmanship,24,12,12
Blattfeder,blackmoore,867,hunter,marksmanship,42,16,26
Саэсантессис,howling-fjord,866,hunter,marksmanship,22,10,12
Prodoomer,twisting-nether,865,hunter,marksmanship,75,34,41
Slo,sylvanas,864,hunter,marksmanship,12,9,3
Denkstah,tarren-mill,864,hunter,marksmanship,18,9,9
Trapgoddxx,archimonde,864,hunter,marksmanship,18,9,9
Mòzetonq,ravencrest,864,hunter,marksmanship,18,9,9
Колякилшот,gordunni,864,hunter,marksmanship,18,9,9
Adefthunt,kazzak,864,hunter,marksmanship,18,9,9
Liquidhunter,quelthalas,864,hunter,marksmanship,18,9,9
Auxsan,outland,864,hunter,marksmanship,21,10,11
Ðayla,nethersturm,864,hunter,marksmanship,24,9,15
Doghxnter,ravencrest,864,hunter,marksmanship,24,9,15
Dariusmm,silvermoon,863,hunter,marksmanship,12,9,3
Фожа,howling-fjord,863,hunter,marksmanship,12,9,3
Xygotn,sylvanas,863,hunter,marksmanship,18,9,9
Flowless,sunstrider,863,hunter,marksmanship,18,9,9
Thugzilla,auchindoun,863,hunter,marksmanship,18,9,9
Elfyhunter,outland,863,hunter,marksmanship,18,9,9
Bärlibupi,tarren-mill,863,hunter,marksmanship,18,9,9
Badytriel,wildhammer,863,hunter,marksmanship,127,62,65
Xurrl,kazzak,863,hunter,marksmanship,24,9,15
Gaudio,outland,863,hunter,marksmanship,24,9,15
Jagarbladet,ravencrest,863,hunter,marksmanship,24,9,15
Wàterloo,marécage-de-zangar,863,hunter,marksmanship,24,9,15
Bloodshot,nethersturm,863,hunter,marksmanship,30,11,19
Какжеплевать,gordunni,862,hunter,marksmanship,12,9,3
Vulfpeck,sylvanas,862,hunter,marksmanship,12,9,3
Retropunk,ravencrest,862,hunter,marksmanship,18,9,9
Thazur,blackmoore,862,hunter,marksmanship,18,9,9
Obii,stormscale,862,hunter,marksmanship,18,9,9
Grolmgar,malganis,862,hunter,marksmanship,18,9,9
Chloros,ysondre,862,hunter,marksmanship,18,9,9
Serpos,cthun,862,hunter,marksmanship,24,9,15
Нэйе,deepholm,862,hunter,marksmanship,64,13,51
Lancer,aggra-português,861,hunter,marksmanship,18,9,9
Bosseleon,blackrock,861,hunter,marksmanship,18,9,9
Tàrzàn,nemesis,861,hunter,marksmanship,18,9,9
Djbombastic,archimonde,861,hunter,marksmanship,24,9,15
Svèntratore,nemesis,861,hunter,marksmanship,24,9,15
Hakamael,kirin-tor,861,hunter,marksmanship,24,9,15
Qpse,silvermoon,861,hunter,marksmanship,24,9,15
Theuzikat,ragnaros,861,hunter,marksmanship,24,9,15
Vandathien,stormrage,861,hunter,marksmanship,24,9,15
Screewu,twisting-nether,861,hunter,marksmanship,27,9,18
Ggproiettili,pozzo-delleternità,860,hunter,marksmanship,24,9,15
Jalcer,draenor,860,hunter,marksmanship,30,9,21
Simphony,sylvanas,859,hunter,marksmanship,18,9,9
Enistee,silvermoon,859,hunter,marksmanship,19,9,10
Marleyson,uldum,858,hunter,marksmanship,13,9,4
Arrown,outland,858,hunter,marksmanship,46,20,26
Avâlos,dentarg,858,hunter,marksmanship,24,9,15
Krippie,dun-modr,857,hunter,marksmanship,42,19,23
Frilance,dun-modr,857,hunter,marksmanship,24,9,15
Lilbaw,the-maelstrom,856,hunter,marksmanship,18,9,9
Prougefate,darksorrow,855,hunter,marksmanship,18,9,9
Qmbonboni,ravencrest,855,hunter,marksmanship,24,9,15
Helioshin,pozzo-delleternità,855,hunter,marksmanship,30,9,21
Nöbody,khaz-modan,854,hunter,marksmanship,18,9,9
Maô,archimonde,854,hunter,marksmanship,72,29,43
Душакотлетки,eversong,854,hunter,marksmanship,30,9,21
Aliriana,doomhammer,853,hunter,marksmanship,18,9,9
Baldazr,shadowsong,853,hunter,marksmanship,24,9,15
Targetor,the-maelstrom,852,hunter,marksmanship,19,9,10
Sasi,burning-legion,851,hunter,marksmanship,36,18,18
Eppinefrin,silvermoon,851,hunter,marksmanship,65,32,33
Oneofus,malygos,851,hunter,marksmanship,24,9,15
Talanar,tarren-mill,850,hunter,marksmanship,18,9,9
Dreemshoot,stormscale,850,hunter,marksmanship,18,9,9
Gohsthunter,dun-morogh,850,hunter,marksmanship,54,25,29
Фридор,deathguard,850,hunter,marksmanship,24,10,14
Hunterhouse,draenor,847,hunter,marksmanship,29,9,20
Èrá,blackmoore,844,hunter,marksmanship,23,9,14
Xborn,draenor,843,hunter,marksmanship,24,9,15
Jondone,silvermoon,842,hunter,marksmanship,42,9,33
Nogneteen,chamber-of-aspects,840,hunter,marksmanship,29,11,18
Crní,tarren-mill,838,hunter,marksmanship,129,55,74
Borac,magtheridon,837,hunter,marksmanship,60,19,41
Penelopé,darkmoon-faire,836,hunter,marksmanship,30,9,21
Luckyshooter,nethersturm,832,hunter,marksmanship,131,63,68
Zicko,argent-dawn,832,hunter,marksmanship,113,49,64
Lilsnuss,outland,831,hunter,marksmanship,17,9,8
Куфа,blackscar,831,hunter,marksmanship,20,10,10
Lokarg,ragnaros,829,hunter,marksmanship,17,9,8
Digsholes,ravencrest,828,hunter,marksmanship,17,9,8
Annihllation,twilights-hammer,826,hunter,marksmanship,18,9,9
Gramakgora,kazzak,826,hunter,marksmanship,18,9,9
Eldrilaon,arthas,823,hunter,marksmanship,45,20,25
Chicagoto,sylvanas,822,hunter,marksmanship,74,24,50
Calea,zirkel-des-cenarius,820,hunter,marksmanship,36,15,21
Aous,burning-legion,820,hunter,marksmanship,54,19,35
Rollei,uldum,816,hunter,marksmanship,18,9,9
Pibealistrea,argent-dawn,815,hunter,marksmanship,15,9,6
Banàna,draenor,815,hunter,marksmanship,23,9,14
Lilsnipè,outland,815,hunter,marksmanship,23,9,14
Kartouche,culte-de-la-rive-noire,811,hunter,marksmanship,133,65,68
Rockymarciaa,dalaran,808,hunter,marksmanship,27,9,18
Фаффурион,gordunni,807,hunter,marksmanship,25,11,14
Honrø,hyjal,806,hunter,marksmanship,78,31,47
Ímpulsion,stormscale,799,hunter,marksmanship,20,9,11
Steelballs,turalyon,792,hunter,marksmanship,15,10,5
Agarez,blackrock,790,hunter,marksmanship,75,35,40
Greel,saurfang,787,hunter,marksmanship,98,42,56
Neiloh,defias-brotherhood,782,hunter,marksmanship,13,9,4
Ntw,aggra-português,782,hunter,marksmanship,16,9,7
Lumidii,burning-legion,774,hunter,marksmanship,30,11,19
Dontspeakeng,ravencrest,772,hunter,marksmanship,84,29,55
Rockét,malorne,770,hunter,marksmanship,30,9,21
Tenkai,cthun,769,hunter,marksmanship,71,31,40
Ormsliskaren,shattered-hand,768,hunter,marksmanship,12,8,4
Luzivar,malganis,768,hunter,marksmanship,12,8,4
Celesticx,chamber-of-aspects,768,hunter,marksmanship,18,8,10
Palav,outland,768,hunter,marksmanship,18,8,10
Küredent,archimonde,768,hunter,marksmanship,18,8,10
Wolfud,pozzo-delleternità,768,hunter,marksmanship,18,8,10
Dtq,silvermoon,768,hunter,marksmanship,18,8,10
Carre,twilights-hammer,768,hunter,marksmanship,18,8,10
Cabuløsø,aggra-português,768,hunter,marksmanship,18,8,10
Myriadx,sylvanas,768,hunter,marksmanship,18,8,10
Vííiíiíiiíí,stormscale,768,hunter,marksmanship,24,8,16
Deviaz,blackrock,768,hunter,marksmanship,24,8,16
Clánkér,madmortem,767,hunter,marksmanship,12,8,4
Mareyn,argent-dawn,767,hunter,marksmanship,12,8,4
Nétharian,tarren-mill,767,hunter,marksmanship,12,8,4
Ðarrk,tarren-mill,767,hunter,marksmanship,12,8,4
Аматорика,howling-fjord,767,hunter,marksmanship,12,8,4
Sylverain,silvermoon,767,hunter,marksmanship,12,8,4
Иттириса,gordunni,767,hunter,marksmanship,18,8,10
Krooghan,outland,767,hunter,marksmanship,18,8,10
Balarium,twisting-nether,767,hunter,marksmanship,18,8,10
Lathisa,zenedar,767,hunter,marksmanship,18,8,10
Ëcheniquë,sanguino,767,hunter,marksmanship,18,8,10
Halfogre,draenor,767,hunter,marksmanship,18,8,10
Lourse,ysondre,767,hunter,marksmanship,18,8,10
Bicepflex,ragnaros,767,hunter,marksmanship,18,8,10
Рэкрэйван,gordunni,767,hunter,marksmanship,18,8,10
Progh,ragnaros,767,hunter,marksmanship,18,8,10
Jettraichu,aggra-português,767,hunter,marksmanship,18,8,10
Galeán,kazzak,767,hunter,marksmanship,18,8,10
Raegal,sanguino,767,hunter,marksmanship,18,8,10
Shockzzyyh,ravencrest,767,hunter,marksmanship,24,8,16
Sepzi,ravencrest,767,hunter,marksmanship,24,8,16
Иоссифсталин,soulflayer,767,hunter,marksmanship,24,8,16
Vitacti,archimonde,766,hunter,marksmanship,12,8,4
Kelnax,draenor,766,hunter,marksmanship,12,8,4
Nelftard,agamaggan,766,hunter,marksmanship,12,8,4
Aenina,kazzak,766,hunter,marksmanship,18,8,10
Макнерис,gordunni,766,hunter,marksmanship,18,8,10
Splishy,ravencrest,766,hunter,marksmanship,18,8,10
Nyxor,kazzak,766,hunter,marksmanship,18,8,10
Sohunter,twisting-nether,766,hunter,marksmanship,22,8,14
Ластшотик,gordunni,766,hunter,marksmanship,24,8,16
Warpo,ysondre,766,hunter,marksmanship,24,8,16
Мафчик,razuvious,766,hunter,marksmanship,24,8,16
Shoót,blackmoore,766,hunter,marksmanship,24,8,16
Slimeshít,blackrock,766,hunter,marksmanship,29,8,21
Backshot,ravencrest,765,hunter,marksmanship,12,8,4
Mimiop,hyjal,765,hunter,marksmanship,114,52,62
Spiidi,chromaggus,765,hunter,marksmanship,18,8,10
Galadris,kirin-tor,765,hunter,marksmanship,24,8,16
Ixôn,tarren-mill,765,hunter,marksmanship,24,8,16
Chapovito,twisting-nether,765,hunter,marksmanship,24,8,16
Guerrilla,stormscale,765,hunter,marksmanship,24,8,16
Razzét,stormscale,764,hunter,marksmanship,18,8,10
Oneeyedjoe,the-maelstrom,764,hunter,marksmanship,18,8,10
Jonsy,blackrock,764,hunter,marksmanship,18,8,10
Aourön,archimonde,764,hunter,marksmanship,18,8,10
Аалка,gordunni,764,hunter,marksmanship,24,8,16
Beryllium,pozzo-delleternità,764,hunter,marksmanship,24,8,16
Тайэре,blackscar,763,hunter,marksmanship,12,8,4
Tock,terenas,763,hunter,marksmanship,12,8,4
Пирс,eversong,763,hunter,marksmanship,18,8,10
Лордорион,gordunni,762,hunter,marksmanship,59,25,34
Galintzor,area-52,761,hunter,marksmanship,18,8,10
Secrety,doomhammer,761,hunter,marksmanship,23,8,15
Lynx,chogall,759,hunter,marksmanship,18,8,10
Wetto,ravencrest,759,hunter,marksmanship,18,8,10
Biggie,azshara,759,hunter,marksmanship,24,8,16
Legath,emerald-dream,758,hunter,marksmanship,22,11,11
Usøøp,dalaran,757,hunter,marksmanship,24,8,16
Turkos,krasus,756,hunter,marksmanship,12,8,4
Zaragattas,aggra-português,755,hunter,marksmanship,33,12,21
Kveyther,silvermoon,754,hunter,marksmanship,18,8,10
Kichassequi,khaz-modan,750,hunter,marksmanship,29,10,19
Kratozs,outland,750,hunter,marksmanship,25,8,17
Hellriderr,silvermoon,748,hunter,marksmanship,81,33,48
Спелла,goldrinn,748,hunter,marksmanship,29,8,21
Erestor,hellfire,747,hunter,marksmanship,12,8,4
Ønur,twisting-nether,747,hunter,marksmanship,18,8,10
Karmios,drakthul,747,hunter,marksmanship,24,9,15
Sixty,rajaxx,740,hunter,marksmanship,24,8,16
Aadarshh,turalyon,739,hunter,marksmanship,66,28,38
Sodomaizer,turalyon,739,hunter,marksmanship,30,8,22
Leonhart,sanguino,735,hunter,marksmanship,22,8,14
Ahek,defias-brotherhood,732,hunter,marksmanship,17,8,9
Leontus,stormscale,731,hunter,marksmanship,16,8,8
Mirselle,drakthul,725,hunter,marksmanship,32,11,21
Deathøfrats,ravencrest,719,hunter,marksmanship,11,8,3
Athará,aegwynn,719,hunter,marksmanship,11,8,3
Gen,twisting-nether,719,hunter,marksmanship,17,8,9
Deahtviper,blackmoore,717,hunter,marksmanship,21,9,12
Juicewrld,xavius,717,hunter,marksmanship,23,8,15
Ryhope,silvermoon,714,hunter,marksmanship,11,8,3
Selvele,hyjal,712,hunter,marksmanship,27,9,18
Banninymph,culte-de-la-rive-noire,711,hunter,marksmanship,117,47,70
Загзигзаг,soulflayer,710,hunter,marksmanship,21,9,12
Jägarenen,kazzak,707,hunter,marksmanship,22,11,11
Grafhunter,antonidas,707,hunter,marksmanship,177,83,94
Multishot,dalaran,706,hunter,marksmanship,126,35,91
Sauer,stormreaver,704,hunter,marksmanship,24,8,16
Supertdk,quelthalas,703,hunter,marksmanship,20,8,12
Grantafla,silvermoon,692,hunter,marksmanship,44,8,36
Tuskah,stormreaver,687,hunter,marksmanship,19,8,11
Rockshredder,ravencrest,672,hunter,marksmanship,12,7,5
Killershadow,twisting-nether,672,hunter,marksmanship,12,7,5
Bigbowyahurd,draenor,672,hunter,marksmanship,12,7,5
Veñom,stormscale,672,hunter,marksmanship,12,7,5
Huntingash,twisting-nether,672,hunter,marksmanship,12,7,5
Fluttershy,terokkar,672,hunter,marksmanship,12,7,5
Vracarx,silvermoon,672,hunter,marksmanship,12,7,5
Хвоостт,gordunni,672,hunter,marksmanship,12,7,5
Brubeck,terokkar,672,hunter,marksmanship,12,7,5
Vrikenh,tarren-mill,672,hunter,marksmanship,12,7,5
Merquryh,ravencrest,672,hunter,marksmanship,12,7,5
Bawzé,archimonde,672,hunter,marksmanship,12,7,5
Аабстрактная,gordunni,672,hunter,marksmanship,12,7,5
Kygoshi,argent-dawn,672,hunter,marksmanship,12,7,5
Yoey,tarren-mill,672,hunter,marksmanship,12,7,5
Zynga,sylvanas,672,hunter,marksmanship,12,7,5
Kathriana,kazzak,672,hunter,marksmanship,12,7,5
Джэймсхант,gordunni,672,hunter,marksmanship,12,7,5
Alfacera,steamwheedle-cartel,672,hunter,marksmanship,12,7,5
Avaren,archimonde,672,hunter,marksmanship,12,7,5
Meeturmakerr,ravencrest,672,hunter,marksmanship,12,7,5
Píkant,silvermoon,672,hunter,marksmanship,12,7,5
Monnee,outland,672,hunter,marksmanship,12,7,5
Elonmask,argent-dawn,672,hunter,marksmanship,18,7,11
Джарвиз,soulflayer,672,hunter,marksmanship,18,7,11
Eveo,antonidas,672,hunter,marksmanship,18,7,11
Делишез,fordragon,672,hunter,marksmanship,18,7,11
Farkrin,silvermoon,672,hunter,marksmanship,18,7,11
Дарцетос,greymane,672,hunter,marksmanship,18,7,11
Sweetpox,twisting-nether,672,hunter,marksmanship,18,7,11
Bnji,hyjal,672,hunter,marksmanship,18,7,11
Powerofanime,drakthul,672,hunter,marksmanship,18,7,11
Землепух,howling-fjord,672,hunter,marksmanship,18,7,11
Hugø,twisting-nether,672,hunter,marksmanship,24,7,17
Онкьяр,gordunni,672,hunter,marksmanship,24,7,17
Piksî,kazzak,672,hunter,marksmanship,24,7,17
Mewithoutyou,ragnaros,672,hunter,marksmanship,24,7,17
Антагонистка,soulflayer,672,hunter,marksmanship,24,7,17
Moroezxoxo,ravencrest,672,hunter,marksmanship,24,7,17
Хантероо,gordunni,671,hunter,marksmanship,12,7,5
Санясурв,gordunni,671,hunter,marksmanship,12,7,5
Недоношенная,howling-fjord,671,hunter,marksmanship,12,7,5
Omnomnom,die-arguswacht,671,hunter,marksmanship,12,7,5
Maknamara,tarren-mill,671,hunter,marksmanship,12,7,5
Snaptrap,eredar,671,hunter,marksmanship,18,7,11
Hashaya,hyjal,671,hunter,marksmanship,18,7,11
Cartmaanbrah,sylvanas,671,hunter,marksmanship,18,7,11
Ashrak,frostmourne,671,hunter,marksmanship,18,7,11
Lovica,draenor,671,hunter,marksmanship,18,7,11
Exthaza,drakthul,671,hunter,marksmanship,18,7,11
Smiren,ragnaros,671,hunter,marksmanship,18,7,11
Thengill,draenor,671,hunter,marksmanship,18,7,11
Hawkeyé,forscherliga,671,hunter,marksmanship,18,7,11
Famex,blackmoore,671,hunter,marksmanship,18,7,11
Carrilynn,blackrock,671,hunter,marksmanship,18,7,11
Lorthymar,ravenholdt,671,hunter,marksmanship,18,7,11
Bobshmurda,defias-brotherhood,671,hunter,marksmanship,18,7,11
Gemjae,onyxia,671,hunter,marksmanship,18,7,11
Sjufemman,ravencrest,671,hunter,marksmanship,24,7,17
Opamortis,karazhan,671,hunter,marksmanship,24,7,17
Pôts,blackrock,671,hunter,marksmanship,24,7,17
Ooneshott,outland,671,hunter,marksmanship,24,7,17
Fenomhunt,silvermoon,671,hunter,marksmanship,24,7,17
Ceres,kaelthas,671,hunter,marksmanship,24,7,17
Jéllytots,ravencrest,670,hunter,marksmanship,12,7,5
Cheesychees,sylvanas,670,hunter,marksmanship,12,7,5
Pewpewshotz,stormscale,670,hunter,marksmanship,12,7,5
Suburra,stormscale,670,hunter,marksmanship,18,7,11
Yip,twisting-nether,670,hunter,marksmanship,18,7,11
Anthélià,antonidas,670,hunter,marksmanship,18,7,11
Okumo,the-maelstrom,670,hunter,marksmanship,18,7,11
Spêctrâ,sylvanas,670,hunter,marksmanship,18,7,11
Birdbow,sylvanas,670,hunter,marksmanship,18,7,11
Querro,azshara,670,hunter,marksmanship,24,7,17
Zhorks,sanguino,669,hunter,marksmanship,12,7,5
Huntbegin,burning-legion,669,hunter,marksmanship,12,7,5
Kaudza,archimonde,669,hunter,marksmanship,18,7,11
Aggyaceshot,silvermoon,669,hunter,marksmanship,18,7,11
Naregar,draenor,669,hunter,marksmanship,24,7,17
Marudô,aegwynn,669,hunter,marksmanship,24,7,17
Wishmeweed,kazzak,668,hunter,marksmanship,18,7,11
Lunalai,antonidas,668,hunter,marksmanship,18,7,11
Starfinder,saurfang,668,hunter,marksmanship,24,7,17
Gaili,ravenholdt,667,hunter,marksmanship,24,7,17
Nevarline,twisting-nether,665,hunter,marksmanship,12,7,5
Aleshanee,anetheron,664,hunter,marksmanship,18,7,11
Vjell,blackhand,663,hunter,marksmanship,18,7,11
Halfstone,frostmane,663,hunter,marksmanship,30,7,23
Schaaxx,archimonde,662,hunter,marksmanship,18,7,11
Kalzifahr,ysera,662,hunter,marksmanship,18,7,11
Eilaa,ravencrest,662,hunter,marksmanship,18,7,11
Traveler,earthen-ring,662,hunter,marksmanship,30,11,19
Fernetcola,los-errantes,661,hunter,marksmanship,12,7,5
Крошкамэг,eversong,661,hunter,marksmanship,19,8,11
Arkman,malganis,660,hunter,marksmanship,30,7,23
Shokre,silvermoon,657,hunter,marksmanship,12,7,5
Miisakaa,antonidas,656,hunter,marksmanship,18,7,11
Есселин,thermaplugg,650,hunter,marksmanship,18,7,11
Cernunnos,auchindoun,639,hunter,marksmanship,11,7,4
Ницшеподлсд,eversong,639,hunter,marksmanship,14,8,6
Fylealaes,ravencrest,639,hunter,marksmanship,17,7,10
Elchivo,sanguino,637,hunter,marksmanship,28,7,21
Пушкабомби,soulflayer,636,hunter,marksmanship,27,9,18
Venatrixx,azjolnerub,626,hunter,marksmanship,13,7,6
Zwerglogan,amanthul,625,hunter,marksmanship,29,7,22
Элфй,gordunni,623,hunter,marksmanship,21,7,14
Kyliun,frostmane,620,hunter,marksmanship,17,7,10
Issue,hyjal,619,hunter,marksmanship,24,7,17
Merrengoj,frostmourne,618,hunter,marksmanship,20,8,12
Legöläs,tarren-mill,617,hunter,marksmanship,17,7,10
Trachunt,twisting-nether,607,hunter,marksmanship,11,7,4
Wîldhunt,burning-legion,607,hunter,marksmanship,25,7,18
Koltyn,culte-de-la-rive-noire,601,hunter,marksmanship,42,8,34
Connyrövöga,draenor,576,hunter,marksmanship,6,6,0
Monsterwhite,stormreaver,576,hunter,marksmanship,6,6,0
Galilia,jaedenar,576,hunter,marksmanship,9,7,2
Westcøãst,archimonde,576,hunter,marksmanship,12,6,6
Dugini,ravencrest,576,hunter,marksmanship,12,6,6
Инкризшот,gordunni,576,hunter,marksmanship,12,6,6
Scrubbi,destromath,576,hunter,marksmanship,12,6,6
Hunlin,kazzak,576,hunter,marksmanship,12,6,6
Madjia,ravencrest,576,hunter,marksmanship,12,6,6
Blazinghunt,kazzak,576,hunter,marksmanship,12,6,6
Артуша,booty-bay,576,hunter,marksmanship,12,6,6
Pantero,kazzak,576,hunter,marksmanship,12,6,6
Vorsia,tarren-mill,576,hunter,marksmanship,12,6,6
Respêct,blackhand,576,hunter,marksmanship,12,6,6
Sqedihunter,silvermoon,576,hunter,marksmanship,12,6,6
Síden,sylvanas,576,hunter,marksmanship,12,6,6
Abaforth,bronze-dragonflight,576,hunter,marksmanship,12,6,6
Grandiosity,tarren-mill,576,hunter,marksmanship,12,6,6
Sketana,silvermoon,576,hunter,marksmanship,12,6,6
Borbotir,silvermoon,576,hunter,marksmanship,12,6,6
Гунныч,grom,576,hunter,marksmanship,12,6,6
Кимчик,borean-tundra,576,hunter,marksmanship,12,6,6
Rakeesh,hyjal,576,hunter,marksmanship,12,6,6
Daemonhunt,tarren-mill,576,hunter,marksmanship,12,6,6
Oogie,laughing-skull,576,hunter,marksmanship,12,6,6
Shína,argent-dawn,576,hunter,marksmanship,12,6,6
Самоанец,gordunni,576,hunter,marksmanship,12,6,6
Destynarîa,illidan,576,hunter,marksmanship,12,6,6
Greg,defias-brotherhood,576,hunter,marksmanship,12,6,6
Kasperhawser,silvermoon,576,hunter,marksmanship,12,6,6
Stamzer,drakthul,576,hunter,marksmanship,12,6,6
Boen,nordrassil,576,hunter,marksmanship,14,6,8
Antisniper,kazzak,576,hunter,marksmanship,17,6,11
Tomli,nemesis,576,hunter,marksmanship,18,6,12
Sayn,la-croisade-écarlate,576,hunter,marksmanship,18,6,12
Sokrám,sanguino,576,hunter,marksmanship,18,6,12
Deepcleaning,kazzak,576,hunter,marksmanship,18,6,12
Bloodymarìe,kelthuzad,576,hunter,marksmanship,18,6,12
Такувами,gordunni,576,hunter,marksmanship,18,6,12
Oobe,hyjal,576,hunter,marksmanship,18,6,12
Jinxpeasant,twisting-nether,576,hunter,marksmanship,18,6,12
Instinctx,agamaggan,576,hunter,marksmanship,18,6,12
Pläpp,stormscale,576,hunter,marksmanship,18,6,12
Юките,soulflayer,576,hunter,marksmanship,18,6,12
Bréanni,auchindoun,576,hunter,marksmanship,18,6,12
Bigramy,sanguino,576,hunter,marksmanship,18,6,12
Somethíngmad,stormscale,576,hunter,marksmanship,24,6,18
Кэрнел,gordunni,576,hunter,marksmanship,24,6,18
Тохадиско,gordunni,575,hunter,marksmanship,6,6,0
Twinkhunter,pozzo-delleternità,575,hunter,marksmanship,12,6,6
Domsín,ravencrest,575,hunter,marksmanship,12,6,6
Rohald,silvermoon,575,hunter,marksmanship,12,6,6
Squidy,archimonde,575,hunter,marksmanship,12,6,6
Tolkienn,archimonde,575,hunter,marksmanship,12,6,6
Xeragon,frostwolf,575,hunter,marksmanship,12,6,6
Manatodamoon,aerie-peak,575,hunter,marksmanship,12,6,6
Ina,tarren-mill,575,hunter,marksmanship,12,6,6
Stralthir,argent-dawn,575,hunter,marksmanship,12,6,6
Maeba,shendralar,575,hunter,marksmanship,12,6,6
Dirtydolores,thrall,575,hunter,marksmanship,12,6,6
Earlyspring,ragnaros,575,hunter,marksmanship,12,6,6
Mattiz,ragnaros,575,hunter,marksmanship,12,6,6
Donpromìlló,blackhand,575,hunter,marksmanship,15,7,8
Elvenian,twisting-nether,575,hunter,marksmanship,18,6,12
Gxx,burning-blade,575,hunter,marksmanship,18,6,12
Harckel,elune,575,hunter,marksmanship,18,6,12
Patuk,exodar,575,hunter,marksmanship,18,6,12
Dritzdòurden,dun-modr,575,hunter,marksmanship,18,6,12
Bourrinax,kazzak,575,hunter,marksmanship,18,6,12
Ozaï,eredar,575,hunter,marksmanship,18,6,12
Bawwykwipkee,ragnaros,575,hunter,marksmanship,18,6,12
Маланориэль,howling-fjord,575,hunter,marksmanship,18,6,12
Maexo,anetheron,575,hunter,marksmanship,18,6,12
Spineshot,thrall,575,hunter,marksmanship,24,6,18
Artdragon,burning-legion,575,hunter,marksmanship,24,6,18
Longshot,burning-legion,574,hunter,marksmanship,12,6,6
Egy,the-maelstrom,574,hunter,marksmanship,12,6,6
Djurslavaren,draenor,574,hunter,marksmanship,18,6,12
Hagall,chamber-of-aspects,574,hunter,marksmanship,30,6,24
Dannydynx,burning-legion,573,hunter,marksmanship,24,6,18
Анариэлль,gordunni,572,hunter,marksmanship,12,6,6
Hitscan,ravencrest,572,hunter,marksmanship,12,6,6
Ninjaskillss,ravencrest,572,hunter,marksmanship,18,6,12
Orcgun,mugthol,572,hunter,marksmanship,18,6,12
Koreic,silvermoon,572,hunter,marksmanship,24,6,18
Cronox,sporeggar,571,hunter,marksmanship,12,6,6
Ginterjudo,burning-legion,571,hunter,marksmanship,12,6,6
Gamwhunter,twisting-nether,571,hunter,marksmanship,12,6,6
Algar,tarren-mill,570,hunter,marksmanship,12,6,6
Dødshøt,twisting-nether,569,hunter,marksmanship,18,6,12
Deadlymayhem,dragonblight,568,hunter,marksmanship,18,6,12
Denixxia,bronzebeard,567,hunter,marksmanship,15,7,8
Jilkhar,twisting-nether,565,hunter,marksmanship,12,6,6
Норапина,eversong,565,hunter,marksmanship,15,7,8
Mooj,malganis,559,hunter,marksmanship,11,6,5
Kaldine,argent-dawn,543,hunter,marksmanship,28,6,22
Gilgämesh,hyjal,522,hunter,marksmanship,16,7,9
Trøllmagedøn,ysondre,521,hunter,marksmanship,28,7,21
Senelor,dalaran,514,hunter,marksmanship,27,7,20
Novifløw,archimonde,512,hunter,marksmanship,10,6,4
Gamosh,anetheron,511,hunter,marksmanship,14,6,8
Emriye,antonidas,510,hunter,marksmanship,14,6,8
Фэйсконтроль,azuregos,506,hunter,marksmanship,20,6,14
Graniz,archimonde,480,hunter,marksmanship,6,5,1
Ggjohnny,kazzak,480,hunter,marksmanship,6,5,1
Hvaskøduenme,stormscale,480,hunter,marksmanship,6,5,1
Akkixz,antonidas,480,hunter,marksmanship,6,5,1
Mecamoot,drekthar,480,hunter,marksmanship,6,5,1
Сальверди,gordunni,480,hunter,marksmanship,6,5,1
Хорпяр,soulflayer,480,hunter,marksmanship,6,5,1
Bredpew,kazzak,480,hunter,marksmanship,6,5,1
Wolder,burning-legion,480,hunter,marksmanship,6,5,1
Torgnolgamin,archimonde,480,hunter,marksmanship,6,5,1
Slagatronic,ragnaros,480,hunter,marksmanship,6,5,1
Soloist,sylvanas,480,hunter,marksmanship,6,5,1
Wayshax,dun-modr,480,hunter,marksmanship,6,5,1
Hawkinstinct,tarren-mill,480,hunter,marksmanship,6,5,1
Sulom,tarren-mill,480,hunter,marksmanship,6,5,1
Toptìérgoðx,drakthul,480,hunter,marksmanship,6,5,1
Trapzila,aggra-português,480,hunter,marksmanship,6,5,1
Lambtron,tarren-mill,480,hunter,marksmanship,12,5,7
Peremptør,alleria,480,hunter,marksmanship,12,5,7
Thúnar,aegwynn,480,hunter,marksmanship,12,5,7
Givz,outland,480,hunter,marksmanship,12,5,7
Lamîndra,blackmoore,480,hunter,marksmanship,12,5,7
Msir,kazzak,480,hunter,marksmanship,12,5,7
Hordasso,burning-legion,480,hunter,marksmanship,12,5,7
Kirenox,quelthalas,480,hunter,marksmanship,12,5,7
Denaik,ravencrest,480,hunter,marksmanship,12,5,7
Sashobg,aerie-peak,480,hunter,marksmanship,12,5,7
Бэталол,gordunni,480,hunter,marksmanship,12,5,7
Ghøst,madmortem,480,hunter,marksmanship,12,5,7
Galou,ghostlands,480,hunter,marksmanship,12,5,7
Olsenas,silvermoon,480,hunter,marksmanship,12,5,7
Ðæom,outland,480,hunter,marksmanship,12,5,7
Adhdbad,tarren-mill,480,hunter,marksmanship,12,5,7
Agbaba,twisting-nether,480,hunter,marksmanship,12,5,7
Уайлен,gordunni,480,hunter,marksmanship,12,5,7
Níghtshot,twisting-nether,480,hunter,marksmanship,12,5,7
Yoggys,outland,480,hunter,marksmanship,12,5,7
Tyranduil,vashj,480,hunter,marksmanship,12,5,7
Mercoman,bronze-dragonflight,480,hunter,marksmanship,12,5,7
Rykini,twisting-nether,480,hunter,marksmanship,12,5,7
Kikilirilivi,ysondre,480,hunter,marksmanship,12,5,7
Sloee,sylvanas,480,hunter,marksmanship,12,5,7
Setadomijo,tarren-mill,480,hunter,marksmanship,12,5,7
Carkaroth,uldum,480,hunter,marksmanship,12,5,7
Mazhug,stormreaver,480,hunter,marksmanship,12,5,7
Sodavand,silvermoon,480,hunter,marksmanship,12,5,7
Djøgi,archimonde,480,hunter,marksmanship,12,5,7
Deathmarks,blackrock,480,hunter,marksmanship,12,5,7
Zerrash,ravencrest,480,hunter,marksmanship,12,5,7
Geete,kazzak,480,hunter,marksmanship,12,5,7
Sissnik,thrall,480,hunter,marksmanship,12,5,7
Хароко,gordunni,480,hunter,marksmanship,12,5,7
Nothrokh,auchindoun,480,hunter,marksmanship,12,5,7
Larrek,aegwynn,480,hunter,marksmanship,12,5,7
Huntardös,outland,480,hunter,marksmanship,12,5,7
Yerî,die-aldor,480,hunter,marksmanship,12,5,7
Хипдо,soulflayer,480,hunter,marksmanship,12,5,7
Stimpak,nordrassil,480,hunter,marksmanship,12,5,7
Gakco,twisting-nether,480,hunter,marksmanship,12,5,7
Semda,blackmoore,480,hunter,marksmanship,12,5,7
Mahuntah,drakthul,480,hunter,marksmanship,12,5,7
Яроняютрапу,gordunni,480,hunter,marksmanship,12,5,7
Кайсго,gordunni,480,hunter,marksmanship,12,5,7
Bláckheart,doomhammer,480,hunter,marksmanship,12,5,7
Присуньмне,galakrond,480,hunter,marksmanship,12,5,7
Spitchy,kazzak,480,hunter,marksmanship,12,5,7
Meghanmarkle,tarren-mill,480,hunter,marksmanship,13,5,8
Draknik,nemesis,480,hunter,marksmanship,16,6,10
Тэуреэль,gordunni,480,hunter,marksmanship,18,5,13
Deathwallker,silvermoon,480,hunter,marksmanship,18,5,13
Hÿyrøk,ysondre,480,hunter,marksmanship,18,5,13
Topgrill,stormscale,480,hunter,marksmanship,18,5,13
Jakis,silvermoon,480,hunter,marksmanship,18,5,13
Rêxxer,blackmoore,480,hunter,marksmanship,18,5,13
Rogthos,malganis,480,hunter,marksmanship,18,5,13
Tetiscaza,sanguino,480,hunter,marksmanship,24,5,19
Yenkovicz,blackmoore,480,hunter,marksmanship,30,5,25
Arawnork,stormreaver,479,hunter,marksmanship,6,5,1
Asâya,blackmoore,479,hunter,marksmanship,6,5,1
Золларис,deathguard,479,hunter,marksmanship,6,5,1
Pepsimaxzero,silvermoon,479,hunter,marksmanship,6,5,1
Живадер,ashenvale,479,hunter,marksmanship,12,5,7
Hapocalypt,pozzo-delleternità,479,hunter,marksmanship,12,5,7
Toxical,ragnaros,479,hunter,marksmanship,12,5,7
Petroleiro,aggra-português,479,hunter,marksmanship,12,5,7
Grimazg,chogall,479,hunter,marksmanship,12,5,7
Xeqter,ravencrest,479,hunter,marksmanship,12,5,7
Tirador,uldum,479,hunter,marksmanship,12,5,7
Whereismypet,azjolnerub,479,hunter,marksmanship,12,5,7
Typex,defias-brotherhood,479,hunter,marksmanship,12,5,7
Shogos,aggra-português,479,hunter,marksmanship,12,5,7
Zäyk,zuljin,479,hunter,marksmanship,12,5,7
Rasttrim,dun-modr,479,hunter,marksmanship,13,5,8
Wolfmcquade,draenor,479,hunter,marksmanship,13,5,8
Attileus,ragnaros,479,hunter,marksmanship,15,5,10
Гангстита,gordunni,479,hunter,marksmanship,18,5,13
Камсшотт,gordunni,479,hunter,marksmanship,18,5,13
Galedjïn,conseil-des-ombres,479,hunter,marksmanship,18,5,13
Hentt,burning-legion,479,hunter,marksmanship,18,5,13
Gêorge,teldrassil,479,hunter,marksmanship,18,5,13
Smígol,stormreaver,479,hunter,marksmanship,18,5,13
Зиргус,gordunni,479,hunter,marksmanship,18,5,13
Longbeardkh,silvermoon,479,hunter,marksmanship,18,5,13
Nígruløl,arthas,479,hunter,marksmanship,18,5,13
Cazaó,sanguino,479,hunter,marksmanship,18,5,13
Fugerlynipps,stormrage,479,hunter,marksmanship,24,5,19
Nightarrows,ravencrest,478,hunter,marksmanship,6,5,1
Crní,ravencrest,478,hunter,marksmanship,6,5,1
Bæbåk,frostmane,478,hunter,marksmanship,6,5,1
Jager,colinas-pardas,478,hunter,marksmanship,12,5,7
Лукорды,gordunni,478,hunter,marksmanship,12,5,7
Darkshàdow,archimonde,478,hunter,marksmanship,12,5,7
Cybertruck,cthun,478,hunter,marksmanship,12,5,7
Pylos,azshara,477,hunter,marksmanship,12,5,7
Bijuelfe,draenor,477,hunter,marksmanship,12,5,7
Zanrawo,blutkessel,476,hunter,marksmanship,12,5,7
Klittcrit,bloodhoof,475,hunter,marksmanship,12,5,7
Skapig,frostwolf,473,hunter,marksmanship,18,5,13
Thebaddy,auchindoun,473,hunter,marksmanship,18,5,13
Juki,pozzo-delleternità,472,hunter,marksmanship,12,5,7
Buffini,nethersturm,469,hunter,marksmanship,18,5,13
Sylasteria,twisting-nether,467,hunter,marksmanship,27,8,19
Brønkø,azshara,463,hunter,marksmanship,17,5,12
Rdevill,outland,448,hunter,marksmanship,16,5,11
Шэнчи,greymane,447,hunter,marksmanship,11,6,5
Littlenugget,ravencrest,447,hunter,marksmanship,11,5,6
Haleth,uldum,447,hunter,marksmanship,17,5,12
Rea,archimonde,442,hunter,marksmanship,22,5,17
Thedanchodak,stormrage,440,hunter,marksmanship,11,5,6
Grokis,blackhand,437,hunter,marksmanship,17,5,12
Cais,drakthul,426,hunter,marksmanship,18,6,12
Neremyn,sylvanas,426,hunter,marksmanship,21,6,15
Qenninkä,drakthul,425,hunter,marksmanship,13,7,6
Bâng,zuljin,424,hunter,marksmanship,19,6,13
Obata,arathor,423,hunter,marksmanship,15,6,9
Sleepyarrow,chogall,420,hunter,marksmanship,12,6,6
Moky,ulduar,418,hunter,marksmanship,15,6,9
Mylolol,outland,416,hunter,marksmanship,16,5,11
Artaeos,lordaeron,416,hunter,marksmanship,16,5,11
Geruga,thrall,415,hunter,marksmanship,8,5,3
Kowaki,blackmoore,415,hunter,marksmanship,10,5,5
Thðr,elune,415,hunter,marksmanship,17,5,12
Gotha,festung-der-stürme,414,hunter,marksmanship,14,5,9
Hokro,thrall,392,hunter,marksmanship,17,7,10
Junqué,sanguino,384,hunter,marksmanship,6,4,2
Yuichiro,senjin,384,hunter,marksmanship,6,4,2
Стёпкахант,gordunni,384,hunter,marksmanship,6,4,2
Nßatrapper,outland,384,hunter,marksmanship,6,4,2
Сацыви,gordunni,384,hunter,marksmanship,6,4,2
Mercurion,dun-modr,384,hunter,marksmanship,6,4,2
Likandria,blackmoore,384,hunter,marksmanship,6,4,2
Telladril,burning-legion,384,hunter,marksmanship,6,4,2
Skytraped,hyjal,384,hunter,marksmanship,6,4,2
Чэрпак,gordunni,384,hunter,marksmanship,6,4,2
Haranti,dun-modr,384,hunter,marksmanship,6,4,2
Deadhot,dun-morogh,384,hunter,marksmanship,6,4,2
Bøømshøtkill,blackrock,384,hunter,marksmanship,6,4,2
Grøøhx,rashgarroth,384,hunter,marksmanship,6,4,2
Rèxxar,arygos,384,hunter,marksmanship,6,4,2
Kovx,turalyon,384,hunter,marksmanship,6,4,2
Бикмекс,howling-fjord,384,hunter,marksmanship,6,4,2
Unßørn,archimonde,384,hunter,marksmanship,6,4,2
Kukenisluken,stormscale,384,hunter,marksmanship,6,4,2
Vantagepoint,arathor,384,hunter,marksmanship,6,4,2
Comegetme,auchindoun,384,hunter,marksmanship,6,4,2
Vypaz,twisting-nether,384,hunter,marksmanship,6,4,2
Джеймсфранко,blackscar,384,hunter,marksmanship,6,4,2
Beeper,twisting-nether,384,hunter,marksmanship,6,4,2
Benbutton,antonidas,384,hunter,marksmanship,6,4,2
Idtrapthat,nagrand,384,hunter,marksmanship,6,4,2
Spyte,twisting-nether,384,hunter,marksmanship,6,4,2
Kiritõ,frostwolf,384,hunter,marksmanship,6,4,2
Атумен,borean-tundra,384,hunter,marksmanship,6,4,2
Greymountain,twisting-nether,384,hunter,marksmanship,6,4,2
Kanisha,dalaran,384,hunter,marksmanship,6,4,2
Natheldir,silvermoon,384,hunter,marksmanship,6,4,2
Moggbang,ravencrest,384,hunter,marksmanship,6,4,2
Snipinx,draenor,384,hunter,marksmanship,6,4,2
Clydefrog,outland,384,hunter,marksmanship,6,4,2
Sovanz,aggra-português,384,hunter,marksmanship,6,4,2
Rymous,nemesis,384,hunter,marksmanship,6,4,2
Éclipze,outland,384,hunter,marksmanship,6,4,2
Ataxyjr,ravencrest,384,hunter,marksmanship,6,4,2
Mcloppe,ravencrest,384,hunter,marksmanship,6,4,2
Shîaa,draenor,384,hunter,marksmanship,6,4,2
Thain,stormscale,384,hunter,marksmanship,6,4,2
Kragán,silvermoon,384,hunter,marksmanship,6,4,2
Burninghunt,ravencrest,384,hunter,marksmanship,6,4,2
Kayndorlek,ravencrest,384,hunter,marksmanship,6,4,2
Myoui,silvermoon,384,hunter,marksmanship,6,4,2
Hntudwn,azshara,384,hunter,marksmanship,6,4,2
Тумбаюмб,howling-fjord,384,hunter,marksmanship,6,4,2
Darllene,kazzak,384,hunter,marksmanship,6,4,2
Переснежник,howling-fjord,384,hunter,marksmanship,6,4,2
Velen,pozzo-delleternità,384,hunter,marksmanship,6,4,2
Fiercemoon,outland,384,hunter,marksmanship,6,4,2
Томбомбадил,howling-fjord,384,hunter,marksmanship,6,4,2
Zoêva,blackhand,384,hunter,marksmanship,6,4,2
Roke,malganis,384,hunter,marksmanship,6,4,2
Zøzø,stormscale,384,hunter,marksmanship,6,4,2
Леегголасс,fordragon,384,hunter,marksmanship,6,4,2
Pergola,spinebreaker,384,hunter,marksmanship,6,4,2
Niffe,stormscale,384,hunter,marksmanship,6,4,2
Intoxd,sylvanas,384,hunter,marksmanship,6,4,2
Marcs,antonidas,384,hunter,marksmanship,6,4,2
Goreac,cthun,384,hunter,marksmanship,9,5,4
Áv,outland,384,hunter,marksmanship,14,5,9
Hallem,karazhan,384,hunter,marksmanship,12,4,8
Blinkerlinks,antonidas,384,hunter,marksmanship,12,4,8
Aamön,tarren-mill,384,hunter,marksmanship,12,4,8
Keyshu,die-aldor,384,hunter,marksmanship,12,4,8
Slinkywinky,eonar,384,hunter,marksmanship,12,4,8
Stefraton,tarren-mill,384,hunter,marksmanship,12,4,8
Cowmelk,stormscale,384,hunter,marksmanship,12,4,8
Eclipsax,cthun,384,hunter,marksmanship,12,4,8
Deeparrow,stormscale,384,hunter,marksmanship,12,4,8
Ecalter,dun-modr,384,hunter,marksmanship,12,4,8
Vallêria,malganis,384,hunter,marksmanship,12,4,8
Naestra,tarren-mill,384,hunter,marksmanship,12,4,8
Marodan,ambossar,384,hunter,marksmanship,12,4,8
Dorkos,sanguino,384,hunter,marksmanship,12,4,8
Tytoyz,khaz-modan,384,hunter,marksmanship,12,4,8
Calyssae,shattered-halls,384,hunter,marksmanship,12,4,8
Powerslade,sanguino,384,hunter,marksmanship,12,4,8
Hardshots,tarren-mill,384,hunter,marksmanship,12,4,8
Double,sylvanas,384,hunter,marksmanship,12,4,8
Sharún,sylvanas,384,hunter,marksmanship,12,4,8
Melvinn,shattered-hand,384,hunter,marksmanship,12,4,8
Darkshe,dun-modr,384,hunter,marksmanship,12,4,8
Taurd,dragonmaw,384,hunter,marksmanship,12,4,8
Peonfarmer,argent-dawn,384,hunter,marksmanship,12,4,8
Eykons,ragnaros,384,hunter,marksmanship,12,4,8
Графруру,soulflayer,384,hunter,marksmanship,12,4,8
Shadowxx,silvermoon,384,hunter,marksmanship,12,4,8
Araemveus,moonglade,384,hunter,marksmanship,12,4,8
Dangerousfoe,argent-dawn,384,hunter,marksmanship,12,4,8
Jskey,aggramar,384,hunter,marksmanship,12,4,8
Diqtore,aszune,384,hunter,marksmanship,12,4,8
Mexine,dun-morogh,384,hunter,marksmanship,12,4,8
Zeyron,ravencrest,384,hunter,marksmanship,12,4,8
Rapid,sylvanas,384,hunter,marksmanship,12,4,8
Ananasankka,ragnaros,384,hunter,marksmanship,12,4,8
Jannolafrite,ysondre,384,hunter,marksmanship,12,4,8
Aimedbot,azjolnerub,384,hunter,marksmanship,12,4,8
Tonttulul,draenor,384,hunter,marksmanship,12,4,8
Becoming,burning-legion,384,hunter,marksmanship,12,4,8
Drágø,blackmoore,384,hunter,marksmanship,12,4,8
Egodennis,frostwolf,384,hunter,marksmanship,12,4,8
Kanlina,ravencrest,384,hunter,marksmanship,12,4,8
Свадебная,gordunni,384,hunter,marksmanship,12,4,8
Fennecshand,colinas-pardas,384,hunter,marksmanship,12,4,8
Hreo,twisting-nether,384,hunter,marksmanship,12,4,8
Sjins,draenor,384,hunter,marksmanship,12,4,8
Scárzz,silvermoon,384,hunter,marksmanship,12,4,8
Vohnívak,turalyon,384,hunter,marksmanship,12,4,8
Верат,howling-fjord,384,hunter,marksmanship,12,4,8
Døømslayer,nemesis,384,hunter,marksmanship,12,4,8
Bugspitz,outland,384,hunter,marksmanship,12,4,8
Hiddenstalk,outland,384,hunter,marksmanship,12,4,8
Linguinhas,aggra-português,384,hunter,marksmanship,12,4,8
Косаяя,gordunni,384,hunter,marksmanship,12,4,8
Йинги,gordunni,384,hunter,marksmanship,12,4,8
Зангейра,blackscar,384,hunter,marksmanship,12,4,8
Tartaupommes,hyjal,384,hunter,marksmanship,12,4,8
Rhyle,hyjal,384,hunter,marksmanship,12,4,8
Oròg,hyjal,384,hunter,marksmanship,12,4,8
Raínbow,aegwynn,384,hunter,marksmanship,12,4,8
Бладшоот,gordunni,384,hunter,marksmanship,12,4,8
Wildslip,archimonde,384,hunter,marksmanship,12,4,8
Draoclick,hyjal,384,hunter,marksmanship,12,4,8
Forthehordee,chamber-of-aspects,384,hunter,marksmanship,14,4,10
Маори,deepholm,384,hunter,marksmanship,18,4,14
Ruhen,aegwynn,384,hunter,marksmanship,18,4,14
Sylverein,silvermoon,384,hunter,marksmanship,18,4,14
Cachapas,ravencrest,384,hunter,marksmanship,18,4,14
Kêêpsmile,blackmoore,384,hunter,marksmanship,18,4,14
Haraigoshí,grim-batol,384,hunter,marksmanship,18,4,14
Pommespinnes,outland,384,hunter,marksmanship,18,4,14
Strykers,stormscale,384,hunter,marksmanship,18,4,14
Jamais,stormscale,384,hunter,marksmanship,18,4,14
Вевери,blackscar,383,hunter,marksmanship,6,4,2
Moneyhunter,nemesis,383,hunter,marksmanship,6,4,2
Hravanihuan,amanthul,383,hunter,marksmanship,6,4,2
Køûrø,hyjal,383,hunter,marksmanship,6,4,2
Jägerelf,malfurion,383,hunter,marksmanship,6,4,2
Snajper,kragjin,383,hunter,marksmanship,6,4,2
Wakar,alakir,383,hunter,marksmanship,6,4,2
Amiosi,sanguino,383,hunter,marksmanship,10,5,5
Ushiuno,defias-brotherhood,383,hunter,marksmanship,12,4,8
Kyéra,kirin-tor,383,hunter,marksmanship,12,4,8
Grognyre,silvermoon,383,hunter,marksmanship,12,4,8
Jinzala,argent-dawn,383,hunter,marksmanship,12,4,8
Amsterdamer,sylvanas,383,hunter,marksmanship,12,4,8
Tervel,dun-morogh,383,hunter,marksmanship,12,4,8
Slicerfoot,ghostlands,383,hunter,marksmanship,12,4,8
Meletis,stormreaver,383,hunter,marksmanship,12,4,8
Anguerande,khaz-modan,383,hunter,marksmanship,12,4,8
Hopeanuoli,terokkar,383,hunter,marksmanship,12,4,8
Lacertia,kazzak,383,hunter,marksmanship,12,4,8
Aamøn,nemesis,383,hunter,marksmanship,12,4,8
Zirriath,mazrigos,383,hunter,marksmanship,12,4,8
Kyliân,stormscale,383,hunter,marksmanship,12,4,8
Somixx,ragnaros,383,hunter,marksmanship,12,4,8
Beaupapa,archimonde,383,hunter,marksmanship,14,4,10
Musux,uldum,383,hunter,marksmanship,18,4,14
Dartas,outland,383,hunter,marksmanship,18,4,14
Youardead,arthas,383,hunter,marksmanship,18,4,14
Defqön,sanguino,383,hunter,marksmanship,18,4,14
Deadshout,kazzak,382,hunter,marksmanship,6,4,2
Boogaloo,hellscream,382,hunter,marksmanship,6,4,2
Costae,aerie-peak,382,hunter,marksmanship,12,4,8
Metapouk,archimonde,382,hunter,marksmanship,12,4,8
Бурбоньчик,soulflayer,382,hunter,marksmanship,12,4,8
Lardobrave,blackhand,381,hunter,marksmanship,18,4,14
Enérgize,argent-dawn,380,hunter,marksmanship,18,4,14
Pâthfînder,destromath,379,hunter,marksmanship,12,4,8
Кисяныч,gordunni,372,hunter,marksmanship,18,7,11
Dhmuntar,ravencrest,367,hunter,marksmanship,11,4,7
Ténsion,silvermoon,367,hunter,marksmanship,11,4,7
Wrymn,sanguino,367,hunter,marksmanship,11,4,7
Éddiémórphín,kazzak,367,hunter,marksmanship,11,4,7
Dryko,silvermoon,367,hunter,marksmanship,17,4,13
Ketsh,antonidas,367,hunter,marksmanship,17,4,13
Doojas,archimonde,351,hunter,marksmanship,11,4,7
Boehelientje,defias-brotherhood,351,hunter,marksmanship,11,4,7
Naepy,thrall,351,hunter,marksmanship,16,4,12
Lujägy,antonidas,344,hunter,marksmanship,14,5,9
Shadoox,argent-dawn,335,hunter,marksmanship,11,4,7
Bìglenny,shattered-hand,335,hunter,marksmanship,11,4,7
Redstormfx,blades-edge,335,hunter,marksmanship,17,4,13
Pregun,malganis,332,hunter,marksmanship,11,4,7
Waizen,archimonde,330,hunter,marksmanship,16,6,10
Nimri,kazzak,329,hunter,marksmanship,15,5,10
Arwenna,argent-dawn,328,hunter,marksmanship,11,6,5
Rakmo,blackmoore,320,hunter,marksmanship,10,4,6
Rixxâr,blackrock,320,hunter,marksmanship,10,4,6
Samasukë,grim-batol,319,hunter,marksmanship,8,4,4
Выпейдождь,gordunni,319,hunter,marksmanship,8,4,4
Ofilantii,ragnaros,303,hunter,marksmanship,8,5,3
Каэсс,gordunni,288,hunter,marksmanship,6,3,3
Osie,kazzak,288,hunter,marksmanship,6,3,3
Annababygirl,silvermoon,288,hunter,marksmanship,6,3,3
Zusale,azshara,288,hunter,marksmanship,6,3,3
Taenic,azshara,288,hunter,marksmanship,6,3,3
Threeguns,blackrock,288,hunter,marksmanship,6,3,3
Celebor,sanguino,288,hunter,marksmanship,6,3,3
Nexztwo,blackrock,288,hunter,marksmanship,6,3,3
Lithell,kazzak,288,hunter,marksmanship,6,3,3
Feyoonxx,blackrock,288,hunter,marksmanship,6,3,3
Padancete,sanguino,288,hunter,marksmanship,6,3,3
Labestiia,sanguino,288,hunter,marksmanship,6,3,3
Jetleesnipez,blackmoore,288,hunter,marksmanship,6,3,3
Vystrelil,drakthul,288,hunter,marksmanship,6,3,3
Fize,blackmoore,288,hunter,marksmanship,6,3,3
Deta,blackmoore,288,hunter,marksmanship,6,3,3
Rakshor,thrall,288,hunter,marksmanship,6,3,3
Babûsch,blackmoore,288,hunter,marksmanship,6,3,3
Rindarshot,dun-modr,288,hunter,marksmanship,6,3,3
Dethroner,dun-modr,288,hunter,marksmanship,6,3,3
Neescafe,sylvanas,288,hunter,marksmanship,6,3,3
Fizè,blackmoore,288,hunter,marksmanship,6,3,3
Osron,blackmoore,288,hunter,marksmanship,6,3,3
Spunkybum,nagrand,288,hunter,marksmanship,6,3,3
Ulischwonsen,blackmoore,288,hunter,marksmanship,6,3,3
Кристисекс,blackscar,288,hunter,marksmanship,6,3,3
Tobisan,arathor,288,hunter,marksmanship,6,3,3
Mhb,quelthalas,288,hunter,marksmanship,6,3,3
Aliltoxic,silvermoon,288,hunter,marksmanship,6,3,3
Hatemybow,ragnaros,288,hunter,marksmanship,6,3,3
Arnasus,silvermoon,288,hunter,marksmanship,6,3,3
ßæro,hyjal,288,hunter,marksmanship,6,3,3
Atranex,ravencrest,288,hunter,marksmanship,6,3,3
Kahbe,ravencrest,288,hunter,marksmanship,6,3,3
Graavi,silvermoon,288,hunter,marksmanship,6,3,3
Kayflock,kazzak,288,hunter,marksmanship,6,3,3
Zyhraa,ravencrest,288,hunter,marksmanship,6,3,3
Techpøint,silvermoon,288,hunter,marksmanship,6,3,3
Nerdhark,hyjal,288,hunter,marksmanship,6,3,3
Fåded,ravencrest,288,hunter,marksmanship,6,3,3
Bláckthorn,ravencrest,288,hunter,marksmanship,6,3,3
Lowboblarry,ravencrest,288,hunter,marksmanship,6,3,3
Tardoboy,blackrock,288,hunter,marksmanship,6,3,3
Комомура,soulflayer,288,hunter,marksmanship,6,3,3
Альцнтриен,eversong,288,hunter,marksmanship,6,3,3
Sheilare,doomhammer,288,hunter,marksmanship,6,3,3
Люблюлюбовь,gordunni,288,hunter,marksmanship,6,3,3
Elnino,eonar,288,hunter,marksmanship,6,3,3
Soulflyer,draenor,288,hunter,marksmanship,6,3,3
Nickells,draenor,288,hunter,marksmanship,6,3,3
Трапча,soulflayer,288,hunter,marksmanship,6,3,3
Tøkyô,ravencrest,288,hunter,marksmanship,6,3,3
Søp,marécage-de-zangar,288,hunter,marksmanship,6,3,3
Kaznek,hyjal,288,hunter,marksmanship,6,3,3
Meridià,malorne,288,hunter,marksmanship,6,3,3
Aimshot,ravencrest,288,hunter,marksmanship,6,3,3
Rachelicious,ravencrest,288,hunter,marksmanship,6,3,3
Homoride,alleria,288,hunter,marksmanship,6,3,3
Sniipe,arthas,288,hunter,marksmanship,6,3,3
Velne,ravencrest,288,hunter,marksmanship,6,3,3
Гринмех,gordunni,288,hunter,marksmanship,6,3,3
Deadluck,kazzak,288,hunter,marksmanship,6,3,3
Iif,frostwolf,288,hunter,marksmanship,6,3,3
Ðøpèz,frostwolf,288,hunter,marksmanship,6,3,3
Kofie,steamwheedle-cartel,288,hunter,marksmanship,6,3,3
Välk,sylvanas,288,hunter,marksmanship,6,3,3
Phinecone,stormscale,288,hunter,marksmanship,6,3,3
Ayiu,argent-dawn,288,hunter,marksmanship,6,3,3
Misstrap,nemesis,288,hunter,marksmanship,6,3,3
Mariabanks,aegwynn,288,hunter,marksmanship,6,3,3
Stickthrower,steamwheedle-cartel,288,hunter,marksmanship,6,3,3
Dedral,aegwynn,288,hunter,marksmanship,6,3,3
Surgethyme,ravencrest,288,hunter,marksmanship,6,3,3
Naramir,ysondre,288,hunter,marksmanship,6,3,3
Marcoh,die-arguswacht,288,hunter,marksmanship,6,3,3
Hieratic,zenedar,288,hunter,marksmanship,6,3,3
Пууша,howling-fjord,288,hunter,marksmanship,6,3,3
Andrøk,archimonde,288,hunter,marksmanship,6,3,3
Ökisek,drakthul,288,hunter,marksmanship,6,3,3
Tyssar,kazzak,288,hunter,marksmanship,6,3,3
Thebigboom,outland,288,hunter,marksmanship,6,3,3
Kandrena,argent-dawn,288,hunter,marksmanship,6,3,3
Aimywinehaus,burning-blade,288,hunter,marksmanship,6,3,3
Shall,outland,288,hunter,marksmanship,6,3,3
Kfcmanagerx,silvermoon,288,hunter,marksmanship,6,3,3
Jarhead,arthas,288,hunter,marksmanship,6,3,3
Zugzlug,tarren-mill,288,hunter,marksmanship,6,3,3
Emànuela,outland,288,hunter,marksmanship,6,3,3
Crispyqt,kazzak,288,hunter,marksmanship,6,3,3
Bocek,silvermoon,288,hunter,marksmanship,6,3,3
Brûmovitch,archimonde,288,hunter,marksmanship,6,3,3
Трапавграунд,howling-fjord,288,hunter,marksmanship,6,3,3
Dippöverdos,outland,288,hunter,marksmanship,6,3,3
Huntresse,archimonde,288,hunter,marksmanship,6,3,3
Djfury,archimonde,288,hunter,marksmanship,6,3,3
Qaedri,kazzak,288,hunter,marksmanship,6,3,3
Filyfy,argent-dawn,288,hunter,marksmanship,6,3,3
Zwockeline,blutkessel,288,hunter,marksmanship,6,3,3
Ев,lich-king,288,hunter,marksmanship,6,3,3
Экономист,fordragon,288,hunter,marksmanship,6,3,3
Ägris,die-todeskrallen,288,hunter,marksmanship,6,3,3
Lopsa,terokkar,288,hunter,marksmanship,6,3,3
Burbutsuluki,silvermoon,288,hunter,marksmanship,6,3,3
Nightarrowq,tarren-mill,288,hunter,marksmanship,9,4,5
Farkiaz,hyjal,288,hunter,marksmanship,7,3,4
Amdéa,boulderfist,288,hunter,marksmanship,10,4,6
Hidalgô,kult-der-verdammten,288,hunter,marksmanship,9,3,6
Нойран,eversong,288,hunter,marksmanship,9,3,6
Лонтерикс,gordunni,288,hunter,marksmanship,11,3,8
Nightsprout,neptulon,288,hunter,marksmanship,12,3,9
Бубунн,howling-fjord,288,hunter,marksmanship,12,3,9
Rosoken,kazzak,288,hunter,marksmanship,12,3,9
Flucxx,stormscale,288,hunter,marksmanship,12,3,9
Akù,magtheridon,288,hunter,marksmanship,12,3,9
Dãhrn,sanguino,288,hunter,marksmanship,12,3,9
Demoira,genjuros,288,hunter,marksmanship,12,3,9
Flyingnipp,arthas,288,hunter,marksmanship,12,3,9
Thalanel,arthas,288,hunter,marksmanship,12,3,9
Naaztko,stormscale,288,hunter,marksmanship,12,3,9
Нэвлоск,gordunni,288,hunter,marksmanship,12,3,9
Grubabicza,silvermoon,288,hunter,marksmanship,12,3,9
Ибражы,howling-fjord,288,hunter,marksmanship,12,3,9
Unclehowdy,sanguino,288,hunter,marksmanship,12,3,9
Chassuu,khaz-modan,288,hunter,marksmanship,12,3,9
Jensa,darksorrow,288,hunter,marksmanship,12,3,9
Snipar,chogall,288,hunter,marksmanship,12,3,9
Скадхи,blackscar,288,hunter,marksmanship,12,3,9
Saîtek,chogall,288,hunter,marksmanship,12,3,9
Lùchiean,kazzak,288,hunter,marksmanship,12,3,9
Foxmis,kazzak,288,hunter,marksmanship,12,3,9
Zubro,kazzak,288,hunter,marksmanship,12,3,9
Fatfrumos,twisting-nether,288,hunter,marksmanship,12,3,9
Nímren,ambossar,288,hunter,marksmanship,12,3,9
Хедшоттер,blackscar,288,hunter,marksmanship,12,3,9
Galathrin,twisting-nether,288,hunter,marksmanship,12,3,9
Sphinx,neptulon,288,hunter,marksmanship,12,3,9
Астериел,blackscar,288,hunter,marksmanship,12,3,9
Oduross,minahonda,288,hunter,marksmanship,12,3,9
Hunteraction,lightbringer,288,hunter,marksmanship,12,3,9
Горгудц,gordunni,288,hunter,marksmanship,12,3,9
Tharzo,thrall,288,hunter,marksmanship,12,3,9
Кактусджекк,gordunni,288,hunter,marksmanship,12,3,9
Zammies,aggramar,288,hunter,marksmanship,12,3,9
Aîmshot,ravencrest,288,hunter,marksmanship,12,3,9
Mcperra,zuljin,288,hunter,marksmanship,12,3,9
Dajägaa,blackmoore,288,hunter,marksmanship,12,3,9
Clickpao,outland,288,hunter,marksmanship,12,3,9
Lilyss,outland,288,hunter,marksmanship,12,3,9
Dafragger,blackmoore,288,hunter,marksmanship,12,3,9
Spítz,outland,288,hunter,marksmanship,12,3,9
Lioness,ahnqiraj,288,hunter,marksmanship,12,3,9
Ghenter,sargeras,288,hunter,marksmanship,12,3,9
Rløad,hyjal,288,hunter,marksmanship,12,3,9
Avp,sylvanas,288,hunter,marksmanship,12,3,9
Deify,grim-batol,288,hunter,marksmanship,12,3,9
Spakster,blackrock,288,hunter,marksmanship,12,3,9
Symphriel,argent-dawn,288,hunter,marksmanship,12,3,9
Bengeh,tarren-mill,288,hunter,marksmanship,12,3,9
Wödën,argent-dawn,288,hunter,marksmanship,12,3,9
Бычарник,eversong,288,hunter,marksmanship,12,3,9
Missdarkness,shattered-hand,288,hunter,marksmanship,12,3,9
Bowgamerx,ravencrest,288,hunter,marksmanship,12,3,9
Augie,kazzak,288,hunter,marksmanship,12,3,9
Arslan,archimonde,288,hunter,marksmanship,16,3,13
Tsía,ysondre,288,hunter,marksmanship,17,3,14
Gabbriel,ravencrest,288,hunter,marksmanship,18,3,15
Showdope,drakthul,288,hunter,marksmanship,18,3,15
Дэнарис,gordunni,288,hunter,marksmanship,18,3,15
Stitcha,doomhammer,288,hunter,marksmanship,18,3,15
Sidera,der-rat-von-dalaran,288,hunter,marksmanship,18,3,15
Richidex,zuljin,288,hunter,marksmanship,18,3,15
Shademd,ahnqiraj,288,hunter,marksmanship,18,3,15
Castbuny,drakthul,288,hunter,marksmanship,18,3,15
Bmo,zuljin,288,hunter,marksmanship,18,3,15
Kolskoot,kilrogg,287,hunter,marksmanship,6,3,3
Thyrazs,archimonde,287,hunter,marksmanship,6,3,3
Btk,sanguino,287,hunter,marksmanship,6,3,3
Оркос,deathweaver,287,hunter,marksmanship,6,3,3
Superfacial,twisting-nether,287,hunter,marksmanship,12,3,9
Constantín,aegwynn,287,hunter,marksmanship,12,3,9
Worus,argent-dawn,287,hunter,marksmanship,12,3,9
Dwoas,darkspear,287,hunter,marksmanship,12,3,9
Onexshot,draenor,287,hunter,marksmanship,12,3,9
Schwarzreh,ulduar,287,hunter,marksmanship,12,3,9
Guf,eredar,287,hunter,marksmanship,13,3,10
Сяову,gordunni,287,hunter,marksmanship,18,3,15
Dambrä,eredar,286,hunter,marksmanship,6,3,3
Jomoguin,stormscale,286,hunter,marksmanship,6,3,3
Tournado,silvermoon,286,hunter,marksmanship,29,3,26
Sushimän,kaelthas,285,hunter,marksmanship,12,3,9
Millhunter,norgannon,284,hunter,marksmanship,12,3,9
Darkstripe,turalyon,281,hunter,marksmanship,13,5,8
Elderhem,sanguino,256,hunter,marksmanship,13,3,10
Najetazruda,drakthul,255,hunter,marksmanship,10,3,7
Бещеный,ashenvale,255,hunter,marksmanship,11,3,8
Dracy,baelgun,239,hunter,marksmanship,5,3,2
Jaguarundy,dun-modr,239,hunter,marksmanship,5,3,2
Eazzyy,auchindoun,239,hunter,marksmanship,5,3,2
Олдорк,howling-fjord,239,hunter,marksmanship,12,3,9
Incrediown,tarren-mill,234,hunter,marksmanship,7,4,3
Doloresman,tarren-mill,234,hunter,marksmanship,9,4,5
Yuptae,alonsus,234,hunter,marksmanship,10,4,6
Everz,silvermoon,234,hunter,marksmanship,13,4,9
Loydzz,hyjal,234,hunter,marksmanship,14,4,10
Vasco,chogall,223,hunter,marksmanship,8,3,5
Falakras,ragnaros,223,hunter,marksmanship,8,3,5
Dampfwâlzê,nozdormu,223,hunter,marksmanship,14,3,11
Skarra,zuljin,208,hunter,marksmanship,7,3,4
Taurïel,stormscale,208,hunter,marksmanship,7,3,4
Dann,uldum,208,hunter,marksmanship,11,3,8
Arrowlight,archimonde,192,hunter,marksmanship,6,2,4
Шейхант,gordunni,192,hunter,marksmanship,6,2,4
Nibbafakkot,ravencrest,192,hunter,marksmanship,6,2,4
Köblow,khaz-modan,192,hunter,marksmanship,6,2,4
Miracleh,tarren-mill,192,hunter,marksmanship,6,2,4
Themehdi,silvermoon,192,hunter,marksmanship,6,2,4
Bellecoq,arathi,192,hunter,marksmanship,6,2,4
Shinyhunt,tarren-mill,192,hunter,marksmanship,6,2,4
Goldnug,karazhan,192,hunter,marksmanship,6,2,4
Lowfet,neptulon,192,hunter,marksmanship,6,2,4
Linkinranger,tarren-mill,192,hunter,marksmanship,6,2,4
Nashanael,argent-dawn,192,hunter,marksmanship,6,2,4
Plilolz,archimonde,192,hunter,marksmanship,6,2,4
Zinà,naxxramas,192,hunter,marksmanship,6,2,4
Трисциллочка,howling-fjord,192,hunter,marksmanship,6,2,4
Bärberøusse,illidan,192,hunter,marksmanship,6,2,4
Slyhunter,kazzak,192,hunter,marksmanship,6,2,4
Gwaewel,argent-dawn,192,hunter,marksmanship,6,2,4
Craisax,nemesis,192,hunter,marksmanship,6,2,4
Olrik,dentarg,192,hunter,marksmanship,6,2,4
Gladodjurig,tarren-mill,192,hunter,marksmanship,6,2,4
Parhainkoira,argent-dawn,192,hunter,marksmanship,6,2,4
Slayman,kazzak,192,hunter,marksmanship,6,2,4
Shenlong,nemesis,192,hunter,marksmanship,6,2,4
Eanflaed,drakthul,192,hunter,marksmanship,6,2,4
Watntietjes,burning-blade,192,hunter,marksmanship,6,2,4
Sugmèg,dragonblight,192,hunter,marksmanship,6,2,4
Хисдед,howling-fjord,192,hunter,marksmanship,6,2,4
Melloy,drakthul,192,hunter,marksmanship,6,2,4
Emiliabr,stormscale,192,hunter,marksmanship,6,2,4
Mìrilass,nemesis,192,hunter,marksmanship,6,2,4
Ðkð,archimonde,192,hunter,marksmanship,6,2,4
Illicit,silvermoon,192,hunter,marksmanship,6,2,4
Slickbackdan,the-maelstrom,192,hunter,marksmanship,6,2,4
Шергала,soulflayer,192,hunter,marksmanship,6,2,4
Benzín,silvermoon,192,hunter,marksmanship,6,2,4
Дэльфис,howling-fjord,192,hunter,marksmanship,6,2,4
Sylvanaskwt,silvermoon,192,hunter,marksmanship,6,2,4
Ptx,stormscale,192,hunter,marksmanship,6,2,4
Дианнесса,howling-fjord,192,hunter,marksmanship,6,2,4
Кейтпрнстар,howling-fjord,192,hunter,marksmanship,6,2,4
Womper,silvermoon,192,hunter,marksmanship,6,2,4
Géziewølf,archimonde,192,hunter,marksmanship,6,2,4
Kagan,nemesis,192,hunter,marksmanship,6,2,4
Aspergun,ragnaros,192,hunter,marksmanship,6,2,4
Trollì,stormreaver,192,hunter,marksmanship,6,2,4
Dola,archimonde,192,hunter,marksmanship,6,2,4
Hvnn,stormscale,192,hunter,marksmanship,6,2,4
Tórbjorn,argent-dawn,192,hunter,marksmanship,6,2,4
Rimmig,malganis,192,hunter,marksmanship,6,2,4
Carioca,blackhand,192,hunter,marksmanship,6,2,4
Gretchin,bloodhoof,192,hunter,marksmanship,6,2,4
Nitroni,rexxar,192,hunter,marksmanship,6,2,4
Eilet,pozzo-delleternità,192,hunter,marksmanship,6,2,4
Marrow,alleria,192,hunter,marksmanship,6,2,4
Megapewpew,bladefist,192,hunter,marksmanship,6,2,4
Sizzlepop,argent-dawn,192,hunter,marksmanship,6,2,4
Nyght,ravencrest,192,hunter,marksmanship,6,2,4
Виндрунир,gordunni,192,hunter,marksmanship,6,2,4
Kodakcrack,draenor,192,hunter,marksmanship,6,2,4
Adkins,elune,192,hunter,marksmanship,6,2,4
Batalul,twisting-nether,192,hunter,marksmanship,6,2,4
Otekkâ,hyjal,192,hunter,marksmanship,6,2,4
Najli,kazzak,192,hunter,marksmanship,6,2,4
Greenstar,twisting-nether,192,hunter,marksmanship,6,2,4
Mobshot,twisting-nether,192,hunter,marksmanship,6,2,4
Tòràk,twisting-nether,192,hunter,marksmanship,6,2,4
Эвелан,soulflayer,192,hunter,marksmanship,6,2,4
Pïckledrick,stormscale,192,hunter,marksmanship,6,2,4
Kyarin,draenor,192,hunter,marksmanship,6,2,4
Зихантер,soulflayer,192,hunter,marksmanship,6,2,4
Bignug,conseil-des-ombres,192,hunter,marksmanship,6,2,4
Chenony,ravencrest,192,hunter,marksmanship,6,2,4
Настякобра,blackscar,192,hunter,marksmanship,6,2,4
Muktarr,stormscale,192,hunter,marksmanship,6,2,4
Madeyhunt,burning-legion,192,hunter,marksmanship,6,2,4
Larrylegend,der-rat-von-dalaran,192,hunter,marksmanship,6,2,4
Hadto,der-rat-von-dalaran,192,hunter,marksmanship,6,2,4
Bóssit,skullcrusher,192,hunter,marksmanship,6,2,4
Фетсол,soulflayer,192,hunter,marksmanship,6,2,4
Охотуначал,soulflayer,192,hunter,marksmanship,6,2,4
Meztarinnan,twisting-nether,192,hunter,marksmanship,6,2,4
Hexorn,ysondre,192,hunter,marksmanship,6,2,4
Tÿro,ravencrest,192,hunter,marksmanship,6,2,4
Garrash,teldrassil,192,hunter,marksmanship,6,2,4
Viktorijå,draenor,192,hunter,marksmanship,6,2,4
Fullxtrap,hyjal,192,hunter,marksmanship,6,2,4
Keinzira,hyjal,192,hunter,marksmanship,6,2,4
Erradane,hyjal,192,hunter,marksmanship,6,2,4
Runescapes,ravencrest,192,hunter,marksmanship,6,2,4
Sinadoreck,sargeras,192,hunter,marksmanship,6,2,4
Ävírøñskÿ,ravencrest,192,hunter,marksmanship,6,2,4
Hor,krasus,192,hunter,marksmanship,6,2,4
Brizza,talnivarr,192,hunter,marksmanship,6,2,4
Juhiu,hyjal,192,hunter,marksmanship,6,2,4
Elvyns,silvermoon,192,hunter,marksmanship,6,2,4
Nînux,frostwolf,192,hunter,marksmanship,6,2,4
Zulldek,sanguino,192,hunter,marksmanship,6,2,4
Erilis,twisting-nether,192,hunter,marksmanship,6,2,4
Велайна,galakrond,192,hunter,marksmanship,6,2,4
Andressc,colinas-pardas,192,hunter,marksmanship,6,2,4
Regus,azjolnerub,192,hunter,marksmanship,6,2,4
Séphirôth,theradras,192,hunter,marksmanship,6,2,4
Bowner,frostmane,192,hunter,marksmanship,6,2,4
Denixilith,eredar,192,hunter,marksmanship,6,2,4
Sebrienne,defias-brotherhood,192,hunter,marksmanship,6,2,4
Nnoyk,defias-brotherhood,192,hunter,marksmanship,6,2,4
Joshalama,quelthalas,192,hunter,marksmanship,6,2,4
Ecthelione,the-venture-co,192,hunter,marksmanship,6,2,4
Kírathril,blackhand,192,hunter,marksmanship,6,2,4
Corrector,outland,192,hunter,marksmanship,6,2,4
Фираналь,blackscar,192,hunter,marksmanship,6,2,4
Changwehh,blackmoore,192,hunter,marksmanship,6,2,4
Akadron,blackmoore,192,hunter,marksmanship,6,2,4
Silenta,outland,192,hunter,marksmanship,6,2,4
Trynext,blackmoore,192,hunter,marksmanship,6,2,4
Bowzaa,blackmoore,192,hunter,marksmanship,6,2,4
Eilosh,outland,192,hunter,marksmanship,6,2,4
Тоу,deathguard,192,hunter,marksmanship,6,2,4
Arrow,shattered-hand,192,hunter,marksmanship,6,2,4
Phanos,draenor,192,hunter,marksmanship,6,2,4
Knallêrbse,blackmoore,192,hunter,marksmanship,6,2,4
Simonhernan,dun-modr,192,hunter,marksmanship,6,2,4
Thunderstarr,blackmoore,192,hunter,marksmanship,6,2,4
Eule,dun-modr,192,hunter,marksmanship,6,2,4
Rollingjoint,blackmoore,192,hunter,marksmanship,6,2,4
Азифаель,gordunni,192,hunter,marksmanship,6,2,4
Сактарион,soulflayer,192,hunter,marksmanship,6,2,4
Cryka,blackmoore,192,hunter,marksmanship,6,2,4
Шалларис,soulflayer,192,hunter,marksmanship,6,2,4
Sankari,blackmoore,192,hunter,marksmanship,6,2,4
Entaiy,blackmoore,192,hunter,marksmanship,6,2,4
Edrenalin,ravencrest,192,hunter,marksmanship,6,2,4
Rafaela,genjuros,192,hunter,marksmanship,6,2,4
Nigina,ravencrest,192,hunter,marksmanship,6,2,4
Wodhunterxdd,outland,192,hunter,marksmanship,6,2,4
Velvett,blackmoore,192,hunter,marksmanship,6,2,4
Jamesyy,ravencrest,192,hunter,marksmanship,6,2,4
Grytax,outland,192,hunter,marksmanship,6,2,4
Upresa,sanguino,192,hunter,marksmanship,6,2,4
Notikâ,aegwynn,192,hunter,marksmanship,6,2,4
Arunaky,uldum,192,hunter,marksmanship,6,2,4
Походупопал,howling-fjord,192,hunter,marksmanship,6,2,4
Ricoshet,silvermoon,192,hunter,marksmanship,6,2,4
Gedept,blackrock,192,hunter,marksmanship,6,2,4
Machini,terokkar,192,hunter,marksmanship,6,2,4
Huntbeard,ragnaros,192,hunter,marksmanship,6,2,4
Svolatch,blackrock,192,hunter,marksmanship,6,2,4
Anklar,blackrock,192,hunter,marksmanship,6,2,4
Røgrøck,archimonde,192,hunter,marksmanship,6,2,4
Naass,silvermoon,192,hunter,marksmanship,6,2,4
Drigs,blackrock,192,hunter,marksmanship,6,2,4
Traenuss,azuremyst,192,hunter,marksmanship,6,2,4
Vâleriaa,blackrock,192,hunter,marksmanship,6,2,4
Wujekwania,silvermoon,192,hunter,marksmanship,6,2,4
Skjutkänslan,outland,192,hunter,marksmanship,6,2,4
Realme,blackrock,192,hunter,marksmanship,6,2,4
Winniepuuh,outland,192,hunter,marksmanship,6,2,4
Flick,auchindoun,192,hunter,marksmanship,6,2,4
Seifér,auchindoun,192,hunter,marksmanship,6,2,4
Arnakua,outland,192,hunter,marksmanship,6,2,4
Reeceyree,outland,192,hunter,marksmanship,6,2,4
Traplørdx,sylvanas,192,hunter,marksmanship,6,2,4
Vengigodx,outland,192,hunter,marksmanship,6,2,4
Anoroxx,arthas,192,hunter,marksmanship,6,2,4
Doknak,gilneas,192,hunter,marksmanship,6,2,4
Lagich,sylvanas,192,hunter,marksmanship,6,2,4
Qled,sylvanas,192,hunter,marksmanship,6,2,4
Isokrates,das-syndikat,192,hunter,marksmanship,6,2,4
Lethalshotz,tarren-mill,192,hunter,marksmanship,7,2,5
Resputimothy,emeriss,192,hunter,marksmanship,9,2,7
Litia,ysondre,192,hunter,marksmanship,12,2,10
Vèla,ysondre,192,hunter,marksmanship,12,2,10
Jaysonmore,argent-dawn,192,hunter,marksmanship,12,2,10
Застрельщикц,soulflayer,192,hunter,marksmanship,12,2,10
Negz,eredar,192,hunter,marksmanship,12,2,10
Kenpach,frostmane,192,hunter,marksmanship,12,2,10
Almêryck,ysondre,192,hunter,marksmanship,12,2,10
Katharyne,argent-dawn,192,hunter,marksmanship,12,2,10
Ølympx,blackhand,192,hunter,marksmanship,12,2,10
Envixia,tarren-mill,192,hunter,marksmanship,12,2,10
Explicits,stormscale,192,hunter,marksmanship,12,2,10
Chassour,archimonde,192,hunter,marksmanship,12,2,10
Headshota,stormscale,192,hunter,marksmanship,12,2,10
Suchykeb,silvermoon,192,hunter,marksmanship,12,2,10
Weedonyhunt,hyjal,192,hunter,marksmanship,12,2,10
Hyod,khaz-modan,192,hunter,marksmanship,12,2,10
Кетроуз,howling-fjord,192,hunter,marksmanship,12,2,10
Лиасон,howling-fjord,192,hunter,marksmanship,12,2,10
Waalth,ragnaros,192,hunter,marksmanship,12,2,10
Friskì,draenor,192,hunter,marksmanship,12,2,10
Täladrielle,hyjal,192,hunter,marksmanship,12,2,10
Elitepeon,blackmoore,192,hunter,marksmanship,12,2,10
Fedya,kazzak,192,hunter,marksmanship,12,2,10
Poszipabre,magtheridon,192,hunter,marksmanship,12,2,10
Banglor,shattered-hand,192,hunter,marksmanship,12,2,10
Oneshotbigi,ravencrest,192,hunter,marksmanship,12,2,10
Gingiismydad,outland,192,hunter,marksmanship,12,2,10
Войдан,gordunni,192,hunter,marksmanship,12,2,10
Dmanite,ravencrest,192,hunter,marksmanship,12,2,10
Zefirr,sanguino,192,hunter,marksmanship,12,2,10
Oktoc,dalaran,192,hunter,marksmanship,13,2,11
Taureno,lordaeron,192,hunter,marksmanship,14,2,12
Haïry,kazzak,192,hunter,marksmanship,18,2,16
Kronzucker,eredar,192,hunter,marksmanship,18,2,16
Ðaiky,khaz-modan,191,hunter,marksmanship,6,2,4
Enanorabioso,minahonda,191,hunter,marksmanship,6,2,4
Downpipe,shattered-hand,191,hunter,marksmanship,6,2,4
Stormhoofd,bloodhoof,191,hunter,marksmanship,6,2,4
Fakepvper,darksorrow,191,hunter,marksmanship,6,2,4
Graff,grim-batol,191,hunter,marksmanship,6,2,4
Fingon,alleria,191,hunter,marksmanship,12,2,10
Chalyto,dun-morogh,191,hunter,marksmanship,12,2,10
Kure,blackrock,191,hunter,marksmanship,12,2,10
Glaukôs,die-nachtwache,190,hunter,marksmanship,12,2,10
Inzyplatv,blackmoore,160,hunter,marksmanship,10,2,8
Bigbababotan,blackrock,159,hunter,marksmanship,5,2,3
Jaguàr,kazzak,159,hunter,marksmanship,5,2,3
Buttsnipe,sylvanas,159,hunter,marksmanship,5,2,3
Bryanblak,colinas-pardas,159,hunter,marksmanship,5,2,3
Tràpz,archimonde,144,hunter,marksmanship,9,2,7
Sylariel,die-aldor,138,hunter,marksmanship,10,4,6
Spagooters,argent-dawn,138,hunter,marksmanship,11,3,8
Sâka,frostwolf,128,hunter,marksmanship,4,2,2
Louce,argent-dawn,128,hunter,marksmanship,7,2,5
Mcnuggat,the-maelstrom,112,hunter,marksmanship,13,2,11
Akahr,thrall,96,hunter,marksmanship,3,2,1
Janoh,dalaran,96,hunter,marksmanship,3,2,1
Tryx,darksorrow,96,hunter,marksmanship,3,2,1
Хюсторн,blackscar,96,hunter,marksmanship,3,2,1
Åbomìnatïon,ravencrest,96,hunter,marksmanship,18,3,15
Killzo,sylvanas,96,hunter,marksmanship,6,1,5
Дэнвин,deathweaver,96,hunter,marksmanship,6,1,5
Горгонт,blackscar,96,hunter,marksmanship,6,1,5
Обспн,borean-tundra,96,hunter,marksmanship,6,1,5
Альмиэлль,gordunni,96,hunter,marksmanship,6,1,5
Хэйоуу,gordunni,96,hunter,marksmanship,6,1,5
Sbop,aegwynn,96,hunter,marksmanship,6,1,5
Левери,gordunni,96,hunter,marksmanship,6,1,5
Камшотовна,blackscar,96,hunter,marksmanship,6,1,5
Ahnter,aegwynn,96,hunter,marksmanship,6,1,5
Faze,hellfire,96,hunter,marksmanship,6,1,5
Høøl,hyjal,96,hunter,marksmanship,6,1,5
Баянист,soulflayer,96,hunter,marksmanship,6,1,5
Варсор,soulflayer,96,hunter,marksmanship,6,1,5
Хантунец,soulflayer,96,hunter,marksmanship,6,1,5
Ренектон,soulflayer,96,hunter,marksmanship,6,1,5
Навальница,gordunni,96,hunter,marksmanship,6,1,5
Wèdra,hyjal,96,hunter,marksmanship,6,1,5
Arakondia,grim-batol,96,hunter,marksmanship,6,1,5
Орталиус,deathguard,96,hunter,marksmanship,6,1,5
Wonderbrax,nemesis,96,hunter,marksmanship,6,1,5
Lòò,aegwynn,96,hunter,marksmanship,6,1,5
Raverave,burning-legion,96,hunter,marksmanship,6,1,5
Davinki,dragonblight,96,hunter,marksmanship,6,1,5
Jtechasse,outland,96,hunter,marksmanship,6,1,5
Gbpusd,outland,96,hunter,marksmanship,6,1,5
Badkirves,kazzak,96,hunter,marksmanship,6,1,5
Haplîn,elune,96,hunter,marksmanship,6,1,5
Chillø,elune,96,hunter,marksmanship,6,1,5
Darthbow,outland,96,hunter,marksmanship,6,1,5
Eowale,outland,96,hunter,marksmanship,6,1,5
Drolarin,zuljin,96,hunter,marksmanship,6,1,5
Pestilencio,shendralar,96,hunter,marksmanship,6,1,5
Mästerkill,dun-modr,96,hunter,marksmanship,6,1,5
Tesourinho,aggra-português,96,hunter,marksmanship,6,1,5
Xarhunt,azjolnerub,96,hunter,marksmanship,6,1,5
Iddqd,outland,96,hunter,marksmanship,6,1,5
Mehtäsika,xavius,96,hunter,marksmanship,6,1,5
Roupinol,aggra-português,96,hunter,marksmanship,6,1,5
Djtrapdaddy,outland,96,hunter,marksmanship,6,1,5
Flechaoscurä,exodar,96,hunter,marksmanship,6,1,5
Wantsumsnipe,twisting-nether,96,hunter,marksmanship,6,1,5
Elmerthehunt,archimonde,96,hunter,marksmanship,6,1,5
Udolff,twisting-nether,96,hunter,marksmanship,6,1,5
Faccacamoale,twisting-nether,96,hunter,marksmanship,6,1,5
Frapt,dalaran,96,hunter,marksmanship,6,1,5
Statik,deathwing,96,hunter,marksmanship,6,1,5
Púrefect,ragnaros,96,hunter,marksmanship,6,1,5
Xaraimz,ravencrest,96,hunter,marksmanship,6,1,5
Kongweaver,ragnaros,96,hunter,marksmanship,6,1,5
Санзи,howling-fjord,96,hunter,marksmanship,6,1,5
Лсныйпамп,howling-fjord,96,hunter,marksmanship,6,1,5
Наладдчик,howling-fjord,96,hunter,marksmanship,6,1,5
Porthunt,kazzak,96,hunter,marksmanship,6,1,5
Барев,howling-fjord,96,hunter,marksmanship,6,1,5
Hunthem,kazzak,96,hunter,marksmanship,6,1,5
Гижуна,howling-fjord,96,hunter,marksmanship,6,1,5
Cllaaw,kazzak,96,hunter,marksmanship,6,1,5
Puciak,drakthul,96,hunter,marksmanship,6,1,5
Luftikuss,arthas,96,hunter,marksmanship,6,1,5
Câlimerô,blackrock,96,hunter,marksmanship,6,1,5
Sîlvêrbullet,blackhand,96,hunter,marksmanship,6,1,5
Zórk,malganis,96,hunter,marksmanship,6,1,5
Djannz,blackhand,96,hunter,marksmanship,6,1,5
Toulouki,silvermoon,96,hunter,marksmanship,6,1,5
Cléò,kazzak,96,hunter,marksmanship,6,1,5
Ninjakimi,ravencrest,96,hunter,marksmanship,6,1,5
Tuljan,ravencrest,96,hunter,marksmanship,6,1,5
Velcy,ravencrest,96,hunter,marksmanship,6,1,5
Randire,guldan,96,hunter,marksmanship,6,1,5
Belmondo,ravencrest,96,hunter,marksmanship,6,1,5
Akaname,ravencrest,96,hunter,marksmanship,6,1,5
Pinocion,drakthul,96,hunter,marksmanship,6,1,5
Cendrac,ravencrest,96,hunter,marksmanship,6,1,5
Fayenia,ravencrest,96,hunter,marksmanship,6,1,5
Ninielnienor,thrall,96,hunter,marksmanship,6,1,5
Chantalia,ravencrest,96,hunter,marksmanship,6,1,5
Nethria,antonidas,96,hunter,marksmanship,6,1,5
Tillhunt,kargath,96,hunter,marksmanship,6,1,5
Syldroxia,antonidas,96,hunter,marksmanship,6,1,5
Ziatajie,drakthul,96,hunter,marksmanship,6,1,5
Cítyzens,drakthul,96,hunter,marksmanship,6,1,5
Sângha,frostwolf,96,hunter,marksmanship,6,1,5
Pampers,silvermoon,96,hunter,marksmanship,6,1,5
Itamedruid,eredar,96,hunter,marksmanship,6,1,5
Mackpass,ysondre,96,hunter,marksmanship,6,1,5
Bykwick,ysondre,96,hunter,marksmanship,6,1,5
Surprises,ysondre,96,hunter,marksmanship,6,1,5
Vulupera,aggramar,96,hunter,marksmanship,6,1,5
Pagman,thrall,96,hunter,marksmanship,6,1,5
Elaresas,argent-dawn,96,hunter,marksmanship,6,1,5
Feedbackloop,silvermoon,96,hunter,marksmanship,6,1,5
Yurai,argent-dawn,96,hunter,marksmanship,6,1,5
Ashjen,aszune,96,hunter,marksmanship,6,1,5
Hanzú,argent-dawn,96,hunter,marksmanship,6,1,5
Crowcifer,argent-dawn,96,hunter,marksmanship,6,1,5
Nalys,argent-dawn,96,hunter,marksmanship,6,1,5
Salie,argent-dawn,96,hunter,marksmanship,6,1,5
Reakanz,tarren-mill,96,hunter,marksmanship,6,1,5
Sentriks,tarren-mill,96,hunter,marksmanship,6,1,5
Teedfredd,tarren-mill,96,hunter,marksmanship,6,1,5
Lyute,draenor,96,hunter,marksmanship,6,1,5
Nortroll,draenor,96,hunter,marksmanship,6,1,5
Applix,tarren-mill,96,hunter,marksmanship,6,1,5
Thefoxsay,draenor,96,hunter,marksmanship,6,1,5
Thorka,tarren-mill,96,hunter,marksmanship,6,1,5
Wrxbugeye,arthas,96,hunter,marksmanship,6,1,5
Maity,die-ewige-wacht,96,hunter,marksmanship,6,1,5
Ferdinandl,draenor,96,hunter,marksmanship,6,1,5
Ispityoudie,defias-brotherhood,96,hunter,marksmanship,6,1,5
Johnnygnus,drakthul,96,hunter,marksmanship,6,1,5
Jackchuka,das-syndikat,96,hunter,marksmanship,6,1,5
Guttz,chants-éternels,96,hunter,marksmanship,6,1,5
Arkancia,throkferoth,96,hunter,marksmanship,6,1,5
Huntred,malfurion,96,hunter,marksmanship,6,1,5
Avizi,anachronos,96,hunter,marksmanship,6,1,5
Syx,amanthul,96,hunter,marksmanship,6,1,5
Xnightmare,draenor,96,hunter,marksmanship,6,1,5
Valora,zuluhed,96,hunter,marksmanship,6,1,5
Merci,nazjatar,96,hunter,marksmanship,6,1,5
Baramia,theradras,96,hunter,marksmanship,6,1,5
Desow,blackrock,96,hunter,marksmanship,6,1,5
Asery,blackmoore,96,hunter,marksmanship,6,1,5
Leaxs,onyxia,96,hunter,marksmanship,6,1,5
Dryagesteak,norgannon,96,hunter,marksmanship,6,1,5
Sagytaryus,nemesis,96,hunter,marksmanship,11,1,10
Acuatropatas,sanguino,96,hunter,marksmanship,12,1,11
Donáldtrúmp,tarren-mill,96,hunter,marksmanship,12,1,11
Moskalhunter,terokkar,96,hunter,marksmanship,12,1,11
Mavis,bloodfeather,96,hunter,marksmanship,12,1,11
Tiguy,archimonde,96,hunter,marksmanship,12,1,11
Riplëy,dun-modr,96,hunter,marksmanship,12,1,11
Yumyúm,antonidas,96,hunter,marksmanship,12,1,11
Dewshot,silvermoon,96,hunter,marksmanship,12,1,11
Noskillbot,twisting-nether,96,hunter,marksmanship,12,1,11
Gorgorotha,ragnaros,96,hunter,marksmanship,12,1,11
Kayoo,stormscale,96,hunter,marksmanship,12,1,11
Râpton,blackmoore,96,hunter,marksmanship,12,1,11
Cauron,blackrock,96,hunter,marksmanship,12,1,11
Volupting,confrérie-du-thorium,96,hunter,marksmanship,23,1,22
Magahra,thrall,95,hunter,marksmanship,6,1,5
Florâ,burning-legion,95,hunter,marksmanship,6,1,5
Gettóbuxa,arathor,79,hunter,marksmanship,5,1,4
Aesrh,drakthul,79,hunter,marksmanship,5,1,4
Carnivorius,silvermoon,64,hunter,marksmanship,4,1,3
Dréws,kazzak,64,hunter,marksmanship,4,1,3
Draugrinnh,tarren-mill,48,hunter,marksmanship,3,1,2
Howlinjoe,darkspear,48,hunter,marksmanship,9,1,8
Merveilleux,hyjal,42,hunter,marksmanship,11,3,8
Daweí,draenor,42,hunter,marksmanship,9,2,7
Lyiene,silvermoon,42,hunter,marksmanship,10,2,8
Aethelred,azjolnerub,41,hunter,marksmanship,9,2,7
Svinrbglol,arygos,31,hunter,marksmanship,2,1,1
Deathproof,haomarush,31,hunter,marksmanship,2,1,1
Jâyranger,ravencrest,31,hunter,marksmanship,2,1,1
Elgango,blackrock,16,hunter,marksmanship,1,1,0
Imortaltroll,kazzak,16,hunter,marksmanship,1,1,0
Дунморг,grom,16,hunter,marksmanship,1,1,0
Lootgobbo,antonidas,16,hunter,marksmanship,1,1,0
Bicmex,ravencrest,2437,hunter,survival,211,129,82
Brkh,ravencrest,2353,hunter,survival,108,62,46
Pridz,archimonde,2243,hunter,survival,216,113,103
Åíøñs,kazzak,2240,hunter,survival,96,55,41
Gíggí,malganis,2223,hunter,survival,78,44,34
Musen,draenor,2206,hunter,survival,102,55,47
Куфа,blackscar,2193,hunter,survival,84,46,38
Bonquiesha,tarren-mill,2163,hunter,survival,120,69,51
Belaux,archimonde,2158,hunter,survival,391,197,194
Kfcmanagerx,silvermoon,2157,hunter,survival,255,141,114
Corossity,blackmoore,2155,hunter,survival,107,71,36
Zpf,silvermoon,2150,hunter,survival,289,152,137
Harrianlar,ravenholdt,2143,hunter,survival,196,100,96
Goosebite,ravencrest,2141,hunter,survival,216,113,103
Rynex,festung-der-stürme,2134,hunter,survival,78,45,33
Urrane,archimonde,2124,hunter,survival,84,54,30
Rewgodxq,ravencrest,2115,hunter,survival,441,228,213
Yeezu,sylvanas,2114,hunter,survival,144,78,66
Djfortnite,ravencrest,2113,hunter,survival,65,39,26
Nikzeubii,archimonde,2113,hunter,survival,66,39,27
Krakenaspect,kazzak,2112,hunter,survival,74,47,27
Sneakyshot,nemesis,2109,hunter,survival,185,94,91
Gukexa,outland,2106,hunter,survival,84,51,33
Momohenní,archimonde,2105,hunter,survival,234,133,101
Rayadz,nethersturm,2104,hunter,survival,240,124,116
Svinrbglol,arygos,2103,hunter,survival,107,59,48
Razoorine,blackrock,2102,hunter,survival,162,90,72
Josethepimpo,stormscale,2102,hunter,survival,263,135,128
Bubby,burning-legion,2100,hunter,survival,86,50,36
Macrolaim,outland,2097,hunter,survival,359,179,180
Scypher,ragnaros,2092,hunter,survival,80,49,31
Earfalass,twisting-nether,2082,hunter,survival,256,143,113
Fíng,tarren-mill,2079,hunter,survival,216,109,107
Stormblãze,ravencrest,2076,hunter,survival,187,92,95
Gukéx,stormscale,2068,hunter,survival,450,233,217
Jànet,ravencrest,2067,hunter,survival,138,68,70
Uglybaboon,draenor,2064,hunter,survival,305,150,155
Zhulk,los-errantes,2063,hunter,survival,220,114,106
Djheartstrng,argent-dawn,2057,hunter,survival,150,86,64
Götdelen,kult-der-verdammten,2053,hunter,survival,341,176,165
Yake,kazzak,2042,hunter,survival,118,58,60
Mestar,outland,2041,hunter,survival,282,143,139
Razôr,blackhand,2031,hunter,survival,72,45,27
Lutza,sanguino,2030,hunter,survival,162,85,77
Wickked,ravencrest,2018,hunter,survival,102,60,42
Pokefangirlx,grim-batol,2014,hunter,survival,319,172,147
Ekexy,aegwynn,2012,hunter,survival,119,69,50
Booxun,sylvanas,2011,hunter,survival,145,75,70
Imtpain,kazzak,2007,hunter,survival,78,45,33
Akronis,outland,2006,hunter,survival,157,79,78
Huntity,kazzak,2003,hunter,survival,119,63,56
Bnak,thrall,1993,hunter,survival,71,42,29
Marvelmary,ravencrest,1988,hunter,survival,127,59,68
Ilovejwrld,dun-modr,1984,hunter,survival,100,51,49
Løvebombing,ravencrest,1982,hunter,survival,70,44,26
Epicsurvive,ravencrest,1982,hunter,survival,114,57,57
Hühneknubbel,blackmoore,1981,hunter,survival,72,39,33
Майен,thermaplugg,1981,hunter,survival,168,85,83
Rubydacherrý,argent-dawn,1980,hunter,survival,84,51,33
Garxzhunter,tarren-mill,1978,hunter,survival,87,48,39
Lultrap,nemesis,1977,hunter,survival,36,25,11
Mmkekw,guldan,1976,hunter,survival,66,42,24
Dackeldustin,norgannon,1970,hunter,survival,59,50,9
Feignfisto,draenor,1966,hunter,survival,75,41,34
Hyderr,aegwynn,1964,hunter,survival,54,34,20
Kurdo,outland,1963,hunter,survival,70,41,29
Queueagain,stormscale,1957,hunter,survival,42,28,14
Marchik,outland,1956,hunter,survival,76,50,26
Mspt,archimonde,1956,hunter,survival,165,81,84
Sneakyshoot,nemesis,1953,hunter,survival,113,65,48
Aboleon,ragnaros,1949,hunter,survival,116,58,58
Jamboss,twisting-nether,1945,hunter,survival,60,29,31
Fatbushpig,stormscale,1941,hunter,survival,108,60,48
Lágåta,outland,1940,hunter,survival,59,32,27
Svetlanatrap,stormscale,1939,hunter,survival,101,54,47
Katzila,outland,1937,hunter,survival,71,44,27
Alvúk,kazzak,1937,hunter,survival,57,32,25
Kaghrot,ragnaros,1937,hunter,survival,204,103,101
Islide,ravencrest,1937,hunter,survival,54,26,28
Nwnw,tarren-mill,1932,hunter,survival,48,27,21
Raelaf,zuljin,1927,hunter,survival,79,39,40
Nttcoopzz,silvermoon,1926,hunter,survival,78,48,30
Yemistar,archimonde,1924,hunter,survival,108,56,52
Jamesyy,ravencrest,1920,hunter,survival,65,41,24
Saliressa,ravencrest,1917,hunter,survival,126,67,59
Vènuhá,ravencrest,1914,hunter,survival,317,169,148
Блатнайт,blackscar,1913,hunter,survival,228,116,112
Karuso,ravencrest,1911,hunter,survival,77,33,44
Kalthrog,ragnaros,1908,hunter,survival,118,69,49
Kyosoku,silvermoon,1908,hunter,survival,69,33,36
Mógwaí,stormscale,1906,hunter,survival,114,70,44
Mogumogu,blackhand,1903,hunter,survival,146,77,69
Dyndns,blackmoore,1903,hunter,survival,156,77,79
Síraw,tarren-mill,1903,hunter,survival,108,53,55
Lagich,stormscale,1902,hunter,survival,58,35,23
Skewdar,hyjal,1896,hunter,survival,186,94,92
Fotmspec,tarren-mill,1892,hunter,survival,48,32,16
Crucfixion,kazzak,1892,hunter,survival,132,66,66
Onlylfg,drakthul,1888,hunter,survival,128,69,59
Saedelaerex,twisting-nether,1887,hunter,survival,196,115,81
Buoma,kazzak,1885,hunter,survival,109,59,50
Killerkatze,outland,1884,hunter,survival,48,25,23
Farell,laughing-skull,1883,hunter,survival,72,42,30
Merryhuntin,ravencrest,1882,hunter,survival,78,43,35
Obbnfriends,ravencrest,1877,hunter,survival,119,61,58
Лесбиянюсь,gordunni,1874,hunter,survival,173,91,82
Аркеро,soulflayer,1873,hunter,survival,115,65,50
Астериел,blackscar,1873,hunter,survival,58,30,28
Horku,kazzak,1871,hunter,survival,72,35,37
Bláckthorn,ravencrest,1868,hunter,survival,118,68,50
Jackjager,ravencrest,1868,hunter,survival,123,67,56
Hyparion,kazzak,1868,hunter,survival,105,54,51
Draxil,archimonde,1867,hunter,survival,156,86,70
Хансбург,howling-fjord,1866,hunter,survival,128,68,60
Mortybeans,ravencrest,1865,hunter,survival,57,31,26
Lugnåls,hyjal,1865,hunter,survival,141,73,68
Glosendra,ravencrest,1863,hunter,survival,168,93,75
Hekyna,ravencrest,1859,hunter,survival,85,53,32
Nintara,outland,1859,hunter,survival,97,57,40
Xamisch,eredar,1859,hunter,survival,153,89,64
Микихаса,galakrond,1858,hunter,survival,278,147,131
Moustø,archimonde,1857,hunter,survival,59,33,26
Yosia,draenor,1857,hunter,survival,178,95,83
Nondinhos,burning-legion,1855,hunter,survival,52,30,22
Дарктеххно,howling-fjord,1854,hunter,survival,102,53,49
Woahx,silvermoon,1854,hunter,survival,78,39,39
Clydefrog,outland,1854,hunter,survival,70,35,35
Relo,dun-modr,1853,hunter,survival,84,47,37
Fablet,draenor,1851,hunter,survival,96,56,40
Øvade,argent-dawn,1851,hunter,survival,84,49,35
Летмимейт,howling-fjord,1851,hunter,survival,166,91,75
Sipsomewater,ravencrest,1851,hunter,survival,72,34,38
Глефард,fordragon,1848,hunter,survival,179,100,79
Ехесу,soulflayer,1848,hunter,survival,77,41,36
Ksreport,stormscale,1844,hunter,survival,189,92,97
Búddhìst,ravencrest,1844,hunter,survival,120,58,62
Bnak,die-ewige-wacht,1842,hunter,survival,42,30,12
Sandina,sylvanas,1842,hunter,survival,66,32,34
Бубунн,howling-fjord,1840,hunter,survival,129,78,51
Dabeszt,draenor,1839,hunter,survival,156,87,69
Hûntyhunt,silvermoon,1838,hunter,survival,83,48,35
Daweí,draenor,1838,hunter,survival,102,53,49
Maiver,ravencrest,1837,hunter,survival,42,26,16
Alwaysthug,ravencrest,1836,hunter,survival,93,46,47
Zerberas,blackrock,1835,hunter,survival,60,32,28
Dîdierraoult,archimonde,1833,hunter,survival,35,20,15
Квит,blackscar,1832,hunter,survival,30,20,10
Privelle,argent-dawn,1832,hunter,survival,42,27,15
Боцекабузер,galakrond,1830,hunter,survival,48,22,26
Fwaffidack,tarren-mill,1829,hunter,survival,63,36,27
Dedral,aegwynn,1829,hunter,survival,90,51,39
Vunter,malganis,1828,hunter,survival,48,26,22
Kukenisluken,stormscale,1827,hunter,survival,41,26,15
Jabela,eredar,1827,hunter,survival,154,84,70
Xexhel,twisting-nether,1824,hunter,survival,92,53,39
Sarrow,ravencrest,1822,hunter,survival,115,64,51
Qwèrts,stormscale,1822,hunter,survival,60,33,27
Dorkos,sanguino,1822,hunter,survival,63,34,29
Doghxnter,ravencrest,1819,hunter,survival,53,31,22
Nixerious,alakir,1819,hunter,survival,126,73,53
Skârlock,blackmoore,1819,hunter,survival,89,50,39
Cadier,argent-dawn,1818,hunter,survival,60,34,26
Raínbow,aegwynn,1818,hunter,survival,114,64,50
Зеленыйиисус,gordunni,1818,hunter,survival,153,84,69
Exquisitor,draenor,1818,hunter,survival,562,283,279
Stuckstepbro,silvermoon,1818,hunter,survival,47,22,25
Ðévi,ravencrest,1817,hunter,survival,38,27,11
Киссмайпет,howling-fjord,1815,hunter,survival,78,47,31
Erethrus,ravencrest,1810,hunter,survival,80,41,39
Леоа,howling-fjord,1808,hunter,survival,71,36,35
Errowini,blackmoore,1807,hunter,survival,66,38,28
Dzago,burning-legion,1807,hunter,survival,62,28,34
Irefutabilâ,outland,1806,hunter,survival,35,20,15
Magicnanø,nemesis,1806,hunter,survival,45,21,24
Кисяныч,gordunni,1805,hunter,survival,78,48,30
Соняпиво,gordunni,1804,hunter,survival,72,41,31
Мигнитюша,blackscar,1803,hunter,survival,48,27,21
Cjezka,blackmoore,1803,hunter,survival,195,95,100
Xlít,outland,1802,hunter,survival,54,29,25
Polaqu,burning-legion,1801,hunter,survival,72,42,30
Unsáinted,ravencrest,1801,hunter,survival,359,192,167
Inter,hellscream,1801,hunter,survival,56,28,28
Thalanos,antonidas,1800,hunter,survival,48,26,22
Brattamer,twisting-nether,1798,hunter,survival,71,47,24
Burbutsuluki,silvermoon,1798,hunter,survival,66,33,33
Agnêas,silvermoon,1797,hunter,survival,84,43,41
Hunjo,quelthalas,1797,hunter,survival,155,74,81
Sphexya,ravencrest,1796,hunter,survival,120,59,61
Avaren,archimonde,1794,hunter,survival,124,63,61
Alexdi,kazzak,1793,hunter,survival,84,39,45
Zanpa,archimonde,1791,hunter,survival,159,86,73
Jske,silvermoon,1790,hunter,survival,86,49,37
Бамбра,thermaplugg,1787,hunter,survival,114,57,57
Eunte,archimonde,1786,hunter,survival,164,85,79
Thugzilla,auchindoun,1784,hunter,survival,77,42,35
Åzey,hyjal,1783,hunter,survival,115,66,49
Xallis,outland,1781,hunter,survival,92,54,38
Astair,hyjal,1780,hunter,survival,144,81,63
Горгонт,blackscar,1779,hunter,survival,174,89,85
Твояпомощь,gordunni,1777,hunter,survival,60,40,20
Jögga,draenor,1777,hunter,survival,54,33,21
Kq,argent-dawn,1776,hunter,survival,63,34,29
Ódelagga,sylvanas,1775,hunter,survival,248,136,112
Merquryh,ravencrest,1773,hunter,survival,30,23,7
Marryme,blackhand,1773,hunter,survival,128,76,52
Calesthas,tarren-mill,1771,hunter,survival,120,60,60
Ravebae,silvermoon,1771,hunter,survival,359,177,182
Dreämhäck,ravencrest,1768,hunter,survival,78,47,31
Zapzy,ravencrest,1760,hunter,survival,261,139,122
Lxoh,turalyon,1760,hunter,survival,585,298,287
Chrønôs,archimonde,1758,hunter,survival,47,27,20
Lìmpy,stormreaver,1757,hunter,survival,48,29,19
Madzynette,archimonde,1757,hunter,survival,95,53,42
Pwon,ravencrest,1757,hunter,survival,248,129,119
Easyclass,hyjal,1756,hunter,survival,78,40,38
Notikâ,aegwynn,1755,hunter,survival,357,191,166
Minibicmex,aegwynn,1753,hunter,survival,106,53,53
Petshøp,outland,1752,hunter,survival,30,23,7
Dheredre,silvermoon,1749,hunter,survival,53,28,25
Clifton,archimonde,1748,hunter,survival,42,27,15
Betarayjinx,kazzak,1748,hunter,survival,105,56,49
Mewithoutyou,ragnaros,1748,hunter,survival,304,148,156
Eilosh,outland,1743,hunter,survival,72,38,34
Nienel,archimonde,1742,hunter,survival,192,94,98
Amyst,senjin,1742,hunter,survival,77,33,44
Sunyjuyono,ravencrest,1741,hunter,survival,95,47,48
Shøt,stormreaver,1738,hunter,survival,88,51,37
Calyssae,shattered-halls,1737,hunter,survival,141,82,59
Døvah,argent-dawn,1737,hunter,survival,60,33,27
Âmalphy,ravencrest,1737,hunter,survival,60,27,33
Kayhh,stormscale,1736,hunter,survival,24,19,5
Skytraped,hyjal,1736,hunter,survival,53,34,19
Monkeytrapz,norgannon,1733,hunter,survival,72,38,34
Knokkelmann,outland,1730,hunter,survival,60,33,27
Slougshot,archimonde,1727,hunter,survival,83,46,37
Næmes,hyjal,1725,hunter,survival,70,40,30
Evengance,dragonblight,1724,hunter,survival,36,22,14
Смертонносна,lich-king,1724,hunter,survival,44,26,18
Thalanos,blackmoore,1724,hunter,survival,55,25,30
Djshibalxd,argent-dawn,1723,hunter,survival,353,171,182
Shotazz,frostmane,1722,hunter,survival,60,36,24
Morkahs,dalaran,1722,hunter,survival,66,38,28
Pecorinö,archimonde,1722,hunter,survival,48,24,24
Boops,ragnaros,1722,hunter,survival,156,74,82
Gurrmex,stormscale,1718,hunter,survival,44,24,20
Gedept,blackrock,1716,hunter,survival,110,59,51
Тэмплест,howling-fjord,1714,hunter,survival,48,32,16
Paxiwtf,eredar,1713,hunter,survival,40,26,14
Wicmex,les-sentinelles,1713,hunter,survival,33,21,12
Критпояйцам,howling-fjord,1712,hunter,survival,41,24,17
Shiceloch,blackmoore,1712,hunter,survival,65,33,32
Варкраб,blackscar,1711,hunter,survival,93,51,42
Cyhi,ravencrest,1711,hunter,survival,36,18,18
Субоота,gordunni,1710,hunter,survival,229,117,112
Xiumiune,antonidas,1708,hunter,survival,131,74,57
Reptile,outland,1707,hunter,survival,24,18,6
Techpøint,silvermoon,1707,hunter,survival,30,21,9
Poggersdaddy,kazzak,1707,hunter,survival,48,28,20
Копия,azuregos,1705,hunter,survival,118,56,62
Natchell,ysondre,1704,hunter,survival,66,34,32
Regale,archimonde,1704,hunter,survival,240,117,123
Ntwoõ,ravencrest,1701,hunter,survival,113,63,50
Motri,tarren-mill,1701,hunter,survival,109,58,51
Bicmeks,ravencrest,1700,hunter,survival,36,23,13
Survivartji,burning-legion,1700,hunter,survival,48,25,23
Zoo,archimonde,1700,hunter,survival,63,32,31
Veðir,argent-dawn,1700,hunter,survival,110,53,57
Ufecläimbe,eredar,1699,hunter,survival,40,25,15
Jeanpisse,hyjal,1699,hunter,survival,173,93,80
Sorozo,aegwynn,1699,hunter,survival,120,62,58
Focüs,les-sentinelles,1699,hunter,survival,38,19,19
Mahikotwo,arathor,1697,hunter,survival,42,24,18
Grulog,kazzak,1697,hunter,survival,133,63,70
Yazqua,deathwing,1696,hunter,survival,70,42,28
Ластшот,blackscar,1696,hunter,survival,44,24,20
Разплюханка,howling-fjord,1696,hunter,survival,132,68,64
Xhn,stormscale,1695,hunter,survival,132,67,65
Скадхи,blackscar,1695,hunter,survival,240,119,121
Cira,archimonde,1691,hunter,survival,66,36,30
Laayopeh,argent-dawn,1690,hunter,survival,240,122,118
Fiskerr,darksorrow,1688,hunter,survival,48,22,26
Chaxxqt,aegwynn,1687,hunter,survival,51,26,25
Næ,kazzak,1686,hunter,survival,154,87,67
Chopitoo,blackmoore,1686,hunter,survival,144,74,70
Frapt,dalaran,1684,hunter,survival,34,20,14
Lukez,ravencrest,1684,hunter,survival,60,35,25
Véncsótány,ragnaros,1684,hunter,survival,93,49,44
Детмазай,soulflayer,1684,hunter,survival,36,18,18
Kurkelx,ravencrest,1683,hunter,survival,84,49,35
Zacxx,ravencrest,1682,hunter,survival,95,63,32
Skyh,outland,1682,hunter,survival,127,63,64
Wonkeedx,ravencrest,1681,hunter,survival,48,23,25
Фломидзе,gordunni,1680,hunter,survival,265,143,122
Trapbot,drakthul,1680,hunter,survival,48,23,25
Nastynutshot,stormscale,1678,hunter,survival,36,23,13
Kajtarn,outland,1678,hunter,survival,90,44,46
Alibigjungle,ravencrest,1678,hunter,survival,48,23,25
Doraxa,sanguino,1678,hunter,survival,116,54,62
Slizzle,sporeggar,1675,hunter,survival,78,42,36
Frog,crushridge,1671,hunter,survival,150,77,73
Arrcher,thrall,1670,hunter,survival,36,26,10
Максиммужик,soulflayer,1670,hunter,survival,30,18,12
Qapheze,silvermoon,1670,hunter,survival,120,69,51
Defix,argent-dawn,1670,hunter,survival,181,94,87
Reelgigachad,archimonde,1668,hunter,survival,42,19,23
Surgethyme,ravencrest,1666,hunter,survival,39,23,16
Skydraz,ysondre,1665,hunter,survival,102,56,46
Liikes,arygos,1664,hunter,survival,48,25,23
Janoh,dalaran,1664,hunter,survival,309,158,151
Pechvogel,blackmoore,1663,hunter,survival,84,48,36
Atalnta,ravencrest,1663,hunter,survival,135,69,66
Waziralwazar,auchindoun,1661,hunter,survival,100,52,48
Иснсейшн,soulflayer,1660,hunter,survival,59,32,27
Subha,quelthalas,1660,hunter,survival,122,66,56
Wuad,silvermoon,1659,hunter,survival,66,37,29
Стингергодх,gordunni,1659,hunter,survival,115,59,56
Нью,soulflayer,1659,hunter,survival,66,27,39
Horxxa,kul-tiras,1658,hunter,survival,120,74,46
Leviáckerman,ravencrest,1657,hunter,survival,42,19,23
Capullospawn,dun-morogh,1656,hunter,survival,65,40,25
Fusko,ysondre,1655,hunter,survival,122,61,61
Tiffanydoll,hyjal,1654,hunter,survival,96,53,43
Meghanmarkle,tarren-mill,1653,hunter,survival,39,22,17
Éddiémórphín,kazzak,1653,hunter,survival,54,30,24
Løngßeâm,ysondre,1653,hunter,survival,90,47,43
Zäroury,ravencrest,1653,hunter,survival,64,32,32
Aspects,blackrock,1652,hunter,survival,42,23,19
Zérpent,kazzak,1652,hunter,survival,102,55,47
Dribla,blackhand,1652,hunter,survival,57,30,27
Xelsera,antonidas,1651,hunter,survival,48,27,21
Kirax,ravencrest,1650,hunter,survival,43,23,20
Фираналь,blackscar,1650,hunter,survival,120,60,60
Xxø,ravencrest,1650,hunter,survival,42,21,21
Ashimaru,sylvanas,1649,hunter,survival,60,34,26
Жэш,howling-fjord,1648,hunter,survival,72,37,35
Nurki,the-maelstrom,1647,hunter,survival,71,34,37
Satantrapbot,outland,1647,hunter,survival,114,54,60
Amilienne,nozdormu,1646,hunter,survival,45,22,23
Nazona,blackmoore,1645,hunter,survival,36,24,12
Hiddenstalke,argent-dawn,1645,hunter,survival,29,18,11
Бомбетта,grom,1645,hunter,survival,150,73,77
Erhu,drakthul,1644,hunter,survival,30,18,12
Ryomen,garona,1644,hunter,survival,200,102,98
Crapulegangz,archimonde,1644,hunter,survival,56,20,36
Kértor,die-aldor,1642,hunter,survival,45,26,19
Blvckjvckz,ravencrest,1642,hunter,survival,107,55,52
Clicktrap,runetotem,1641,hunter,survival,56,29,27
Анариэльсин,soulflayer,1640,hunter,survival,243,129,114
Кайракс,gordunni,1639,hunter,survival,42,23,19
Vruh,antonidas,1638,hunter,survival,54,36,18
Legolassexx,stormreaver,1638,hunter,survival,42,23,19
Zulldek,sanguino,1638,hunter,survival,78,42,36
Avizi,anachronos,1637,hunter,survival,90,44,46
Geevhunt,hyjal,1637,hunter,survival,48,22,26
Lottemor,tarren-mill,1636,hunter,survival,101,64,37
Bren,shattrath,1636,hunter,survival,145,75,70
Closeenought,ravencrest,1633,hunter,survival,102,51,51
Виралатта,gordunni,1632,hunter,survival,60,35,25
Geralt,argent-dawn,1632,hunter,survival,54,26,28
Maiverx,ravencrest,1631,hunter,survival,24,17,7
Iloveluna,silvermoon,1631,hunter,survival,24,17,7
ßlackjack,thrall,1630,hunter,survival,60,38,22
Olk,stormscale,1629,hunter,survival,30,17,13
Spiffs,twisting-nether,1628,hunter,survival,84,45,39
Sàvannah,ravencrest,1627,hunter,survival,177,92,85
Stellhammer,kazzak,1626,hunter,survival,58,31,27
Iceyx,stormscale,1624,hunter,survival,49,22,27
Zøk,stormscale,1623,hunter,survival,208,110,98
Миаур,gordunni,1622,hunter,survival,112,54,58
Taurïel,stormscale,1620,hunter,survival,205,114,91
Fådèd,ravencrest,1619,hunter,survival,40,22,18
Urtanis,stormscale,1619,hunter,survival,113,60,53
Алекскиллшот,blackscar,1618,hunter,survival,42,23,19
Waza,grim-batol,1618,hunter,survival,216,111,105
Musekiker,tarren-mill,1617,hunter,survival,38,23,15
Neyv,blackmoore,1617,hunter,survival,75,39,36
Mahikosan,outland,1617,hunter,survival,42,20,22
Iòvól,azuremyst,1616,hunter,survival,162,87,75
Huntaro,blackmoore,1616,hunter,survival,158,81,77
Оверман,azuregos,1616,hunter,survival,54,25,29
Bigbababotan,blackrock,1615,hunter,survival,117,71,46
Fyrya,ravencrest,1615,hunter,survival,36,21,15
Gradevine,twisting-nether,1614,hunter,survival,146,83,63
Ozga,magtheridon,1613,hunter,survival,88,44,44
Bittercoast,stormscale,1613,hunter,survival,53,24,29
Rizlay,the-maelstrom,1612,hunter,survival,216,109,107
Серебрин,howling-fjord,1611,hunter,survival,40,26,14
Weedonyhunt,hyjal,1610,hunter,survival,42,24,18
Sharún,sylvanas,1608,hunter,survival,70,42,28
Галятрицепс,eversong,1608,hunter,survival,79,43,36
Swïtchz,hyjal,1607,hunter,survival,42,27,15
Westcøãst,archimonde,1607,hunter,survival,60,37,23
Ruxhunter,sanguino,1607,hunter,survival,90,50,40
Vincex,ravencrest,1607,hunter,survival,36,17,19
Hawambae,draenor,1606,hunter,survival,52,28,24
Kydérr,aegwynn,1606,hunter,survival,48,23,25
Gorgorm,ravencrest,1606,hunter,survival,36,17,19
Christophèr,grim-batol,1606,hunter,survival,66,31,35
Ashjen,aszune,1605,hunter,survival,85,43,42
Mclooving,runetotem,1604,hunter,survival,49,29,20
Burninghunt,ravencrest,1604,hunter,survival,42,22,20
Jexxa,draenor,1603,hunter,survival,54,34,20
Florya,blackhand,1602,hunter,survival,63,32,31
Axehead,outland,1602,hunter,survival,72,32,40
Сабакаа,borean-tundra,1600,hunter,survival,90,50,40
Pluttbug,xavius,1599,hunter,survival,24,20,4
Juniorm,kazzak,1599,hunter,survival,54,29,25
Losiané,thrall,1599,hunter,survival,98,49,49
Darllene,kazzak,1599,hunter,survival,101,46,55
Dariusmm,silvermoon,1598,hunter,survival,58,32,26
Mahmoudá,archimonde,1596,hunter,survival,36,21,15
Curbý,blackhand,1596,hunter,survival,66,30,36
Snippy,sanguino,1595,hunter,survival,252,119,133
Fyxo,talnivarr,1594,hunter,survival,56,30,26
Zisqa,alleria,1593,hunter,survival,72,37,35
Repap,defias-brotherhood,1593,hunter,survival,48,24,24
Synthyxqt,silvermoon,1590,hunter,survival,241,123,118
Snarer,argent-dawn,1590,hunter,survival,120,61,59
Мэйвиан,gordunni,1589,hunter,survival,36,22,14
Yemmeth,argent-dawn,1589,hunter,survival,264,132,132
Zeer,sylvanas,1589,hunter,survival,207,98,109
Оути,azuregos,1588,hunter,survival,138,76,62
Свадебная,gordunni,1588,hunter,survival,208,109,99
Zeanoff,ravencrest,1588,hunter,survival,48,24,24
Недел,greymane,1587,hunter,survival,48,26,22
Jakis,silvermoon,1586,hunter,survival,73,36,37
Jinxpeasant,twisting-nether,1585,hunter,survival,48,29,19
Sznxøxo,ravencrest,1585,hunter,survival,42,24,18
Nozugzug,blackmoore,1584,hunter,survival,181,99,82
Savageone,frostwhisper,1584,hunter,survival,60,28,32
Æblesaft,stormscale,1583,hunter,survival,54,28,26
Outofarrows,earthen-ring,1582,hunter,survival,60,38,22
Huntdekalité,khaz-modan,1582,hunter,survival,36,19,17
Shubou,silvermoon,1580,hunter,survival,36,19,17
Zion,kul-tiras,1580,hunter,survival,53,27,26
Renathir,argent-dawn,1579,hunter,survival,103,53,50
Оскорбление,howling-fjord,1579,hunter,survival,138,65,73
Rasmi,kazzak,1578,hunter,survival,224,110,114
Oczkuhne,burning-legion,1577,hunter,survival,60,29,31
Trappewpew,blackmoore,1576,hunter,survival,54,29,25
Danissia,argent-dawn,1576,hunter,survival,116,58,58
Подлыйстарик,gordunni,1575,hunter,survival,133,84,49
Смолильщик,gordunni,1575,hunter,survival,119,61,58
Tillhunt,kargath,1573,hunter,survival,87,50,37
Jäegr,hyjal,1572,hunter,survival,72,40,32
Гудхантер,blackscar,1571,hunter,survival,120,64,56
Плутяра,blackscar,1570,hunter,survival,162,75,87
Sparcùs,stormreaver,1569,hunter,survival,60,40,20
Twitche,ravencrest,1568,hunter,survival,148,75,73
Ревирин,gordunni,1567,hunter,survival,30,20,10
Larrylegend,der-rat-von-dalaran,1567,hunter,survival,30,18,12
Каморан,grom,1566,hunter,survival,82,45,37
Жуткойкрот,lich-king,1566,hunter,survival,138,60,78
Orcflayer,outland,1565,hunter,survival,60,31,29
Ранкон,lich-king,1564,hunter,survival,36,18,18
Dhadhar,kazzak,1562,hunter,survival,71,38,33
Vâzâyô,ravencrest,1562,hunter,survival,42,20,22
Annóyance,ravencrest,1561,hunter,survival,54,28,26
Robzyhunter,kazzak,1561,hunter,survival,136,70,66
Skzu,archimonde,1560,hunter,survival,59,35,24
Coopatron,silvermoon,1560,hunter,survival,36,21,15
Wórldz,dun-modr,1560,hunter,survival,36,18,18
Faccacamoale,twisting-nether,1559,hunter,survival,48,21,27
Ävírøñskÿ,ravencrest,1557,hunter,survival,30,18,12
Турбоквардо,howling-fjord,1557,hunter,survival,47,22,25
Khodii,aegwynn,1556,hunter,survival,30,18,12
Headhunterrz,burning-legion,1556,hunter,survival,120,65,55
Coromant,blackrock,1556,hunter,survival,72,34,38
Hræsvëlg,archimonde,1555,hunter,survival,40,22,18
Lunikehunt,eldrethalas,1554,hunter,survival,102,47,55
Хитвейн,gordunni,1553,hunter,survival,96,48,48
Shrapnela,ravencrest,1553,hunter,survival,77,27,50
Akasa,twilights-hammer,1552,hunter,survival,59,31,28
Otekkâ,hyjal,1552,hunter,survival,100,50,50
Skumrask,outland,1552,hunter,survival,54,27,27
Kayvaal,kaelthas,1551,hunter,survival,48,27,21
Survsen,kazzak,1551,hunter,survival,108,58,50
Teztded,ravencrest,1551,hunter,survival,54,29,25
Løwg,drekthar,1549,hunter,survival,84,41,43
Aspergun,ragnaros,1549,hunter,survival,76,35,41
Nillaxy,blackmoore,1547,hunter,survival,61,33,28
Pizzafanatic,blackrock,1547,hunter,survival,59,28,31
Пистоглазка,howling-fjord,1544,hunter,survival,29,18,11
Oggi,draenor,1544,hunter,survival,114,61,53
Jøki,blackmoore,1544,hunter,survival,42,17,25
Jeddaj,stormscale,1543,hunter,survival,149,76,73
Noop,sylvanas,1542,hunter,survival,153,75,78
Bågeniburen,draenor,1541,hunter,survival,36,21,15
Turdy,executus,1541,hunter,survival,100,52,48
Flappypig,stormscale,1541,hunter,survival,44,21,23
Abeji,malygos,1541,hunter,survival,41,19,22
Nemámponetí,drakthul,1540,hunter,survival,84,44,40
Halfogre,draenor,1540,hunter,survival,42,22,20
Albumx,hyjal,1540,hunter,survival,309,156,153
Wikariusz,kazzak,1540,hunter,survival,72,30,42
Slickbackdan,the-maelstrom,1539,hunter,survival,108,60,48
Capd,kazzak,1538,hunter,survival,71,39,32
Jónes,dunemaul,1538,hunter,survival,74,40,34
Ищименявтени,gordunni,1538,hunter,survival,84,43,41
Ledrox,ravencrest,1538,hunter,survival,78,39,39
Zaphody,doomhammer,1537,hunter,survival,161,88,73
Riema,ragnaros,1536,hunter,survival,100,48,52
Blhunt,magtheridon,1535,hunter,survival,34,21,13
Suzumebachi,twisting-nether,1535,hunter,survival,115,63,52
Psychotik,stormreaver,1534,hunter,survival,338,173,165
Knoxblå,stormscale,1533,hunter,survival,24,16,8
Глаззалмаз,howling-fjord,1531,hunter,survival,46,27,19
Китас,soulflayer,1531,hunter,survival,207,118,89
Trapfish,dalaran,1531,hunter,survival,340,180,160
Piercing,stormrage,1531,hunter,survival,42,17,25
Куджикс,gordunni,1531,hunter,survival,44,17,27
Mert,ravencrest,1530,hunter,survival,177,96,81
Badäpple,ravencrest,1530,hunter,survival,56,28,28
Jackdaniéls,twisting-nether,1530,hunter,survival,82,39,43
Kuzes,ravencrest,1529,hunter,survival,107,49,58
Самоанец,gordunni,1528,hunter,survival,54,29,25
Saejku,archimonde,1528,hunter,survival,119,59,60
Vâleriaa,blackrock,1527,hunter,survival,106,53,53
Sheronin,sylvanas,1526,hunter,survival,66,42,24
Warroan,kilrogg,1525,hunter,survival,24,16,8
Raztreadör,dun-modr,1525,hunter,survival,342,175,167
Cenesthesia,draenor,1524,hunter,survival,130,68,62
Lowfet,neptulon,1524,hunter,survival,162,80,82
Axered,outland,1523,hunter,survival,30,17,13
Neddly,draenor,1523,hunter,survival,36,16,20
Fmatzen,the-maelstrom,1522,hunter,survival,96,45,51
Гаррельд,blackscar,1521,hunter,survival,78,42,36
Beaststeaks,thrall,1519,hunter,survival,46,26,20
Vexxed,thrall,1518,hunter,survival,36,21,15
Badboyxoxo,stormscale,1517,hunter,survival,139,81,58
Óneshóter,madmortem,1515,hunter,survival,92,51,41
Baddschr,blackmoore,1512,hunter,survival,30,18,12
Zrijad,draenor,1510,hunter,survival,50,35,15
Ðrãke,blackmoore,1510,hunter,survival,114,59,55
Mcgloebels,archimonde,1509,hunter,survival,57,33,24
Шадак,soulflayer,1509,hunter,survival,202,106,96
Хальвеген,gordunni,1509,hunter,survival,96,47,49
Джулибуба,howling-fjord,1509,hunter,survival,61,26,35
Morgard,uldum,1506,hunter,survival,36,16,20
Kleiar,dun-modr,1505,hunter,survival,33,17,16
Survivalhunt,draenor,1504,hunter,survival,54,30,24
Petman,area-52,1503,hunter,survival,42,24,18
Молеандрис,gordunni,1503,hunter,survival,81,41,40
Unferth,the-venture-co,1502,hunter,survival,100,49,51
Шеддикс,gordunni,1501,hunter,survival,47,25,22
Melissax,silvermoon,1498,hunter,survival,69,30,39
Andjelaa,kazzak,1496,hunter,survival,60,30,30
Abeba,grim-batol,1496,hunter,survival,59,29,30
Solotrap,kazzak,1495,hunter,survival,39,17,22
Clicker,runetotem,1494,hunter,survival,90,43,47
Chiwa,cthun,1494,hunter,survival,84,37,47
Jäegarn,ravencrest,1493,hunter,survival,24,16,8
Bøøya,aegwynn,1492,hunter,survival,34,24,10
Illnysa,silvermoon,1492,hunter,survival,47,24,23
Ðarrk,tarren-mill,1492,hunter,survival,72,36,36
Хантзер,howling-fjord,1491,hunter,survival,158,75,83
Элфй,gordunni,1490,hunter,survival,51,26,25
Ázurâ,blackhand,1490,hunter,survival,187,89,98
Robinbuds,stormscale,1489,hunter,survival,59,31,28
Kabedon,drakthul,1489,hunter,survival,98,50,48
Lilsnuss,outland,1488,hunter,survival,48,27,21
Dangerears,silvermoon,1488,hunter,survival,80,41,39
Hakkoti,argent-dawn,1486,hunter,survival,72,36,36
Killitoss,blackmoore,1485,hunter,survival,58,29,29
Чууч,blackscar,1485,hunter,survival,236,108,128
Phesx,sylvanas,1484,hunter,survival,42,18,24
Rolky,silvermoon,1483,hunter,survival,76,43,33
Kaynor,dalaran,1482,hunter,survival,36,20,16
Плутис,howling-fjord,1482,hunter,survival,108,47,61
Kobayashi,arathor,1481,hunter,survival,237,120,117
Spidak,stormscale,1479,hunter,survival,42,21,21
Sayn,la-croisade-écarlate,1478,hunter,survival,80,42,38
Чужойй,howling-fjord,1478,hunter,survival,54,28,26
Rettoo,aszune,1478,hunter,survival,54,28,26
Ravendy,stormscale,1478,hunter,survival,54,25,29
Akibane,blackmoore,1475,hunter,survival,38,21,17
Яшатаю,soulflayer,1474,hunter,survival,57,35,22
Onyros,hyjal,1474,hunter,survival,60,27,33
Feignindeath,twisting-nether,1473,hunter,survival,124,69,55
Himatoumi,elune,1473,hunter,survival,42,21,21
Babûsch,blackmoore,1473,hunter,survival,102,44,58
Bigter,arathor,1472,hunter,survival,62,35,27
Крэин,howling-fjord,1472,hunter,survival,94,49,45
Bigmøist,ravencrest,1470,hunter,survival,180,95,85
Hreo,twisting-nether,1467,hunter,survival,90,45,45
Jailevaccin,khaz-modan,1465,hunter,survival,175,84,91
Танчибосс,soulflayer,1464,hunter,survival,139,67,72
Blackwarz,la-croisade-écarlate,1462,hunter,survival,44,29,15
Ashablack,argent-dawn,1462,hunter,survival,268,143,125
Zuggander,ravencrest,1462,hunter,survival,42,21,21
Луврен,deepholm,1461,hunter,survival,38,19,19
Кир,blackscar,1460,hunter,survival,88,52,36
Zinà,naxxramas,1459,hunter,survival,77,41,36
Graavi,silvermoon,1459,hunter,survival,62,32,30
Shall,outland,1458,hunter,survival,60,31,29
Русланяшный,soulflayer,1458,hunter,survival,102,50,52
Hoffen,dentarg,1456,hunter,survival,48,31,17
Комомура,soulflayer,1456,hunter,survival,179,91,88
Deathwallker,silvermoon,1454,hunter,survival,140,81,59
Headshotxd,ragnaros,1451,hunter,survival,49,21,28
Макфлайь,howling-fjord,1448,hunter,survival,42,18,24
Nalys,argent-dawn,1447,hunter,survival,70,39,31
Карвинн,soulflayer,1446,hunter,survival,63,30,33
Nevêrse,archimonde,1444,hunter,survival,41,17,24
Dorota,auchindoun,1442,hunter,survival,67,35,32
Kazzaak,kazzak,1440,hunter,survival,126,63,63
Звериныйпапа,gordunni,1440,hunter,survival,58,27,31
Kasperle,frostwolf,1439,hunter,survival,30,20,10
Куджикс,soulflayer,1439,hunter,survival,24,15,9
Gormlokar,kazzak,1438,hunter,survival,30,16,14
Ðoñko,hyjal,1438,hunter,survival,223,110,113
Konghans,ravencrest,1437,hunter,survival,91,51,40
Winiswin,stormscale,1436,hunter,survival,24,15,9
Cásper,tarren-mill,1436,hunter,survival,84,48,36
Штынь,gordunni,1436,hunter,survival,84,39,45
Jäinenool,outland,1435,hunter,survival,30,15,15
Svinaset,shattered-hand,1434,hunter,survival,81,44,37
Plebtor,drakthul,1434,hunter,survival,44,19,25
Йинги,gordunni,1432,hunter,survival,101,54,47
Huntsmart,kazzak,1432,hunter,survival,30,15,15
Boggy,outland,1431,hunter,survival,81,42,39
Eufumo,sanguino,1431,hunter,survival,53,26,27
Tyrone,saurfang,1431,hunter,survival,48,19,29
Pyrep,draenor,1430,hunter,survival,42,23,19
Сыньйорита,howling-fjord,1430,hunter,survival,54,28,26
Dashaft,kazzak,1429,hunter,survival,93,52,41
Goblinhood,tarren-mill,1429,hunter,survival,96,53,43
Афганыч,soulflayer,1428,hunter,survival,54,24,30
Buszos,burning-legion,1427,hunter,survival,66,39,27
Vorsord,zuljin,1427,hunter,survival,108,56,52
Вилдфлекс,gordunni,1426,hunter,survival,36,25,11
Artemisïa,archimonde,1426,hunter,survival,72,32,40
Тэуреэль,gordunni,1426,hunter,survival,66,26,40
Ambermyst,outland,1425,hunter,survival,30,16,14
Sjufemman,ravencrest,1425,hunter,survival,42,21,21
Wræqraxx,ravencrest,1424,hunter,survival,168,98,70
Rheyl,dun-morogh,1423,hunter,survival,18,15,3
Хипдо,soulflayer,1422,hunter,survival,30,15,15
Virts,hyjal,1422,hunter,survival,36,15,21
Pentaboule,archimonde,1421,hunter,survival,150,78,72
Enistee,silvermoon,1421,hunter,survival,62,30,32
Shibai,outland,1420,hunter,survival,71,34,37
Борькабритва,soulflayer,1420,hunter,survival,72,33,39
Ashendan,silvermoon,1420,hunter,survival,48,17,31
Мандалорецц,soulflayer,1418,hunter,survival,148,74,74
Перидот,howling-fjord,1417,hunter,survival,30,15,15
Мюнхаусен,gordunni,1416,hunter,survival,37,22,15
Torelk,dalaran,1416,hunter,survival,36,17,19
Nunziatellà,nemesis,1415,hunter,survival,30,15,15
Sívér,antonidas,1414,hunter,survival,90,41,49
Bowmasterjay,kazzak,1413,hunter,survival,63,35,28
Sarttrap,aerie-peak,1413,hunter,survival,72,38,34
Westend,draenor,1413,hunter,survival,54,26,28
Hännibal,nazjatar,1413,hunter,survival,65,30,35
Дэнитрехо,soulflayer,1413,hunter,survival,48,21,27
Bicepspump,dun-morogh,1412,hunter,survival,36,15,21
Сильвиина,eversong,1411,hunter,survival,48,24,24
Röwene,argent-dawn,1410,hunter,survival,62,35,27
Anupephu,stormscale,1410,hunter,survival,30,16,14
Suxino,doomhammer,1410,hunter,survival,118,57,61
Arykes,drakthul,1410,hunter,survival,65,30,35
Санясурв,gordunni,1410,hunter,survival,48,21,27
Kürze,silvermoon,1409,hunter,survival,58,27,31
Kishunt,ravencrest,1408,hunter,survival,33,21,12
Zárnah,defias-brotherhood,1408,hunter,survival,42,15,27
Dauria,blackhand,1406,hunter,survival,44,18,26
Sarbacanes,hyjal,1405,hunter,survival,60,30,30
Grusijohn,executus,1405,hunter,survival,30,15,15
Кфоззи,soulflayer,1403,hunter,survival,48,23,25
Äzul,ysondre,1402,hunter,survival,91,44,47
Heliandra,dun-modr,1400,hunter,survival,42,23,19
Ниалла,thermaplugg,1399,hunter,survival,60,28,32
Bôbby,kelthuzad,1395,hunter,survival,36,17,19
Живучийорех,gordunni,1394,hunter,survival,24,15,9
Айхана,gordunni,1393,hunter,survival,59,35,24
Zehned,ysondre,1392,hunter,survival,110,54,56
Фурболгов,gordunni,1391,hunter,survival,113,57,56
Pewpewronin,the-maelstrom,1390,hunter,survival,69,37,32
Crème,blackrock,1390,hunter,survival,389,192,197
Кулерквест,soulflayer,1390,hunter,survival,144,67,77
Littlhuntard,tarren-mill,1388,hunter,survival,30,17,13
Millebobert,kazzak,1388,hunter,survival,42,20,22
Moralisa,eredar,1388,hunter,survival,66,31,35
Twérk,blackmoore,1387,hunter,survival,71,36,35
Tortoise,blackrock,1386,hunter,survival,21,15,6
Volotyr,ravencrest,1386,hunter,survival,63,36,27
Makeawish,antonidas,1385,hunter,survival,82,44,38
Schwabbels,silvermoon,1384,hunter,survival,30,15,15
Assaultrifle,frostmane,1384,hunter,survival,42,19,23
Sekkeh,ragnaros,1383,hunter,survival,95,47,48
Wastage,draenor,1383,hunter,survival,54,26,28
Бандерака,goldrinn,1382,hunter,survival,54,32,22
Santiägø,archimonde,1380,hunter,survival,66,37,29
Ajko,blackmoore,1378,hunter,survival,60,33,27
Ballistix,elune,1376,hunter,survival,64,29,35
Toesniper,argent-dawn,1375,hunter,survival,75,42,33
Outofcontrol,karazhan,1373,hunter,survival,75,35,40
Wims,terenas,1373,hunter,survival,42,18,24
Darksylvanas,arathor,1372,hunter,survival,47,25,22
Hotgrillexde,sylvanas,1369,hunter,survival,29,15,14
Odmehb,silvermoon,1368,hunter,survival,78,52,26
Shootingu,aegwynn,1368,hunter,survival,226,115,111
Malgorn,burning-legion,1366,hunter,survival,87,51,36
Kalani,la-croisade-écarlate,1366,hunter,survival,202,96,106
Harrak,ysondre,1365,hunter,survival,72,47,25
Hunttes,nagrand,1365,hunter,survival,29,15,14
Cinnè,frostwolf,1364,hunter,survival,28,15,13
Getsniffarn,sylvanas,1362,hunter,survival,114,60,54
Скримзх,gordunni,1360,hunter,survival,103,61,42
Huntiika,silvermoon,1359,hunter,survival,101,49,52
Pls,blackmoore,1359,hunter,survival,35,16,19
Herubin,doomhammer,1357,hunter,survival,111,58,53
Vengefull,draenor,1357,hunter,survival,174,88,86
Myoui,silvermoon,1354,hunter,survival,30,15,15
Gakco,twisting-nether,1353,hunter,survival,72,40,32
Mizumo,burning-legion,1352,hunter,survival,42,16,26
Wolder,burning-legion,1350,hunter,survival,29,15,14
Abovival,ragnaros,1349,hunter,survival,30,20,10
Reðrighthånð,throkferoth,1349,hunter,survival,61,32,29
Juícecannon,twisting-nether,1349,hunter,survival,66,31,35
Ilørell,archimonde,1348,hunter,survival,77,35,42
Yszï,dalaran,1346,hunter,survival,60,32,28
Didzon,ravencrest,1345,hunter,survival,30,18,12
Воррен,howling-fjord,1345,hunter,survival,71,38,33
Ägris,die-todeskrallen,1343,hunter,survival,332,171,161
Вандамос,soulflayer,1343,hunter,survival,148,74,74
Liltitan,tarren-mill,1343,hunter,survival,36,17,19
Shoty,zuluhed,1343,hunter,survival,118,54,64
Santaana,twisting-nether,1343,hunter,survival,50,22,28
Согекхей,gordunni,1343,hunter,survival,120,51,69
Orzâ,blackrock,1342,hunter,survival,36,20,16
Antisober,ravencrest,1341,hunter,survival,18,14,4
Ketaminösa,zuljin,1341,hunter,survival,24,14,10
Cosmokid,shadowsong,1341,hunter,survival,251,138,113
Icetrapped,eredar,1341,hunter,survival,30,14,16
Xaone,blackrock,1340,hunter,survival,18,14,4
Knoxröd,outland,1340,hunter,survival,18,14,4
Рэдхаант,soulflayer,1338,hunter,survival,107,47,60
Amadia,defias-brotherhood,1338,hunter,survival,66,28,38
Snôptas,blackmoore,1337,hunter,survival,32,15,17
Purée,ragnaros,1337,hunter,survival,30,14,16
Roacher,hyjal,1337,hunter,survival,70,32,38
Hexojs,outland,1334,hunter,survival,24,14,10
Jalcer,draenor,1334,hunter,survival,62,28,34
Забзаб,soulflayer,1333,hunter,survival,24,14,10
Spitchy,kazzak,1333,hunter,survival,62,33,29
Grimazg,chogall,1332,hunter,survival,42,25,17
Chupsor,ravencrest,1332,hunter,survival,128,59,69
Dimholdt,grim-batol,1332,hunter,survival,36,14,22
Oneshootqt,aegwynn,1331,hunter,survival,91,48,43
Adram,burning-legion,1331,hunter,survival,64,30,34
Ryubeast,hyjal,1330,hunter,survival,24,14,10
Larinaa,blackmoore,1329,hunter,survival,30,16,14
Misscreggor,ravencrest,1328,hunter,survival,66,28,38
Beksha,blackrock,1325,hunter,survival,24,14,10
Bláckheart,doomhammer,1325,hunter,survival,34,18,16
Edshoot,hyjal,1325,hunter,survival,69,33,36
Itchy,das-syndikat,1325,hunter,survival,128,61,67
Noréaga,suramar,1325,hunter,survival,42,19,23
Badhunt,stormscale,1325,hunter,survival,36,16,20
Kamayail,skullcrusher,1324,hunter,survival,86,44,42
Murotar,dalaran,1323,hunter,survival,30,18,12
Стивстифлер,razuvious,1323,hunter,survival,84,44,40
Jamalinho,silvermoon,1322,hunter,survival,60,38,22
Tortillia,madmortem,1322,hunter,survival,150,72,78
Torrë,sanguino,1322,hunter,survival,115,55,60
Girlfwiend,argent-dawn,1320,hunter,survival,66,30,36
Speartusk,blackhand,1319,hunter,survival,42,22,20
Danaetia,aerie-peak,1317,hunter,survival,30,14,16
Алестея,gordunni,1316,hunter,survival,30,14,16
Slagatronic,ragnaros,1314,hunter,survival,114,60,54
Jimpage,eredar,1310,hunter,survival,35,15,20
Pãstèque,ravencrest,1309,hunter,survival,28,15,13
Занзуолли,howling-fjord,1309,hunter,survival,66,32,34
Барабаша,deathguard,1307,hunter,survival,76,30,46
Ubietza,aegwynn,1304,hunter,survival,48,23,25
Karabeg,twisting-nether,1301,hunter,survival,53,22,31
Junglez,nagrand,1298,hunter,survival,70,38,32
Thëoden,cthun,1298,hunter,survival,30,16,14
Iyelee,malfurion,1297,hunter,survival,33,16,17
Steezowl,kazzak,1297,hunter,survival,47,20,27
Prodanhunts,frostmane,1296,hunter,survival,30,14,16
Пятницкий,soulflayer,1292,hunter,survival,53,26,27
Onefatalshot,the-maelstrom,1291,hunter,survival,60,25,35
Lrr,grim-batol,1289,hunter,survival,87,42,45
Zwerghauer,arthas,1286,hunter,survival,42,20,22
Regele,silvermoon,1285,hunter,survival,220,112,108
Tôm,ravencrest,1281,hunter,survival,54,31,23
Ямабусетэнгу,gordunni,1281,hunter,survival,42,19,23
Whyareurunin,silvermoon,1281,hunter,survival,76,32,44
Wôôdsy,blackrock,1280,hunter,survival,48,22,26
Calculate,silvermoon,1272,hunter,survival,41,19,22
Míoo,antonidas,1270,hunter,survival,168,85,83
Desertgipsy,ragnaros,1269,hunter,survival,40,19,21
Apachy,amanthul,1268,hunter,survival,35,17,18
Тике,soulflayer,1267,hunter,survival,116,59,57
Dhmain,frostmane,1267,hunter,survival,93,40,53
Wessin,ysondre,1266,hunter,survival,60,31,29
Мауровани,eversong,1265,hunter,survival,30,16,14
Никизаняты,ashenvale,1264,hunter,survival,42,21,21
Foxyfoxo,guldan,1263,hunter,survival,54,26,28
Doojas,archimonde,1263,hunter,survival,30,14,16
Hopefol,ravencrest,1261,hunter,survival,54,20,34
Jomoguin,stormscale,1260,hunter,survival,57,30,27
Yakx,dun-modr,1260,hunter,survival,36,18,18
Huntanova,antonidas,1259,hunter,survival,72,28,44
Haku,burning-legion,1254,hunter,survival,57,27,30
Henario,ravencrest,1251,hunter,survival,31,15,16
Kaboumba,archimonde,1248,hunter,survival,30,19,11
Rollin,khaz-modan,1247,hunter,survival,24,15,9
Giggiwho,malganis,1247,hunter,survival,30,13,17
Oey,ravencrest,1247,hunter,survival,30,13,17
Jumong,ragnaros,1246,hunter,survival,24,13,11
Sasquaczek,burning-legion,1246,hunter,survival,110,55,55
Lightxyz,ravencrest,1246,hunter,survival,30,13,17
Spliinter,twisting-nether,1245,hunter,survival,58,37,21
Nith,ungoro,1245,hunter,survival,149,75,74
Fyoni,silvermoon,1245,hunter,survival,36,18,18
Caelas,outland,1245,hunter,survival,36,17,19
Vargar,arygos,1245,hunter,survival,30,13,17
Guanchin,silvermoon,1245,hunter,survival,42,16,26
Nkl,archimonde,1243,hunter,survival,30,13,17
Tomasínos,drakthul,1241,hunter,survival,30,13,17
Querro,azshara,1241,hunter,survival,54,17,37
Lascazador,dun-modr,1240,hunter,survival,18,13,5
Sÿkzz,hyjal,1238,hunter,survival,24,13,11
Hasselunden,ravencrest,1237,hunter,survival,24,13,11
Koblajan,draenor,1236,hunter,survival,22,14,8
Caìuz,pozzo-delleternità,1236,hunter,survival,30,13,17
Cliff,kiljaeden,1235,hunter,survival,75,36,39
Sláyer,the-shatar,1233,hunter,survival,82,45,37
Petcan,twisting-nether,1230,hunter,survival,30,13,17
Umani,lightnings-blade,1230,hunter,survival,30,13,17
Zaboozá,ragnaros,1230,hunter,survival,75,31,44
Lebalaffré,arathi,1228,hunter,survival,24,13,11
Мертвыйпсарь,soulflayer,1228,hunter,survival,52,25,27
Dørrak,hyjal,1228,hunter,survival,142,66,76
Døømslayer,nemesis,1226,hunter,survival,47,28,19
Kapitannapas,deathwing,1225,hunter,survival,30,13,17
Lìsica,silvermoon,1223,hunter,survival,24,13,11
Bairex,magtheridon,1222,hunter,survival,120,66,54
Chalid,aegwynn,1222,hunter,survival,60,33,27
Sainttcc,thrall,1221,hunter,survival,78,38,40
Питбуль,deepholm,1219,hunter,survival,30,17,13
Bloodxx,ragnaros,1218,hunter,survival,104,49,55
Bhalmar,the-maelstrom,1218,hunter,survival,30,13,17
Doru,silvermoon,1215,hunter,survival,166,84,82
Eonait,ravencrest,1210,hunter,survival,29,13,16
Kaletorw,ragnaros,1209,hunter,survival,36,17,19
Тельдритис,gordunni,1207,hunter,survival,35,14,21
Aequitaz,blackhand,1207,hunter,survival,44,16,28
Nvukaze,argent-dawn,1205,hunter,survival,39,23,16
Caedus,argent-dawn,1205,hunter,survival,48,18,30
Bâng,zuljin,1204,hunter,survival,30,15,15
Eledanu,blackmoore,1200,hunter,survival,24,16,8
Voltár,antonidas,1198,hunter,survival,76,35,41
Фетсол,soulflayer,1193,hunter,survival,29,13,16
Jarekk,auchindoun,1192,hunter,survival,23,14,9
Wållåce,rexxar,1192,hunter,survival,28,14,14
Skyyw,tarren-mill,1191,hunter,survival,115,55,60
Zudith,sanguino,1186,hunter,survival,53,26,27
Raenard,ragnaros,1186,hunter,survival,33,15,18
Trackmedown,kazzak,1180,hunter,survival,22,13,9
Dragonflayer,sylvanas,1180,hunter,survival,66,37,29
Binhoker,argent-dawn,1173,hunter,survival,18,13,5
Pàtküt,blackmoore,1173,hunter,survival,34,15,19
Эквинтия,soulflayer,1171,hunter,survival,23,13,10
Тофуитер,howling-fjord,1168,hunter,survival,36,13,23
Zisga,blackrock,1167,hunter,survival,30,14,16
Raley,archimonde,1165,hunter,survival,29,13,16
Platza,ragnaros,1162,hunter,survival,36,17,19
Pôîson,kazzak,1158,hunter,survival,155,73,82
Riscante,dun-morogh,1154,hunter,survival,56,28,28
Chamillon,archimonde,1154,hunter,survival,60,26,34
Jám,blackhand,1153,hunter,survival,28,15,13
Alpharaven,ravencrest,1151,hunter,survival,18,12,6
Sniperqueenx,bloodscalp,1151,hunter,survival,18,12,6
Vilopez,arthas,1151,hunter,survival,18,12,6
Ähäkutti,kazzak,1151,hunter,survival,30,12,18
Niro,argent-dawn,1150,hunter,survival,24,12,12
Xoarqt,aegwynn,1150,hunter,survival,24,12,12
Sadmasl,blackmoore,1149,hunter,survival,18,12,6
Rêmøórsêlês,outland,1149,hunter,survival,18,12,6
Еваджонсон,gordunni,1149,hunter,survival,24,12,12
Shergeon,sanguino,1149,hunter,survival,48,22,26
Bacongodx,archimonde,1147,hunter,survival,18,12,6
Sagitari,chamber-of-aspects,1147,hunter,survival,24,12,12
Terrorduni,tarren-mill,1147,hunter,survival,30,12,18
Eyvin,defias-brotherhood,1144,hunter,survival,24,12,12
Zerøskilgodx,antonidas,1143,hunter,survival,18,12,6
Orcpie,defias-brotherhood,1143,hunter,survival,36,16,20
Anklar,blackrock,1142,hunter,survival,30,12,18
Såvëâmäzøñíà,stormscale,1142,hunter,survival,30,12,18
Lepel,draenor,1142,hunter,survival,30,12,18
Jâckíe,aegwynn,1139,hunter,survival,27,13,14
Gilzog,exodar,1138,hunter,survival,30,12,18
Cabaim,eredar,1137,hunter,survival,18,12,6
Хантероо,gordunni,1137,hunter,survival,30,17,13
Grufflin,bronzebeard,1137,hunter,survival,54,22,32
Karruck,tarren-mill,1137,hunter,survival,30,12,18
Absolutnoob,blackrock,1136,hunter,survival,110,56,54
Huntoon,doomhammer,1135,hunter,survival,24,12,12
Autoturret,eredar,1130,hunter,survival,30,12,18
Blackox,zirkel-des-cenarius,1129,hunter,survival,30,14,16
Cämper,aegwynn,1124,hunter,survival,24,12,12
Leemool,ysondre,1123,hunter,survival,30,18,12
Azuren,twisting-nether,1122,hunter,survival,29,13,16
Ayshæ,tarren-mill,1119,hunter,survival,114,48,66
Fãdê,ravencrest,1118,hunter,survival,20,13,7
Phiix,blackhand,1117,hunter,survival,24,13,11
Encharged,kazzak,1117,hunter,survival,30,12,18
Marvii,drakthul,1117,hunter,survival,66,26,40
Zimmoo,tarren-mill,1116,hunter,survival,57,21,36
Renegansnipe,silvermoon,1115,hunter,survival,48,18,30
Miggs,hellfire,1113,hunter,survival,84,40,44
Floris,outland,1108,hunter,survival,114,50,64
Зомбим,soulflayer,1103,hunter,survival,53,20,33
Reinschrubba,ravencrest,1100,hunter,survival,29,12,17
Brittany,pozzo-delleternità,1099,hunter,survival,87,46,41
Aszasi,azjolnerub,1096,hunter,survival,23,12,11
Eromoar,outland,1091,hunter,survival,45,20,25
Himba,dentarg,1088,hunter,survival,36,18,18
Фарфира,gordunni,1085,hunter,survival,23,12,11
Mefhunter,tarren-mill,1081,hunter,survival,17,12,5
Sliki,auchindoun,1079,hunter,survival,49,18,31
Archfiend,stormscale,1077,hunter,survival,27,12,15
Therön,silvermoon,1074,hunter,survival,71,23,48
Tessuti,doomhammer,1065,hunter,survival,38,13,25
Daiking,pozzo-delleternità,1064,hunter,survival,160,68,92
Milandra,the-maelstrom,1061,hunter,survival,112,55,57
Djsecousse,hyjal,1056,hunter,survival,18,11,7
Guccyfied,blackrock,1056,hunter,survival,18,11,7
Speedymarieh,argent-dawn,1056,hunter,survival,18,11,7
Supcuz,stormscale,1056,hunter,survival,24,11,13
Epicsurvive,kazzak,1056,hunter,survival,30,11,19
Djurmästaren,ravencrest,1055,hunter,survival,18,11,7
Syniix,ravencrest,1055,hunter,survival,18,11,7
Djtrápálót,dragonmaw,1055,hunter,survival,18,11,7
Jayquillen,sylvanas,1055,hunter,survival,24,11,13
Ремонтлицаа,gordunni,1055,hunter,survival,24,11,13
Theeonetime,ravencrest,1055,hunter,survival,30,11,19
Talent,bronzebeard,1054,hunter,survival,18,11,7
Tràpz,archimonde,1053,hunter,survival,18,11,7
Nobuno,dun-modr,1053,hunter,survival,18,11,7
Неужто,deathguard,1053,hunter,survival,24,11,13
Cataleýà,outland,1052,hunter,survival,18,11,7
Abgeherjoe,antonidas,1051,hunter,survival,30,11,19
Isøbu,hyjal,1047,hunter,survival,30,11,19
Haileyjones,darkmoon-faire,1046,hunter,survival,18,11,7
Klittcrit,bloodhoof,1046,hunter,survival,24,11,13
Haranti,dun-modr,1042,hunter,survival,18,11,7
Cazados,shendralar,1038,hunter,survival,28,12,16
Ertestuing,tarren-mill,1032,hunter,survival,30,11,19
Yukina,frostmourne,1027,hunter,survival,30,11,19
Yinn,kilrogg,1026,hunter,survival,115,51,64
Bawzé,archimonde,1022,hunter,survival,22,11,11
Nèxz,blackrock,1021,hunter,survival,29,11,18
Shanè,blackrock,1021,hunter,survival,36,13,23
Szybky,defias-brotherhood,1017,hunter,survival,18,11,7
Utt,argent-dawn,1016,hunter,survival,47,16,31
Giobi,draenor,1013,hunter,survival,36,20,16
Worlogosh,stormscale,1010,hunter,survival,23,11,12
Midooaa,nerathor,1007,hunter,survival,17,11,6
Zofía,ravencrest,1007,hunter,survival,36,15,21
Kubelwagen,dun-modr,1004,hunter,survival,23,11,12
Yvenne,uldaman,1003,hunter,survival,23,12,11
Kinaou,sargeras,1003,hunter,survival,54,25,29
Animàl,argent-dawn,988,hunter,survival,22,11,11
Keinzira,hyjal,988,hunter,survival,32,12,20
Huntoruu,outland,983,hunter,survival,113,48,65
Naramir,ysondre,981,hunter,survival,38,11,27
Agarez,blackrock,978,hunter,survival,60,26,34
Änubïs,culte-de-la-rive-noire,973,hunter,survival,28,12,16
Крысюкпифпаф,blackscar,971,hunter,survival,19,11,8
Trapyourheal,archimonde,967,hunter,survival,36,16,20
Аминотоксид,blackscar,960,hunter,survival,12,10,2
Reviam,ravencrest,960,hunter,survival,12,10,2
Tayu,throkferoth,960,hunter,survival,12,10,2
Neilime,marécage-de-zangar,960,hunter,survival,80,37,43
Nayeem,silvermoon,959,hunter,survival,12,10,2
Ynv,argent-dawn,959,hunter,survival,12,10,2
Smøkyyjk,eredar,959,hunter,survival,18,10,8
Fóx,sunstrider,959,hunter,survival,18,10,8
Патчхороший,howling-fjord,959,hunter,survival,18,10,8
Ohboy,dun-morogh,959,hunter,survival,18,10,8
Painaldeepz,stormscale,959,hunter,survival,18,10,8
Canezhnt,aegwynn,959,hunter,survival,18,10,8
Badboybørge,draenor,959,hunter,survival,18,10,8
Masthuhn,blackmoore,959,hunter,survival,24,10,14
Cryts,dun-modr,959,hunter,survival,24,10,14
Iphonexr,archimonde,958,hunter,survival,12,10,2
Уроборос,gordunni,958,hunter,survival,18,10,8
Менстряк,deathguard,958,hunter,survival,18,10,8
Silverlaine,quelthalas,957,hunter,survival,12,10,2
Elyar,eredar,957,hunter,survival,18,10,8
Dekax,blackhand,957,hunter,survival,20,10,10
Starkt,ragnaros,956,hunter,survival,24,10,14
Раелиин,gordunni,955,hunter,survival,24,10,14
Цезарьрома,soulflayer,955,hunter,survival,33,10,23
Nokti,die-ewige-wacht,954,hunter,survival,18,10,8
Shenra,argent-dawn,954,hunter,survival,18,10,8
Hevl,silvermoon,954,hunter,survival,18,10,8
Memli,uldaman,950,hunter,survival,18,10,8
Marluxiâ,archimonde,947,hunter,survival,30,11,19
Zipzâp,blackrock,936,hunter,survival,18,10,8
Shannaë,sanguino,924,hunter,survival,12,10,2
Louårn,hyjal,924,hunter,survival,81,27,54
Reenacer,dun-modr,920,hunter,survival,60,28,32
Karasana,earthen-ring,912,hunter,survival,32,11,21
Arashïn,silvermoon,911,hunter,survival,21,10,11
Maikbb,stormreaver,910,hunter,survival,23,10,13
Chillibetv,blackrock,906,hunter,survival,27,11,16
Gerzyy,drakthul,906,hunter,survival,28,11,17
Jezter,darksorrow,905,hunter,survival,27,10,17
Eretreyya,draenor,901,hunter,survival,28,13,15
Djøgi,archimonde,892,hunter,survival,22,10,12
Ирртой,grom,885,hunter,survival,24,10,14
Greel,saurfang,871,hunter,survival,147,67,80
Bowkeeper,kazzak,870,hunter,survival,103,50,53
Crøxx,archimonde,864,hunter,survival,12,9,3
Veganmuscles,madmortem,864,hunter,survival,15,10,5
Nßatrapper,outland,864,hunter,survival,17,9,8
Bùddhíst,ravencrest,864,hunter,survival,18,9,9
Rynextwo,khaz-modan,864,hunter,survival,18,9,9
Vukal,kazzak,864,hunter,survival,18,9,9
Feyoonxx,blackrock,864,hunter,survival,18,9,9
Deuteríum,outland,864,hunter,survival,18,9,9
Nooksem,blackrock,864,hunter,survival,24,9,15
Mileysaures,stormscale,863,hunter,survival,12,9,3
Tomli,nemesis,863,hunter,survival,12,9,3
Murkek,drakthul,863,hunter,survival,12,9,3
Kravchenko,draenor,863,hunter,survival,12,9,3
Merkabba,kazzak,863,hunter,survival,18,9,9
Nirn,ravencrest,863,hunter,survival,18,9,9
Waizen,archimonde,863,hunter,survival,18,9,9
Тиометра,gordunni,862,hunter,survival,12,9,3
Kailley,conseil-des-ombres,862,hunter,survival,12,9,3
Sebikh,ravencrest,861,hunter,survival,12,9,3
Fluffiis,twisting-nether,861,hunter,survival,12,9,3
Kissnodig,outland,861,hunter,survival,18,9,9
Välk,sylvanas,860,hunter,survival,18,9,9
Secrety,doomhammer,860,hunter,survival,18,9,9
Alithanar,drekthar,860,hunter,survival,30,9,21
Пивпавнах,gordunni,859,hunter,survival,12,9,3
Koblih,draenor,859,hunter,survival,36,9,27
Gyurkicz,hyjal,858,hunter,survival,18,9,9
Madtony,aegwynn,858,hunter,survival,24,9,15
Mufassa,sinstralis,849,hunter,survival,18,9,9
Лукасика,ashenvale,847,hunter,survival,30,11,19
Beaupapa,archimonde,846,hunter,survival,18,9,9
Wolfína,drakthul,842,hunter,survival,30,9,21
Powerhord,burning-legion,839,hunter,survival,41,16,25
Charlet,archimonde,837,hunter,survival,18,9,9
Trabucones,sanguino,830,hunter,survival,24,9,15
Louce,argent-dawn,810,hunter,survival,26,10,16
Lofiv,turalyon,799,hunter,survival,16,9,7
Норапина,eversong,773,hunter,survival,54,24,30
Dumbfoundead,argent-dawn,768,hunter,survival,12,8,4
Ostarintero,stormreaver,768,hunter,survival,12,8,4
Slighth,ragnaros,768,hunter,survival,12,8,4
Fub,eredar,768,hunter,survival,12,8,4
Techpoint,silvermoon,768,hunter,survival,12,8,4
Velen,pozzo-delleternità,768,hunter,survival,12,8,4
Joetheripper,dun-modr,768,hunter,survival,12,8,4
Scopieturner,burning-blade,768,hunter,survival,12,8,4
Jaggy,hyjal,768,hunter,survival,12,8,4
Adefthunt,kazzak,768,hunter,survival,12,8,4
Equiph,silvermoon,768,hunter,survival,18,8,10
Notrexx,kazzak,768,hunter,survival,18,8,10
Трапавграунд,howling-fjord,768,hunter,survival,18,8,10
Пьёт,gordunni,768,hunter,survival,18,8,10
Ormassey,drakthul,768,hunter,survival,18,8,10
Bø,burning-blade,768,hunter,survival,18,8,10
Янемилашка,howling-fjord,768,hunter,survival,24,8,16
Viperr,nemesis,768,hunter,survival,30,8,22
Øpedro,kirin-tor,767,hunter,survival,12,8,4
Luftikuss,arthas,767,hunter,survival,12,8,4
Scröte,draenor,767,hunter,survival,12,8,4
Alissón,aegwynn,767,hunter,survival,12,8,4
Тиандриса,soulflayer,767,hunter,survival,12,8,4
Lockshot,ragnaros,767,hunter,survival,12,8,4
Суперструнка,gordunni,767,hunter,survival,12,8,4
Scarletgirl,draenor,767,hunter,survival,18,8,10
Ямилигодц,soulflayer,767,hunter,survival,18,8,10
Tyqqepiq,the-maelstrom,767,hunter,survival,18,8,10
Yonsa,blackmoore,767,hunter,survival,18,8,10
Double,sylvanas,767,hunter,survival,18,8,10
Hulnhigh,grim-batol,767,hunter,survival,18,8,10
Вкинулматрас,gordunni,767,hunter,survival,18,8,10
Arnakua,outland,767,hunter,survival,18,8,10
Nawaal,kazzak,767,hunter,survival,18,8,10
Kaj,kelthuzad,766,hunter,survival,18,8,10
Анютикус,gordunni,766,hunter,survival,18,8,10
Вуйчеч,howling-fjord,766,hunter,survival,24,8,16
Twinkies,ysondre,765,hunter,survival,12,8,4
Lînc,twisting-nether,765,hunter,survival,12,8,4
Lucrecius,magtheridon,765,hunter,survival,18,8,10
Pispirelul,ravencrest,765,hunter,survival,21,9,12
Темикс,ashenvale,765,hunter,survival,22,9,13
Травмаопасен,gordunni,765,hunter,survival,28,9,19
Nece,argent-dawn,764,hunter,survival,24,8,16
Harmonía,outland,764,hunter,survival,24,8,16
Лютыйхант,lich-king,763,hunter,survival,18,8,10
Haskeer,shattrath,763,hunter,survival,24,8,16
Риппер,gordunni,762,hunter,survival,24,8,16
Кардеин,gordunni,761,hunter,survival,16,8,8
Läderhora,stormscale,759,hunter,survival,24,8,16
Hntrleka,argent-dawn,757,hunter,survival,24,8,16
Thëhunter,tyrande,749,hunter,survival,17,8,9
Hanibale,burning-blade,740,hunter,survival,31,8,23
Pjållistani,ravencrest,735,hunter,survival,11,8,3
Grytax,outland,719,hunter,survival,11,8,3
Glama,archimonde,719,hunter,survival,11,8,3
Frozenpies,stormscale,719,hunter,survival,21,8,13
Ватмано,gordunni,718,hunter,survival,11,8,3
Killdembro,sunstrider,717,hunter,survival,460,197,263
Soukoukouu,archimonde,704,hunter,survival,16,8,8
Shàlý,antonidas,703,hunter,survival,11,8,3
Ilòóll,veknilash,703,hunter,survival,17,8,9
Reefa,the-maelstrom,702,hunter,survival,11,8,3
Vavabxl,ysondre,702,hunter,survival,16,8,8
Mustyflor,ravencrest,702,hunter,survival,20,8,12
Dexx,kazzak,698,hunter,survival,17,9,8
Rosiee,dun-modr,687,hunter,survival,13,8,5
Гринмех,gordunni,672,hunter,survival,12,7,5
Enim,tarren-mill,672,hunter,survival,12,7,5
Tomorrow,ravencrest,672,hunter,survival,12,7,5
Nulles,ravencrest,672,hunter,survival,12,7,5
Велирона,gordunni,672,hunter,survival,12,7,5
Drvix,outland,672,hunter,survival,12,7,5
Ilovemax,archimonde,672,hunter,survival,12,7,5
Muxilina,ravencrest,672,hunter,survival,12,7,5
Волкорн,gordunni,672,hunter,survival,12,7,5
Nopopehere,draenor,672,hunter,survival,12,7,5
Synaticx,thrall,672,hunter,survival,12,7,5
Trapsgaye,blackmoore,672,hunter,survival,12,7,5
Laptopplayër,ravencrest,672,hunter,survival,12,7,5
Rynex,ravencrest,672,hunter,survival,12,7,5
Трапгодикс,eversong,672,hunter,survival,12,7,5
Atod,dalaran,672,hunter,survival,12,7,5
Çrêñshâw,twisting-nether,672,hunter,survival,12,7,5
Davidghettô,dalaran,672,hunter,survival,12,7,5
Avashah,ravencrest,672,hunter,survival,16,7,9
Moscowmule,tarren-mill,672,hunter,survival,18,7,11
Crostaws,terokkar,672,hunter,survival,18,7,11
Kapowz,kazzak,672,hunter,survival,18,7,11
Dalkus,stormscale,672,hunter,survival,18,7,11
Хикази,soulflayer,672,hunter,survival,18,7,11
Creedncali,outland,672,hunter,survival,19,7,12
Theme,aegwynn,671,hunter,survival,12,7,5
Dogthebounty,tarren-mill,671,hunter,survival,12,7,5
Flamehand,kazzak,671,hunter,survival,12,7,5
Oldlynx,ravencrest,671,hunter,survival,12,7,5
Mechakænytwo,antonidas,671,hunter,survival,13,7,6
Ketaminè,ravencrest,671,hunter,survival,18,7,11
Oneshotr,aegwynn,671,hunter,survival,18,7,11
Neepal,archimonde,671,hunter,survival,18,7,11
Shanndu,ravencrest,671,hunter,survival,18,7,11
Panfilmaaj,burning-legion,670,hunter,survival,19,7,12
Tyràél,mugthol,669,hunter,survival,12,7,5
Goonii,bronzebeard,669,hunter,survival,18,7,11
Sylverein,silvermoon,669,hunter,survival,24,7,17
Ламберг,deepholm,668,hunter,survival,18,7,11
Jsâ,blackmoore,667,hunter,survival,18,7,11
Mahemi,mazrigos,664,hunter,survival,30,7,23
Skyythe,dun-morogh,649,hunter,survival,18,7,11
Drolig,blackmoore,643,hunter,survival,21,11,10
Denzal,archimonde,640,hunter,survival,16,7,9
Jalu,die-aldor,639,hunter,survival,12,8,4
Sharrowkyn,twisting-nether,639,hunter,survival,16,8,8
Iendx,silvermoon,623,hunter,survival,11,7,4
Beersalma,arathor,623,hunter,survival,11,7,4
Axiøs,thrall,623,hunter,survival,17,7,10
Bugspitz,outland,622,hunter,survival,11,7,4
Хищник,gordunni,622,hunter,survival,14,8,6
Gharzok,blackrock,618,hunter,survival,14,8,6
Prøxyh,hyjal,607,hunter,survival,11,7,4
Katwizrø,hyjal,584,hunter,survival,21,9,12
Charterjk,eredar,576,hunter,survival,6,6,0
Kustjägaren,twisting-nether,576,hunter,survival,6,6,0
Vinniehunter,archimonde,576,hunter,survival,6,6,0
Gitanìlla,dun-modr,576,hunter,survival,6,6,0
Азирона,gordunni,576,hunter,survival,6,6,0
Ernorx,stormscale,576,hunter,survival,6,6,0
Гусевод,gordunni,576,hunter,survival,9,7,2
Psghunt,argent-dawn,576,hunter,survival,12,6,6
Milkyway,jaedenar,576,hunter,survival,12,6,6
Lizch,argent-dawn,576,hunter,survival,12,6,6
Jamoneame,sanguino,576,hunter,survival,12,6,6
Triipiachu,zuljin,576,hunter,survival,12,6,6
Bkrbot,dun-modr,576,hunter,survival,12,6,6
Zøøkëëper,silvermoon,576,hunter,survival,12,6,6
Bitbytes,kazzak,576,hunter,survival,12,6,6
Тхойне,gordunni,576,hunter,survival,12,6,6
Mouganstine,archimonde,576,hunter,survival,12,6,6
Коблазнх,howling-fjord,576,hunter,survival,12,6,6
Common,drakthul,576,hunter,survival,12,6,6
Uranîa,blackmoore,576,hunter,survival,12,6,6
Maddoqx,frostwolf,576,hunter,survival,12,6,6
Yezzu,sylvanas,576,hunter,survival,12,6,6
Weraxo,ravencrest,576,hunter,survival,12,6,6
Muffscoper,outland,576,hunter,survival,12,6,6
Snoude,silvermoon,576,hunter,survival,12,6,6
Nagal,ragnaros,576,hunter,survival,12,6,6
Куоль,gordunni,576,hunter,survival,12,6,6
Jenello,thrall,576,hunter,survival,15,7,8
Voldtzeig,dentarg,576,hunter,survival,15,6,9
Seandeluxe,defias-brotherhood,576,hunter,survival,18,6,12
Эвилтар,soulflayer,576,hunter,survival,18,6,12
Cough,earthen-ring,576,hunter,survival,18,6,12
Wezzó,kazzak,576,hunter,survival,18,6,12
Borbotir,silvermoon,576,hunter,survival,18,6,12
Bobshmurda,defias-brotherhood,576,hunter,survival,18,6,12
Fatshaming,silvermoon,576,hunter,survival,19,6,13
Травахант,gordunni,575,hunter,survival,12,6,6
Broomyuk,kilrogg,575,hunter,survival,12,6,6
Knösler,anetheron,575,hunter,survival,12,6,6
Lòò,aegwynn,575,hunter,survival,12,6,6
Йеттеринг,deathweaver,575,hunter,survival,15,7,8
Amjamh,hyjal,575,hunter,survival,18,6,12
Sàclak,ysondre,575,hunter,survival,18,6,12
Ohnostepbro,blackmoore,575,hunter,survival,18,6,12
Дондонандон,gordunni,575,hunter,survival,18,6,12
Jwishrankone,outland,574,hunter,survival,12,6,6
Васябицепс,howling-fjord,574,hunter,survival,18,6,12
Vuloshi,twisting-nether,573,hunter,survival,18,6,12
Блоуйоэсс,howling-fjord,573,hunter,survival,24,6,18
Keredájn,outland,572,hunter,survival,12,6,6
Mâjôô,blackhand,544,hunter,survival,10,6,4
Sumecxh,aegwynn,543,hunter,survival,11,6,5
Natheldir,silvermoon,527,hunter,survival,11,6,5
Sizemattersx,kazzak,527,hunter,survival,17,6,11
Жарарака,gordunni,526,hunter,survival,21,6,15
Eazzyy,auchindoun,522,hunter,survival,14,7,7
Хантвкроксах,gordunni,496,hunter,survival,13,6,7
Osskkar,uldum,480,hunter,survival,6,5,1
Slado,nemesis,480,hunter,survival,6,5,1
Jelibon,ragnaros,480,hunter,survival,6,5,1
Lilpancake,kazzak,480,hunter,survival,6,5,1
Lísy,hyjal,480,hunter,survival,6,5,1
Smellygroin,darksorrow,480,hunter,survival,6,5,1
Alohunt,archimonde,480,hunter,survival,6,5,1
Zybxd,drakthul,480,hunter,survival,6,5,1
Taraz,dun-modr,480,hunter,survival,6,5,1
Mòzetónq,ravencrest,480,hunter,survival,6,5,1
Deek,ysera,480,hunter,survival,6,5,1
Unscripted,kazzak,480,hunter,survival,6,5,1
Onishan,ragnaros,480,hunter,survival,6,5,1
Animalistic,twisting-nether,480,hunter,survival,6,5,1
Intensivigel,blackmoore,480,hunter,survival,6,5,1
Lansha,hyjal,480,hunter,survival,6,5,1
Spirys,drakthul,480,hunter,survival,6,5,1
Noneedtotrap,darksorrow,480,hunter,survival,12,5,7
Doloresman,tarren-mill,480,hunter,survival,12,5,7
Vypaz,twisting-nether,480,hunter,survival,12,5,7
Kiralay,alleria,480,hunter,survival,12,5,7
Baconflips,ravencrest,480,hunter,survival,12,5,7
Kàisèr,shendralar,480,hunter,survival,12,5,7
Hunterado,burning-legion,480,hunter,survival,12,5,7
Olamay,blackmoore,480,hunter,survival,12,5,7
Asery,blackmoore,480,hunter,survival,12,5,7
Gogolehunt,archimonde,480,hunter,survival,12,5,7
Djzntrap,outland,480,hunter,survival,12,5,7
Bubboo,dun-modr,480,hunter,survival,12,5,7
Mercpet,tarren-mill,480,hunter,survival,12,5,7
Discoråttan,stormscale,480,hunter,survival,12,5,7
Ðîe,ysondre,480,hunter,survival,12,5,7
Lostinmist,kazzak,480,hunter,survival,12,5,7
Neyli,aegwynn,480,hunter,survival,12,5,7
Steffxd,twisting-nether,480,hunter,survival,12,5,7
Малтея,blackscar,480,hunter,survival,12,5,7
Recovery,sylvanas,480,hunter,survival,12,5,7
Минихантэр,blackscar,480,hunter,survival,12,5,7
Acefyre,sylvanas,480,hunter,survival,12,5,7
Oof,lightnings-blade,480,hunter,survival,12,5,7
Yakayoshi,kazzak,480,hunter,survival,12,5,7
Аскентр,gordunni,480,hunter,survival,12,5,7
Akyra,runetotem,480,hunter,survival,12,5,7
Majhin,ravencrest,480,hunter,survival,18,5,13
Bloópy,silvermoon,480,hunter,survival,18,5,13
Огнеборик,howling-fjord,480,hunter,survival,18,5,13
Ector,silvermoon,480,hunter,survival,18,5,13
Beletor,medivh,480,hunter,survival,18,5,13
Джакака,gordunni,480,hunter,survival,18,5,13
Sharpeyezz,ravencrest,480,hunter,survival,18,5,13
Aleenya,dalaran,480,hunter,survival,18,5,13
Zireal,pozzo-delleternità,479,hunter,survival,6,5,1
Kayflock,blackmoore,479,hunter,survival,10,6,4
Loading,garrosh,479,hunter,survival,12,5,7
Фемтто,greymane,479,hunter,survival,12,5,7
Daltyr,ravencrest,479,hunter,survival,12,5,7
Сногивкабину,soulflayer,479,hunter,survival,18,5,13
Trollshadow,tarren-mill,479,hunter,survival,18,5,13
Jumangi,blackmoore,478,hunter,survival,12,5,7
Absolutenon,alakir,478,hunter,survival,18,5,13
Everrunner,argent-dawn,463,hunter,survival,11,5,6
Nazumåks,stormscale,448,hunter,survival,16,5,11
Naokyy,sanguino,447,hunter,survival,11,5,6
Blackbane,ravencrest,447,hunter,survival,11,5,6
Nektard,ravencrest,425,hunter,survival,14,6,8
Bubonciêl,archimonde,425,hunter,survival,22,7,15
Minisay,magtheridon,424,hunter,survival,18,6,12
Trapandstun,aszune,384,hunter,survival,6,4,2
Kayflock,kazzak,384,hunter,survival,6,4,2
Akahr,thrall,384,hunter,survival,6,4,2
Nomorex,frostwhisper,384,hunter,survival,6,4,2
Deyanirah,sanguino,384,hunter,survival,6,4,2
Lergosh,zenedar,384,hunter,survival,6,4,2
Ujikãy,archimonde,384,hunter,survival,6,4,2
Mekerosh,burning-legion,384,hunter,survival,6,4,2
Salvo,silvermoon,384,hunter,survival,6,4,2
Националь,gordunni,384,hunter,survival,6,4,2
Cranekickzhu,blackmoore,384,hunter,survival,6,4,2
Vádîazmeý,twisting-nether,384,hunter,survival,6,4,2
Schmoopz,silvermoon,384,hunter,survival,6,4,2
Hvaskøduenme,stormscale,384,hunter,survival,6,4,2
Lunns,frostmane,384,hunter,survival,6,4,2
Copenhyggen,silvermoon,384,hunter,survival,6,4,2
Oída,blackmoore,384,hunter,survival,6,4,2
Яналице,gordunni,384,hunter,survival,6,4,2
Jeppe,sylvanas,384,hunter,survival,6,4,2
Bièretrand,les-clairvoyants,384,hunter,survival,6,4,2
Youngbepse,blackrock,384,hunter,survival,6,4,2
Donneraàn,blackrock,384,hunter,survival,6,4,2
Virzion,silvermoon,384,hunter,survival,6,4,2
Granteqar,ysondre,384,hunter,survival,6,4,2
Wlx,ravencrest,384,hunter,survival,6,4,2
Luckissues,argent-dawn,384,hunter,survival,6,4,2
Ледо,deathguard,384,hunter,survival,6,4,2
Meat,ravencrest,384,hunter,survival,6,4,2
Thresha,ravenholdt,384,hunter,survival,6,4,2
Tibaq,burning-legion,384,hunter,survival,6,4,2
Nyxìa,shattered-halls,384,hunter,survival,6,4,2
Muttsnuts,argent-dawn,384,hunter,survival,6,4,2
Mooj,malganis,384,hunter,survival,6,4,2
Zhannezza,sylvanas,384,hunter,survival,6,4,2
Rokmahr,stormscale,384,hunter,survival,6,4,2
Krohant,auchindoun,384,hunter,survival,6,4,2
Jêsslíne,ravencrest,384,hunter,survival,11,5,6
Castbuny,drakthul,384,hunter,survival,15,5,10
Terraxx,die-ewige-wacht,384,hunter,survival,12,4,8
Salie,argent-dawn,384,hunter,survival,12,4,8
Nimoria,zuluhed,384,hunter,survival,12,4,8
Helvetiya,sylvanas,384,hunter,survival,12,4,8
Aevlerz,draenor,384,hunter,survival,12,4,8
Callmepapi,kazzak,384,hunter,survival,12,4,8
Jorhan,ravencrest,384,hunter,survival,12,4,8
Friendlyone,quelthalas,384,hunter,survival,12,4,8
Fíwhale,tarren-mill,384,hunter,survival,12,4,8
Simppeli,sylvanas,384,hunter,survival,12,4,8
Illuminate,laughing-skull,384,hunter,survival,12,4,8
Rudimentary,ravencrest,384,hunter,survival,12,4,8
Esperion,ragnaros,384,hunter,survival,12,4,8
Vvax,stormscale,384,hunter,survival,12,4,8
Badwar,twisting-nether,384,hunter,survival,12,4,8
Эдерим,gordunni,384,hunter,survival,12,4,8
Rákthar,blackmoore,384,hunter,survival,12,4,8
Dettas,silvermoon,384,hunter,survival,12,4,8
Eâgleêyê,frostwolf,384,hunter,survival,12,4,8
Wärft,arathi,384,hunter,survival,12,4,8
Voldagor,hyjal,384,hunter,survival,12,4,8
Kulashaly,blackmoore,384,hunter,survival,12,4,8
Claimi,silvermoon,384,hunter,survival,24,4,20
Arshino,argent-dawn,383,hunter,survival,12,4,8
Шичими,galakrond,383,hunter,survival,12,4,8
Alongshot,outland,383,hunter,survival,24,6,18
Kayarii,ravencrest,382,hunter,survival,13,6,7
Sluhser,eredar,372,hunter,survival,20,8,12
Vhaagarr,blackmoore,351,hunter,survival,11,4,7
Ghob,kazzak,330,hunter,survival,8,5,3
Ptx,stormscale,319,hunter,survival,5,4,1
Sùnzí,alakir,319,hunter,survival,6,4,2
Velrhegal,tarren-mill,304,hunter,survival,13,4,9
Whis,blackrock,288,hunter,survival,6,3,3
Lajnus,frostmane,288,hunter,survival,6,3,3
Rangedrouge,bloodfeather,288,hunter,survival,6,3,3
Jondone,silvermoon,288,hunter,survival,6,3,3
Aidsmacka,shattered-hand,288,hunter,survival,6,3,3
Azeky,uldum,288,hunter,survival,6,3,3
Drandra,tarren-mill,288,hunter,survival,6,3,3
Remiss,sanguino,288,hunter,survival,6,3,3
Psychadelic,chamber-of-aspects,288,hunter,survival,6,3,3
Nashanael,argent-dawn,288,hunter,survival,6,3,3
Prinzz,blackmoore,288,hunter,survival,6,3,3
Crispystix,draenor,288,hunter,survival,6,3,3
Engetsu,drakthul,288,hunter,survival,6,3,3
Рэкрэйван,gordunni,288,hunter,survival,6,3,3
Хюсторн,blackscar,288,hunter,survival,6,3,3
Tomgun,dun-modr,288,hunter,survival,6,3,3
Kovokmah,lordaeron,288,hunter,survival,6,3,3
Monnezzus,nemesis,288,hunter,survival,6,3,3
Bearimcat,ravencrest,288,hunter,survival,6,3,3
Zwergjäger,aegwynn,288,hunter,survival,6,3,3
Rayburst,sylvanas,288,hunter,survival,6,3,3
Kyrâx,silvermoon,288,hunter,survival,6,3,3
Hépheistos,kelthuzad,288,hunter,survival,6,3,3
Fjarla,aegwynn,288,hunter,survival,6,3,3
Spakster,blackrock,288,hunter,survival,6,3,3
Металшот,blackscar,288,hunter,survival,6,3,3
Benbutton,antonidas,288,hunter,survival,6,3,3
Røgrøck,archimonde,288,hunter,survival,6,3,3
Grippage,draenor,288,hunter,survival,6,3,3
Daddytrap,burning-legion,288,hunter,survival,6,3,3
Likandria,blackmoore,288,hunter,survival,6,3,3
Ашмадей,eversong,288,hunter,survival,6,3,3
Чобушек,eversong,288,hunter,survival,6,3,3
Narziel,die-todeskrallen,288,hunter,survival,6,3,3
Lootgobbo,antonidas,288,hunter,survival,6,3,3
Raylauch,nethersturm,288,hunter,survival,6,3,3
Properchub,ravencrest,288,hunter,survival,6,3,3
Xý,hyjal,288,hunter,survival,6,3,3
Unöhänä,archimonde,288,hunter,survival,6,3,3
Dragonbomb,tarren-mill,288,hunter,survival,6,3,3
Nyyrikkí,ravencrest,288,hunter,survival,6,3,3
Gilgämesh,hyjal,288,hunter,survival,6,3,3
Aamøn,nemesis,288,hunter,survival,6,3,3
Syzuu,ravencrest,288,hunter,survival,6,3,3
Peppiz,ragnaros,288,hunter,survival,6,3,3
Oneeyedjoe,the-maelstrom,288,hunter,survival,6,3,3
Suetøløgx,shadowsong,288,hunter,survival,6,3,3
Kirinó,ragnaros,288,hunter,survival,6,3,3
Igyunk,ragnaros,288,hunter,survival,6,3,3
Arrowknee,outland,288,hunter,survival,6,3,3
Mayhemshotz,silvermoon,288,hunter,survival,6,3,3
Buekåre,outland,288,hunter,survival,6,3,3
Ahrtemís,destromath,288,hunter,survival,6,3,3
Palesson,ragnaros,288,hunter,survival,6,3,3
Hiðe,archimonde,288,hunter,survival,6,3,3
Нойран,eversong,288,hunter,survival,6,3,3
Sworra,silvermoon,288,hunter,survival,6,3,3
Ténsion,silvermoon,288,hunter,survival,6,3,3
Ефимушка,howling-fjord,288,hunter,survival,6,3,3
Iamedward,silvermoon,288,hunter,survival,6,3,3
Марчик,blackscar,288,hunter,survival,6,3,3
Hugart,sylvanas,288,hunter,survival,6,3,3
Deskö,shendralar,288,hunter,survival,6,3,3
Leonyy,blackhand,288,hunter,survival,6,3,3
Swaffield,stormscale,288,hunter,survival,6,3,3
Tøkyô,ravencrest,288,hunter,survival,6,3,3
Nightvarn,burning-blade,288,hunter,survival,6,3,3
Goblinstyle,kazzak,288,hunter,survival,6,3,3
Givz,outland,288,hunter,survival,6,3,3
Паркх,soulflayer,288,hunter,survival,6,3,3
Dîzzy,malganis,288,hunter,survival,6,3,3
Lazò,dun-morogh,288,hunter,survival,6,3,3
Thekev,ravencrest,288,hunter,survival,6,3,3
Telluric,silvermoon,288,hunter,survival,8,3,5
Twinshot,anetheron,288,hunter,survival,11,4,7
Homesz,blackmoore,288,hunter,survival,12,3,9
Ullburn,tyrande,288,hunter,survival,12,3,9
Pull,kirin-tor,288,hunter,survival,12,3,9
Sláynôs,blackrock,288,hunter,survival,12,3,9
Шмалетар,gordunni,288,hunter,survival,12,3,9
Heoden,nemesis,288,hunter,survival,12,3,9
Àfpro,hyjal,288,hunter,survival,12,3,9
Dezmoinez,twisting-nether,288,hunter,survival,12,3,9
Zäphiiro,archimonde,288,hunter,survival,12,3,9
Monsterbácke,nathrezim,288,hunter,survival,12,3,9
Nestór,todeswache,288,hunter,survival,12,3,9
Bigfoot,argent-dawn,288,hunter,survival,12,3,9
Bigtobacco,outland,288,hunter,survival,12,3,9
Diabloiv,doomhammer,288,hunter,survival,12,3,9
Ansâvage,ravencrest,288,hunter,survival,12,3,9
Ддондигидон,gordunni,288,hunter,survival,12,3,9
Aella,thrall,288,hunter,survival,12,3,9
Grundibg,chamber-of-aspects,288,hunter,survival,18,3,15
Zlotar,doomhammer,288,hunter,survival,18,3,15
Lezigoulleur,marécage-de-zangar,287,hunter,survival,6,3,3
Weedstin,ravencrest,287,hunter,survival,12,3,9
Jarhead,arthas,287,hunter,survival,12,3,9
Bosnimph,bloodfeather,285,hunter,survival,18,3,15
Arkeye,draenor,271,hunter,survival,11,3,8
Twinkhunter,pozzo-delleternità,256,hunter,survival,10,3,7
Jacobszy,outland,255,hunter,survival,8,4,4
Wódén,draenor,255,hunter,survival,17,3,14
Стёпкахант,gordunni,239,hunter,survival,5,3,2
Bowtreat,aggramar,239,hunter,survival,5,3,2
Fakepvper,darksorrow,239,hunter,survival,5,3,2
Дочьпескова,gordunni,239,hunter,survival,5,3,2
Arrowboss,kazzak,239,hunter,survival,5,3,2
Deôrro,twisting-nether,239,hunter,survival,5,3,2
Quilent,anachronos,239,hunter,survival,11,3,8
Arisko,silvermoon,234,hunter,survival,8,4,4
Zuljar,ulduar,234,hunter,survival,13,6,7
Himpy,twisting-nether,234,hunter,survival,14,4,10
Одисенс,eversong,233,hunter,survival,13,4,9
Antidrogue,arathi,208,hunter,survival,7,3,4
Cryptstalkér,antonidas,192,hunter,survival,4,3,1
Ратататат,eversong,192,hunter,survival,6,2,4
Talnaru,ravencrest,192,hunter,survival,6,2,4
Prettyy,ravencrest,192,hunter,survival,6,2,4
Aléx,ravencrest,192,hunter,survival,6,2,4
Púrefect,ragnaros,192,hunter,survival,6,2,4
Toxical,ragnaros,192,hunter,survival,6,2,4
Vasco,chogall,192,hunter,survival,6,2,4
Marshmallorr,dalaran,192,hunter,survival,6,2,4
Делишез,fordragon,192,hunter,survival,6,2,4
Rusticroll,stormscale,192,hunter,survival,6,2,4
Wirda,ravencrest,192,hunter,survival,6,2,4
Akhtabot,twisting-nether,192,hunter,survival,6,2,4
Daarkkhunter,twisting-nether,192,hunter,survival,6,2,4
Topgrill,stormscale,192,hunter,survival,6,2,4
Evazeonhunt,antonidas,192,hunter,survival,6,2,4
Robosexual,ravencrest,192,hunter,survival,6,2,4
Fajitax,lightbringer,192,hunter,survival,6,2,4
Мусафа,eversong,192,hunter,survival,6,2,4
Наладдчик,howling-fjord,192,hunter,survival,6,2,4
Пиворк,soulflayer,192,hunter,survival,6,2,4
Тиблэк,soulflayer,192,hunter,survival,6,2,4
Bloodyshot,dun-modr,192,hunter,survival,6,2,4
Орталиус,deathguard,192,hunter,survival,6,2,4
Leeyuael,stormscale,192,hunter,survival,6,2,4
Badenhunt,ravencrest,192,hunter,survival,6,2,4
Abomìnatìon,blackhand,192,hunter,survival,6,2,4
Tdapills,sanguino,192,hunter,survival,6,2,4
Xaotsu,ravencrest,192,hunter,survival,6,2,4
Bèâr,stormscale,192,hunter,survival,6,2,4
Pantherovich,ravencrest,192,hunter,survival,6,2,4
Jablaka,blackhand,192,hunter,survival,6,2,4
Poôpthrower,silvermoon,192,hunter,survival,6,2,4
Helloman,darksorrow,192,hunter,survival,6,2,4
Nøøtx,ravencrest,192,hunter,survival,6,2,4
Geppet,pozzo-delleternità,192,hunter,survival,6,2,4
Demónhunter,frostmane,192,hunter,survival,6,2,4
Valtondre,argent-dawn,192,hunter,survival,6,2,4
Gulkhar,ysondre,192,hunter,survival,6,2,4
Stace,archimonde,192,hunter,survival,6,2,4
Sakaryali,silvermoon,192,hunter,survival,6,2,4
Skä,archimonde,192,hunter,survival,6,2,4
Brindefolìe,archimonde,192,hunter,survival,6,2,4
Bearday,silvermoon,192,hunter,survival,6,2,4
Ayaera,argent-dawn,192,hunter,survival,6,2,4
Slayné,silvermoon,192,hunter,survival,6,2,4
Kënpachi,silvermoon,192,hunter,survival,6,2,4
Lardobrave,blackhand,192,hunter,survival,6,2,4
Gransu,argent-dawn,192,hunter,survival,6,2,4
Oidxari,aegwynn,192,hunter,survival,6,2,4
Senedeck,silvermoon,192,hunter,survival,6,2,4
Howlinjoe,darkspear,192,hunter,survival,6,2,4
Meyerheim,tarren-mill,192,hunter,survival,6,2,4
Fullxtrap,hyjal,192,hunter,survival,6,2,4
Orcca,malganis,192,hunter,survival,6,2,4
Draugrinnh,tarren-mill,192,hunter,survival,6,2,4
Gynax,hyjal,192,hunter,survival,6,2,4
Oliv,tarren-mill,192,hunter,survival,6,2,4
Hänta,hyjal,192,hunter,survival,6,2,4
Rølyn,hyjal,192,hunter,survival,6,2,4
Flexifys,tarren-mill,192,hunter,survival,6,2,4
Lotto,stormreaver,192,hunter,survival,6,2,4
Malover,ravencrest,192,hunter,survival,6,2,4
Ducdolan,outland,192,hunter,survival,6,2,4
Roscke,drakthul,192,hunter,survival,6,2,4
Lithell,kazzak,192,hunter,survival,6,2,4
Daymö,drakthul,192,hunter,survival,6,2,4
Nýka,sanguino,192,hunter,survival,6,2,4
Ammò,kazzak,192,hunter,survival,6,2,4
Jøhnsnøw,ravencrest,192,hunter,survival,6,2,4
Avyo,tichondrius,192,hunter,survival,6,2,4
Цумочка,blackscar,192,hunter,survival,6,2,4
Twobuttngodx,blackrock,192,hunter,survival,6,2,4
Yopps,draenor,192,hunter,survival,6,2,4
Svolatch,blackrock,192,hunter,survival,6,2,4
Aggrobatics,blackmoore,192,hunter,survival,6,2,4
Дунморг,grom,192,hunter,survival,6,2,4
Оркос,deathweaver,192,hunter,survival,6,2,4
Hunterkolben,blackmoore,192,hunter,survival,6,2,4
Honeytrap,blackmoore,192,hunter,survival,6,2,4
Reijuan,doomhammer,192,hunter,survival,6,2,4
Canadianboy,draenor,192,hunter,survival,6,2,4
Blàdê,blackrock,192,hunter,survival,6,2,4
Nígruløl,arthas,192,hunter,survival,6,2,4
Тандеркейдж,gordunni,192,hunter,survival,6,2,4
Сайдокс,gordunni,192,hunter,survival,6,2,4
Skullex,defias-brotherhood,192,hunter,survival,6,2,4
Alenda,auchindoun,192,hunter,survival,7,2,5
Layro,burning-legion,192,hunter,survival,9,2,7
Thorkai,runetotem,192,hunter,survival,12,2,10
Zéros,argent-dawn,192,hunter,survival,12,2,10
Ecthelione,the-venture-co,192,hunter,survival,12,2,10
Ryztik,garona,192,hunter,survival,12,2,10
Sicktrigger,aegwynn,192,hunter,survival,12,2,10
Nolsey,outland,192,hunter,survival,12,2,10
Hallem,karazhan,192,hunter,survival,12,2,10
Réja,norgannon,192,hunter,survival,12,2,10
Sixty,rajaxx,192,hunter,survival,18,2,16
Bélier,hyjal,191,hunter,survival,6,2,4
Grracio,tarren-mill,159,hunter,survival,5,2,3
Klarix,outland,159,hunter,survival,5,2,3
Samasukë,grim-batol,159,hunter,survival,5,2,3
Kissay,blackmoore,159,hunter,survival,5,2,3
Bnji,hyjal,159,hunter,survival,11,2,9
Rdwlf,draenor,138,hunter,survival,8,3,5
Zethik,argent-dawn,128,hunter,survival,4,2,2
Donaldtrap,archimonde,128,hunter,survival,4,2,2
Alary,burning-legion,128,hunter,survival,4,2,2
Fígo,burning-blade,96,hunter,survival,3,2,1
Sisilianno,khaz-modan,96,hunter,survival,10,2,8
Zynga,sylvanas,96,hunter,survival,6,1,5
Anchin,defias-brotherhood,96,hunter,survival,6,1,5
Blackszpak,jaedenar,96,hunter,survival,6,1,5
Grapplegear,ravencrest,96,hunter,survival,6,1,5
Varkiza,sylvanas,96,hunter,survival,6,1,5
Axran,ravencrest,96,hunter,survival,6,1,5
Убершванц,soulflayer,96,hunter,survival,6,1,5
Grollar,ragnaros,96,hunter,survival,6,1,5
Ditbjrapex,chants-éternels,96,hunter,survival,6,1,5
Khalimèro,kaelthas,96,hunter,survival,6,1,5
Барановируса,soulflayer,96,hunter,survival,6,1,5
Leaxs,onyxia,96,hunter,survival,6,1,5
Негатившица,gordunni,96,hunter,survival,6,1,5
Yezzízo,ravencrest,96,hunter,survival,6,1,5
Серомиг,eversong,96,hunter,survival,6,1,5
Bôwdan,magtheridon,96,hunter,survival,6,1,5
Neremyn,sylvanas,96,hunter,survival,6,1,5
Stirea,alakir,96,hunter,survival,6,1,5
Hentt,burning-legion,96,hunter,survival,6,1,5
Durion,tichondrius,96,hunter,survival,6,1,5
Торая,gordunni,96,hunter,survival,6,1,5
Katzchen,burning-legion,96,hunter,survival,6,1,5
Fantus,sylvanas,96,hunter,survival,6,1,5
Тораджи,soulflayer,96,hunter,survival,6,1,5
Algar,tarren-mill,96,hunter,survival,6,1,5
Артуша,booty-bay,96,hunter,survival,6,1,5
Noobhuntress,norgannon,96,hunter,survival,6,1,5
Gordo,burning-legion,96,hunter,survival,6,1,5
Kartosh,burning-legion,96,hunter,survival,6,1,5
Multigodx,draenor,96,hunter,survival,6,1,5
Kahoonas,silvermoon,96,hunter,survival,6,1,5
Askaris,ravencrest,96,hunter,survival,6,1,5
Freezyshinkn,blackrock,96,hunter,survival,6,1,5
Skidzo,alakir,96,hunter,survival,6,1,5
Хипстеркотик,gordunni,96,hunter,survival,6,1,5
Дакоока,deepholm,96,hunter,survival,6,1,5
Kideyosi,silvermoon,96,hunter,survival,6,1,5
Aimywinehaus,drakthul,96,hunter,survival,6,1,5
Rambow,ravenholdt,96,hunter,survival,6,1,5
Saksa,blackrock,96,hunter,survival,6,1,5
Fôx,frostmane,96,hunter,survival,6,1,5
Zuggi,defias-brotherhood,96,hunter,survival,6,1,5
Оркистор,eversong,96,hunter,survival,6,1,5
Softishot,archimonde,96,hunter,survival,6,1,5
Liljan,kult-der-verdammten,96,hunter,survival,6,1,5
Oobe,hyjal,96,hunter,survival,6,1,5
Themfkiller,outland,96,hunter,survival,6,1,5
Escaflôwn,aegwynn,96,hunter,survival,6,1,5
Aneji,hyjal,96,hunter,survival,6,1,5
Panzershot,hyjal,96,hunter,survival,6,1,5
Síevis,stormreaver,95,hunter,survival,6,1,5
Рангмар,howling-fjord,79,hunter,survival,5,1,4
Skrag,outland,79,hunter,survival,5,1,4
Эннабонни,gordunni,79,hunter,survival,5,1,4
Zuxz,blackmoore,64,hunter,survival,4,1,3
Pilogbueferd,silvermoon,64,hunter,survival,4,1,3
Silßow,dun-modr,63,hunter,survival,2,2,0
Хароко,gordunni,42,hunter,survival,9,3,6
Фдшер,soulflayer,42,hunter,survival,10,2,8
Brajanush,silvermoon,31,hunter,survival,2,1,1
Hypse,kazzak,2356,hunter,beastmastery,534,274,260
Cbã,ravencrest,2257,hunter,beastmastery,78,43,35
Mariabanks,aegwynn,2224,hunter,beastmastery,276,143,133
Куфа,blackscar,2222,hunter,beastmastery,78,43,35
Brokeasalwys,ravencrest,2193,hunter,beastmastery,131,67,64
Куфачка,soulflayer,2181,hunter,beastmastery,77,41,36
Hypsenn,kazzak,2174,hunter,beastmastery,138,69,69
Ataxyz,draenor,2172,hunter,beastmastery,120,62,58
Jägarntwo,stormscale,2171,hunter,beastmastery,99,52,47
Krakenaspect,kazzak,2159,hunter,beastmastery,72,37,35
Kásúxôxô,ravencrest,2157,hunter,beastmastery,60,34,26
Jägarn,stormscale,2154,hunter,beastmastery,114,59,55
Марчик,blackscar,2136,hunter,beastmastery,69,38,31
Zxll,silvermoon,2136,hunter,beastmastery,86,44,42
Ynv,argent-dawn,2130,hunter,beastmastery,272,145,127
Беби,gordunni,2129,hunter,beastmastery,96,49,47
Màdnéss,blackmoore,2126,hunter,beastmastery,78,46,32
Voldtzeig,dentarg,2125,hunter,beastmastery,150,76,74
Pryse,hyjal,2124,hunter,beastmastery,78,46,32
Zyrøra,ravencrest,2124,hunter,beastmastery,126,68,58
Moscowmule,tarren-mill,2109,hunter,beastmastery,89,44,45
Nelida,ragnaros,2105,hunter,beastmastery,60,32,28
Watchouttah,the-maelstrom,2103,hunter,beastmastery,78,44,34
Tøkyô,ravencrest,2098,hunter,beastmastery,113,70,43
Noorky,kazzak,2093,hunter,beastmastery,78,43,35
Roarmantic,blackrock,2072,hunter,beastmastery,84,41,43
Poggelicious,terenas,2055,hunter,beastmastery,72,37,35
Fãdê,ravencrest,2053,hunter,beastmastery,114,72,42
Plugonbaby,hyjal,2035,hunter,beastmastery,77,37,40
Kachaxa,kazzak,2030,hunter,beastmastery,165,80,85
Тружка,soulflayer,2027,hunter,beastmastery,102,48,54
Truejkee,silvermoon,2026,hunter,beastmastery,166,87,79
Esperion,ragnaros,2025,hunter,beastmastery,167,81,86
Nivshot,kazzak,2024,hunter,beastmastery,60,37,23
Каосси,gordunni,2024,hunter,beastmastery,84,43,41
Bøgs,the-maelstrom,2024,hunter,beastmastery,96,44,52
Baltímore,stormscale,2023,hunter,beastmastery,83,39,44
Doghxnter,ravencrest,2011,hunter,beastmastery,84,40,44
Jambomambo,twisting-nether,2008,hunter,beastmastery,90,46,44
Wilfyre,twisting-nether,2002,hunter,beastmastery,465,235,230
Jàsøn,ravencrest,2002,hunter,beastmastery,102,49,53
Xoarqt,aegwynn,2001,hunter,beastmastery,268,134,134
Kachaxaa,ravencrest,2001,hunter,beastmastery,124,59,65
Дашатрирубля,soulflayer,1999,hunter,beastmastery,96,47,49
Hasáblover,ragnaros,1996,hunter,beastmastery,66,34,32
Kfcmanagerx,silvermoon,1996,hunter,beastmastery,96,44,52
Deadshøt,outland,1993,hunter,beastmastery,59,42,17
Pëâcêßß,outland,1984,hunter,beastmastery,102,62,40
Enîgmatîke,archimonde,1983,hunter,beastmastery,81,40,41
Nennimi,ravencrest,1977,hunter,beastmastery,78,40,38
Gernoqz,frostwolf,1973,hunter,beastmastery,107,51,56
Seviante,outland,1967,hunter,beastmastery,126,62,64
Pfizershotx,khaz-modan,1966,hunter,beastmastery,126,65,61
Рагнарианх,gordunni,1966,hunter,beastmastery,153,77,76
Winiswin,stormscale,1966,hunter,beastmastery,201,100,101
Ghost,tarren-mill,1966,hunter,beastmastery,66,31,35
Eldrekou,kazzak,1962,hunter,beastmastery,234,119,115
Zyphx,der-rat-von-dalaran,1962,hunter,beastmastery,174,83,91
Priceqtxd,ravencrest,1956,hunter,beastmastery,193,115,78
Expiraa,twisting-nether,1954,hunter,beastmastery,72,35,37
Luzivar,malganis,1954,hunter,beastmastery,109,52,57
Dangen,stormreaver,1952,hunter,beastmastery,54,27,27
Гринмех,gordunni,1951,hunter,beastmastery,72,39,33
Masthuhn,blackmoore,1950,hunter,beastmastery,77,48,29
Tyranski,ravencrest,1949,hunter,beastmastery,261,140,121
Raawy,blackmoore,1948,hunter,beastmastery,42,31,11
Miraculous,dalaran,1948,hunter,beastmastery,87,46,41
Vectør,anachronos,1945,hunter,beastmastery,233,117,116
Sipsomewater,ravencrest,1943,hunter,beastmastery,69,36,33
Mestar,outland,1942,hunter,beastmastery,175,84,91
Syveera,twisting-nether,1939,hunter,beastmastery,84,41,43
Krampack,dun-modr,1933,hunter,beastmastery,61,37,24
Snarthelg,tarren-mill,1932,hunter,beastmastery,78,43,35
Scrubbi,destromath,1932,hunter,beastmastery,77,39,38
Ayiu,argent-dawn,1931,hunter,beastmastery,101,51,50
Экономист,fordragon,1929,hunter,beastmastery,84,47,37
Kabaro,rajaxx,1926,hunter,beastmastery,102,46,56
Babýrage,twisting-nether,1923,hunter,beastmastery,96,49,47
Twineyes,ravencrest,1923,hunter,beastmastery,208,106,102
Bobmàrley,frostwolf,1921,hunter,beastmastery,282,158,124
Odeôn,twisting-nether,1921,hunter,beastmastery,65,27,38
Irefutabil,stormscale,1920,hunter,beastmastery,102,46,56
Мираклдримз,gordunni,1919,hunter,beastmastery,72,38,34
Hacz,bronzebeard,1919,hunter,beastmastery,273,142,131
Tagz,ravencrest,1917,hunter,beastmastery,66,31,35
Wiffed,tarren-mill,1916,hunter,beastmastery,60,36,24
Nondinhos,burning-legion,1915,hunter,beastmastery,83,38,45
Âmalphy,ravencrest,1915,hunter,beastmastery,59,27,32
Поппишот,blackscar,1914,hunter,beastmastery,59,28,31
Samanou,kazzak,1912,hunter,beastmastery,124,62,62
Lambo,laughing-skull,1912,hunter,beastmastery,72,35,37
Найстити,deathguard,1909,hunter,beastmastery,120,60,60
Aimshots,twisting-nether,1908,hunter,beastmastery,130,67,63
Rapidfirez,twisting-nether,1905,hunter,beastmastery,48,35,13
Gaeln,outland,1905,hunter,beastmastery,387,193,194
Nexztwo,blackrock,1905,hunter,beastmastery,145,72,73
Brokenpetman,defias-brotherhood,1902,hunter,beastmastery,48,26,22
Akrokillshot,outland,1901,hunter,beastmastery,57,39,18
Онкьяр,gordunni,1901,hunter,beastmastery,98,53,45
Silverwolfa,dun-modr,1900,hunter,beastmastery,93,54,39
Thing,kazzak,1900,hunter,beastmastery,42,24,18
Jawox,antonidas,1898,hunter,beastmastery,78,35,43
Берх,gordunni,1897,hunter,beastmastery,292,141,151
Каоссхант,howling-fjord,1896,hunter,beastmastery,71,45,26
Антошадпс,gordunni,1896,hunter,beastmastery,158,89,69
Колякилшот,gordunni,1895,hunter,beastmastery,66,33,33
Trapgoddxx,archimonde,1894,hunter,beastmastery,65,44,21
Mekerosh,burning-legion,1893,hunter,beastmastery,136,61,75
Solò,eredar,1888,hunter,beastmastery,54,31,23
Raggeh,frostwhisper,1887,hunter,beastmastery,114,57,57
Nøne,sylvanas,1885,hunter,beastmastery,48,30,18
Feevah,frostmane,1885,hunter,beastmastery,283,140,143
Дэнвин,deathweaver,1884,hunter,beastmastery,281,147,134
Spirys,drakthul,1884,hunter,beastmastery,82,40,42
Fullxtrap,hyjal,1884,hunter,beastmastery,53,25,28
Dafhel,hyjal,1883,hunter,beastmastery,137,69,68
Trend,silvermoon,1881,hunter,beastmastery,551,272,279
Dohter,kazzak,1877,hunter,beastmastery,61,34,27
Крайдершот,howling-fjord,1876,hunter,beastmastery,65,33,32
Rndhunt,shattrath,1876,hunter,beastmastery,144,70,74
Кукито,goldrinn,1875,hunter,beastmastery,71,32,39
Txa,hyjal,1873,hunter,beastmastery,77,38,39
Burninghunt,ravencrest,1871,hunter,beastmastery,84,46,38
Pussirotta,stormreaver,1869,hunter,beastmastery,60,30,30
Avyo,tichondrius,1869,hunter,beastmastery,66,31,35
Mottorhead,kazzak,1865,hunter,beastmastery,63,40,23
Phesx,sylvanas,1865,hunter,beastmastery,54,27,27
Ígrågøßñø,silvermoon,1864,hunter,beastmastery,44,30,14
Биско,gordunni,1864,hunter,beastmastery,240,119,121
Filaliel,outland,1863,hunter,beastmastery,59,34,25
Easyclass,hyjal,1862,hunter,beastmastery,208,117,91
Hanuong,ragnaros,1862,hunter,beastmastery,36,20,16
Infléx,silvermoon,1862,hunter,beastmastery,161,89,72
Thogelle,hyjal,1862,hunter,beastmastery,345,179,166
Лвндскейп,gordunni,1861,hunter,beastmastery,122,63,59
Safnirx,tarren-mill,1860,hunter,beastmastery,78,33,45
Thetrashness,kazzak,1855,hunter,beastmastery,44,34,10
Lufreak,ravencrest,1855,hunter,beastmastery,78,56,22
Chillbroo,twisting-nether,1855,hunter,beastmastery,167,81,86
Draxil,archimonde,1855,hunter,beastmastery,60,27,33
Freakyhoe,twisting-nether,1854,hunter,beastmastery,54,27,27
Alpharaven,ravencrest,1853,hunter,beastmastery,102,51,51
Евилик,gordunni,1853,hunter,beastmastery,305,148,157
Ridbàck,archimonde,1853,hunter,beastmastery,89,35,54
Lysanhunt,zuljin,1852,hunter,beastmastery,72,36,36
Trapgodxx,archimonde,1852,hunter,beastmastery,54,22,32
Киборка,howling-fjord,1849,hunter,beastmastery,147,90,57
Teals,blackrock,1849,hunter,beastmastery,409,204,205
Кронн,howling-fjord,1849,hunter,beastmastery,89,43,46
Wêskêr,tarren-mill,1848,hunter,beastmastery,72,35,37
Appirc,tarren-mill,1847,hunter,beastmastery,54,27,27
Djfury,archimonde,1847,hunter,beastmastery,70,34,36
Nèxz,blackrock,1846,hunter,beastmastery,125,61,64
Huntchonk,kazzak,1846,hunter,beastmastery,77,34,43
Kondy,twisting-nether,1845,hunter,beastmastery,55,35,20
Оуаоа,blackscar,1844,hunter,beastmastery,127,70,57
Мунгардина,blackscar,1844,hunter,beastmastery,60,23,37
Дианнесса,howling-fjord,1843,hunter,beastmastery,101,49,52
Nyzuri,die-aldor,1843,hunter,beastmastery,54,26,28
Мерзкийбот,gordunni,1843,hunter,beastmastery,74,33,41
Ashjen,aszune,1842,hunter,beastmastery,71,41,30
Sekzpitch,blackmoore,1842,hunter,beastmastery,78,40,38
Лесбиянюсь,gordunni,1838,hunter,beastmastery,60,43,17
Hiddenx,blackmoore,1836,hunter,beastmastery,48,25,23
Dheredre,silvermoon,1835,hunter,beastmastery,48,27,21
Miløø,silvermoon,1835,hunter,beastmastery,48,26,22
Manj,blackhand,1835,hunter,beastmastery,65,32,33
Pawzz,kazzak,1835,hunter,beastmastery,114,56,58
Ætå,blackmoore,1834,hunter,beastmastery,71,34,37
Hlogic,tarren-mill,1834,hunter,beastmastery,108,51,57
Thogel,hyjal,1834,hunter,beastmastery,120,56,64
Breezme,twisting-nether,1834,hunter,beastmastery,143,66,77
Duïvell,grim-batol,1831,hunter,beastmastery,42,20,22
Ilovedf,dun-modr,1830,hunter,beastmastery,36,23,13
Dogetrainer,silvermoon,1830,hunter,beastmastery,319,162,157
Næmes,hyjal,1830,hunter,beastmastery,66,32,34
Piranhaa,archimonde,1829,hunter,beastmastery,51,24,27
Elfyhunter,outland,1829,hunter,beastmastery,77,33,44
Fotmrerollér,aegwynn,1828,hunter,beastmastery,108,57,51
Petshopgirl,ravencrest,1828,hunter,beastmastery,102,52,50
Diktatos,kazzak,1828,hunter,beastmastery,64,31,33
Ryxzn,eredar,1828,hunter,beastmastery,113,53,60
Altimor,blackmoore,1827,hunter,beastmastery,41,22,19
Джаствэл,howling-fjord,1827,hunter,beastmastery,56,29,27
Jêsslíne,ravencrest,1827,hunter,beastmastery,66,31,35
Zæuz,outland,1826,hunter,beastmastery,75,35,40
Bilbohunter,draenor,1825,hunter,beastmastery,48,27,21
Горгонт,blackscar,1825,hunter,beastmastery,47,25,22
Izmad,archimonde,1824,hunter,beastmastery,341,187,154
Axran,ravencrest,1824,hunter,beastmastery,124,67,57
Sivoh,silvermoon,1823,hunter,beastmastery,92,61,31
Nimhunt,dentarg,1823,hunter,beastmastery,185,91,94
Hawkeyé,forscherliga,1823,hunter,beastmastery,169,80,89
Libanais,archimonde,1823,hunter,beastmastery,269,125,144
Nystaleoss,grim-batol,1821,hunter,beastmastery,302,151,151
Kásúxøxø,ravencrest,1820,hunter,beastmastery,28,20,8
Куроните,howling-fjord,1820,hunter,beastmastery,48,27,21
Rakeesh,hyjal,1820,hunter,beastmastery,54,27,27
Irükandji,chants-éternels,1819,hunter,beastmastery,48,24,24
Piky,nemesis,1819,hunter,beastmastery,120,58,62
Bynen,tarren-mill,1818,hunter,beastmastery,131,55,76
Ветрослав,thermaplugg,1817,hunter,beastmastery,48,32,16
Omegakek,madmortem,1817,hunter,beastmastery,85,45,40
Rïm,haomarush,1817,hunter,beastmastery,72,33,39
Blackszpak,jaedenar,1816,hunter,beastmastery,48,24,24
Ilovemax,archimonde,1816,hunter,beastmastery,52,25,27
Играсломана,howling-fjord,1815,hunter,beastmastery,60,39,21
Antisniper,kazzak,1815,hunter,beastmastery,99,55,44
Lothram,les-sentinelles,1815,hunter,beastmastery,66,36,30
Bíllybobbs,argent-dawn,1815,hunter,beastmastery,36,19,17
Пожилойпупь,soulflayer,1815,hunter,beastmastery,66,32,34
Ooh,doomhammer,1815,hunter,beastmastery,120,56,64
Jabela,eredar,1814,hunter,beastmastery,59,42,17
Лордсахарок,gordunni,1814,hunter,beastmastery,90,40,50
Vrikenh,tarren-mill,1813,hunter,beastmastery,133,80,53
Nîøssx,blackrock,1813,hunter,beastmastery,125,70,55
Jackjager,ravencrest,1813,hunter,beastmastery,57,27,30
Порошокк,howling-fjord,1812,hunter,beastmastery,60,27,33
Jungletime,outland,1811,hunter,beastmastery,82,42,40
Dréws,kazzak,1811,hunter,beastmastery,58,26,32
Bøøya,aegwynn,1810,hunter,beastmastery,163,86,77
Jamesyy,ravencrest,1810,hunter,beastmastery,66,30,36
Reyko,stormscale,1810,hunter,beastmastery,78,35,43
Áñmy,ravencrest,1809,hunter,beastmastery,100,66,34
Mòzetonq,ravencrest,1809,hunter,beastmastery,42,22,20
Corossity,blackmoore,1808,hunter,beastmastery,30,19,11
Reptile,outland,1808,hunter,beastmastery,146,86,60
Yarrgi,kazzak,1808,hunter,beastmastery,108,63,45
Tháyn,tarren-mill,1808,hunter,beastmastery,180,99,81
Galileo,sanguino,1808,hunter,beastmastery,109,57,52
Хантунец,soulflayer,1807,hunter,beastmastery,101,59,42
Father,auchindoun,1807,hunter,beastmastery,119,65,54
Цитрукс,gordunni,1806,hunter,beastmastery,90,47,43
Круперок,howling-fjord,1805,hunter,beastmastery,90,46,44
Rafizox,kazzak,1804,hunter,beastmastery,36,19,17
Bebiyo,sanguino,1804,hunter,beastmastery,172,90,82
Astari,outland,1804,hunter,beastmastery,60,29,31
Denkstah,tarren-mill,1804,hunter,beastmastery,75,32,43
Quasar,ravencrest,1804,hunter,beastmastery,66,28,38
Jägarnmt,twisting-nether,1804,hunter,beastmastery,95,40,55
Johnblønn,stormscale,1803,hunter,beastmastery,86,46,40
Crippa,tarren-mill,1803,hunter,beastmastery,54,28,26
Tillhunt,kargath,1803,hunter,beastmastery,54,26,28
Drakona,outland,1803,hunter,beastmastery,65,31,34
Tobbè,silvermoon,1803,hunter,beastmastery,77,36,41
Lolez,dun-modr,1803,hunter,beastmastery,66,30,36
Orcji,blackhand,1802,hunter,beastmastery,149,74,75
Трапгодикс,eversong,1800,hunter,beastmastery,176,95,81
Pekaxôxô,sanguino,1798,hunter,beastmastery,87,60,27
Spergmeister,argent-dawn,1797,hunter,beastmastery,41,25,16
Ashily,blackhand,1795,hunter,beastmastery,156,79,77
Bluefluclue,draenor,1795,hunter,beastmastery,223,109,114
Cor,ravencrest,1793,hunter,beastmastery,136,65,71
Dìgítal,twisting-nether,1792,hunter,beastmastery,101,51,50
Пивопьюня,ashenvale,1790,hunter,beastmastery,71,34,37
Pkz,dun-modr,1790,hunter,beastmastery,125,59,66
Laserkamel,aegwynn,1789,hunter,beastmastery,30,22,8
Smhx,stormscale,1788,hunter,beastmastery,30,21,9
Келен,blackscar,1788,hunter,beastmastery,88,52,36
Wodhunterxdd,outland,1788,hunter,beastmastery,53,25,28
Luzivarus,malganis,1788,hunter,beastmastery,224,103,121
Hugø,twisting-nether,1788,hunter,beastmastery,179,79,100
Giwtus,blackmoore,1788,hunter,beastmastery,48,19,29
Elmez,outland,1785,hunter,beastmastery,66,30,36
Baïonnettex,archimonde,1785,hunter,beastmastery,54,22,32
Simpyani,silvermoon,1784,hunter,beastmastery,86,50,36
Deathcode,stormscale,1784,hunter,beastmastery,66,27,39
Shroomynuts,kazzak,1782,hunter,beastmastery,120,70,50
Negz,eredar,1781,hunter,beastmastery,84,47,37
Хаурос,soulflayer,1781,hunter,beastmastery,72,35,37
Ruffixvs,blackrock,1779,hunter,beastmastery,47,23,24
Nevier,tarren-mill,1779,hunter,beastmastery,48,21,27
Xxiioo,ravencrest,1778,hunter,beastmastery,163,95,68
Imcuteandfun,ravencrest,1778,hunter,beastmastery,159,79,80
Sparcùs,stormreaver,1777,hunter,beastmastery,146,81,65
Narolaf,doomhammer,1776,hunter,beastmastery,69,38,31
Coltan,nemesis,1774,hunter,beastmastery,108,51,57
Hacx,ravencrest,1774,hunter,beastmastery,134,63,71
Sukzess,antonidas,1774,hunter,beastmastery,196,92,104
Gucçi,kazzak,1773,hunter,beastmastery,73,42,31
Treaz,sanguino,1770,hunter,beastmastery,78,40,38
Gigamesh,sporeggar,1769,hunter,beastmastery,240,133,107
Gostry,archimonde,1768,hunter,beastmastery,66,34,32
Ambarcrojas,kazzak,1767,hunter,beastmastery,122,69,53
Блэкстейдж,howling-fjord,1767,hunter,beastmastery,217,115,102
Wîldhunt,burning-legion,1767,hunter,beastmastery,250,120,130
Donixx,blackrock,1765,hunter,beastmastery,60,29,31
Dogwatcher,outland,1762,hunter,beastmastery,60,29,31
Скадхи,blackscar,1762,hunter,beastmastery,88,42,46
Vènuhá,ravencrest,1761,hunter,beastmastery,54,29,25
Ansâvage,ravencrest,1761,hunter,beastmastery,120,57,63
Guccihuntlol,ravencrest,1760,hunter,beastmastery,74,35,39
Наспидахх,blackscar,1759,hunter,beastmastery,90,50,40
Jamzyhunter,emerald-dream,1759,hunter,beastmastery,120,60,60
Rákthar,blackmoore,1759,hunter,beastmastery,167,79,88
Hellhawk,twisting-nether,1758,hunter,beastmastery,47,28,19
Grynu,kazzak,1757,hunter,beastmastery,102,45,57
Порошокк,gordunni,1756,hunter,beastmastery,75,32,43
Hitandtrap,stormscale,1755,hunter,beastmastery,66,32,34
Dtq,silvermoon,1755,hunter,beastmastery,155,75,80
Vhalín,magtheridon,1755,hunter,beastmastery,48,22,26
Мэлвиса,borean-tundra,1754,hunter,beastmastery,90,50,40
Erethrus,ravencrest,1752,hunter,beastmastery,54,20,34
Fatmum,magtheridon,1751,hunter,beastmastery,188,97,91
Unßørn,archimonde,1751,hunter,beastmastery,120,52,68
Dwgkia,ravencrest,1751,hunter,beastmastery,60,26,34
Заксель,soulflayer,1750,hunter,beastmastery,84,44,40
Pewpewshotz,stormscale,1750,hunter,beastmastery,229,117,112
Akaris,archimonde,1748,hunter,beastmastery,102,51,51
Haltrâdar,archimonde,1746,hunter,beastmastery,104,48,56
Córelly,outland,1745,hunter,beastmastery,171,91,80
Мориартис,ashenvale,1744,hunter,beastmastery,83,43,40
Sentriks,tarren-mill,1743,hunter,beastmastery,54,24,30
Åsynåmvp,twisting-nether,1742,hunter,beastmastery,65,29,36
Fôx,frostmane,1741,hunter,beastmastery,36,27,9
Noversia,aegwynn,1741,hunter,beastmastery,165,81,84
Wlâd,archimonde,1740,hunter,beastmastery,47,29,18
Boomgorush,kazzak,1739,hunter,beastmastery,60,36,24
Cajakekw,madmortem,1738,hunter,beastmastery,56,34,22
Keegan,hellfire,1738,hunter,beastmastery,60,35,25
Amyndôr,ravencrest,1738,hunter,beastmastery,78,41,37
Tëmeh,ysondre,1738,hunter,beastmastery,66,33,33
Dregor,nemesis,1737,hunter,beastmastery,48,28,20
Erilis,twisting-nether,1737,hunter,beastmastery,55,30,25
Кристисекс,blackscar,1737,hunter,beastmastery,59,32,27
Híldir,draenor,1737,hunter,beastmastery,36,19,17
Cnby,stormscale,1736,hunter,beastmastery,73,44,29
Shinkichi,archimonde,1736,hunter,beastmastery,48,23,25
Hunterla,tarren-mill,1735,hunter,beastmastery,81,42,39
Coôkie,ysondre,1735,hunter,beastmastery,66,31,35
Такувами,gordunni,1735,hunter,beastmastery,168,74,94
Blmlooter,stormreaver,1734,hunter,beastmastery,49,26,23
Saggymilkies,outland,1734,hunter,beastmastery,132,60,72
Недостижений,soulflayer,1734,hunter,beastmastery,60,24,36
Космодиск,gordunni,1733,hunter,beastmastery,54,29,25
Kestlér,twisting-nether,1733,hunter,beastmastery,222,106,116
Freemàén,drakthul,1733,hunter,beastmastery,95,42,53
Stingsz,chogall,1733,hunter,beastmastery,64,25,39
Lofiel,blackrock,1732,hunter,beastmastery,92,50,42
Letsrock,outland,1732,hunter,beastmastery,116,62,54
Arcø,dun-modr,1732,hunter,beastmastery,50,26,24
Land,darkspear,1731,hunter,beastmastery,77,42,35
Kmps,ravencrest,1731,hunter,beastmastery,48,25,23
Sankari,blackmoore,1731,hunter,beastmastery,156,80,76
Mentalasylum,blackmoore,1731,hunter,beastmastery,51,24,27
Zoomiesuwu,antonidas,1729,hunter,beastmastery,29,19,10
Ðéadsøulz,stormscale,1729,hunter,beastmastery,159,86,73
Dullcat,ravencrest,1728,hunter,beastmastery,50,30,20
Misstrap,nemesis,1728,hunter,beastmastery,90,42,48
Кертион,howling-fjord,1727,hunter,beastmastery,84,38,46
Bonobo,dentarg,1727,hunter,beastmastery,42,19,23
Valkrys,die-aldor,1726,hunter,beastmastery,70,35,35
Qtìp,aegwynn,1725,hunter,beastmastery,107,48,59
Hizzenstein,blackhand,1724,hunter,beastmastery,54,27,27
Atrisi,tarren-mill,1721,hunter,beastmastery,47,29,18
Bigdog,eredar,1721,hunter,beastmastery,89,43,46
Morìtz,ravencrest,1720,hunter,beastmastery,66,38,28
Oldbear,frostmane,1720,hunter,beastmastery,106,56,50
Bobletty,tarren-mill,1720,hunter,beastmastery,36,19,17
Sagethunt,blackrock,1720,hunter,beastmastery,107,47,60
Bêastî,blackrock,1718,hunter,beastmastery,54,29,25
Riflur,stormscale,1718,hunter,beastmastery,162,79,83
Вождь,howling-fjord,1718,hunter,beastmastery,89,42,47
Duppdupp,eredar,1718,hunter,beastmastery,114,53,61
Zeanort,nordrassil,1718,hunter,beastmastery,42,18,24
Lëgølåslõrdx,blackrock,1717,hunter,beastmastery,98,52,46
Exlune,sylvanas,1717,hunter,beastmastery,114,56,58
Domnite,ravencrest,1716,hunter,beastmastery,370,198,172
Venomtrap,sanguino,1716,hunter,beastmastery,59,24,35
Swallowbaby,lothar,1714,hunter,beastmastery,102,51,51
Xenvantoss,silvermoon,1714,hunter,beastmastery,42,21,21
Koffh,argent-dawn,1714,hunter,beastmastery,84,39,45
Palav,outland,1713,hunter,beastmastery,60,34,26
Fåded,ravencrest,1713,hunter,beastmastery,112,58,54
Yezzu,sylvanas,1713,hunter,beastmastery,48,21,27
Pagman,thrall,1713,hunter,beastmastery,53,23,30
Xenvantos,stormscale,1711,hunter,beastmastery,54,26,28
Spider,zuljin,1710,hunter,beastmastery,200,103,97
Mogwai,stormscale,1709,hunter,beastmastery,42,18,24
Танчибосс,soulflayer,1708,hunter,beastmastery,54,33,21
Feijfeij,stormreaver,1706,hunter,beastmastery,96,50,46
Bicmax,archimonde,1705,hunter,beastmastery,45,20,25
Impxgodx,outland,1704,hunter,beastmastery,51,24,27
Lobo,kazzak,1704,hunter,beastmastery,66,28,38
Joffey,stormscale,1704,hunter,beastmastery,54,22,32
Hultasy,outland,1703,hunter,beastmastery,209,107,102
Sayn,la-croisade-écarlate,1703,hunter,beastmastery,125,60,65
Ysina,arathi,1703,hunter,beastmastery,108,50,58
Saiko,kazzak,1703,hunter,beastmastery,42,18,24
Azrhu,ravencrest,1702,hunter,beastmastery,42,18,24
Vilopez,arthas,1701,hunter,beastmastery,24,20,4
Murtagh,khaz-modan,1701,hunter,beastmastery,66,36,30
Parhainkoira,argent-dawn,1701,hunter,beastmastery,114,62,52
Lyllidrop,varimathras,1701,hunter,beastmastery,56,27,29
Krix,ragnaros,1700,hunter,beastmastery,120,67,53
Oldcocknbals,silvermoon,1700,hunter,beastmastery,118,65,53
Legosoldaten,stormscale,1700,hunter,beastmastery,40,22,18
Jeskö,tarren-mill,1700,hunter,beastmastery,42,21,21
Леао,howling-fjord,1699,hunter,beastmastery,93,59,34
Agrmash,drakthul,1699,hunter,beastmastery,42,26,16
Chambiann,tarren-mill,1699,hunter,beastmastery,30,18,12
Elamondria,outland,1699,hunter,beastmastery,72,42,30
Sznxøxo,ravencrest,1699,hunter,beastmastery,54,29,25
Nollieflip,stormscale,1698,hunter,beastmastery,126,71,55
Idtrapthat,nagrand,1698,hunter,beastmastery,108,52,56
Jaxxoo,outland,1697,hunter,beastmastery,42,26,16
Clockwerk,durotan,1697,hunter,beastmastery,100,46,54
Traplørdx,sylvanas,1697,hunter,beastmastery,54,24,30
Liquidhunter,quelthalas,1696,hunter,beastmastery,48,26,22
Angeedau,kazzak,1696,hunter,beastmastery,72,31,41
Ericspet,stormscale,1695,hunter,beastmastery,72,44,28
Wicmex,les-sentinelles,1695,hunter,beastmastery,59,33,26
Azzazeal,drakthul,1694,hunter,beastmastery,54,24,30
Jimbowjones,antonidas,1693,hunter,beastmastery,60,35,25
Merquryh,ravencrest,1693,hunter,beastmastery,48,27,21
Фираналь,blackscar,1693,hunter,beastmastery,200,99,101
Vinsanity,dunemaul,1693,hunter,beastmastery,54,21,33
Holdmypurse,kazzak,1692,hunter,beastmastery,78,43,35
Timec,outland,1692,hunter,beastmastery,42,18,24
Lîs,kargath,1691,hunter,beastmastery,36,20,16
Thinkerer,silvermoon,1691,hunter,beastmastery,139,71,68
Naraxis,blackrock,1691,hunter,beastmastery,102,51,51
Madeyhunt,burning-legion,1691,hunter,beastmastery,48,23,25
Chrysantes,forscherliga,1691,hunter,beastmastery,44,21,23
Fluphy,thrall,1690,hunter,beastmastery,106,55,51
Tauriêl,blutkessel,1690,hunter,beastmastery,48,24,24
Douglas,die-silberne-hand,1690,hunter,beastmastery,76,35,41
Xiioo,ravencrest,1689,hunter,beastmastery,143,70,73
Fize,blackmoore,1689,hunter,beastmastery,101,48,53
Painaldeepz,stormscale,1688,hunter,beastmastery,90,46,44
Mânhunt,blackhand,1688,hunter,beastmastery,687,342,345
Дуссита,gordunni,1688,hunter,beastmastery,149,70,79
Альриен,gordunni,1687,hunter,beastmastery,454,231,223
Utoast,ravencrest,1687,hunter,beastmastery,60,30,30
Daxhunter,twisting-nether,1687,hunter,beastmastery,72,32,40
Carioca,blackhand,1687,hunter,beastmastery,84,37,47
Askaway,sylvanas,1686,hunter,beastmastery,48,35,13
Balthazzarxx,ravencrest,1686,hunter,beastmastery,68,36,32
Джарвиз,soulflayer,1686,hunter,beastmastery,78,41,37
Dragonbomb,tarren-mill,1686,hunter,beastmastery,60,25,35
Earlygrey,ravencrest,1685,hunter,beastmastery,213,107,106
Баянист,soulflayer,1684,hunter,beastmastery,160,76,84
Kalá,defias-brotherhood,1684,hunter,beastmastery,51,23,28
Survabuse,silvermoon,1683,hunter,beastmastery,57,35,22
Ðxlz,archimonde,1683,hunter,beastmastery,71,35,36
Hunterlolz,tarren-mill,1682,hunter,beastmastery,138,74,64
Svolatch,blackrock,1681,hunter,beastmastery,42,18,24
Bówyóurfácé,outland,1680,hunter,beastmastery,66,37,29
Забзаб,soulflayer,1680,hunter,beastmastery,63,31,32
Trapzila,aggra-português,1679,hunter,beastmastery,132,73,59
Nolove,burning-legion,1679,hunter,beastmastery,191,99,92
Vajraw,blackrock,1679,hunter,beastmastery,243,120,123
Nestór,todeswache,1678,hunter,beastmastery,47,28,19
Gnubbzn,aegwynn,1676,hunter,beastmastery,60,23,37
Миилленниум,howling-fjord,1675,hunter,beastmastery,66,27,39
Cubro,sanguino,1672,hunter,beastmastery,95,53,42
Ремонтлицаа,gordunni,1672,hunter,beastmastery,68,31,37
Knocked,quelthalas,1672,hunter,beastmastery,90,39,51
Шергала,soulflayer,1671,hunter,beastmastery,389,187,202
Hîldegard,todeswache,1670,hunter,beastmastery,70,35,35
Irefutabilâ,outland,1670,hunter,beastmastery,144,66,78
Kethos,draenor,1669,hunter,beastmastery,93,56,37
Hiddenxsabo,blackmoore,1669,hunter,beastmastery,47,26,21
Techpøint,silvermoon,1669,hunter,beastmastery,35,18,17
Адыгах,blackscar,1668,hunter,beastmastery,84,46,38
Инкризшот,gordunni,1668,hunter,beastmastery,83,43,40
Twirlylock,emerald-dream,1668,hunter,beastmastery,60,27,33
Кразайс,ashenvale,1668,hunter,beastmastery,126,51,75
Kerólus,blackhand,1668,hunter,beastmastery,54,20,34
Дэскрайт,soulflayer,1667,hunter,beastmastery,78,44,34
Fanjah,sylvanas,1667,hunter,beastmastery,105,54,51
Raindra,twisting-nether,1667,hunter,beastmastery,78,37,41
Neïç,antonidas,1666,hunter,beastmastery,125,57,68
Triggaz,stormscale,1665,hunter,beastmastery,216,109,107
Zanpa,archimonde,1663,hunter,beastmastery,122,56,66
Badboybørge,draenor,1663,hunter,beastmastery,89,40,49
Hõth,kazzak,1662,hunter,beastmastery,42,18,24
Trendsetterx,pozzo-delleternità,1662,hunter,beastmastery,66,28,38
Flanägan,hyjal,1661,hunter,beastmastery,119,70,49
Тиблэк,soulflayer,1661,hunter,beastmastery,149,78,71
Trapyoubro,blackrock,1661,hunter,beastmastery,60,26,34
Trenesta,tarren-mill,1659,hunter,beastmastery,34,18,16
Zubro,kazzak,1659,hunter,beastmastery,231,116,115
Psymòn,ravencrest,1659,hunter,beastmastery,48,24,24
Focüs,les-sentinelles,1658,hunter,beastmastery,36,23,13
Noór,silvermoon,1658,hunter,beastmastery,75,47,28
Ðesøtø,frostwolf,1658,hunter,beastmastery,72,37,35
Eggcowmeow,azjolnerub,1658,hunter,beastmastery,102,52,50
Wayland,dalaran,1658,hunter,beastmastery,120,51,69
Pérnix,tarren-mill,1657,hunter,beastmastery,30,18,12
Yoey,tarren-mill,1657,hunter,beastmastery,78,42,36
Wolfster,kazzak,1655,hunter,beastmastery,96,50,46
Meghanmarkle,tarren-mill,1655,hunter,beastmastery,111,56,55
Chúx,twisting-nether,1655,hunter,beastmastery,233,117,116
Brawnshunt,stormscale,1655,hunter,beastmastery,101,46,55
Kravchenko,draenor,1653,hunter,beastmastery,109,62,47
Diapositiv,draenor,1653,hunter,beastmastery,119,65,54
Futureman,blackrock,1653,hunter,beastmastery,67,33,34
Dybhalsma,outland,1652,hunter,beastmastery,35,19,16
Grabbin,silvermoon,1652,hunter,beastmastery,64,32,32
Greavius,kazzak,1652,hunter,beastmastery,77,37,40
Séyena,outland,1652,hunter,beastmastery,114,51,63
Гигапупсх,howling-fjord,1651,hunter,beastmastery,183,100,83
Crispystix,draenor,1651,hunter,beastmastery,47,23,24
Digital,twisting-nether,1650,hunter,beastmastery,45,24,21
Kissnodig,outland,1649,hunter,beastmastery,158,93,65
Taoshii,die-aldor,1649,hunter,beastmastery,100,55,45
Hask,pozzo-delleternità,1648,hunter,beastmastery,40,22,18
Bebar,kazzak,1648,hunter,beastmastery,156,81,75
Djøgi,archimonde,1648,hunter,beastmastery,72,36,36
Røzy,twisting-nether,1647,hunter,beastmastery,48,35,13
Ritmkesh,draenor,1647,hunter,beastmastery,61,36,25
Zisqa,alleria,1647,hunter,beastmastery,46,25,21
Nkdchef,outland,1646,hunter,beastmastery,66,35,31
Mirmona,stormscale,1645,hunter,beastmastery,120,60,60
Beeasty,aegwynn,1644,hunter,beastmastery,42,25,17
Digimørtal,kazzak,1644,hunter,beastmastery,54,28,26
Bearday,silvermoon,1644,hunter,beastmastery,96,40,56
Darksmoke,forscherliga,1643,hunter,beastmastery,83,41,42
Gondoo,tarren-mill,1643,hunter,beastmastery,48,22,26
Ефрейя,gordunni,1643,hunter,beastmastery,56,25,31
Barrybigtoe,tarren-mill,1642,hunter,beastmastery,36,21,15
Rachelgg,ravencrest,1642,hunter,beastmastery,40,18,22
Scräppÿ,kazzak,1641,hunter,beastmastery,45,26,19
Peazý,ravencrest,1641,hunter,beastmastery,120,60,60
Sazox,blackrock,1641,hunter,beastmastery,36,18,18
Смертонносна,lich-king,1641,hunter,beastmastery,71,30,41
Rynx,hellfire,1640,hunter,beastmastery,120,58,62
Downey,azshara,1640,hunter,beastmastery,111,46,65
Paraskámu,twisting-nether,1639,hunter,beastmastery,41,23,18
Ariabeast,archimonde,1639,hunter,beastmastery,60,30,30
Shoranon,stormscale,1639,hunter,beastmastery,48,23,25
Ingvi,antonidas,1639,hunter,beastmastery,209,100,109
Teestylee,stormscale,1638,hunter,beastmastery,42,21,21
Ксила,blackscar,1637,hunter,beastmastery,77,41,36
Drøøðqt,blackrock,1637,hunter,beastmastery,60,31,29
Jinxpeasant,twisting-nether,1636,hunter,beastmastery,42,27,15
Yolofant,blackhand,1634,hunter,beastmastery,36,22,14
Miladinorc,azjolnerub,1634,hunter,beastmastery,69,41,28
Imdepressed,sylvanas,1634,hunter,beastmastery,57,31,26
Фэннон,gordunni,1634,hunter,beastmastery,69,30,39
Куоль,gordunni,1634,hunter,beastmastery,53,23,30
Fizè,blackmoore,1633,hunter,beastmastery,53,32,21
Dragosvis,arathor,1633,hunter,beastmastery,83,46,37
Dealtqt,ysondre,1633,hunter,beastmastery,54,23,31
Notx,ravencrest,1632,hunter,beastmastery,54,29,25
Sïmc,archimonde,1632,hunter,beastmastery,136,70,66
Smecher,ravencrest,1631,hunter,beastmastery,92,44,48
Cicatrice,kazzak,1631,hunter,beastmastery,40,19,21
Horhyndan,ragnaros,1631,hunter,beastmastery,51,24,27
Santiino,silvermoon,1630,hunter,beastmastery,94,47,47
Malover,ravencrest,1630,hunter,beastmastery,47,21,26
Pareia,blackrock,1629,hunter,beastmastery,30,20,10
Pareîa,alexstrasza,1629,hunter,beastmastery,33,18,15
Drewsx,ravencrest,1627,hunter,beastmastery,36,22,14
Porch,dragonmaw,1627,hunter,beastmastery,49,26,23
Eazzyy,auchindoun,1627,hunter,beastmastery,144,68,76
Janko,ravencrest,1626,hunter,beastmastery,494,249,245
Nashanael,argent-dawn,1626,hunter,beastmastery,48,22,26
Wolder,burning-legion,1625,hunter,beastmastery,30,20,10
ßeans,sanguino,1625,hunter,beastmastery,41,20,21
Gibiswag,outland,1625,hunter,beastmastery,36,17,19
Uglybaboon,draenor,1625,hunter,beastmastery,42,17,25
Noxin,blackrock,1624,hunter,beastmastery,48,24,24
Dispairge,antonidas,1624,hunter,beastmastery,48,21,27
Sicktrapbtw,hyjal,1624,hunter,beastmastery,42,17,25
Illaice,antonidas,1623,hunter,beastmastery,42,23,19
Fiftyóne,festung-der-stürme,1623,hunter,beastmastery,120,65,55
Пихпахах,gordunni,1623,hunter,beastmastery,148,74,74
Акройя,gordunni,1622,hunter,beastmastery,132,70,62
Pluttbug,xavius,1622,hunter,beastmastery,38,20,18
Сенджогахара,greymane,1622,hunter,beastmastery,115,58,57
Podroto,tyrande,1622,hunter,beastmastery,47,22,25
Índigo,kazzak,1620,hunter,beastmastery,56,30,26
Poupoune,uldum,1620,hunter,beastmastery,114,55,59
Ausgefuchst,forscherliga,1620,hunter,beastmastery,54,24,30
Flappypig,stormscale,1620,hunter,beastmastery,50,22,28
Jomerin,thrall,1620,hunter,beastmastery,53,23,30
Gzà,kazzak,1620,hunter,beastmastery,59,24,35
Bulletride,stormscale,1619,hunter,beastmastery,36,21,15
Ilovekatsu,archimonde,1619,hunter,beastmastery,30,17,13
Ðoxz,blackrock,1619,hunter,beastmastery,30,17,13
Jèrsèy,draenor,1619,hunter,beastmastery,42,22,20
Зоотян,gordunni,1619,hunter,beastmastery,129,65,64
Onof,archimonde,1619,hunter,beastmastery,36,17,19
Vezeka,ravencrest,1618,hunter,beastmastery,42,26,16
Tiendat,kazzak,1618,hunter,beastmastery,84,46,38
Chasxc,kazzak,1618,hunter,beastmastery,124,64,60
Вееном,gordunni,1618,hunter,beastmastery,78,37,41
Chuntardi,stormscale,1618,hunter,beastmastery,42,17,25
Poatan,outland,1617,hunter,beastmastery,176,104,72
Tràxes,quelthalas,1617,hunter,beastmastery,378,193,185
Bobon,stormscale,1617,hunter,beastmastery,54,26,28
Deathvain,tarren-mill,1617,hunter,beastmastery,91,38,53
Notdilly,varimathras,1617,hunter,beastmastery,48,20,28
Zuxz,blackmoore,1616,hunter,beastmastery,103,50,53
Bujie,ragnaros,1616,hunter,beastmastery,54,23,31
Трапча,soulflayer,1615,hunter,beastmastery,30,19,11
Thatsaturtle,arathor,1615,hunter,beastmastery,30,17,13
Декгардпро,blackscar,1614,hunter,beastmastery,42,20,22
Eltrapo,ravencrest,1613,hunter,beastmastery,24,17,7
Oife,auchindoun,1613,hunter,beastmastery,101,61,40
Trnx,antonidas,1613,hunter,beastmastery,36,21,15
Asâya,blackmoore,1613,hunter,beastmastery,184,104,80
Missmytraps,ravencrest,1613,hunter,beastmastery,39,20,19
Kawal,hyjal,1613,hunter,beastmastery,42,21,21
Mævis,ravencrest,1612,hunter,beastmastery,69,29,40
Gajoshunter,frostwolf,1611,hunter,beastmastery,30,18,12
Shenely,kazzak,1611,hunter,beastmastery,30,17,13
Aroeris,ravencrest,1611,hunter,beastmastery,57,32,25
Xraay,stormscale,1610,hunter,beastmastery,54,31,23
Thorkron,sanguino,1610,hunter,beastmastery,36,19,17
Dawil,ragnaros,1610,hunter,beastmastery,66,30,36
Мальберна,eversong,1609,hunter,beastmastery,48,30,18
Encore,sylvanas,1609,hunter,beastmastery,227,122,105
Proccter,silvermoon,1608,hunter,beastmastery,174,96,78
Slmao,tarren-mill,1608,hunter,beastmastery,251,125,126
Zoo,archimonde,1608,hunter,beastmastery,51,24,27
Каэлланис,soulflayer,1608,hunter,beastmastery,95,44,51
Kdjschgzdsv,archimonde,1608,hunter,beastmastery,47,18,29
Símpíng,tarren-mill,1607,hunter,beastmastery,24,17,7
Nukenfoobs,draenor,1607,hunter,beastmastery,36,23,13
Kamar,archimonde,1607,hunter,beastmastery,132,73,59
Garfie,tarren-mill,1607,hunter,beastmastery,47,25,22
Paimen,darksorrow,1606,hunter,beastmastery,108,57,51
Midist,stormscale,1606,hunter,beastmastery,42,21,21
Æblesaft,stormscale,1605,hunter,beastmastery,94,45,49
Sadira,echsenkessel,1604,hunter,beastmastery,45,28,17
Céah,blackrock,1604,hunter,beastmastery,54,28,26
Calutis,blackmoore,1603,hunter,beastmastery,66,39,27
Bànsundara,hyjal,1603,hunter,beastmastery,97,53,44
Pumbuboo,deathwing,1603,hunter,beastmastery,133,72,61
Xeld,outland,1603,hunter,beastmastery,36,19,17
Мунлэс,lich-king,1603,hunter,beastmastery,129,61,68
Dackeldustin,norgannon,1603,hunter,beastmastery,36,17,19
Xplosiveshot,tarren-mill,1602,hunter,beastmastery,35,22,13
Pewpewcus,ravencrest,1602,hunter,beastmastery,247,141,106
Atlanta,arygos,1602,hunter,beastmastery,42,22,20
Solot,silvermoon,1602,hunter,beastmastery,108,55,53
Spinella,antonidas,1602,hunter,beastmastery,203,101,102
Sjins,draenor,1601,hunter,beastmastery,35,20,15
Эвилтар,soulflayer,1601,hunter,beastmastery,120,61,59
Feralhound,exodar,1601,hunter,beastmastery,491,248,243
Povish,twisting-nether,1601,hunter,beastmastery,59,28,31
Xarhunt,azjolnerub,1600,hunter,beastmastery,36,22,14
Ivanthebeast,twisting-nether,1600,hunter,beastmastery,111,65,46
Stickey,antonidas,1600,hunter,beastmastery,66,34,32
Zinco,ravencrest,1600,hunter,beastmastery,171,84,87
Иоссифсталин,soulflayer,1600,hunter,beastmastery,127,60,67
Fatihvahset,stormscale,1600,hunter,beastmastery,39,18,21
Gorebatschov,aegwynn,1600,hunter,beastmastery,60,21,39
Coldmonster,tarren-mill,1598,hunter,beastmastery,208,115,93
Bråndy,draenor,1598,hunter,beastmastery,52,28,24
Оути,azuregos,1595,hunter,beastmastery,69,37,32
Zendra,sylvanas,1595,hunter,beastmastery,242,129,113
Klausmanne,blackrock,1595,hunter,beastmastery,425,205,220
Mtrider,twisting-nether,1595,hunter,beastmastery,151,69,82
Gukexa,outland,1594,hunter,beastmastery,37,19,18
Ðrtrapx,blackmoore,1594,hunter,beastmastery,80,41,39
Smegmagol,baelgun,1594,hunter,beastmastery,95,48,47
Berenger,twisting-nether,1593,hunter,beastmastery,42,21,21
Ðìløx,ysondre,1593,hunter,beastmastery,66,31,35
Daveq,drakthul,1593,hunter,beastmastery,71,32,39
Akhtabot,twisting-nether,1592,hunter,beastmastery,42,19,23
Memehunter,aegwynn,1591,hunter,beastmastery,78,47,31
Britannia,frostmane,1589,hunter,beastmastery,48,30,18
Latschodives,malorne,1589,hunter,beastmastery,175,89,86
Hecken,nemesis,1588,hunter,beastmastery,30,20,10
Brisbya,khaz-modan,1588,hunter,beastmastery,59,35,24
Arcaniz,ravencrest,1588,hunter,beastmastery,72,38,34
Жмыххунтер,howling-fjord,1588,hunter,beastmastery,84,42,42
Nordafrøst,antonidas,1587,hunter,beastmastery,72,29,43
Saymqt,blackrock,1584,hunter,beastmastery,87,42,45
Onphonecall,kazzak,1583,hunter,beastmastery,54,31,23
Sallya,kazzak,1583,hunter,beastmastery,53,28,25
Солевойй,gordunni,1583,hunter,beastmastery,75,38,37
Nycrom,ravencrest,1583,hunter,beastmastery,92,46,46
Drivenscope,twisting-nether,1581,hunter,beastmastery,86,46,40
Dankohunt,drakthul,1580,hunter,beastmastery,36,20,16
Zusale,azshara,1580,hunter,beastmastery,78,40,38
Wrongtarget,auchindoun,1580,hunter,beastmastery,65,28,37
Гульнарамвд,gordunni,1578,hunter,beastmastery,48,20,28
Kafkules,outland,1577,hunter,beastmastery,155,83,72
Cyclontrapgg,antonidas,1576,hunter,beastmastery,41,21,20
Luckyxcharm,blackrock,1576,hunter,beastmastery,128,64,64
Wèndy,blackrock,1576,hunter,beastmastery,94,46,48
Chasseurcool,argent-dawn,1575,hunter,beastmastery,62,33,29
Slip,silvermoon,1574,hunter,beastmastery,42,23,19
Akïratqz,sanguino,1572,hunter,beastmastery,30,18,12
Пулявзубах,gordunni,1572,hunter,beastmastery,144,76,68
Nickyhunt,stormscale,1572,hunter,beastmastery,79,39,40
Жэш,howling-fjord,1571,hunter,beastmastery,93,61,32
Gramzy,blackmoore,1571,hunter,beastmastery,215,110,105
Orcoro,ysondre,1571,hunter,beastmastery,353,175,178
Grapemint,blackrock,1570,hunter,beastmastery,30,18,12
Strélka,blackrock,1570,hunter,beastmastery,78,39,39
Snaipergirl,twisting-nether,1570,hunter,beastmastery,132,62,70
Омежка,deepholm,1570,hunter,beastmastery,88,35,53
Tuskah,stormreaver,1569,hunter,beastmastery,72,41,31
Йокуя,blackscar,1568,hunter,beastmastery,90,51,39
Pandanero,ravencrest,1568,hunter,beastmastery,36,18,18
Комомура,soulflayer,1568,hunter,beastmastery,53,24,29
Callmepapi,kazzak,1567,hunter,beastmastery,68,38,30
Amigoss,argent-dawn,1567,hunter,beastmastery,131,70,61
Антисерт,ashenvale,1567,hunter,beastmastery,76,37,39
Темпеест,gordunni,1567,hunter,beastmastery,48,22,26
Ганидони,soulflayer,1567,hunter,beastmastery,121,53,68
Huntma,kazzak,1566,hunter,beastmastery,133,70,63
Trapyx,malganis,1566,hunter,beastmastery,417,210,207
Wraithlit,bronzebeard,1565,hunter,beastmastery,84,43,41
Snipertjuh,silvermoon,1565,hunter,beastmastery,199,100,99
Øô,dun-morogh,1564,hunter,beastmastery,95,50,45
Dyve,antonidas,1564,hunter,beastmastery,97,49,48
Thieuu,twisting-nether,1564,hunter,beastmastery,48,22,26
Yeign,eredar,1563,hunter,beastmastery,96,51,45
Кейдлер,gordunni,1563,hunter,beastmastery,62,31,31
Dragomirka,kazzak,1563,hunter,beastmastery,117,58,59
Fritzi,outland,1563,hunter,beastmastery,41,18,23
Gedzer,silvermoon,1560,hunter,beastmastery,78,38,40
Wondersnipes,stormrage,1560,hunter,beastmastery,63,30,33
Charleramsey,outland,1558,hunter,beastmastery,60,30,30
Тоффи,blackscar,1557,hunter,beastmastery,47,21,26
Expoh,blackmoore,1556,hunter,beastmastery,55,28,27
Tigerups,burning-legion,1556,hunter,beastmastery,60,29,31
Shkorvi,drakthul,1555,hunter,beastmastery,36,17,19
Pjållistani,ravencrest,1554,hunter,beastmastery,48,18,30
Søuïlløn,archimonde,1553,hunter,beastmastery,48,30,18
Zugmypole,stormscale,1553,hunter,beastmastery,84,44,40
Búddhá,stormscale,1553,hunter,beastmastery,227,108,119
Lsa,kazzak,1553,hunter,beastmastery,95,40,55
Жокра,greymane,1553,hunter,beastmastery,61,25,36
Asery,blackmoore,1552,hunter,beastmastery,60,25,35
Маунтдроп,gordunni,1551,hunter,beastmastery,231,122,109
Anca,aegwynn,1551,hunter,beastmastery,234,119,115
Трэйсх,howling-fjord,1551,hunter,beastmastery,42,21,21
Толяарканшот,razuvious,1550,hunter,beastmastery,60,36,24
Ziathiel,draenor,1550,hunter,beastmastery,63,36,27
Githo,argent-dawn,1550,hunter,beastmastery,156,86,70
Fearmygun,grim-batol,1550,hunter,beastmastery,36,18,18
Haleth,uldum,1550,hunter,beastmastery,47,21,26
Камшотовна,blackscar,1549,hunter,beastmastery,205,114,91
Sharún,sylvanas,1548,hunter,beastmastery,56,27,29
Hyunkies,ysondre,1548,hunter,beastmastery,71,30,41
Deadlysnîpe,antonidas,1547,hunter,beastmastery,64,35,29
Homesz,blackmoore,1547,hunter,beastmastery,46,25,21
Раелиин,gordunni,1546,hunter,beastmastery,37,21,16
Кривоватый,galakrond,1546,hunter,beastmastery,36,18,18
Siegbald,ragnaros,1545,hunter,beastmastery,76,37,39
Инфлэйн,howling-fjord,1545,hunter,beastmastery,47,20,27
Megagloc,shadowsong,1544,hunter,beastmastery,36,18,18
Grusijohn,executus,1543,hunter,beastmastery,72,35,37
Ixix,blackhand,1543,hunter,beastmastery,87,40,47
Bigfoot,argent-dawn,1542,hunter,beastmastery,258,135,123
Dmanite,ravencrest,1541,hunter,beastmastery,180,90,90
Yoorizz,outland,1540,hunter,beastmastery,78,32,46
Lobos,ravencrest,1539,hunter,beastmastery,140,73,67
Crâsh,ysondre,1538,hunter,beastmastery,80,40,40
Ileira,blackmoore,1538,hunter,beastmastery,73,34,39
Cosmol,kazzak,1537,hunter,beastmastery,150,81,69
Kürze,silvermoon,1537,hunter,beastmastery,151,81,70
Bortian,argent-dawn,1536,hunter,beastmastery,73,41,32
Снюсинка,gordunni,1535,hunter,beastmastery,100,52,48
Corrupth,outland,1535,hunter,beastmastery,43,22,21
Gunde,kazzak,1535,hunter,beastmastery,182,92,90
Avatarofwoe,blackmoore,1535,hunter,beastmastery,54,24,30
Rachelzane,blackrock,1534,hunter,beastmastery,30,16,14
Уроборос,gordunni,1533,hunter,beastmastery,35,19,16
Lòò,aegwynn,1533,hunter,beastmastery,113,55,58
Cabal,alleria,1532,hunter,beastmastery,55,29,26
Sonìc,kazzak,1531,hunter,beastmastery,44,25,19
Massimox,draenor,1529,hunter,beastmastery,30,22,8
Nottberozz,silvermoon,1529,hunter,beastmastery,284,138,146
Yryyh,silvermoon,1529,hunter,beastmastery,90,41,49
Crippler,arthas,1528,hunter,beastmastery,46,29,17
Отерон,gordunni,1528,hunter,beastmastery,182,96,86
Tayaa,draenor,1528,hunter,beastmastery,91,47,44
Jagarbladet,ravencrest,1528,hunter,beastmastery,52,26,26
Hiphophunter,thunderhorn,1527,hunter,beastmastery,42,18,24
Criticalbomb,kazzak,1526,hunter,beastmastery,66,31,35
Белыйатомщик,howling-fjord,1525,hunter,beastmastery,49,31,18
Синглшот,blackscar,1525,hunter,beastmastery,43,24,19
Zamx,outland,1525,hunter,beastmastery,36,16,20
Anklar,blackrock,1525,hunter,beastmastery,65,25,40
Diablohuntt,burning-legion,1524,hunter,beastmastery,63,22,41
Blakkablakka,eredar,1523,hunter,beastmastery,59,33,26
Sarrow,ravencrest,1523,hunter,beastmastery,77,41,36
Killshotovna,stormscale,1523,hunter,beastmastery,36,19,17
Arthó,kazzak,1522,hunter,beastmastery,54,30,24
Crowsza,archimonde,1522,hunter,beastmastery,91,50,41
Lowfet,neptulon,1522,hunter,beastmastery,269,138,131
Renamexyz,blackmoore,1521,hunter,beastmastery,48,26,22
Assbúrgers,silvermoon,1521,hunter,beastmastery,118,60,58
Eaglexx,twisting-nether,1521,hunter,beastmastery,90,42,48
Nallepuuoh,outland,1520,hunter,beastmastery,135,67,68
Zeniar,pozzo-delleternità,1520,hunter,beastmastery,89,44,45
Денвиин,deathweaver,1520,hunter,beastmastery,66,30,36
Оксанчек,howling-fjord,1520,hunter,beastmastery,47,17,30
Честнный,howling-fjord,1518,hunter,beastmastery,352,175,177
Lightcheese,twisting-nether,1518,hunter,beastmastery,48,23,25
Amigosaa,draenor,1517,hunter,beastmastery,66,34,32
Soulthirsty,ravencrest,1517,hunter,beastmastery,144,69,75
Johntoffee,eredar,1517,hunter,beastmastery,47,18,29
Лёт,azuregos,1516,hunter,beastmastery,98,55,43
Reijuan,doomhammer,1516,hunter,beastmastery,30,16,14
Дарцетос,greymane,1516,hunter,beastmastery,36,17,19
Кежма,howling-fjord,1515,hunter,beastmastery,54,32,22
Субоота,gordunni,1515,hunter,beastmastery,58,21,37
Recrent,kazzak,1513,hunter,beastmastery,48,33,15
Spidak,stormscale,1513,hunter,beastmastery,60,29,31
Hêndricks,eredar,1513,hunter,beastmastery,42,16,26
Dhadhar,kazzak,1512,hunter,beastmastery,324,153,171
Pizzafanatic,blackrock,1511,hunter,beastmastery,30,16,14
Жажждущий,gordunni,1511,hunter,beastmastery,190,95,95
Lis,gorgonnash,1511,hunter,beastmastery,78,35,43
Johnwick,aerie-peak,1510,hunter,beastmastery,78,44,34
Анастазис,soulflayer,1509,hunter,beastmastery,36,17,19
Стэпси,gordunni,1506,hunter,beastmastery,56,23,33
Gerentral,burning-legion,1505,hunter,beastmastery,106,58,48
Чапуршилов,lich-king,1504,hunter,beastmastery,291,147,144
Icetrapped,eredar,1502,hunter,beastmastery,41,25,16
Яроняютрапу,gordunni,1500,hunter,beastmastery,52,33,19
Measpy,blackrock,1500,hunter,beastmastery,57,34,23
Ryuwen,dun-modr,1499,hunter,beastmastery,142,68,74
Kalt,twisting-nether,1498,hunter,beastmastery,70,41,29
Jannolafrite,ysondre,1498,hunter,beastmastery,68,33,35
Bladestalker,trollbane,1497,hunter,beastmastery,66,34,32
Palaur,kazzak,1496,hunter,beastmastery,190,97,93
Lowpital,hyjal,1496,hunter,beastmastery,42,20,22
Mêshuggah,ravencrest,1495,hunter,beastmastery,54,30,24
Funkalation,ravencrest,1495,hunter,beastmastery,36,20,16
Pennymarks,blackhand,1494,hunter,beastmastery,74,36,38
Ledrox,ravencrest,1494,hunter,beastmastery,90,42,48
Jeeso,baelgun,1494,hunter,beastmastery,189,88,101
Ângell,kirin-tor,1494,hunter,beastmastery,60,26,34
Arslan,archimonde,1493,hunter,beastmastery,39,19,20
Raxedo,blackrock,1492,hunter,beastmastery,50,25,25
Pewmasters,stormscale,1492,hunter,beastmastery,79,37,42
Pufyrella,kilrogg,1491,hunter,beastmastery,78,43,35
Shantala,frostwolf,1490,hunter,beastmastery,72,40,32
Idetylem,burning-legion,1490,hunter,beastmastery,84,44,40
Almogrote,sanguino,1490,hunter,beastmastery,90,43,47
Luckissues,argent-dawn,1490,hunter,beastmastery,42,20,22
Бей,gordunni,1490,hunter,beastmastery,73,33,40
Делар,howling-fjord,1490,hunter,beastmastery,80,35,45
Laoriane,hyjal,1489,hunter,beastmastery,51,28,23
Gnouminøu,archimonde,1489,hunter,beastmastery,218,112,106
Vimd,archimonde,1489,hunter,beastmastery,89,45,44
Wolfyx,cthun,1489,hunter,beastmastery,78,36,42
Chenony,ravencrest,1489,hunter,beastmastery,84,38,46
Рэттс,soulflayer,1488,hunter,beastmastery,122,63,59
Kasperhawser,silvermoon,1488,hunter,beastmastery,42,21,21
Heoden,nemesis,1488,hunter,beastmastery,66,32,34
Сотк,howling-fjord,1488,hunter,beastmastery,65,28,37
Ханзолес,gordunni,1487,hunter,beastmastery,101,54,47
Vescar,argent-dawn,1487,hunter,beastmastery,54,17,37
Spizglub,defias-brotherhood,1486,hunter,beastmastery,101,51,50
Stòkke,stormscale,1486,hunter,beastmastery,60,25,35
Luniel,gilneas,1485,hunter,beastmastery,36,21,15
Ahlgood,stormscale,1484,hunter,beastmastery,30,16,14
Sylvænæs,stormscale,1483,hunter,beastmastery,87,42,45
Гернриета,gordunni,1482,hunter,beastmastery,90,44,46
Budhunter,alakir,1481,hunter,beastmastery,169,88,81
Dzördzo,kazzak,1481,hunter,beastmastery,56,26,30
Zantorious,ravencrest,1480,hunter,beastmastery,99,59,40
Sindørei,lightbringer,1480,hunter,beastmastery,39,21,18
Váal,dun-modr,1479,hunter,beastmastery,85,49,36
Lokiis,hyjal,1479,hunter,beastmastery,138,75,63
Dirtydolores,thrall,1478,hunter,beastmastery,41,24,17
Glorfindhel,archimonde,1478,hunter,beastmastery,108,59,49
Xystîco,thrall,1478,hunter,beastmastery,78,41,37
Valldes,argent-dawn,1478,hunter,beastmastery,75,33,42
Gumm,gorgonnash,1477,hunter,beastmastery,120,60,60
Аллони,booty-bay,1477,hunter,beastmastery,189,90,99
Aorence,kirin-tor,1476,hunter,beastmastery,90,53,37
Aenina,kazzak,1476,hunter,beastmastery,78,43,35
Pego,grim-batol,1476,hunter,beastmastery,61,29,32
Djbombastic,archimonde,1475,hunter,beastmastery,72,42,30
Lännennopein,outland,1474,hunter,beastmastery,83,39,44
Enty,blackrock,1473,hunter,beastmastery,26,17,9
Wingclip,ravencrest,1472,hunter,beastmastery,40,17,23
Bastianapa,twisting-nether,1471,hunter,beastmastery,66,31,35
Velrox,blackmoore,1470,hunter,beastmastery,30,16,14
Bogüen,sanguino,1470,hunter,beastmastery,66,33,33
Kurtanâ,blackmoore,1470,hunter,beastmastery,48,21,27
Ñápøléóñ,draenor,1469,hunter,beastmastery,30,18,12
Machinedream,sylvanas,1469,hunter,beastmastery,30,17,13
Sylariel,die-aldor,1469,hunter,beastmastery,46,23,23
Маори,deepholm,1469,hunter,beastmastery,42,18,24
Lascazador,dun-modr,1469,hunter,beastmastery,80,33,47
Варсор,soulflayer,1468,hunter,beastmastery,42,18,24
Dzikabestia,burning-legion,1467,hunter,beastmastery,36,21,15
Leriath,shadowsong,1466,hunter,beastmastery,149,82,67
Råhl,zuljin,1466,hunter,beastmastery,41,17,24
Kibola,antonidas,1465,hunter,beastmastery,72,29,43
Slippytoad,kazzak,1464,hunter,beastmastery,22,16,6
Viktorijå,draenor,1464,hunter,beastmastery,59,35,24
Halfogre,draenor,1464,hunter,beastmastery,36,18,18
Twinshot,anetheron,1463,hunter,beastmastery,138,79,59
Зимняясказка,soulflayer,1461,hunter,beastmastery,48,19,29
Desow,blackrock,1458,hunter,beastmastery,102,58,44
Zäroury,ravencrest,1458,hunter,beastmastery,88,39,49
Dezmoinez,twisting-nether,1457,hunter,beastmastery,28,16,12
Mufdii,sylvanas,1457,hunter,beastmastery,34,16,18
Moistmán,kazzak,1456,hunter,beastmastery,290,141,149
Рэмпейджшот,soulflayer,1455,hunter,beastmastery,42,24,18
Dramin,defias-brotherhood,1455,hunter,beastmastery,239,128,111
Куников,booty-bay,1453,hunter,beastmastery,26,17,9
Naramir,ysondre,1453,hunter,beastmastery,33,18,15
Freebïrd,shattered-hand,1453,hunter,beastmastery,54,25,29
Druckwelle,frostwolf,1453,hunter,beastmastery,134,60,74
Хедшоттер,blackscar,1453,hunter,beastmastery,38,17,21
Туруханец,gordunni,1452,hunter,beastmastery,266,142,124
Anjeschka,nemesis,1451,hunter,beastmastery,64,37,27
Acmé,kazzak,1451,hunter,beastmastery,54,22,32
Ynfik,sinstralis,1450,hunter,beastmastery,130,70,60
Feerea,burning-legion,1450,hunter,beastmastery,51,23,28
Tukene,kazzak,1450,hunter,beastmastery,63,24,39
Shawnrai,drakthul,1449,hunter,beastmastery,44,24,20
Crossjob,kazzak,1449,hunter,beastmastery,54,29,25
Bambamgalke,antonidas,1449,hunter,beastmastery,131,66,65
Vaelyste,doomhammer,1449,hunter,beastmastery,127,63,64
Zevlove,kazzak,1447,hunter,beastmastery,108,48,60
Huntardxx,outland,1447,hunter,beastmastery,36,16,20
Jarekk,auchindoun,1446,hunter,beastmastery,91,48,43
Vypaz,twisting-nether,1446,hunter,beastmastery,60,30,30
Drigs,blackrock,1445,hunter,beastmastery,117,59,58
Gaiä,sanguino,1445,hunter,beastmastery,60,30,30
Nätzz,dun-modr,1445,hunter,beastmastery,71,33,38
Whazupdude,drakthul,1444,hunter,beastmastery,53,34,19
Toxical,ragnaros,1444,hunter,beastmastery,42,26,16
Miracleh,tarren-mill,1444,hunter,beastmastery,48,26,22
Metrolog,twisting-nether,1444,hunter,beastmastery,117,57,60
Loyuf,burning-blade,1443,hunter,beastmastery,39,20,19
Trapwann,argent-dawn,1443,hunter,beastmastery,98,46,52
Markev,norgannon,1442,hunter,beastmastery,36,17,19
Фдкд,howling-fjord,1442,hunter,beastmastery,134,62,72
Makaxx,stormscale,1441,hunter,beastmastery,49,31,18
Dêstiny,dun-modr,1441,hunter,beastmastery,60,35,25
Vasu,azjolnerub,1440,hunter,beastmastery,72,41,31
Rifle,dun-morogh,1440,hunter,beastmastery,58,29,29
Engetsu,drakthul,1440,hunter,beastmastery,145,70,75
Syniix,ravencrest,1439,hunter,beastmastery,30,15,15
Rdom,stormreaver,1439,hunter,beastmastery,200,99,101
Lustor,ravencrest,1439,hunter,beastmastery,173,83,90
Draugrinnh,tarren-mill,1439,hunter,beastmastery,72,29,43
Tràpz,archimonde,1439,hunter,beastmastery,57,22,35
Flytomars,ravencrest,1439,hunter,beastmastery,47,18,29
Therakal,culte-de-la-rive-noire,1438,hunter,beastmastery,30,16,14
Luluxfire,burning-legion,1438,hunter,beastmastery,64,30,34
Tokyodripztv,drakthul,1437,hunter,beastmastery,48,27,21
Ахотакрепкая,gordunni,1437,hunter,beastmastery,30,16,14
Khatia,blackrock,1437,hunter,beastmastery,42,21,21
Xenvantos,silvermoon,1437,hunter,beastmastery,30,15,15
Juha,the-maelstrom,1437,hunter,beastmastery,57,28,29
Secretagent,zenedar,1436,hunter,beastmastery,30,16,14
Kayoo,stormscale,1436,hunter,beastmastery,54,20,34
Mágaz,draenor,1435,hunter,beastmastery,48,26,22
Wüst,tarren-mill,1435,hunter,beastmastery,30,16,14
Wøden,ysondre,1435,hunter,beastmastery,123,54,69
Застрельщикц,soulflayer,1434,hunter,beastmastery,72,41,31
Rachelicious,ravencrest,1434,hunter,beastmastery,30,15,15
Mdmalol,malganis,1433,hunter,beastmastery,30,15,15
Galduhr,silvermoon,1433,hunter,beastmastery,36,16,20
Tipsü,blackmoore,1432,hunter,beastmastery,51,28,23
Arrowman,burning-legion,1432,hunter,beastmastery,42,22,20
Pixxeel,khaz-modan,1432,hunter,beastmastery,36,18,18
Dràcula,tarren-mill,1432,hunter,beastmastery,52,24,28
Noréaga,suramar,1431,hunter,beastmastery,36,20,16
Zäyk,zuljin,1431,hunter,beastmastery,79,42,37
Jaxteller,archimonde,1431,hunter,beastmastery,30,15,15
Velites,aggra-português,1430,hunter,beastmastery,57,27,30
Natchell,ysondre,1429,hunter,beastmastery,30,15,15
Yoggys,outland,1429,hunter,beastmastery,95,47,48
Ayyubi,blackrock,1428,hunter,beastmastery,89,44,45
Tsivoula,twisting-nether,1427,hunter,beastmastery,65,40,25
Toosmall,stormscale,1427,hunter,beastmastery,58,33,25
Eufumo,sanguino,1427,hunter,beastmastery,88,48,40
Нариса,soulflayer,1427,hunter,beastmastery,48,26,22
Steezowl,kazzak,1427,hunter,beastmastery,33,17,16
Necromercy,burning-legion,1426,hunter,beastmastery,76,41,35
Зуланария,howling-fjord,1426,hunter,beastmastery,106,52,54
Clickbile,twisting-nether,1426,hunter,beastmastery,32,15,17
Хипдо,soulflayer,1426,hunter,beastmastery,48,15,33
Bibsy,tarren-mill,1425,hunter,beastmastery,35,19,16
Убершванц,soulflayer,1425,hunter,beastmastery,67,30,37
Tasdiingo,tarren-mill,1423,hunter,beastmastery,48,20,28
Beorind,frostwolf,1422,hunter,beastmastery,24,15,9
Mytown,hyjal,1422,hunter,beastmastery,227,113,114
Shieryu,archimonde,1422,hunter,beastmastery,90,39,51
Bempl,onyxia,1422,hunter,beastmastery,36,15,21
Торая,gordunni,1421,hunter,beastmastery,30,15,15
Hävenofün,archimonde,1421,hunter,beastmastery,54,19,35
Medûse,stormscale,1420,hunter,beastmastery,79,40,39
Mariehunt,blackmoore,1420,hunter,beastmastery,108,52,56
Graavi,silvermoon,1420,hunter,beastmastery,45,18,27
Softishot,archimonde,1419,hunter,beastmastery,30,16,14
Crynomore,tarren-mill,1418,hunter,beastmastery,68,41,27
Andjelaa,kazzak,1417,hunter,beastmastery,38,19,19
Zy,silvermoon,1416,hunter,beastmastery,30,15,15
Badkirves,kazzak,1416,hunter,beastmastery,109,50,59
Thyala,twisting-nether,1416,hunter,beastmastery,75,33,42
Бвонсамдик,howling-fjord,1415,hunter,beastmastery,82,42,40
Arseniic,dalaran,1415,hunter,beastmastery,52,22,30
Dogthebounty,tarren-mill,1414,hunter,beastmastery,43,25,18
Weiaw,blackmoore,1414,hunter,beastmastery,57,26,31
Metsänmies,defias-brotherhood,1413,hunter,beastmastery,52,31,21
Waalth,ragnaros,1412,hunter,beastmastery,172,85,87
Leáa,eredar,1411,hunter,beastmastery,72,35,37
Velocity,nagrand,1411,hunter,beastmastery,41,19,22
Batalul,twisting-nether,1410,hunter,beastmastery,48,29,19
Маянашашлыки,galakrond,1410,hunter,beastmastery,108,60,48
Hruon,sporeggar,1410,hunter,beastmastery,66,31,35
Earnzie,outland,1410,hunter,beastmastery,84,36,48
Focuslhunt,archimonde,1409,hunter,beastmastery,76,40,36
Дипшот,deathguard,1408,hunter,beastmastery,103,53,50
Andraz,burning-legion,1408,hunter,beastmastery,60,25,35
Стреладемона,gordunni,1407,hunter,beastmastery,75,43,32
Jas,kargath,1406,hunter,beastmastery,184,94,90
Taveon,turalyon,1406,hunter,beastmastery,56,28,28
Афонадзе,gordunni,1406,hunter,beastmastery,152,74,78
Лиор,howling-fjord,1405,hunter,beastmastery,171,79,92
Tizzlbang,ragnaros,1404,hunter,beastmastery,30,17,13
Loógosh,blackmoore,1404,hunter,beastmastery,120,59,61
Glizzygobblr,kazzak,1404,hunter,beastmastery,62,29,33
Neíth,the-maelstrom,1404,hunter,beastmastery,129,60,69
Àrsaidh,draenor,1403,hunter,beastmastery,59,33,26
Джантига,howling-fjord,1403,hunter,beastmastery,54,30,24
Retropunk,ravencrest,1403,hunter,beastmastery,48,23,25
Xiaoly,kaelthas,1403,hunter,beastmastery,36,15,21
Ravis,aegwynn,1403,hunter,beastmastery,44,18,26
Môrkh,sanguino,1403,hunter,beastmastery,42,17,25
Smitheye,argent-dawn,1402,hunter,beastmastery,90,43,47
Rhee,the-maelstrom,1402,hunter,beastmastery,157,72,85
Elsasehunter,zuljin,1402,hunter,beastmastery,132,60,72
Blupo,stormscale,1401,hunter,beastmastery,381,190,191
Geete,kazzak,1400,hunter,beastmastery,30,17,13
Drestan,drakthul,1400,hunter,beastmastery,96,47,49
Phinecone,stormscale,1399,hunter,beastmastery,42,18,24
Ikschietjou,frostmane,1398,hunter,beastmastery,134,72,62
Flunkytim,blackmoore,1398,hunter,beastmastery,108,58,50
Raymear,kazzak,1398,hunter,beastmastery,110,56,54
Napa,kazzak,1396,hunter,beastmastery,29,16,13
Belorgrim,kirin-tor,1395,hunter,beastmastery,90,49,41
Беспокойный,soulflayer,1395,hunter,beastmastery,71,31,40
Bláckheart,doomhammer,1395,hunter,beastmastery,44,19,25
Artemisas,draenor,1395,hunter,beastmastery,72,29,43
Mââl,archimonde,1394,hunter,beastmastery,36,16,20
Бубунн,howling-fjord,1394,hunter,beastmastery,96,42,54
Blàdê,blackrock,1393,hunter,beastmastery,30,15,15
Гиладар,borean-tundra,1393,hunter,beastmastery,69,33,36
Soulflyer,draenor,1393,hunter,beastmastery,61,27,34
Hiðe,archimonde,1393,hunter,beastmastery,61,25,36
Câonimâ,twisting-nether,1392,hunter,beastmastery,96,49,47
Sníper,aggra-português,1392,hunter,beastmastery,125,58,67
Шионо,howling-fjord,1391,hunter,beastmastery,56,29,27
Traktorr,stormscale,1391,hunter,beastmastery,102,50,52
Bozidarka,kazzak,1390,hunter,beastmastery,30,18,12
Ázurâ,blackhand,1390,hunter,beastmastery,86,42,44
Bigbababotan,blackrock,1390,hunter,beastmastery,45,20,25
Kareltje,stormscale,1388,hunter,beastmastery,37,21,16
Афигеннски,ashenvale,1387,hunter,beastmastery,54,25,29
Adram,burning-legion,1386,hunter,beastmastery,29,16,13
Hammertime,sanguino,1385,hunter,beastmastery,114,58,56
Curtiss,sanguino,1385,hunter,beastmastery,86,40,46
Reiign,burning-legion,1385,hunter,beastmastery,59,24,35
Xüscha,ysera,1384,hunter,beastmastery,152,69,83
Эмомото,howling-fjord,1384,hunter,beastmastery,72,29,43
Кулинарк,howling-fjord,1383,hunter,beastmastery,94,50,44
Shädoh,outland,1382,hunter,beastmastery,54,28,26
Труласек,blackscar,1381,hunter,beastmastery,60,36,24
Beardmastery,auchindoun,1380,hunter,beastmastery,36,16,20
Фожа,howling-fjord,1379,hunter,beastmastery,110,47,63
Straybullet,kazzak,1378,hunter,beastmastery,296,148,148
Kaisêl,silvermoon,1378,hunter,beastmastery,54,24,30
Vachekiki,archimonde,1377,hunter,beastmastery,77,52,25
Sørha,chogall,1376,hunter,beastmastery,26,17,9
Хлопс,howling-fjord,1376,hunter,beastmastery,36,16,20
Haggy,die-nachtwache,1375,hunter,beastmastery,30,16,14
Фетсол,soulflayer,1375,hunter,beastmastery,54,28,26
Hogar,frostwolf,1375,hunter,beastmastery,44,21,23
Ommadawn,dun-modr,1374,hunter,beastmastery,107,55,52
Vruh,antonidas,1374,hunter,beastmastery,43,22,21
Esgar,blackrock,1374,hunter,beastmastery,74,34,40
Texaco,dun-modr,1374,hunter,beastmastery,55,25,30
Cabuløsø,aggra-português,1373,hunter,beastmastery,66,38,28
Bøwjøb,arthas,1373,hunter,beastmastery,74,42,32
Зихантер,soulflayer,1372,hunter,beastmastery,56,27,29
Penehuntos,eredar,1371,hunter,beastmastery,42,15,27
Retroxia,stormreaver,1370,hunter,beastmastery,42,24,18
Lunaunii,argent-dawn,1370,hunter,beastmastery,42,22,20
Шуггарэй,soulflayer,1370,hunter,beastmastery,41,17,24
Yayoo,cthun,1369,hunter,beastmastery,77,31,46
Jaky,illidan,1368,hunter,beastmastery,179,104,75
Vivako,silvermoon,1368,hunter,beastmastery,66,35,31
Максдпс,deathguard,1368,hunter,beastmastery,31,16,15
Demónhunter,frostmane,1368,hunter,beastmastery,38,16,22
Анариэльсин,soulflayer,1368,hunter,beastmastery,36,15,21
Dunkelmut,arthas,1367,hunter,beastmastery,36,15,21
Beletor,medivh,1365,hunter,beastmastery,30,15,15
Élenas,confrérie-du-thorium,1364,hunter,beastmastery,42,22,20
Dzikapumpa,burning-legion,1363,hunter,beastmastery,69,29,40
Saromán,ravencrest,1362,hunter,beastmastery,42,23,19
Цумочка,blackscar,1362,hunter,beastmastery,41,22,19
Эннабонни,gordunni,1362,hunter,beastmastery,66,34,32
Tåxi,silvermoon,1362,hunter,beastmastery,207,102,105
Gabbriel,ravencrest,1361,hunter,beastmastery,49,30,19
Kënpachi,silvermoon,1360,hunter,beastmastery,52,22,30
Devøurer,blackmoore,1359,hunter,beastmastery,42,21,21
Бедствиие,galakrond,1359,hunter,beastmastery,127,57,70
Zúzú,hyjal,1358,hunter,beastmastery,54,32,22
Erenjaeger,onyxia,1356,hunter,beastmastery,72,43,29
Halgen,medivh,1355,hunter,beastmastery,140,67,73
Metalmaison,archimonde,1355,hunter,beastmastery,214,101,113
Xndr,sanguino,1354,hunter,beastmastery,24,15,9
Bufosh,twisting-nether,1352,hunter,beastmastery,139,74,65
Pancakesgo,twilights-hammer,1351,hunter,beastmastery,212,106,106
Коблазнх,howling-fjord,1351,hunter,beastmastery,33,16,17
Cfueb,doomhammer,1351,hunter,beastmastery,42,15,27
Elanimal,blackmoore,1350,hunter,beastmastery,52,24,28
Alêx,outland,1349,hunter,beastmastery,24,15,9
Boulaax,ysondre,1349,hunter,beastmastery,136,73,63
Кэрнел,gordunni,1349,hunter,beastmastery,71,34,37
Lootgobbo,antonidas,1349,hunter,beastmastery,63,30,33
Joshalama,quelthalas,1348,hunter,beastmastery,64,34,30
Amitar,tarren-mill,1347,hunter,beastmastery,60,33,27
Sebastien,frostmane,1347,hunter,beastmastery,33,17,16
Zelarun,ragnaros,1345,hunter,beastmastery,42,24,18
Ловихимеру,soulflayer,1345,hunter,beastmastery,78,37,41
Фузег,deathguard,1343,hunter,beastmastery,282,142,140
Инойхохо,gordunni,1342,hunter,beastmastery,18,14,4
Grandiosity,tarren-mill,1342,hunter,beastmastery,47,29,18
Onlyforfun,ravencrest,1342,hunter,beastmastery,24,14,10
Võnbødefeld,frostmourne,1342,hunter,beastmastery,52,27,25
Ubietza,aegwynn,1342,hunter,beastmastery,301,145,156
Чизано,deathguard,1342,hunter,beastmastery,53,25,28
Kiingsane,archimonde,1342,hunter,beastmastery,61,25,36
Keoph,tarren-mill,1342,hunter,beastmastery,36,14,22
Swâân,sanguino,1341,hunter,beastmastery,39,20,19
Chibimonx,ravencrest,1341,hunter,beastmastery,34,15,19
Missmytrap,archimonde,1340,hunter,beastmastery,18,14,4
Karuso,ravencrest,1340,hunter,beastmastery,30,14,16
Meskette,ravencrest,1340,hunter,beastmastery,70,30,40
Mïrynn,culte-de-la-rive-noire,1339,hunter,beastmastery,30,14,16
Swargano,archimonde,1339,hunter,beastmastery,48,16,32
Bãldur,ravencrest,1338,hunter,beastmastery,40,21,19
Дафирия,deathguard,1338,hunter,beastmastery,124,62,62
Стрелывалеры,gordunni,1338,hunter,beastmastery,36,14,22
Artze,outland,1337,hunter,beastmastery,30,14,16
Notikâ,aegwynn,1336,hunter,beastmastery,48,20,28
Bågeniburen,draenor,1335,hunter,beastmastery,44,23,21
Marleyson,uldum,1335,hunter,beastmastery,54,27,27
Cryptstalkér,antonidas,1335,hunter,beastmastery,42,21,21
Pammycakes,bronze-dragonflight,1335,hunter,beastmastery,194,96,98
Raythe,argent-dawn,1335,hunter,beastmastery,30,14,16
Korneatza,twisting-nether,1335,hunter,beastmastery,48,17,31
Huntercheese,ravencrest,1334,hunter,beastmastery,41,23,18
Kaaj,nemesis,1334,hunter,beastmastery,30,16,14
Дэментед,soulflayer,1333,hunter,beastmastery,30,14,16
Шурикцаревич,galakrond,1333,hunter,beastmastery,66,23,43
Гримкааг,eversong,1332,hunter,beastmastery,102,56,46
Ninjaskillss,ravencrest,1331,hunter,beastmastery,30,17,13
Tonk,garrosh,1331,hunter,beastmastery,84,38,46
Skribez,blackmoore,1330,hunter,beastmastery,82,42,40
Eagletalon,twisting-nether,1330,hunter,beastmastery,79,34,45
Сашатетива,gordunni,1329,hunter,beastmastery,30,14,16
Feignindeath,twisting-nether,1328,hunter,beastmastery,60,35,25
Huntarbeît,eredar,1328,hunter,beastmastery,45,15,30
Hantro,argent-dawn,1327,hunter,beastmastery,60,33,27
Magrha,khaz-modan,1327,hunter,beastmastery,63,34,29
Rogg,destromath,1327,hunter,beastmastery,28,15,13
Hílfíger,kazzak,1327,hunter,beastmastery,89,37,52
Hardo,guldan,1326,hunter,beastmastery,60,30,30
Melèxè,ysondre,1326,hunter,beastmastery,59,26,33
Dotkor,laughing-skull,1325,hunter,beastmastery,168,86,82
Rabyan,zuljin,1325,hunter,beastmastery,81,32,49
Woriodhuntz,twisting-nether,1324,hunter,beastmastery,106,55,51
Holdmabeerx,silvermoon,1324,hunter,beastmastery,45,20,25
Sélenaé,hyjal,1324,hunter,beastmastery,58,24,34
Settisetä,defias-brotherhood,1323,hunter,beastmastery,24,14,10
Choukzt,archimonde,1323,hunter,beastmastery,24,14,10
Platzpatron,eredar,1323,hunter,beastmastery,132,62,70
Aluara,burning-legion,1323,hunter,beastmastery,42,18,24
Waidø,blackhand,1321,hunter,beastmastery,48,25,23
Turbogt,stormscale,1321,hunter,beastmastery,30,14,16
Travels,tarren-mill,1320,hunter,beastmastery,165,82,83
Eéilin,the-maelstrom,1320,hunter,beastmastery,52,25,27
Ríckybobby,kazzak,1319,hunter,beastmastery,43,22,21
Талигар,razuvious,1319,hunter,beastmastery,206,95,111
Halessia,ravencrest,1318,hunter,beastmastery,190,94,96
Хантвкроксах,gordunni,1317,hunter,beastmastery,38,18,20
Gamosh,anetheron,1317,hunter,beastmastery,60,25,35
Macabremoon,silvermoon,1316,hunter,beastmastery,24,14,10
Angrypickle,defias-brotherhood,1315,hunter,beastmastery,105,52,53
Rushgarroth,ravencrest,1315,hunter,beastmastery,138,67,71
Кровавыйсэм,howling-fjord,1315,hunter,beastmastery,42,14,28
Имбакласс,howling-fjord,1314,hunter,beastmastery,24,15,9
Анютикус,gordunni,1314,hunter,beastmastery,97,57,40
Øßlíck,ysondre,1314,hunter,beastmastery,30,14,16
Nomadest,silvermoon,1313,hunter,beastmastery,24,14,10
Meredo,burning-legion,1313,hunter,beastmastery,64,33,31
Dùmbo,khaz-modan,1313,hunter,beastmastery,96,46,50
Konghans,ravencrest,1313,hunter,beastmastery,83,38,45
Baileé,onyxia,1312,hunter,beastmastery,80,40,40
Berkobaggins,twisting-nether,1312,hunter,beastmastery,104,46,58
Вижусвет,howling-fjord,1311,hunter,beastmastery,66,35,31
Trapiswinyes,aegwynn,1311,hunter,beastmastery,30,14,16
Люблюлюбовь,gordunni,1310,hunter,beastmastery,42,27,15
Goethe,ravencrest,1309,hunter,beastmastery,42,22,20
Aneji,hyjal,1308,hunter,beastmastery,86,45,41
Герциг,gordunni,1306,hunter,beastmastery,40,20,20
Grrizzly,kazzak,1306,hunter,beastmastery,85,42,43
Watntietjes,burning-blade,1306,hunter,beastmastery,72,33,39
Expulse,eredar,1305,hunter,beastmastery,18,14,4
Ххун,gordunni,1305,hunter,beastmastery,106,49,57
Showerhead,silvermoon,1305,hunter,beastmastery,32,14,18
Sillychilly,frostwolf,1305,hunter,beastmastery,45,17,28
Radley,conseil-des-ombres,1304,hunter,beastmastery,72,34,38
Soen,zuljin,1304,hunter,beastmastery,70,32,38
Hoffarex,grim-batol,1304,hunter,beastmastery,42,18,24
Felorya,kazzak,1303,hunter,beastmastery,58,30,28
Coxxie,ragnaros,1303,hunter,beastmastery,51,24,27
Karên,blackmoore,1303,hunter,beastmastery,41,19,22
Zerisi,silvermoon,1302,hunter,beastmastery,41,25,16
Ivvy,defias-brotherhood,1301,hunter,beastmastery,48,23,25
Румлис,gordunni,1299,hunter,beastmastery,111,62,49
Birdseye,thrall,1299,hunter,beastmastery,60,29,31
Сатарр,gordunni,1299,hunter,beastmastery,219,105,114
Пиворк,soulflayer,1299,hunter,beastmastery,59,20,39
Magarosh,eredar,1298,hunter,beastmastery,30,14,16
Buc,burning-legion,1298,hunter,beastmastery,64,22,42
Blackdingo,lightnings-blade,1296,hunter,beastmastery,24,14,10
Mînérvá,blackhand,1296,hunter,beastmastery,42,22,20
Asousa,stormscale,1296,hunter,beastmastery,78,39,39
Lovecjelenu,drakthul,1296,hunter,beastmastery,49,20,29
Paînfull,kazzak,1296,hunter,beastmastery,35,14,21
Pitton,tarren-mill,1295,hunter,beastmastery,59,37,22
Sueky,dun-modr,1295,hunter,beastmastery,29,16,13
Xéraphine,mannoroth,1295,hunter,beastmastery,127,55,72
Ziday,sargeras,1295,hunter,beastmastery,51,19,32
Nyght,ravencrest,1294,hunter,beastmastery,134,63,71
Druvnik,zenedar,1293,hunter,beastmastery,84,38,46
Papramorgóó,ragnaros,1293,hunter,beastmastery,40,15,25
Tidydarts,balnazzar,1291,hunter,beastmastery,43,22,21
Shaznak,argent-dawn,1290,hunter,beastmastery,48,25,23
Kideyosi,silvermoon,1290,hunter,beastmastery,85,38,47
Jooetheman,stormscale,1290,hunter,beastmastery,41,18,23
Oneshotkill,laughing-skull,1289,hunter,beastmastery,54,29,25
Cêleste,kaelthas,1289,hunter,beastmastery,128,64,64
Neescafe,sylvanas,1289,hunter,beastmastery,95,46,49
Tyssar,kazzak,1289,hunter,beastmastery,59,24,35
Bourrinax,kazzak,1288,hunter,beastmastery,151,75,76
Râxxis,alleria,1288,hunter,beastmastery,77,35,42
Keinzira,hyjal,1288,hunter,beastmastery,53,24,29
Барбарисовна,ashenvale,1286,hunter,beastmastery,113,51,62
Ridlas,silvermoon,1285,hunter,beastmastery,207,104,103
Yoüllsuffer,twisting-nether,1285,hunter,beastmastery,36,15,21
Дзэнмашина,booty-bay,1284,hunter,beastmastery,110,55,55
Demolaiser,dun-modr,1283,hunter,beastmastery,117,62,55
Nårgai,kargath,1283,hunter,beastmastery,114,60,54
Gbureczka,burning-legion,1282,hunter,beastmastery,72,31,41
Блудитролль,soulflayer,1282,hunter,beastmastery,36,14,22
Nymmbtw,tarren-mill,1281,hunter,beastmastery,41,22,19
Vör,drakthul,1281,hunter,beastmastery,38,17,21
Nelthara,burning-blade,1281,hunter,beastmastery,36,15,21
Chagaure,hyjal,1280,hunter,beastmastery,60,25,35
Балласкиндер,gordunni,1279,hunter,beastmastery,82,46,36
Random,sylvanas,1278,hunter,beastmastery,32,15,17
Darkdexou,defias-brotherhood,1277,hunter,beastmastery,24,14,10
Drothani,argent-dawn,1277,hunter,beastmastery,48,17,31
Nerdhark,hyjal,1276,hunter,beastmastery,105,50,55
Bessa,skullcrusher,1274,hunter,beastmastery,90,45,45
Yoimdjsebo,twisting-nether,1272,hunter,beastmastery,24,14,10
Grumpyhuntér,draenor,1272,hunter,beastmastery,30,15,15
Kyliun,frostmane,1272,hunter,beastmastery,95,47,48
Sbegodx,hyjal,1272,hunter,beastmastery,215,106,109
Edùens,ysondre,1272,hunter,beastmastery,213,104,109
Скелус,soulflayer,1271,hunter,beastmastery,30,15,15
Drowranger,frostwolf,1271,hunter,beastmastery,65,30,35
Безос,soulflayer,1270,hunter,beastmastery,44,23,21
Shadowmiz,shattered-hand,1270,hunter,beastmastery,50,23,27
Footsy,twisting-nether,1270,hunter,beastmastery,54,24,30
Øï,outland,1269,hunter,beastmastery,56,24,32
Oogyboogy,draenor,1269,hunter,beastmastery,35,14,21
Whatifany,tarren-mill,1268,hunter,beastmastery,102,41,61
Тысячиимен,gordunni,1267,hunter,beastmastery,30,16,14
Arhyah,medivh,1265,hunter,beastmastery,33,15,18
Krasavcik,shattrath,1264,hunter,beastmastery,24,14,10
Zamale,arakarahm,1264,hunter,beastmastery,72,32,40
Elua,guldan,1264,hunter,beastmastery,54,23,31
Rxr,kazzak,1264,hunter,beastmastery,54,17,37
Lusifa,antonidas,1263,hunter,beastmastery,123,65,58
Tbeck,ragnaros,1263,hunter,beastmastery,42,18,24
Vådesskudd,outland,1262,hunter,beastmastery,60,35,25
Remiss,sanguino,1262,hunter,beastmastery,34,19,15
Wutrapog,kazzak,1262,hunter,beastmastery,26,14,12
Pêvépê,silvermoon,1261,hunter,beastmastery,48,29,19
Gheezana,blackhand,1260,hunter,beastmastery,36,14,22
Аквилеон,gordunni,1260,hunter,beastmastery,40,15,25
Slojork,thrall,1259,hunter,beastmastery,300,146,154
Cdorak,zuljin,1259,hunter,beastmastery,53,25,28
Diac,dalaran,1258,hunter,beastmastery,30,19,11
Mentera,doomhammer,1258,hunter,beastmastery,30,16,14
Kaktus,shattered-hand,1258,hunter,beastmastery,36,18,18
Zalacko,ragnaros,1258,hunter,beastmastery,30,15,15
Фитьфитий,howling-fjord,1256,hunter,beastmastery,88,45,43
Fahin,draenor,1256,hunter,beastmastery,130,62,68
Ïnayä,dalaran,1255,hunter,beastmastery,52,26,26
Taemper,azshara,1255,hunter,beastmastery,54,26,28
Fenstad,dalaran,1255,hunter,beastmastery,88,42,46
Linchpin,dentarg,1255,hunter,beastmastery,62,28,34
Vavabxl,ysondre,1254,hunter,beastmastery,30,14,16
Míoo,antonidas,1254,hunter,beastmastery,36,14,22
Graltar,tarren-mill,1253,hunter,beastmastery,110,59,51
Basìcs,nemesis,1253,hunter,beastmastery,191,96,95
Lioness,ahnqiraj,1252,hunter,beastmastery,51,23,28
Verathelon,drakthul,1251,hunter,beastmastery,81,40,41
Snípér,blackhand,1251,hunter,beastmastery,60,26,34
Древнинко,greymane,1251,hunter,beastmastery,42,15,27
Tsoutsoukoss,silvermoon,1250,hunter,beastmastery,253,130,123
Michaelvm,ravencrest,1250,hunter,beastmastery,47,24,23
Nesthor,sinstralis,1250,hunter,beastmastery,58,26,32
Deblaze,aegwynn,1248,hunter,beastmastery,24,13,11
Monodeguyabo,sanguino,1248,hunter,beastmastery,30,14,16
Oliene,twisting-nether,1248,hunter,beastmastery,58,27,31
Kermitjump,drakthul,1248,hunter,beastmastery,92,42,50
Ðowz,ysondre,1248,hunter,beastmastery,30,13,17
Maverz,blackhand,1247,hunter,beastmastery,30,13,17
Lagich,sylvanas,1247,hunter,beastmastery,30,13,17
Omarah,sanguino,1247,hunter,beastmastery,53,21,32
Poke,aggra-português,1247,hunter,beastmastery,36,13,23
Dravara,blackmoore,1246,hunter,beastmastery,118,63,55
Lucivs,ravenholdt,1246,hunter,beastmastery,77,41,36
Eluun,saurfang,1246,hunter,beastmastery,47,23,24
Sâtaria,blackhand,1246,hunter,beastmastery,31,15,16
Ivanoé,archimonde,1246,hunter,beastmastery,30,13,17
Jablaka,blackhand,1245,hunter,beastmastery,197,95,102
Тоу,deathguard,1244,hunter,beastmastery,25,13,12
Ládysháyà,blackrock,1243,hunter,beastmastery,292,150,142
Iamedward,silvermoon,1242,hunter,beastmastery,49,31,18
Arkelion,argent-dawn,1242,hunter,beastmastery,24,13,11
Skytraped,hyjal,1242,hunter,beastmastery,24,13,11
Flugsmälla,kazzak,1242,hunter,beastmastery,24,13,11
Lökout,twilights-hammer,1240,hunter,beastmastery,30,13,17
Хастла,greymane,1240,hunter,beastmastery,30,13,17
Blazeityolo,outland,1240,hunter,beastmastery,36,13,23
Salvia,chromaggus,1239,hunter,beastmastery,275,139,136
Puska,gilneas,1239,hunter,beastmastery,117,59,58
Zyhraa,ravencrest,1238,hunter,beastmastery,24,13,11
Lurigalinda,twisting-nether,1237,hunter,beastmastery,30,13,17
Deathwallker,silvermoon,1236,hunter,beastmastery,24,13,11
Ázèrøñå,draenor,1235,hunter,beastmastery,18,13,5
Шмыгахант,gordunni,1235,hunter,beastmastery,30,13,17
Jyenety,stormscale,1234,hunter,beastmastery,54,27,27
Sackboy,thrall,1233,hunter,beastmastery,33,16,17
Brâzahart,silvermoon,1233,hunter,beastmastery,36,13,23
Zithis,argent-dawn,1233,hunter,beastmastery,36,13,23
Bisschen,azshara,1232,hunter,beastmastery,106,51,55
Jegeralv,argent-dawn,1232,hunter,beastmastery,92,36,56
Aguerex,alleria,1232,hunter,beastmastery,42,14,28
Skidzo,alakir,1231,hunter,beastmastery,32,15,17
Mecamoot,drekthar,1230,hunter,beastmastery,24,13,11
Bowere,kazzak,1230,hunter,beastmastery,30,13,17
Dariatate,eredar,1229,hunter,beastmastery,64,34,30
Sauce,alonsus,1228,hunter,beastmastery,36,13,23
Kaletorw,ragnaros,1227,hunter,beastmastery,72,39,33
Zercore,echsenkessel,1227,hunter,beastmastery,65,32,33
Penthesîlea,aegwynn,1227,hunter,beastmastery,133,63,70
Qmbonboni,ravencrest,1226,hunter,beastmastery,55,32,23
Sisilianno,khaz-modan,1226,hunter,beastmastery,72,38,34
Spíke,tarren-mill,1225,hunter,beastmastery,18,13,5
Toralfmoralf,aegwynn,1225,hunter,beastmastery,24,13,11
Davíncí,tarren-mill,1224,hunter,beastmastery,77,41,36
Neeske,sylvanas,1224,hunter,beastmastery,30,13,17
Deunan,shattered-hand,1223,hunter,beastmastery,96,48,48
Bravestarr,blades-edge,1223,hunter,beastmastery,90,42,48
Noaim,blackrock,1222,hunter,beastmastery,26,14,12
Annisaqt,kazzak,1222,hunter,beastmastery,59,31,28
Vexhh,outland,1221,hunter,beastmastery,24,13,11
Lore,hyjal,1221,hunter,beastmastery,29,14,15
Biggbazzaa,aggramar,1221,hunter,beastmastery,71,32,39
Ililivillumi,tarren-mill,1220,hunter,beastmastery,49,27,22
Huntiio,khaz-modan,1220,hunter,beastmastery,84,41,43
Wolfyh,terokkar,1219,hunter,beastmastery,36,19,17
Ecalter,dun-modr,1219,hunter,beastmastery,72,35,37
Alongshot,outland,1219,hunter,beastmastery,64,31,33
Mehtäsika,xavius,1219,hunter,beastmastery,74,34,40
Robal,burning-legion,1219,hunter,beastmastery,42,19,23
Logales,dragonblight,1219,hunter,beastmastery,50,20,30
Beasted,frostwolf,1218,hunter,beastmastery,30,13,17
Badhunt,stormscale,1218,hunter,beastmastery,36,13,23
Isohunt,alakir,1217,hunter,beastmastery,23,18,5
Stogie,auchindoun,1217,hunter,beastmastery,24,13,11
Arnatti,tyrande,1217,hunter,beastmastery,34,18,16
Mikhäilxdløl,tarren-mill,1217,hunter,beastmastery,75,36,39
Darkhunt,ysondre,1217,hunter,beastmastery,50,24,26
Glückskiller,nozdormu,1215,hunter,beastmastery,48,15,33
Тофуитер,howling-fjord,1214,hunter,beastmastery,57,25,32
Oròme,pozzo-delleternità,1213,hunter,beastmastery,131,69,62
Гримнар,borean-tundra,1213,hunter,beastmastery,29,13,16
Heita,sylvanas,1212,hunter,beastmastery,30,13,17
Squidy,archimonde,1212,hunter,beastmastery,30,13,17
Äyumi,chogall,1211,hunter,beastmastery,133,59,74
Zorine,culte-de-la-rive-noire,1210,hunter,beastmastery,24,14,10
Janjal,silvermoon,1210,hunter,beastmastery,183,89,94
Blutack,stormscale,1210,hunter,beastmastery,112,44,68
Snipingdog,stormscale,1209,hunter,beastmastery,36,18,18
Hunteriye,twisting-nether,1209,hunter,beastmastery,30,14,16
Jeyl,aegwynn,1207,hunter,beastmastery,29,14,15
Nerøz,ravencrest,1207,hunter,beastmastery,35,13,22
Bolgroth,balnazzar,1206,hunter,beastmastery,24,13,11
Gorett,kazzak,1206,hunter,beastmastery,149,75,74
Heylie,senjin,1206,hunter,beastmastery,47,16,31
Tedohunter,ragnaros,1205,hunter,beastmastery,108,55,53
Donbonz,blackmoore,1204,hunter,beastmastery,30,13,17
Loridana,tichondrius,1204,hunter,beastmastery,113,47,66
Грознострел,gordunni,1203,hunter,beastmastery,88,49,39
Papithagore,hyjal,1203,hunter,beastmastery,29,13,16
Bouboule,elune,1202,hunter,beastmastery,122,74,48
Самомаза,soulflayer,1202,hunter,beastmastery,113,57,56
Skyren,defias-brotherhood,1202,hunter,beastmastery,74,33,41
Kruk,blackhand,1201,hunter,beastmastery,52,26,26
Sithrom,blackmoore,1201,hunter,beastmastery,28,13,15
Бирмингем,ashenvale,1199,hunter,beastmastery,146,69,77
Spineshot,thrall,1199,hunter,beastmastery,93,40,53
Panbuczek,defias-brotherhood,1197,hunter,beastmastery,54,21,33
Heedbónger,tarren-mill,1196,hunter,beastmastery,68,30,38
Tempestes,tarren-mill,1193,hunter,beastmastery,101,53,48
Blêst,tarren-mill,1193,hunter,beastmastery,151,67,84
Marsian,lordaeron,1193,hunter,beastmastery,55,24,31
Cobra,magtheridon,1193,hunter,beastmastery,131,57,74
Noskillclasz,sylvanas,1193,hunter,beastmastery,47,19,28
Spycke,dalaran,1192,hunter,beastmastery,45,29,16
Faramír,azjolnerub,1192,hunter,beastmastery,54,21,33
Graniz,archimonde,1191,hunter,beastmastery,24,14,10
Nieki,eitrigg,1191,hunter,beastmastery,134,61,73
Mazekhin,khaz-modan,1188,hunter,beastmastery,48,18,30
Phalakorn,blackhand,1187,hunter,beastmastery,48,20,28
Быщь,gordunni,1186,hunter,beastmastery,29,14,15
Stokesly,terenas,1186,hunter,beastmastery,29,13,16
Mckanê,ysondre,1183,hunter,beastmastery,30,14,16
Straikkeri,draenor,1182,hunter,beastmastery,117,55,62
Harpin,azuremyst,1181,hunter,beastmastery,95,47,48
Loyalman,blackmoore,1180,hunter,beastmastery,24,15,9
Винченцо,blackscar,1180,hunter,beastmastery,27,13,14
Mizumi,frostmane,1177,hunter,beastmastery,47,20,27
Nidromel,stormscale,1176,hunter,beastmastery,196,98,98
Sehkmet,silvermoon,1176,hunter,beastmastery,68,34,34
Filluu,dalaran,1175,hunter,beastmastery,78,36,42
Benbutton,antonidas,1174,hunter,beastmastery,64,28,36
Blastarrow,the-maelstrom,1172,hunter,beastmastery,120,49,71
Shnidelwoods,blackrock,1171,hunter,beastmastery,56,29,27
Heiltfürzwei,ungoro,1171,hunter,beastmastery,133,61,72
Drakar,eredar,1170,hunter,beastmastery,60,30,30
Unrealy,grim-batol,1169,hunter,beastmastery,269,131,138
Bakatumbah,draenor,1168,hunter,beastmastery,52,26,26
Darilli,wildhammer,1167,hunter,beastmastery,32,17,15
Lakys,cthun,1165,hunter,beastmastery,82,33,49
Kure,blackrock,1164,hunter,beastmastery,185,96,89
Jimmý,sylvanas,1164,hunter,beastmastery,56,27,29
Kiwala,burning-legion,1164,hunter,beastmastery,77,35,42
Bigramy,sanguino,1164,hunter,beastmastery,52,15,37
Eddy,the-maelstrom,1162,hunter,beastmastery,76,39,37
Tunhaa,arthas,1162,hunter,beastmastery,78,40,38
Schnezzler,nerathor,1161,hunter,beastmastery,359,181,178
Biscuitt,kazzak,1161,hunter,beastmastery,47,16,31
Крисмаз,gordunni,1160,hunter,beastmastery,68,21,47
Laerya,les-clairvoyants,1158,hunter,beastmastery,36,16,20
Пулемётчег,razuvious,1158,hunter,beastmastery,52,23,29
Cinan,twisting-nether,1157,hunter,beastmastery,397,199,198
Maglór,senjin,1157,hunter,beastmastery,98,44,54
Arrowin,ravencrest,1154,hunter,beastmastery,36,20,16
Shakuran,burning-legion,1153,hunter,beastmastery,34,13,21
Lajnus,frostmane,1152,hunter,beastmastery,24,12,12
Fivebabe,tarren-mill,1152,hunter,beastmastery,66,32,34
Mercoßenz,kazzak,1151,hunter,beastmastery,24,12,12
Jachu,blackhand,1151,hunter,beastmastery,24,12,12
Bullterrier,ragnaros,1151,hunter,beastmastery,24,12,12
Beeng,ravencrest,1151,hunter,beastmastery,30,14,16
Lilpancake,kazzak,1150,hunter,beastmastery,18,12,6
Kayluh,sylvanas,1150,hunter,beastmastery,18,12,6
Blazinghunt,kazzak,1150,hunter,beastmastery,18,12,6
Shïndh,archimonde,1150,hunter,beastmastery,24,12,12
Leza,kult-der-verdammten,1150,hunter,beastmastery,24,12,12
Outkást,sylvanas,1150,hunter,beastmastery,30,12,18
Næ,kazzak,1150,hunter,beastmastery,30,12,18
Амореселф,gordunni,1150,hunter,beastmastery,30,12,18
Mâjôô,blackhand,1149,hunter,beastmastery,22,13,9
Opalus,ravenholdt,1149,hunter,beastmastery,24,12,12
Forthehordee,chamber-of-aspects,1148,hunter,beastmastery,24,12,12
Petitsui,zuljin,1148,hunter,beastmastery,30,12,18
Appollo,magtheridon,1148,hunter,beastmastery,30,12,18
Envam,outland,1147,hunter,beastmastery,36,12,24
Подлыйстарик,gordunni,1146,hunter,beastmastery,24,12,12
Demyxerus,sanguino,1146,hunter,beastmastery,24,12,12
Adcabuser,tarren-mill,1146,hunter,beastmastery,24,12,12
Jollis,argent-dawn,1146,hunter,beastmastery,173,81,92
Brmwall,twisting-nether,1146,hunter,beastmastery,30,12,18
Gorgorm,ravencrest,1146,hunter,beastmastery,36,12,24
Dasimir,blackrock,1145,hunter,beastmastery,18,12,6
Foxyyo,emerald-dream,1145,hunter,beastmastery,18,12,6
Топотелло,ashenvale,1145,hunter,beastmastery,34,19,15
Лсныйпамп,howling-fjord,1145,hunter,beastmastery,24,12,12
Eöe,ragnaros,1145,hunter,beastmastery,28,12,16
Брзенк,gordunni,1145,hunter,beastmastery,90,33,57
Ниамх,blackscar,1144,hunter,beastmastery,59,25,34
Hunterbeck,ravencrest,1144,hunter,beastmastery,78,32,46
Blackbane,ravencrest,1143,hunter,beastmastery,18,12,6
Haraigoshí,grim-batol,1142,hunter,beastmastery,24,12,12
Nissa,blackrock,1142,hunter,beastmastery,30,12,18
Hlynsson,tarren-mill,1140,hunter,beastmastery,18,12,6
Isaîas,uldum,1139,hunter,beastmastery,106,45,61
Pilogbueferd,silvermoon,1138,hunter,beastmastery,24,12,12
Mordhunterx,draenor,1138,hunter,beastmastery,24,12,12
Zpy,blackmoore,1137,hunter,beastmastery,18,12,6
Мэдраэль,deathguard,1137,hunter,beastmastery,69,33,36
Doômzi,ysondre,1136,hunter,beastmastery,48,27,21
Vyrê,ghostlands,1135,hunter,beastmastery,30,12,18
Abovival,ragnaros,1134,hunter,beastmastery,24,12,12
Vorthrax,drakthul,1134,hunter,beastmastery,30,12,18
Tomli,nemesis,1133,hunter,beastmastery,27,13,14
Crmov,silvermoon,1131,hunter,beastmastery,18,12,6
Ägris,die-todeskrallen,1130,hunter,beastmastery,198,92,106
Ázèrøñå,ravencrest,1129,hunter,beastmastery,27,16,11
Ahsóka,frostwhisper,1128,hunter,beastmastery,24,12,12
Maknamara,tarren-mill,1127,hunter,beastmastery,63,32,31
Ceedlulz,antonidas,1126,hunter,beastmastery,30,12,18
Koopo,stormreaver,1125,hunter,beastmastery,149,72,77
Deôrro,twisting-nether,1125,hunter,beastmastery,28,13,15
Tremby,kazzak,1124,hunter,beastmastery,27,13,14
Biorson,silvermoon,1124,hunter,beastmastery,46,17,29
Skullstah,ravencrest,1123,hunter,beastmastery,95,45,50
Ønur,twisting-nether,1122,hunter,beastmastery,78,39,39
Quasar,arakarahm,1122,hunter,beastmastery,59,22,37
Plong,argent-dawn,1121,hunter,beastmastery,24,14,10
Anthorio,cthun,1121,hunter,beastmastery,36,16,20
Täpy,arathor,1120,hunter,beastmastery,30,12,18
Zhazha,chamber-of-aspects,1119,hunter,beastmastery,49,26,23
Sokyokuh,burning-legion,1119,hunter,beastmastery,24,12,12
Chillarn,tarren-mill,1118,hunter,beastmastery,94,44,50
Kirky,terokkar,1118,hunter,beastmastery,45,20,25
Бэрими,gordunni,1118,hunter,beastmastery,29,12,17
Marudô,aegwynn,1118,hunter,beastmastery,35,12,23
Ezelina,lightnings-blade,1117,hunter,beastmastery,82,42,40
Ratul,pozzo-delleternità,1117,hunter,beastmastery,47,16,31
Karstarkk,sanguino,1116,hunter,beastmastery,71,32,39
Гоу,fordragon,1116,hunter,beastmastery,60,26,34
Zanto,aegwynn,1114,hunter,beastmastery,24,12,12
Soulshoot,khaz-modan,1113,hunter,beastmastery,94,48,46
Slide,dalaran,1113,hunter,beastmastery,71,35,36
Høøl,hyjal,1111,hunter,beastmastery,31,12,19
Cäri,colinas-pardas,1109,hunter,beastmastery,36,16,20
Armanny,sylvanas,1109,hunter,beastmastery,157,64,93
Шейхант,gordunni,1106,hunter,beastmastery,48,26,22
Axams,archimonde,1106,hunter,beastmastery,123,48,75
Øutkast,silvermoon,1105,hunter,beastmastery,29,18,11
Ertestuing,tarren-mill,1105,hunter,beastmastery,33,16,17
Epheso,daggerspine,1105,hunter,beastmastery,33,15,18
Oldgrandpa,stormscale,1101,hunter,beastmastery,30,14,16
Savori,kazzak,1100,hunter,beastmastery,37,21,16
Jaguarundy,dun-modr,1098,hunter,beastmastery,38,16,22
Zorana,twisting-nether,1097,hunter,beastmastery,34,12,22
Atraxi,aegwynn,1096,hunter,beastmastery,64,28,36
Goonii,bronzebeard,1094,hunter,beastmastery,24,12,12
Guanchin,silvermoon,1089,hunter,beastmastery,124,55,69
Bmazor,silvermoon,1088,hunter,beastmastery,19,13,6
Bâng,zuljin,1088,hunter,beastmastery,34,16,18
Crittix,kiljaeden,1088,hunter,beastmastery,30,12,18
Salemenos,silvermoon,1085,hunter,beastmastery,22,12,10
Zsara,ravencrest,1085,hunter,beastmastery,22,12,10
Ulyash,ysondre,1085,hunter,beastmastery,90,41,49
Tracrium,hyjal,1084,hunter,beastmastery,71,24,47
Luckyhunty,dalaran,1083,hunter,beastmastery,119,55,64
Brometheus,sylvanas,1083,hunter,beastmastery,41,15,26
Nerfjuice,silvermoon,1081,hunter,beastmastery,81,41,40
Bigbadhunter,twilights-hammer,1080,hunter,beastmastery,24,12,12
Sâranjágo,argent-dawn,1080,hunter,beastmastery,96,46,50
Айлиси,soulflayer,1080,hunter,beastmastery,79,25,54
Huntarent,argent-dawn,1080,hunter,beastmastery,60,16,44
Авроратян,blackscar,1079,hunter,beastmastery,23,15,8
Feigur,sanguino,1078,hunter,beastmastery,65,36,29
Olamay,blackmoore,1078,hunter,beastmastery,90,43,47
Seviaz,draenor,1077,hunter,beastmastery,29,12,17
Pawder,silvermoon,1077,hunter,beastmastery,42,15,27
Musraah,zuljin,1076,hunter,beastmastery,21,13,8
Амобарбиталх,gordunni,1075,hunter,beastmastery,44,23,21
Bladius,ragnaros,1075,hunter,beastmastery,60,23,37
Hugechode,kazzak,1074,hunter,beastmastery,24,12,12
Latira,eonar,1072,hunter,beastmastery,84,38,46
Papiou,les-sentinelles,1071,hunter,beastmastery,60,28,32
Ветиринарша,gordunni,1069,hunter,beastmastery,48,18,30
Anghron,minahonda,1068,hunter,beastmastery,31,15,16
Somixx,ragnaros,1067,hunter,beastmastery,88,46,42
Yasopp,draenor,1066,hunter,beastmastery,24,13,11
Aamøn,nemesis,1066,hunter,beastmastery,41,21,20
Spiritshot,baelgun,1066,hunter,beastmastery,34,14,20
Hentt,burning-legion,1064,hunter,beastmastery,28,13,15
Ceres,kaelthas,1063,hunter,beastmastery,30,12,18
Venkox,archimonde,1062,hunter,beastmastery,79,42,37
Sàclak,ysondre,1062,hunter,beastmastery,43,19,24
Crostaws,terokkar,1062,hunter,beastmastery,40,12,28
Grollar,ragnaros,1061,hunter,beastmastery,92,50,42
Cruelsummer,kul-tiras,1061,hunter,beastmastery,60,22,38
Teacee,twisting-nether,1060,hunter,beastmastery,53,28,25
Silenthunter,blackrock,1060,hunter,beastmastery,35,15,20
Sixty,rajaxx,1059,hunter,beastmastery,119,52,67
Noobatala,tarren-mill,1058,hunter,beastmastery,60,23,37
Rudeness,frostmane,1058,hunter,beastmastery,42,12,30
Dorkos,sanguino,1056,hunter,beastmastery,24,11,13
Jøki,blackmoore,1056,hunter,beastmastery,24,11,13
Ayaz,ravencrest,1056,hunter,beastmastery,30,11,19
Nihau,ravencrest,1055,hunter,beastmastery,18,11,7
Styxht,blackhand,1055,hunter,beastmastery,18,11,7
Vanthaes,argent-dawn,1055,hunter,beastmastery,24,11,13
Deadshøt,thrall,1055,hunter,beastmastery,24,11,13
Geeked,tarren-mill,1055,hunter,beastmastery,24,11,13
Gitanìlla,dun-modr,1055,hunter,beastmastery,36,11,25
Mettämies,twisting-nether,1054,hunter,beastmastery,18,11,7
Hariana,hyjal,1054,hunter,beastmastery,18,11,7
Bazouf,outland,1054,hunter,beastmastery,18,11,7
Funkysht,outland,1054,hunter,beastmastery,22,12,10
Leemool,ysondre,1054,hunter,beastmastery,36,18,18
Душнила,razuvious,1054,hunter,beastmastery,24,11,13
Barneyarrow,tarren-mill,1054,hunter,beastmastery,24,11,13
Iliketraps,blackmoore,1054,hunter,beastmastery,24,11,13
Рафлекс,eversong,1054,hunter,beastmastery,26,11,15
Pigoen,sporeggar,1053,hunter,beastmastery,141,64,77
Jakis,silvermoon,1052,hunter,beastmastery,18,11,7
Gobliniehoóo,azuremyst,1051,hunter,beastmastery,16,12,4
Няшуличка,gordunni,1051,hunter,beastmastery,24,11,13
Greg,defias-brotherhood,1051,hunter,beastmastery,24,11,13
Unreachable,dethecus,1051,hunter,beastmastery,24,11,13
Melilissya,dalaran,1051,hunter,beastmastery,30,11,19
Darllene,kazzak,1051,hunter,beastmastery,30,11,19
Oramar,archimonde,1050,hunter,beastmastery,36,17,19
Nèlandar,archimonde,1049,hunter,beastmastery,48,21,27
Nandrohunt,dalaran,1049,hunter,beastmastery,30,11,19
Хантетский,howling-fjord,1048,hunter,beastmastery,26,12,14
Sourxete,silvermoon,1048,hunter,beastmastery,24,11,13
Sheilare,doomhammer,1047,hunter,beastmastery,18,11,7
Fléqs,antonidas,1046,hunter,beastmastery,24,11,13
Bezi,tarren-mill,1045,hunter,beastmastery,47,21,26
Strade,argent-dawn,1044,hunter,beastmastery,24,11,13
Tusibi,dalaran,1044,hunter,beastmastery,30,11,19
Shinibon,blackmoore,1044,hunter,beastmastery,36,11,25
Dreemshoot,stormscale,1043,hunter,beastmastery,26,12,14
Ayaille,marécage-de-zangar,1043,hunter,beastmastery,40,14,26
Pickaboo,defias-brotherhood,1040,hunter,beastmastery,24,11,13
Glarco,eldrethalas,1039,hunter,beastmastery,36,19,17
Dorkis,sanguino,1039,hunter,beastmastery,29,11,18
Rubyblack,archimonde,1038,hunter,beastmastery,78,41,37
Yukina,frostmourne,1038,hunter,beastmastery,28,13,15
Rivery,azjolnerub,1038,hunter,beastmastery,43,17,26
Pennyflame,blackmoore,1037,hunter,beastmastery,28,12,16
Korbs,ravencrest,1032,hunter,beastmastery,28,12,16
Sika,nozdormu,1031,hunter,beastmastery,30,11,19
Saîtek,chogall,1027,hunter,beastmastery,18,11,7
Pîpî,blackrock,1027,hunter,beastmastery,23,13,10
Auau,the-maelstrom,1027,hunter,beastmastery,67,30,37
Attiladagun,hellfire,1027,hunter,beastmastery,67,19,48
Китас,soulflayer,1021,hunter,beastmastery,28,11,17
Eilnu,zuljin,1021,hunter,beastmastery,78,24,54
Бодрыйсэм,soulflayer,1020,hunter,beastmastery,34,17,17
Bmilfhunter,blackhand,1020,hunter,beastmastery,28,11,17
Bellecoq,arathi,1019,hunter,beastmastery,23,11,12
Kuzes,ravencrest,1018,hunter,beastmastery,26,12,14
Cityhunter,archimonde,1018,hunter,beastmastery,114,50,64
Talentlos,guldan,1017,hunter,beastmastery,53,19,34
Vu,shattered-hand,1016,hunter,beastmastery,23,11,12
Aelridel,kirin-tor,1016,hunter,beastmastery,211,98,113
Atnan,vashj,1012,hunter,beastmastery,54,24,30
Orgasmatronn,stormscale,1008,hunter,beastmastery,30,11,19
Weisswinter,drakthul,1004,hunter,beastmastery,24,12,12
Talija,nathrezim,1003,hunter,beastmastery,36,18,18
Ohwagga,pozzo-delleternità,1003,hunter,beastmastery,30,15,15
Wolfmarko,ragnaros,1003,hunter,beastmastery,61,25,36
Клак,howling-fjord,1003,hunter,beastmastery,92,33,59
Knokkelmann,outland,1001,hunter,beastmastery,28,13,15
Arrechus,khaz-modan,999,hunter,beastmastery,180,85,95
Kagan,nemesis,998,hunter,beastmastery,29,17,12
Heallena,magtheridon,998,hunter,beastmastery,42,11,31
Апельсинчес,howling-fjord,997,hunter,beastmastery,17,11,6
Sinux,lordaeron,995,hunter,beastmastery,17,11,6
Insanepvper,argent-dawn,995,hunter,beastmastery,27,11,16
Lissudarlin,stormreaver,992,hunter,beastmastery,549,277,272
Хантнерюга,gordunni,991,hunter,beastmastery,20,11,9
Enanorabioso,minahonda,991,hunter,beastmastery,30,12,18
Skullshooter,twisting-nether,991,hunter,beastmastery,28,11,17
Frencharena,the-venture-co,990,hunter,beastmastery,29,11,18
Neuromancien,archimonde,990,hunter,beastmastery,35,11,24
Aryelis,draenor,988,hunter,beastmastery,26,11,15
Pumukle,madmortem,987,hunter,beastmastery,45,18,27
Roclen,uldum,987,hunter,beastmastery,30,11,19
Qled,sylvanas,986,hunter,beastmastery,37,15,22
Kekkistä,ravencrest,986,hunter,beastmastery,46,15,31
Nixxay,antonidas,984,hunter,beastmastery,54,30,24
Xyrone,bladefist,984,hunter,beastmastery,110,55,55
Зоопсихолог,gordunni,981,hunter,beastmastery,150,77,73
Floppybobby,burning-blade,980,hunter,beastmastery,29,12,17
Frittman,silvermoon,978,hunter,beastmastery,48,21,27
Traknard,confrérie-du-thorium,977,hunter,beastmastery,33,16,17
Bloodxx,ragnaros,976,hunter,beastmastery,54,25,29
Jamaro,dun-modr,974,hunter,beastmastery,134,62,72
Yümekø,khaz-modan,973,hunter,beastmastery,19,11,8
Arrowlight,archimonde,973,hunter,beastmastery,61,31,30
Kyßa,uldum,971,hunter,beastmastery,19,11,8
Jaydogg,lightbringer,970,hunter,beastmastery,19,11,8
Гррешница,galakrond,968,hunter,beastmastery,54,29,25
Kikijojo,ravencrest,968,hunter,beastmastery,57,29,28
Traenuss,azuremyst,968,hunter,beastmastery,48,19,29
Naarâ,blackhand,967,hunter,beastmastery,53,19,34
Olddèath,archimonde,966,hunter,beastmastery,30,12,18
Amdonesia,ravencrest,966,hunter,beastmastery,70,24,46
Llamp,draenor,964,hunter,beastmastery,60,29,31
Zanéy,ravencrest,960,hunter,beastmastery,12,10,2
Dathrixjr,ravencrest,960,hunter,beastmastery,12,10,2
Tiffanydoll,hyjal,960,hunter,beastmastery,18,10,8
Hahahxd,ragnaros,960,hunter,beastmastery,18,10,8
Ðøømsðay,sanguino,960,hunter,beastmastery,22,11,11
Dashiro,drakthul,960,hunter,beastmastery,24,10,14
Synaticx,thrall,960,hunter,beastmastery,24,10,14
Hollyz,auchindoun,960,hunter,beastmastery,24,10,14
Jwah,tarren-mill,960,hunter,beastmastery,24,10,14
Silencxz,aegwynn,960,hunter,beastmastery,30,10,20
Ráptør,silvermoon,960,hunter,beastmastery,30,10,20
Mobshot,twisting-nether,960,hunter,beastmastery,30,10,20
Boen,nordrassil,960,hunter,beastmastery,30,10,20
Bubby,burning-legion,960,hunter,beastmastery,34,11,23
Mentalbowie,stormreaver,959,hunter,beastmastery,12,10,2
Rashoumon,zuljin,959,hunter,beastmastery,18,10,8
Dragh,blackrock,959,hunter,beastmastery,18,10,8
Woöky,dalaran,959,hunter,beastmastery,94,49,45
Alée,twisting-nether,959,hunter,beastmastery,30,10,20
Rikitikii,burning-legion,958,hunter,beastmastery,15,11,4
Soblazed,twisting-nether,958,hunter,beastmastery,18,10,8
Komesz,ragnaros,958,hunter,beastmastery,18,10,8
Multigodx,draenor,958,hunter,beastmastery,18,10,8
Shikar,sanguino,958,hunter,beastmastery,18,10,8
Versache,kazzak,958,hunter,beastmastery,24,10,14
Mahuntah,drakthul,958,hunter,beastmastery,24,10,14
Haihappen,das-konsortium,958,hunter,beastmastery,30,10,20
Blainehunts,arathor,958,hunter,beastmastery,36,11,25
Vortee,drakthul,957,hunter,beastmastery,18,10,8
Therasin,ravenholdt,957,hunter,beastmastery,18,10,8
Tylahnem,hyjal,957,hunter,beastmastery,30,10,20
Khaos,zuluhed,957,hunter,beastmastery,30,10,20
Skipee,ravencrest,956,hunter,beastmastery,18,10,8
Happyrme,thrall,956,hunter,beastmastery,54,28,26
Vassiliadis,bronze-dragonflight,956,hunter,beastmastery,30,10,20
Cirenivel,draenor,955,hunter,beastmastery,22,11,11
Альмиэлль,gordunni,955,hunter,beastmastery,24,10,14
Prodanhunts,frostmane,955,hunter,beastmastery,30,10,20
Flecheoeil,hyjal,955,hunter,beastmastery,30,10,20
Hadicak,drakthul,954,hunter,beastmastery,18,10,8
Kairrux,twisting-nether,954,hunter,beastmastery,18,10,8
Beaststeaks,thrall,954,hunter,beastmastery,18,10,8
Vystrelil,drakthul,954,hunter,beastmastery,220,113,107
Herpray,blackmoore,953,hunter,beastmastery,18,10,8
Ragingdragon,turalyon,953,hunter,beastmastery,18,10,8
Katsa,ragnaros,953,hunter,beastmastery,30,10,20
Faze,hellfire,952,hunter,beastmastery,72,34,38
Phillon,blackrock,952,hunter,beastmastery,24,10,14
Topgrill,stormscale,952,hunter,beastmastery,30,10,20
Beefchops,draenor,951,hunter,beastmastery,18,10,8
Вагар,blackscar,951,hunter,beastmastery,51,27,24
Misscreggor,ravencrest,951,hunter,beastmastery,24,10,14
Misfîre,tarren-mill,950,hunter,beastmastery,18,10,8
Zappikhunter,silvermoon,950,hunter,beastmastery,24,10,14
Hattoro,drakthul,948,hunter,beastmastery,30,10,20
Zarlena,tarren-mill,947,hunter,beastmastery,43,19,24
Hjørnz,stormscale,947,hunter,beastmastery,30,10,20
Telx,blackmoore,946,hunter,beastmastery,18,10,8
Jorch,ahnqiraj,946,hunter,beastmastery,18,10,8
Cernunnos,auchindoun,944,hunter,beastmastery,19,10,9
Lemeric,blackmoore,942,hunter,beastmastery,19,10,9
Lynx,garona,941,hunter,beastmastery,102,44,58
Hixia,archimonde,940,hunter,beastmastery,17,10,7
Chipok,outland,939,hunter,beastmastery,35,16,19
Shtooko,conseil-des-ombres,934,hunter,beastmastery,35,12,23
Bammbammx,twisting-nether,932,hunter,beastmastery,24,12,12
Dioxis,silvermoon,932,hunter,beastmastery,118,57,61
Hpyhun,draenor,931,hunter,beastmastery,30,10,20
Utopia,korgall,928,hunter,beastmastery,116,53,63
Elfanka,sanguino,925,hunter,beastmastery,30,15,15
Usop,medivh,924,hunter,beastmastery,36,19,17
Arakton,drakthul,923,hunter,beastmastery,58,26,32
Heegal,stormscale,922,hunter,beastmastery,42,20,22
Towu,archimonde,918,hunter,beastmastery,30,11,19
Stjordal,chamber-of-aspects,917,hunter,beastmastery,63,30,33
Axg,burning-legion,916,hunter,beastmastery,53,21,32
Kronzucker,eredar,914,hunter,beastmastery,36,16,20
Dis,twilights-hammer,911,hunter,beastmastery,23,10,13
Allcollapse,outland,910,hunter,beastmastery,21,11,10
Нью,soulflayer,910,hunter,beastmastery,23,10,13
Bitig,argent-dawn,909,hunter,beastmastery,28,10,18
Mankkis,stormscale,909,hunter,beastmastery,48,14,34
Bjarnhild,die-aldor,906,hunter,beastmastery,24,11,13
Vargar,arygos,906,hunter,beastmastery,26,11,15
Dafragger,blackmoore,905,hunter,beastmastery,25,12,13
Delazi,proudmoore,905,hunter,beastmastery,30,11,19
Ñava,dalaran,898,hunter,beastmastery,24,11,13
Draknik,nemesis,895,hunter,beastmastery,39,10,29
Igotwatuneed,kazzak,894,hunter,beastmastery,24,11,13
Kënshiro,kazzak,893,hunter,beastmastery,20,10,10
Slaghunter,argent-dawn,893,hunter,beastmastery,23,10,13
Bornum,khaz-modan,892,hunter,beastmastery,31,10,21
Mykris,aegwynn,889,hunter,beastmastery,120,49,71
Catmother,grim-batol,886,hunter,beastmastery,20,12,8
Sylverein,silvermoon,886,hunter,beastmastery,109,38,71
Zimmoo,tarren-mill,884,hunter,beastmastery,77,35,42
Penelopé,darkmoon-faire,883,hunter,beastmastery,97,42,55
Shpider,burning-blade,883,hunter,beastmastery,82,33,49
Mcperra,zuljin,882,hunter,beastmastery,26,10,16
Colth,hyjal,882,hunter,beastmastery,47,16,31
Wodlenprince,draenor,881,hunter,beastmastery,82,22,60
Араэль,galakrond,877,hunter,beastmastery,66,33,33
Баззи,grom,866,hunter,beastmastery,121,61,60
Тирин,ashenvale,864,hunter,beastmastery,12,9,3
Eenel,twisting-nether,864,hunter,beastmastery,12,9,3
Tholano,rexxar,864,hunter,beastmastery,12,9,3
Азирона,gordunni,864,hunter,beastmastery,12,9,3
Ледо,deathguard,864,hunter,beastmastery,12,9,3
Hispanøxd,sanguino,864,hunter,beastmastery,12,9,3
Kapowz,kazzak,864,hunter,beastmastery,12,9,3
Lísy,hyjal,864,hunter,beastmastery,18,9,9
Flouky,blackmoore,864,hunter,beastmastery,18,9,9
Dåo,doomhammer,864,hunter,beastmastery,18,9,9
Réâlñúððà,kazzak,864,hunter,beastmastery,18,9,9
Mspt,archimonde,864,hunter,beastmastery,18,9,9
Охотницагодх,borean-tundra,864,hunter,beastmastery,18,9,9
Weoneshot,ravencrest,864,hunter,beastmastery,18,9,9
Orosko,archimonde,864,hunter,beastmastery,18,9,9
Autopilot,aegwynn,864,hunter,beastmastery,18,9,9
Elionora,kazzak,864,hunter,beastmastery,24,9,15
Klèo,frostwhisper,864,hunter,beastmastery,24,9,15
Valhnir,sanguino,864,hunter,beastmastery,24,9,15
Cryptomars,twisting-nether,864,hunter,beastmastery,24,9,15
Akkixz,antonidas,864,hunter,beastmastery,24,9,15
Pilpetra,tarren-mill,864,hunter,beastmastery,24,9,15
Леоа,howling-fjord,864,hunter,beastmastery,27,10,17
Ancalarion,tarren-mill,864,hunter,beastmastery,27,9,18
Hunterstein,archimonde,864,hunter,beastmastery,30,9,21
Srvol,dun-modr,863,hunter,beastmastery,12,9,3
Duviidb,drakthul,863,hunter,beastmastery,12,9,3
Skeng,xavius,863,hunter,beastmastery,12,9,3
Генрах,soulflayer,863,hunter,beastmastery,18,9,9
Reshka,dunemaul,863,hunter,beastmastery,18,9,9
Sgmarine,khaz-modan,863,hunter,beastmastery,18,9,9
Кишмякхант,howling-fjord,863,hunter,beastmastery,18,9,9
Ванхогер,gordunni,863,hunter,beastmastery,18,9,9
Сальверди,gordunni,863,hunter,beastmastery,18,9,9
Jordlol,hellscream,863,hunter,beastmastery,18,9,9
Aliltoxic,silvermoon,863,hunter,beastmastery,18,9,9
Fléxyz,sylvanas,863,hunter,beastmastery,18,9,9
Iliíilíiílíl,outland,863,hunter,beastmastery,18,9,9
Sarganno,archimonde,863,hunter,beastmastery,18,9,9
Fogknows,ravencrest,863,hunter,beastmastery,18,9,9
Jahunter,aggra-português,863,hunter,beastmastery,18,9,9
Nillaxy,blackmoore,863,hunter,beastmastery,18,9,9
Brotaniku,tarren-mill,863,hunter,beastmastery,124,54,70
Tjodalf,zuluhed,863,hunter,beastmastery,24,9,15
Nettie,arathor,863,hunter,beastmastery,24,9,15
Krâven,ysondre,863,hunter,beastmastery,36,9,27
Zirheael,argent-dawn,862,hunter,beastmastery,18,9,9
Bluffmakarn,silvermoon,862,hunter,beastmastery,18,9,9
Арнесс,deepholm,862,hunter,beastmastery,23,10,13
Максиммужик,soulflayer,862,hunter,beastmastery,24,9,15
Aamön,tarren-mill,862,hunter,beastmastery,24,9,15
Ecthelione,the-venture-co,862,hunter,beastmastery,24,9,15
Saturigos,eredar,861,hunter,beastmastery,12,9,3
Doubleoseven,frostmane,861,hunter,beastmastery,18,9,9
Xalh,hyjal,861,hunter,beastmastery,18,9,9
Nîco,nathrezim,861,hunter,beastmastery,24,9,15
Andraethanal,ravencrest,860,hunter,beastmastery,17,10,7
Ashryqt,ravencrest,860,hunter,beastmastery,18,9,9
Petfeelya,antonidas,860,hunter,beastmastery,18,9,9
Steìn,ysondre,860,hunter,beastmastery,24,9,15
Vïcødïnë,sinstralis,859,hunter,beastmastery,18,9,9
Rògor,sylvanas,859,hunter,beastmastery,18,9,9
Focùs,eredar,859,hunter,beastmastery,24,9,15
Rem,zuljin,858,hunter,beastmastery,24,9,15
Mindgap,pozzo-delleternità,858,hunter,beastmastery,24,9,15
Бруксиан,fordragon,857,hunter,beastmastery,19,9,10
Deathcrôwler,shattrath,857,hunter,beastmastery,24,9,15
Maxtozer,silvermoon,857,hunter,beastmastery,24,9,15
Скартэкс,howling-fjord,856,hunter,beastmastery,12,9,3
Äctæon,ravencrest,855,hunter,beastmastery,18,9,9
Shalinda,azshara,855,hunter,beastmastery,30,9,21
Abendstern,silvermoon,855,hunter,beastmastery,36,9,27
Фаталлити,grom,853,hunter,beastmastery,18,9,9
Goliathoz,blackmoore,852,hunter,beastmastery,117,57,60
Scatterinc,antonidas,851,hunter,beastmastery,24,9,15
Starfinder,saurfang,847,hunter,beastmastery,22,10,12
Zinnady,outland,846,hunter,beastmastery,12,9,3
Greenstar,twisting-nether,846,hunter,beastmastery,27,10,17
Ârhya,ysondre,845,hunter,beastmastery,36,15,21
Barzti,thrall,842,hunter,beastmastery,30,11,19
Tixôü,archimonde,841,hunter,beastmastery,18,9,9
Losc,blackrock,841,hunter,beastmastery,24,9,15
Ôrly,outland,839,hunter,beastmastery,51,25,26
Sushimän,kaelthas,834,hunter,beastmastery,18,10,8
Marlaska,exodar,834,hunter,beastmastery,275,135,140
Venõm,pozzo-delleternità,832,hunter,beastmastery,21,11,10
Deathmarks,blackrock,830,hunter,beastmastery,35,9,26
Ludo,chogall,829,hunter,beastmastery,111,53,58
Lembó,zuljin,827,hunter,beastmastery,18,9,9
Ranrôk,rexxar,824,hunter,beastmastery,74,28,46
Drogostorm,steamwheedle-cartel,823,hunter,beastmastery,71,31,40
Aryaae,les-clairvoyants,822,hunter,beastmastery,52,23,29
Anoroxx,arthas,815,hunter,beastmastery,17,9,8
Шаурмэ,gordunni,815,hunter,beastmastery,21,9,12
Хихихихх,gordunni,814,hunter,beastmastery,21,9,12
Akrepkral,kargath,813,hunter,beastmastery,100,47,53
Speartusk,blackhand,813,hunter,beastmastery,23,9,14
Rollei,uldum,812,hunter,beastmastery,17,9,8
Кустурица,azuregos,811,hunter,beastmastery,34,9,25
Kreiden,twisting-nether,810,hunter,beastmastery,34,11,23
Thebigboom,outland,809,hunter,beastmastery,21,10,11
Winniepuuh,outland,808,hunter,beastmastery,27,10,17
Belgorin,alexstrasza,806,hunter,beastmastery,159,76,83
Abgeherjoe,antonidas,799,hunter,beastmastery,16,9,7
Shaib,kazzak,798,hunter,beastmastery,17,9,8
Arkell,los-errantes,797,hunter,beastmastery,18,9,9
Bnji,hyjal,797,hunter,beastmastery,22,9,13
Rezgor,stormscale,796,hunter,beastmastery,17,9,8
Swaffel,draenor,794,hunter,beastmastery,19,10,9
Роктавия,howling-fjord,793,hunter,beastmastery,16,9,7
Dorollo,khaz-modan,791,hunter,beastmastery,56,25,31
Bihoreanul,sylvanas,790,hunter,beastmastery,42,18,24
Rozgnyy,silvermoon,783,hunter,beastmastery,11,9,2
Elíonora,kazzak,783,hunter,beastmastery,19,9,10
Suffrebobbs,ravencrest,768,hunter,beastmastery,12,8,4
Rollingpork,silvermoon,768,hunter,beastmastery,12,8,4
Strazza,ragnaros,768,hunter,beastmastery,12,8,4
Ebobuss,tarren-mill,768,hunter,beastmastery,12,8,4
Dáky,ravencrest,768,hunter,beastmastery,12,8,4
Puopoufu,drakthul,768,hunter,beastmastery,12,8,4
Khyleanxøxø,dun-modr,768,hunter,beastmastery,12,8,4
Papisbae,stormscale,768,hunter,beastmastery,12,8,4
Sejkxi,malganis,768,hunter,beastmastery,12,8,4
Nihae,drakthul,768,hunter,beastmastery,12,8,4
Tøkÿöghøül,ravencrest,768,hunter,beastmastery,13,8,5
Deenkz,ravencrest,768,hunter,beastmastery,15,9,6
Krâýnn,aegwynn,768,hunter,beastmastery,18,8,10
Justeclicd,hyjal,768,hunter,beastmastery,18,8,10
Lambikas,argent-dawn,768,hunter,beastmastery,18,8,10
Lowboblarry,ravencrest,768,hunter,beastmastery,18,8,10
Белатраиса,gordunni,768,hunter,beastmastery,18,8,10
Gromogg,blackmoore,768,hunter,beastmastery,18,8,10
Матопопа,gordunni,768,hunter,beastmastery,18,8,10
Leonidazar,draenor,768,hunter,beastmastery,18,8,10
Yamadorî,blackrock,768,hunter,beastmastery,18,8,10
Ishotharambe,doomhammer,768,hunter,beastmastery,18,8,10
Vasco,chogall,768,hunter,beastmastery,18,8,10
Pewpewstuff,draenor,768,hunter,beastmastery,18,8,10
Xalihuntio,ravencrest,768,hunter,beastmastery,18,8,10
Páiz,tarren-mill,768,hunter,beastmastery,18,8,10
Myriadx,sylvanas,768,hunter,beastmastery,18,8,10
Double,sylvanas,768,hunter,beastmastery,18,8,10
Spazi,kazzak,768,hunter,beastmastery,18,8,10
Xn,cthun,768,hunter,beastmastery,18,8,10
Zárnah,defias-brotherhood,768,hunter,beastmastery,24,8,16
Джулибуба,howling-fjord,768,hunter,beastmastery,24,8,16
Mogumogu,blackhand,768,hunter,beastmastery,24,8,16
Fridion,argent-dawn,768,hunter,beastmastery,24,8,16
Бранцо,howling-fjord,768,hunter,beastmastery,24,8,16
Stuckstepbro,silvermoon,768,hunter,beastmastery,24,8,16
Deepcleaning,kazzak,768,hunter,beastmastery,30,8,22
Awoe,blackrock,767,hunter,beastmastery,12,8,4
Aldra,kelthuzad,767,hunter,beastmastery,12,8,4
Ahrtemís,destromath,767,hunter,beastmastery,12,8,4
Nulldmgmaker,malganis,767,hunter,beastmastery,12,8,4
Gordo,burning-legion,767,hunter,beastmastery,12,8,4
Huntyadaun,blackrock,767,hunter,beastmastery,12,8,4
Yungkillshot,aegwynn,767,hunter,beastmastery,12,8,4
Loydzz,hyjal,767,hunter,beastmastery,12,8,4
Nocturr,ragnaros,767,hunter,beastmastery,12,8,4
Síthrom,blackmoore,767,hunter,beastmastery,12,8,4
Kuljaa,ravencrest,767,hunter,beastmastery,12,8,4
Hakamael,kirin-tor,767,hunter,beastmastery,18,8,10
Sylda,blutkessel,767,hunter,beastmastery,18,8,10
Jónes,dunemaul,767,hunter,beastmastery,18,8,10
Kartantrax,culte-de-la-rive-noire,767,hunter,beastmastery,18,8,10
Венкара,gordunni,767,hunter,beastmastery,18,8,10
Søtyz,dalaran,767,hunter,beastmastery,18,8,10
Elionora,grim-batol,767,hunter,beastmastery,18,8,10
Kurobi,kazzak,767,hunter,beastmastery,18,8,10
Huntzki,tarren-mill,767,hunter,beastmastery,18,8,10
Рофшор,gordunni,767,hunter,beastmastery,18,8,10
Zajebantip,sylvanas,767,hunter,beastmastery,18,8,10
Yorskha,dun-modr,767,hunter,beastmastery,18,8,10
Schwaiger,blackhand,767,hunter,beastmastery,18,8,10
Гунныч,grom,767,hunter,beastmastery,30,8,22
Oozzee,tarren-mill,766,hunter,beastmastery,12,8,4
Rdwlf,draenor,766,hunter,beastmastery,18,8,10
Notley,thrall,766,hunter,beastmastery,18,8,10
Msâka,blackrock,766,hunter,beastmastery,24,8,16
Amberye,dalaran,766,hunter,beastmastery,24,8,16
Luigianetti,shadowsong,766,hunter,beastmastery,24,8,16
Airtz,ysondre,766,hunter,beastmastery,24,8,16
Rickh,ravencrest,765,hunter,beastmastery,12,8,4
Isøbu,hyjal,765,hunter,beastmastery,15,9,6
Лузановка,gordunni,765,hunter,beastmastery,18,8,10
Cxc,dun-modr,765,hunter,beastmastery,18,8,10
Poine,sylvanas,765,hunter,beastmastery,36,14,22
Castbuny,drakthul,765,hunter,beastmastery,24,8,16
Джэромо,gordunni,765,hunter,beastmastery,24,8,16
Abraxan,twisting-nether,764,hunter,beastmastery,18,8,10
Tuturz,la-croisade-écarlate,764,hunter,beastmastery,18,8,10
Chalid,aegwynn,764,hunter,beastmastery,24,8,16
Maríschká,amanthul,763,hunter,beastmastery,18,8,10
Killzo,sylvanas,763,hunter,beastmastery,18,8,10
Ferdinandl,draenor,763,hunter,beastmastery,18,8,10
Bradunov,sylvanas,763,hunter,beastmastery,18,8,10
Фаусти,gordunni,762,hunter,beastmastery,12,8,4
Petroleiro,aggra-português,762,hunter,beastmastery,18,8,10
Furian,der-rat-von-dalaran,762,hunter,beastmastery,18,8,10
Jâyranger,ravencrest,762,hunter,beastmastery,28,10,18
Djzntrap,outland,761,hunter,beastmastery,18,8,10
Boompuf,draenor,761,hunter,beastmastery,24,8,16
Trollhunt,bloodscalp,759,hunter,beastmastery,21,9,12
Bliss,senjin,756,hunter,beastmastery,12,8,4
Oldrocker,sylvanas,756,hunter,beastmastery,24,8,16
Арогорд,gordunni,756,hunter,beastmastery,24,8,16
Franzfuchs,blackmoore,751,hunter,beastmastery,17,8,9
Petoveri,stormreaver,746,hunter,beastmastery,24,9,15
Begehunter,sylvanas,740,hunter,beastmastery,18,8,10
Neklab,blackhand,735,hunter,beastmastery,12,10,2
Wödën,argent-dawn,735,hunter,beastmastery,26,9,17
Механямка,gordunni,735,hunter,beastmastery,29,8,21
Kakopaikths,sylvanas,733,hunter,beastmastery,23,8,15
Splodge,kazzak,731,hunter,beastmastery,17,8,9
Anesa,lightbringer,728,hunter,beastmastery,21,9,12
Guna,aggra-português,727,hunter,beastmastery,23,8,15
Пушкабомби,soulflayer,718,hunter,beastmastery,124,51,73
Stayswag,nemesis,718,hunter,beastmastery,21,8,13
Rkd,stormrage,715,hunter,beastmastery,23,8,15
Адула,eversong,714,hunter,beastmastery,59,22,37
Grufflin,bronzebeard,713,hunter,beastmastery,23,8,15
Дикийджош,soulflayer,707,hunter,beastmastery,17,9,8
Tetrapet,pozzo-delleternità,706,hunter,beastmastery,46,22,24
Онурисс,grom,703,hunter,beastmastery,16,8,8
Feyoonx,blackrock,703,hunter,beastmastery,23,9,14
Aravis,moonglade,702,hunter,beastmastery,20,8,12
Wakar,alakir,701,hunter,beastmastery,16,8,8
Huntbeard,aegwynn,695,hunter,beastmastery,22,8,14
Attileus,ragnaros,687,hunter,beastmastery,17,8,9
Jexxa,draenor,681,hunter,beastmastery,33,9,24
Elledrin,argent-dawn,680,hunter,beastmastery,21,11,10
Ulfrîc,exodar,672,hunter,beastmastery,12,7,5
Найтсол,greymane,672,hunter,beastmastery,12,7,5
Виралатта,gordunni,672,hunter,beastmastery,12,7,5
Waza,grim-batol,672,hunter,beastmastery,12,7,5
Alexdi,kazzak,672,hunter,beastmastery,12,7,5
Lïîlÿ,ysondre,672,hunter,beastmastery,12,7,5
Hunttes,nagrand,672,hunter,beastmastery,12,7,5
Kioception,blackrock,672,hunter,beastmastery,12,7,5
Hiddenstalke,argent-dawn,672,hunter,beastmastery,12,7,5
Eisenhørn,archimonde,672,hunter,beastmastery,12,7,5
Wülfhart,argent-dawn,672,hunter,beastmastery,12,7,5
Wodhunterjr,ravencrest,672,hunter,beastmastery,12,7,5
Merakai,aegwynn,672,hunter,beastmastery,12,7,5
Tiiduus,blackmoore,672,hunter,beastmastery,12,7,5
Marcsman,blackrock,672,hunter,beastmastery,12,7,5
Npkhunt,outland,672,hunter,beastmastery,12,7,5
Connyrøvøga,stormscale,672,hunter,beastmastery,12,7,5
Samuru,auchindoun,672,hunter,beastmastery,12,7,5
Haxaids,sylvanas,672,hunter,beastmastery,12,7,5
Rânchiêk,ravencrest,672,hunter,beastmastery,12,7,5
Razuye,nerathor,672,hunter,beastmastery,12,7,5
Загзигзаг,soulflayer,672,hunter,beastmastery,12,7,5
Eretrya,blackmoore,672,hunter,beastmastery,12,7,5
Slejpy,drakthul,672,hunter,beastmastery,12,7,5
Stillflowi,draenor,672,hunter,beastmastery,12,7,5
Potatobeast,twisting-nether,672,hunter,beastmastery,12,7,5
Belaux,archimonde,672,hunter,beastmastery,12,7,5
Gødcømplêx,ravencrest,672,hunter,beastmastery,12,7,5
Varkiza,sylvanas,672,hunter,beastmastery,12,7,5
Misfire,archimonde,672,hunter,beastmastery,12,7,5
Mewithoutyou,ragnaros,672,hunter,beastmastery,12,7,5
Ufecläimbe,eredar,672,hunter,beastmastery,12,7,5
Exzö,outland,672,hunter,beastmastery,12,7,5
Clayh,silvermoon,672,hunter,beastmastery,12,7,5
Xerathdinger,elune,672,hunter,beastmastery,12,7,5
Зорэллка,soulflayer,672,hunter,beastmastery,12,7,5
Lultrap,nemesis,672,hunter,beastmastery,12,7,5
Hølinkasbabe,blackmoore,672,hunter,beastmastery,12,7,5
Сашказнаток,azuregos,672,hunter,beastmastery,12,7,5
Whiskeylover,outland,672,hunter,beastmastery,12,7,5
Adenøsin,blackmoore,672,hunter,beastmastery,12,7,5
Stamzer,drakthul,672,hunter,beastmastery,12,7,5
Nightvarn,burning-blade,672,hunter,beastmastery,12,7,5
Ahotnik,aegwynn,672,hunter,beastmastery,12,7,5
Virel,sanguino,672,hunter,beastmastery,13,7,6
Frods,dun-modr,672,hunter,beastmastery,16,8,8
Fyô,outland,672,hunter,beastmastery,15,7,8
Grokis,blackhand,672,hunter,beastmastery,137,55,82
Batcool,tarren-mill,672,hunter,beastmastery,18,7,11
Ромкола,gordunni,672,hunter,beastmastery,18,7,11
Mårcxb,antonidas,672,hunter,beastmastery,18,7,11
Тандеркейдж,gordunni,672,hunter,beastmastery,18,7,11
Svinrbglol,arygos,672,hunter,beastmastery,18,7,11
Goosebite,ravencrest,672,hunter,beastmastery,18,7,11
Nôldagôn,aegwynn,672,hunter,beastmastery,18,7,11
Дьярэ,gordunni,672,hunter,beastmastery,18,7,11
Slougshot,archimonde,672,hunter,beastmastery,18,7,11
Bosessz,ragnaros,672,hunter,beastmastery,18,7,11
Женистайл,howling-fjord,672,hunter,beastmastery,18,7,11
Ledarkchauve,archimonde,672,hunter,beastmastery,18,7,11
Boybiron,silvermoon,672,hunter,beastmastery,18,7,11
Chabbs,stormscale,672,hunter,beastmastery,18,7,11
Düivell,grim-batol,672,hunter,beastmastery,18,7,11
Zublime,dragonblight,672,hunter,beastmastery,18,7,11
Géeked,ravencrest,672,hunter,beastmastery,18,7,11
Chïefhunt,twisting-nether,672,hunter,beastmastery,18,7,11
Setyouintrap,ravencrest,672,hunter,beastmastery,24,7,17
Uselessx,kazzak,672,hunter,beastmastery,24,7,17
Летмимейт,howling-fjord,672,hunter,beastmastery,26,7,19
Nemámponetí,drakthul,671,hunter,beastmastery,12,7,5
Nith,ungoro,671,hunter,beastmastery,12,7,5
Junqué,sanguino,671,hunter,beastmastery,12,7,5
Szrek,frostmane,671,hunter,beastmastery,12,7,5
Euhh,stormscale,671,hunter,beastmastery,12,7,5
Weedonyhunt,hyjal,671,hunter,beastmastery,12,7,5
Nakepw,stormscale,671,hunter,beastmastery,12,7,5
Бэталол,gordunni,671,hunter,beastmastery,12,7,5
Karabos,nemesis,671,hunter,beastmastery,12,7,5
Nothrokh,auchindoun,671,hunter,beastmastery,12,7,5
Cycada,antonidas,671,hunter,beastmastery,12,7,5
Onacid,tarren-mill,671,hunter,beastmastery,12,7,5
Aýsun,kazzak,671,hunter,beastmastery,12,7,5
Døømslayer,nemesis,671,hunter,beastmastery,12,7,5
Стёпкахант,gordunni,671,hunter,beastmastery,15,8,7
Mehtämìes,kazzak,671,hunter,beastmastery,18,7,11
Orian,argent-dawn,671,hunter,beastmastery,18,7,11
Thromkhar,sanguino,671,hunter,beastmastery,18,7,11
Jezaja,draenor,671,hunter,beastmastery,18,7,11
Lebalaffré,arathi,671,hunter,beastmastery,18,7,11
Álfié,ravencrest,671,hunter,beastmastery,18,7,11
Stónéyyx,azjolnerub,671,hunter,beastmastery,18,7,11
Huntness,kazzak,671,hunter,beastmastery,21,7,14
Tstigaard,argent-dawn,671,hunter,beastmastery,24,7,17
Shakoor,argent-dawn,671,hunter,beastmastery,24,7,17
Løløsifredo,ysondre,671,hunter,beastmastery,26,7,19
Hoppelchen,blackmoore,670,hunter,beastmastery,12,7,5
Hugart,sylvanas,670,hunter,beastmastery,12,7,5
Хантмантхант,howling-fjord,670,hunter,beastmastery,12,7,5
Èlo,dun-morogh,670,hunter,beastmastery,12,7,5
Cainzy,silvermoon,670,hunter,beastmastery,12,7,5
Sxmphxny,argent-dawn,670,hunter,beastmastery,18,7,11
Psychotik,dalaran,670,hunter,beastmastery,18,7,11
Nocalories,grim-batol,670,hunter,beastmastery,18,7,11
Paradisiaco,sanguino,670,hunter,beastmastery,24,7,17
Gladiátor,kult-der-verdammten,669,hunter,beastmastery,12,7,5
Хантероо,gordunni,669,hunter,beastmastery,14,7,7
Casey,zuluhed,669,hunter,beastmastery,18,7,11
Rhiko,argent-dawn,669,hunter,beastmastery,18,7,11
Bemtistaru,draenor,669,hunter,beastmastery,24,7,17
Nelerias,defias-brotherhood,669,hunter,beastmastery,24,7,17
Annababygirl,silvermoon,668,hunter,beastmastery,18,7,11
Asharial,twisting-nether,668,hunter,beastmastery,21,8,13
Okumo,the-maelstrom,667,hunter,beastmastery,18,7,11
Örrn,ragnaros,667,hunter,beastmastery,24,7,17
Snots,stormscale,667,hunter,beastmastery,30,7,23
Аеессо,gordunni,666,hunter,beastmastery,24,7,17
Aroldo,kazzak,665,hunter,beastmastery,12,7,5
Papagallo,los-errantes,665,hunter,beastmastery,12,7,5
Саэсантессис,howling-fjord,665,hunter,beastmastery,18,7,11
Electrastar,illidan,664,hunter,beastmastery,12,7,5
Beerox,ysondre,664,hunter,beastmastery,18,7,11
Winfar,draenor,664,hunter,beastmastery,24,7,17
Irduzir,silvermoon,664,hunter,beastmastery,24,7,17
Zikkem,burning-legion,663,hunter,beastmastery,24,7,17
Ticklez,shadowsong,658,hunter,beastmastery,12,7,5
Электракрут,gordunni,654,hunter,beastmastery,17,7,10
Akù,magtheridon,653,hunter,beastmastery,23,7,16
Skaði,bloodfeather,640,hunter,beastmastery,10,8,2
Harog,thrall,639,hunter,beastmastery,14,8,6
Àshcatchem,kelthuzad,639,hunter,beastmastery,16,7,9
Eveo,antonidas,639,hunter,beastmastery,17,7,10
Kokorambow,silvermoon,639,hunter,beastmastery,17,7,10
Sniffprince,ragnaros,624,hunter,beastmastery,15,7,8
Shòurén,blackmoore,620,hunter,beastmastery,11,7,4
Craná,blackrock,618,hunter,beastmastery,27,8,19
Stukrotka,hellfire,617,hunter,beastmastery,15,7,8
Zwergnàse,thrall,616,hunter,beastmastery,23,7,16
Tiratats,sylvanas,615,hunter,beastmastery,14,8,6
Truxp,tarren-mill,608,hunter,beastmastery,16,7,9
Sferâ,burning-legion,606,hunter,beastmastery,16,7,9
Nerophine,stormscale,588,hunter,beastmastery,13,7,6
Dnuma,tarren-mill,587,hunter,beastmastery,21,8,13
Rahgnaar,ysera,576,hunter,beastmastery,6,6,0
Luke,chromaggus,576,hunter,beastmastery,6,6,0
Дэльфис,howling-fjord,576,hunter,beastmastery,12,6,6
Ventrillo,draenor,576,hunter,beastmastery,12,6,6
Xðxðxðxðxðxð,sylvanas,576,hunter,beastmastery,12,6,6
Efficíent,auchindoun,576,hunter,beastmastery,12,6,6
Ptithoms,hyjal,576,hunter,beastmastery,12,6,6
Gîsh,burning-legion,576,hunter,beastmastery,12,6,6
Fraps,garona,576,hunter,beastmastery,12,6,6
Стейнтар,gordunni,576,hunter,beastmastery,12,6,6
Nómarak,drakthul,576,hunter,beastmastery,12,6,6
Zêrøtwø,draenor,576,hunter,beastmastery,12,6,6
Guidomista,drakthul,576,hunter,beastmastery,12,6,6
Bubboo,dun-modr,576,hunter,beastmastery,12,6,6
Дайсё,soulflayer,576,hunter,beastmastery,12,6,6
Malmet,shattered-hand,576,hunter,beastmastery,12,6,6
Batony,ravencrest,576,hunter,beastmastery,12,6,6
Kabá,eredar,576,hunter,beastmastery,12,6,6
Razoorine,blackrock,576,hunter,beastmastery,12,6,6
Raegal,sanguino,576,hunter,beastmastery,12,6,6
Bierbjörn,eredar,576,hunter,beastmastery,12,6,6
Chileys,blackrock,576,hunter,beastmastery,12,6,6
Hidethegun,draenor,576,hunter,beastmastery,12,6,6
Pointnclick,the-maelstrom,576,hunter,beastmastery,12,6,6
Gréènthumbs,ragnaros,576,hunter,beastmastery,12,6,6
Cítyzens,drakthul,576,hunter,beastmastery,12,6,6
Hagall,chamber-of-aspects,576,hunter,beastmastery,12,6,6
Testotorben,malfurion,576,hunter,beastmastery,12,6,6
Metalbaci,sylvanas,576,hunter,beastmastery,12,6,6
Hï,eitrigg,576,hunter,beastmastery,12,6,6
Ówl,silvermoon,576,hunter,beastmastery,12,6,6
Onxtac,burning-legion,576,hunter,beastmastery,12,6,6
Nirviena,nazjatar,576,hunter,beastmastery,12,6,6
Nagu,antonidas,576,hunter,beastmastery,12,6,6
Bablor,kul-tiras,576,hunter,beastmastery,12,6,6
Iuyiuy,dalaran,576,hunter,beastmastery,12,6,6
Pedji,alakir,576,hunter,beastmastery,12,6,6
Jayyke,frostmane,576,hunter,beastmastery,12,6,6
Массовик,blackscar,576,hunter,beastmastery,12,6,6
Showdope,drakthul,576,hunter,beastmastery,12,6,6
Mclooving,runetotem,576,hunter,beastmastery,12,6,6
Burbutsuluki,silvermoon,576,hunter,beastmastery,12,6,6
Bodytypedog,ragnaros,576,hunter,beastmastery,12,6,6
Imonér,frostmane,576,hunter,beastmastery,12,6,6
Xiviora,archimonde,576,hunter,beastmastery,12,6,6
Skarra,zuljin,576,hunter,beastmastery,12,6,6
Astair,hyjal,576,hunter,beastmastery,12,6,6
Darkstripe,turalyon,576,hunter,beastmastery,12,6,6
Kaballa,ahnqiraj,576,hunter,beastmastery,12,6,6
Toptìérgoðx,drakthul,576,hunter,beastmastery,12,6,6
Niedzwiedzor,silvermoon,576,hunter,beastmastery,12,6,6
Келентори,gordunni,576,hunter,beastmastery,12,6,6
Valtondre,argent-dawn,576,hunter,beastmastery,12,6,6
Зеленыйиисус,gordunni,576,hunter,beastmastery,12,6,6
Мишечкатоп,gordunni,576,hunter,beastmastery,12,6,6
Magicnanø,nemesis,576,hunter,beastmastery,12,6,6
Prossh,ravencrest,576,hunter,beastmastery,15,7,8
Healscare,dalaran,576,hunter,beastmastery,16,7,9
Ñibiru,archimonde,576,hunter,beastmastery,21,7,14
Exwifey,ravencrest,576,hunter,beastmastery,18,6,12
Safnirxx,tarren-mill,576,hunter,beastmastery,18,6,12
Свадебная,gordunni,576,hunter,beastmastery,18,6,12
Cynosa,tarren-mill,576,hunter,beastmastery,18,6,12
Headhunterzz,dun-modr,576,hunter,beastmastery,18,6,12
Bloodpanter,ragnaros,576,hunter,beastmastery,18,6,12
Pergola,spinebreaker,576,hunter,beastmastery,18,6,12
Матанал,gordunni,576,hunter,beastmastery,18,6,12
Disyö,kazzak,576,hunter,beastmastery,18,6,12
Raztreadör,dun-modr,576,hunter,beastmastery,18,6,12
Realme,blackrock,576,hunter,beastmastery,18,6,12
Wetto,ravencrest,576,hunter,beastmastery,18,6,12
Vepzen,haomarush,576,hunter,beastmastery,18,6,12
Fotmspec,tarren-mill,576,hunter,beastmastery,18,6,12
Qsun,auchindoun,576,hunter,beastmastery,18,6,12
Zelghor,frostwolf,576,hunter,beastmastery,18,6,12
Nevêrse,archimonde,576,hunter,beastmastery,18,6,12
Ramboblast,ravencrest,576,hunter,beastmastery,18,6,12
Vulupera,aggramar,576,hunter,beastmastery,18,6,12
Suisiide,antonidas,576,hunter,beastmastery,18,6,12
Cronoz,stormscale,576,hunter,beastmastery,18,6,12
Седактив,grom,576,hunter,beastmastery,27,7,20
Сексишмекс,soulflayer,576,hunter,beastmastery,30,6,24
Rheyl,dun-morogh,576,hunter,beastmastery,30,6,24
Superx,argent-dawn,575,hunter,beastmastery,6,6,0
Tukezz,outland,575,hunter,beastmastery,12,6,6
Нагито,galakrond,575,hunter,beastmastery,12,6,6
Dippöverdos,outland,575,hunter,beastmastery,12,6,6
Абунай,soulflayer,575,hunter,beastmastery,12,6,6
Iddqd,outland,575,hunter,beastmastery,12,6,6
Truedetectiv,aggramar,575,hunter,beastmastery,12,6,6
Eyetto,dun-modr,575,hunter,beastmastery,12,6,6
Ghanik,draenor,575,hunter,beastmastery,12,6,6
Gløbi,malfurion,575,hunter,beastmastery,12,6,6
Nosfuratu,stormscale,575,hunter,beastmastery,12,6,6
Robinlebois,ysondre,575,hunter,beastmastery,12,6,6
Ipad,cthun,575,hunter,beastmastery,12,6,6
Najbrzi,tarren-mill,575,hunter,beastmastery,12,6,6
Blacksyo,elune,575,hunter,beastmastery,12,6,6
Hunterizi,silvermoon,575,hunter,beastmastery,12,6,6
Jimpage,eredar,575,hunter,beastmastery,12,6,6
Dödskatten,kazzak,575,hunter,beastmastery,18,6,12
Slaÿers,archimonde,575,hunter,beastmastery,18,6,12
Sylphie,dalaran,575,hunter,beastmastery,18,6,12
Shibai,outland,575,hunter,beastmastery,18,6,12
Hitray,stormscale,575,hunter,beastmastery,18,6,12
Çraze,silvermoon,575,hunter,beastmastery,18,6,12
Donneraàn,blackrock,575,hunter,beastmastery,18,6,12
Ápêx,ravencrest,575,hunter,beastmastery,18,6,12
Piit,elune,575,hunter,beastmastery,18,6,12
Szafri,draenor,575,hunter,beastmastery,18,6,12
Ølympx,blackhand,575,hunter,beastmastery,24,6,18
Ketator,archimonde,574,hunter,beastmastery,12,6,6
Musjägaretvå,silvermoon,574,hunter,beastmastery,15,7,8
Вентрана,gordunni,574,hunter,beastmastery,18,6,12
Kannon,twisting-nether,574,hunter,beastmastery,18,6,12
Syldroxia,antonidas,574,hunter,beastmastery,24,6,18
Talmïr,archimonde,574,hunter,beastmastery,24,6,18
Fünf,das-konsortium,573,hunter,beastmastery,18,6,12
Cliff,kiljaeden,572,hunter,beastmastery,30,6,24
Jelezenchuk,outland,571,hunter,beastmastery,12,6,6
Jsâ,blackmoore,571,hunter,beastmastery,12,6,6
Úlfynja,sylvanas,570,hunter,beastmastery,12,6,6
Corrwus,argent-dawn,570,hunter,beastmastery,18,6,12
Кеоки,soulflayer,569,hunter,beastmastery,18,6,12
Merodin,nerathor,569,hunter,beastmastery,18,6,12
Олькахант,galakrond,568,hunter,beastmastery,12,6,6
Zahgrug,aerie-peak,568,hunter,beastmastery,12,6,6
Notrapnaga,stormscale,559,hunter,beastmastery,11,6,5
Сяову,gordunni,551,hunter,beastmastery,154,57,97
Crasharrow,stormscale,544,hunter,beastmastery,22,6,16
Béarrockx,alleria,543,hunter,beastmastery,11,6,5
Egoshôoter,eredar,543,hunter,beastmastery,14,7,7
Hamina,tarren-mill,543,hunter,beastmastery,17,6,11
Åånei,twisting-nether,528,hunter,beastmastery,15,6,9
Kukenisluken,stormscale,527,hunter,beastmastery,11,6,5
Archfiend,stormscale,527,hunter,beastmastery,11,6,5
Haplîn,elune,527,hunter,beastmastery,11,6,5
Вреднаязая,soulflayer,527,hunter,beastmastery,11,6,5
Braatski,stormscale,526,hunter,beastmastery,18,7,11
Kissay,blackmoore,522,hunter,beastmastery,12,7,5
Devilmilo,khaz-modan,520,hunter,beastmastery,15,6,9
Raxxic,eredar,512,hunter,beastmastery,10,6,4
Buzzle,sylvanas,512,hunter,beastmastery,22,6,16
Níne,sylvanas,511,hunter,beastmastery,11,6,5
Powerfist,blackhand,511,hunter,beastmastery,16,6,10
Sacroz,frostwhisper,510,hunter,beastmastery,20,6,14
Gnomslakter,ragnaros,509,hunter,beastmastery,16,6,10
Nefroo,defias-brotherhood,505,hunter,beastmastery,11,6,5
Dogliz,stormscale,480,hunter,beastmastery,6,5,1
Jorhan,ravencrest,480,hunter,beastmastery,6,5,1
Azeezti,stormscale,480,hunter,beastmastery,6,5,1
Badboyxoxo,stormscale,480,hunter,beastmastery,6,5,1
Sunyjuyono,ravencrest,480,hunter,beastmastery,6,5,1
Pantherovich,ravencrest,480,hunter,beastmastery,6,5,1
Sheeya,argent-dawn,480,hunter,beastmastery,6,5,1
Smokerofweed,kazzak,480,hunter,beastmastery,6,5,1
Мунмейстер,blackscar,480,hunter,beastmastery,6,5,1
Arrowsticini,pozzo-delleternità,480,hunter,beastmastery,6,5,1
Arkhalis,drakthul,480,hunter,beastmastery,6,5,1
Techpoint,silvermoon,480,hunter,beastmastery,6,5,1
Connyrövöga,draenor,480,hunter,beastmastery,6,5,1
Qaedri,kazzak,480,hunter,beastmastery,6,5,1
Huntourd,eredar,480,hunter,beastmastery,6,5,1
Jinxbomber,draenor,480,hunter,beastmastery,6,5,1
Xreroll,ysondre,480,hunter,beastmastery,6,5,1
Wellocérapt,confrérie-du-thorium,480,hunter,beastmastery,6,5,1
Bashrah,blackrock,480,hunter,beastmastery,9,6,3
Elvenian,twisting-nether,480,hunter,beastmastery,12,5,7
Ekz,twisting-nether,480,hunter,beastmastery,12,5,7
Copenhyggen,silvermoon,480,hunter,beastmastery,12,5,7
Shimzz,twisting-nether,480,hunter,beastmastery,12,5,7
Bloodymarìe,kelthuzad,480,hunter,beastmastery,12,5,7
Peppiz,ragnaros,480,hunter,beastmastery,12,5,7
Kanzlerkohl,frostwolf,480,hunter,beastmastery,12,5,7
Wildwingsebb,nazjatar,480,hunter,beastmastery,12,5,7
Thursty,twisting-nether,480,hunter,beastmastery,12,5,7
Eredark,zuljin,480,hunter,beastmastery,12,5,7
Ggjohnny,kazzak,480,hunter,beastmastery,12,5,7
Eferos,quelthalas,480,hunter,beastmastery,12,5,7
Minisniper,aegwynn,480,hunter,beastmastery,12,5,7
Arsola,sylvanas,480,hunter,beastmastery,12,5,7
Juniorm,kazzak,480,hunter,beastmastery,12,5,7
Noraka,blackrock,480,hunter,beastmastery,12,5,7
Khort,twisting-nether,480,hunter,beastmastery,12,5,7
Джеймсфранко,blackscar,480,hunter,beastmastery,12,5,7
Квит,blackscar,480,hunter,beastmastery,12,5,7
Kongharald,ravencrest,480,hunter,beastmastery,12,5,7
Ataxyjr,ravencrest,480,hunter,beastmastery,12,5,7
Drandra,tarren-mill,480,hunter,beastmastery,12,5,7
Naposin,ragnaros,480,hunter,beastmastery,12,5,7
Maruxs,dun-modr,480,hunter,beastmastery,12,5,7
Palomo,argent-dawn,480,hunter,beastmastery,12,5,7
Aleina,dentarg,480,hunter,beastmastery,12,5,7
Feelmyfurý,tarren-mill,480,hunter,beastmastery,12,5,7
Honeey,dun-modr,480,hunter,beastmastery,12,5,7
Mjkhunt,tarren-mill,480,hunter,beastmastery,12,5,7
Chase,wildhammer,480,hunter,beastmastery,12,5,7
Mazhug,stormreaver,480,hunter,beastmastery,12,5,7
Lersey,blackmoore,480,hunter,beastmastery,12,5,7
Sarhina,draenor,480,hunter,beastmastery,12,5,7
Zrijad,draenor,480,hunter,beastmastery,12,5,7
Bubbahubba,ragnaros,480,hunter,beastmastery,12,5,7
Нитидон,howling-fjord,480,hunter,beastmastery,12,5,7
Roomeo,the-maelstrom,480,hunter,beastmastery,12,5,7
Waneìs,stormscale,480,hunter,beastmastery,12,5,7
Quoicoubèh,hyjal,480,hunter,beastmastery,12,5,7
Sharkeater,outland,480,hunter,beastmastery,12,5,7
Benjtrapgodx,antonidas,480,hunter,beastmastery,12,5,7
Вуйчеч,howling-fjord,480,hunter,beastmastery,12,5,7
Küry,archimonde,480,hunter,beastmastery,12,5,7
Келкузд,howling-fjord,480,hunter,beastmastery,12,5,7
Ôrïøn,archimonde,480,hunter,beastmastery,12,5,7
Dordok,ysondre,480,hunter,beastmastery,12,5,7
Jins,illidan,480,hunter,beastmastery,12,5,7
Óné,blackhand,480,hunter,beastmastery,12,5,7
Yésdave,stormscale,480,hunter,beastmastery,12,5,7
Hiff,burning-legion,480,hunter,beastmastery,12,5,7
Darkdrais,archimonde,480,hunter,beastmastery,12,5,7
Двустволка,gordunni,480,hunter,beastmastery,12,5,7
Bojestemrudy,outland,480,hunter,beastmastery,12,5,7
Toonzbro,blackmoore,480,hunter,beastmastery,15,6,9
Elðer,dentarg,480,hunter,beastmastery,16,6,10
Lepap,arygos,480,hunter,beastmastery,17,5,12
Uqash,outland,480,hunter,beastmastery,18,5,13
Duaij,outland,480,hunter,beastmastery,18,5,13
Stomugromova,ragnaros,480,hunter,beastmastery,18,5,13
Chrishyh,blackrock,480,hunter,beastmastery,18,5,13
Ohboy,dun-morogh,480,hunter,beastmastery,18,5,13
Begøne,draenor,480,hunter,beastmastery,18,5,13
Schwen,grim-batol,480,hunter,beastmastery,18,5,13
Killstreak,magtheridon,480,hunter,beastmastery,18,5,13
Скримзх,gordunni,479,hunter,beastmastery,6,5,1
Artexxia,kazzak,479,hunter,beastmastery,6,5,1
Möttii,blackrock,479,hunter,beastmastery,6,5,1
Зонксс,gordunni,479,hunter,beastmastery,12,7,5
Swïtchz,hyjal,479,hunter,beastmastery,12,5,7
Ivanrockstar,draenor,479,hunter,beastmastery,12,5,7
Droubidi,garona,479,hunter,beastmastery,12,5,7
Hallem,karazhan,479,hunter,beastmastery,12,5,7
Jana,ragnaros,479,hunter,beastmastery,12,5,7
Atranex,ravencrest,479,hunter,beastmastery,12,5,7
Slett,twisting-nether,479,hunter,beastmastery,12,5,7
Енвина,gordunni,479,hunter,beastmastery,12,5,7
Живучийорех,gordunni,479,hunter,beastmastery,12,5,7
Саняприцел,howling-fjord,479,hunter,beastmastery,12,5,7
Baldazr,shadowsong,479,hunter,beastmastery,12,5,7
Arielowy,doomhammer,479,hunter,beastmastery,18,5,13
Petdmg,kazzak,479,hunter,beastmastery,18,5,13
Itssharpwall,stormscale,479,hunter,beastmastery,24,5,19
Agarez,blackrock,478,hunter,beastmastery,6,5,1
Добрыйклыкач,gordunni,478,hunter,beastmastery,12,5,7
Kepâssa,ysondre,478,hunter,beastmastery,12,5,7
Ëcheniquë,sanguino,478,hunter,beastmastery,24,5,19
Спиночух,lich-king,477,hunter,beastmastery,12,5,7
Ghostaim,kazzak,475,hunter,beastmastery,10,6,4
Alunite,sporeggar,475,hunter,beastmastery,12,5,7
Asca,eldrethalas,475,hunter,beastmastery,18,5,13
Опаснаяя,borean-tundra,473,hunter,beastmastery,12,5,7
Ahilleaa,aegwynn,472,hunter,beastmastery,12,5,7
Ferax,alleria,472,hunter,beastmastery,12,5,7
Ruhen,aegwynn,463,hunter,beastmastery,11,5,6
Tiguy,archimonde,462,hunter,beastmastery,23,5,18
Momohenní,archimonde,448,hunter,beastmastery,10,5,5
Kabedon,drakthul,448,hunter,beastmastery,16,5,11
Artemmis,tarren-mill,447,hunter,beastmastery,11,5,6
Drennak,kult-der-verdammten,447,hunter,beastmastery,17,5,12
Uab,dun-morogh,447,hunter,beastmastery,40,6,34
Xsniper,sylvanas,446,hunter,beastmastery,17,5,12
Prebranatz,the-shatar,432,hunter,beastmastery,15,5,10
Såvëâmäzøñíà,stormscale,431,hunter,beastmastery,11,5,6
Thinkfast,twilights-hammer,426,hunter,beastmastery,11,7,4
Braînbúg,blackmoore,426,hunter,beastmastery,12,6,6
Grubabicza,silvermoon,426,hunter,beastmastery,19,6,13
Robingood,alexstrasza,425,hunter,beastmastery,17,7,10
Grollrik,blackhand,425,hunter,beastmastery,15,6,9
Sarnak,thrall,416,hunter,beastmastery,10,5,5
Taureno,lordaeron,415,hunter,beastmastery,8,5,3
Valamié,stormscale,415,hunter,beastmastery,8,5,3
Topbow,talnivarr,415,hunter,beastmastery,10,5,5
Darkshe,dun-modr,415,hunter,beastmastery,14,5,9
Panlong,tarren-mill,415,hunter,beastmastery,16,5,11
Marksmaniak,ysondre,384,hunter,beastmastery,6,4,2
Ihsie,eredar,384,hunter,beastmastery,6,4,2
Барногор,gordunni,384,hunter,beastmastery,6,4,2
Вихтриэль,gordunni,384,hunter,beastmastery,6,4,2
Djurmästaren,ravencrest,384,hunter,beastmastery,6,4,2
Ðøpèz,frostwolf,384,hunter,beastmastery,6,4,2
Moelester,eredar,384,hunter,beastmastery,6,4,2
Crooklyn,ravencrest,384,hunter,beastmastery,6,4,2
Кайсго,gordunni,384,hunter,beastmastery,6,4,2
Balamut,aegwynn,384,hunter,beastmastery,6,4,2
Sín,kirin-tor,384,hunter,beastmastery,6,4,2
Трисциллочка,howling-fjord,384,hunter,beastmastery,6,4,2
Lávender,magtheridon,384,hunter,beastmastery,6,4,2
Ghõst,frostmane,384,hunter,beastmastery,6,4,2
Oobe,hyjal,384,hunter,beastmastery,6,4,2
Шадоуселект,howling-fjord,384,hunter,beastmastery,6,4,2
Патапум,deathguard,384,hunter,beastmastery,6,4,2
Noxxen,burning-legion,384,hunter,beastmastery,6,4,2
Murkek,drakthul,384,hunter,beastmastery,6,4,2
Поторопись,gordunni,384,hunter,beastmastery,6,4,2
Sambucamasta,draenor,384,hunter,beastmastery,6,4,2
Sindaro,kazzak,384,hunter,beastmastery,6,4,2
Wristflex,kazzak,384,hunter,beastmastery,6,4,2
Хипстеркотик,gordunni,384,hunter,beastmastery,6,4,2
Êvêr,thrall,384,hunter,beastmastery,6,4,2
Powpewpom,kazzak,384,hunter,beastmastery,6,4,2
Chindaliña,zuljin,384,hunter,beastmastery,6,4,2
Bohemond,stormrage,384,hunter,beastmastery,6,4,2
Stingarrow,stormscale,384,hunter,beastmastery,6,4,2
Mothmanx,kazzak,384,hunter,beastmastery,6,4,2
Dràka,twisting-nether,384,hunter,beastmastery,6,4,2
Cryneth,ravencrest,384,hunter,beastmastery,6,4,2
Arellia,blackmoore,384,hunter,beastmastery,6,4,2
Missmytraps,stormscale,384,hunter,beastmastery,6,4,2
Celebor,sanguino,384,hunter,beastmastery,6,4,2
Riema,ragnaros,384,hunter,beastmastery,6,4,2
Вандамос,soulflayer,384,hunter,beastmastery,6,4,2
Ginirosh,blackmoore,384,hunter,beastmastery,6,4,2
Dzesija,aszune,384,hunter,beastmastery,6,4,2
Zyprix,blackrock,384,hunter,beastmastery,6,4,2
Ещёвмете,blackscar,384,hunter,beastmastery,6,4,2
Kàisèr,shendralar,384,hunter,beastmastery,6,4,2
Khregan,aerie-peak,384,hunter,beastmastery,6,4,2
Robbingyou,tarren-mill,384,hunter,beastmastery,6,4,2
Naturals,silvermoon,384,hunter,beastmastery,6,4,2
Noux,stormscale,384,hunter,beastmastery,6,4,2
Nomorepain,outland,384,hunter,beastmastery,6,4,2
Gigatrap,ravencrest,384,hunter,beastmastery,6,4,2
Evengance,dragonblight,384,hunter,beastmastery,6,4,2
Hetzenauer,nathrezim,384,hunter,beastmastery,6,4,2
Garratha,burning-legion,384,hunter,beastmastery,6,4,2
Evílíckxøxø,ravencrest,384,hunter,beastmastery,6,4,2
Mórz,magtheridon,384,hunter,beastmastery,6,4,2
Ntguilty,blackrock,384,hunter,beastmastery,6,4,2
Absoluthunt,neptulon,384,hunter,beastmastery,6,4,2
Xóxó,frostmane,384,hunter,beastmastery,6,4,2
Fajitax,lightbringer,384,hunter,beastmastery,6,4,2
Elonyr,sanguino,384,hunter,beastmastery,6,4,2
Toonzdude,blackmoore,384,hunter,beastmastery,6,4,2
Legolasso,saurfang,384,hunter,beastmastery,6,4,2
Zbyrkana,neptulon,384,hunter,beastmastery,6,4,2
Szybky,defias-brotherhood,384,hunter,beastmastery,6,4,2
Kyarin,draenor,384,hunter,beastmastery,6,4,2
Schwabbels,silvermoon,384,hunter,beastmastery,6,4,2
Hknavci,defias-brotherhood,384,hunter,beastmastery,6,4,2
Разплюханка,howling-fjord,384,hunter,beastmastery,6,4,2
Quasarx,draenor,384,hunter,beastmastery,9,5,4
Lancer,aggra-português,384,hunter,beastmastery,12,6,6
Pson,draenor,384,hunter,beastmastery,10,5,5
Mystyle,sylvanas,384,hunter,beastmastery,15,5,10
Qiix,kargath,384,hunter,beastmastery,12,4,8
Qwèrts,stormscale,384,hunter,beastmastery,12,4,8
Lexayah,twisting-nether,384,hunter,beastmastery,12,4,8
Trollohunt,twisting-nether,384,hunter,beastmastery,12,4,8
Bmo,zuljin,384,hunter,beastmastery,12,4,8
Бочонок,goldrinn,384,hunter,beastmastery,12,4,8
Aléxy,sanguino,384,hunter,beastmastery,12,4,8
Fatshaming,silvermoon,384,hunter,beastmastery,12,4,8
Zynga,sylvanas,384,hunter,beastmastery,12,4,8
Catman,stormreaver,384,hunter,beastmastery,12,4,8
Zähmbar,malganis,384,hunter,beastmastery,12,4,8
Marzenielas,silvermoon,384,hunter,beastmastery,12,4,8
Korkyra,outland,384,hunter,beastmastery,12,4,8
Sjufemman,ravencrest,384,hunter,beastmastery,12,4,8
Katana,stormreaver,384,hunter,beastmastery,12,4,8
Samasukë,grim-batol,384,hunter,beastmastery,12,4,8
Rabiate,blackrock,384,hunter,beastmastery,12,4,8
Mógwaí,stormscale,384,hunter,beastmastery,12,4,8
Дэлмор,greymane,384,hunter,beastmastery,12,4,8
Rockshredder,ravencrest,384,hunter,beastmastery,12,4,8
Reakanz,tarren-mill,384,hunter,beastmastery,12,4,8
Khanö,twisting-nether,384,hunter,beastmastery,12,4,8
Venatrixx,azjolnerub,384,hunter,beastmastery,12,4,8
Zaknow,dalaran,384,hunter,beastmastery,12,4,8
Grigur,dalaran,384,hunter,beastmastery,12,4,8
Navarro,nemesis,384,hunter,beastmastery,12,4,8
Czauner,blackmoore,384,hunter,beastmastery,12,4,8
Teddybeardo,stormscale,384,hunter,beastmastery,12,4,8
Khyleanqt,dun-modr,384,hunter,beastmastery,12,4,8
Амадаре,howling-fjord,384,hunter,beastmastery,12,4,8
Porthunt,kazzak,384,hunter,beastmastery,12,4,8
Monnee,outland,384,hunter,beastmastery,12,4,8
Skydraz,ysondre,384,hunter,beastmastery,12,4,8
Thekev,ravencrest,384,hunter,beastmastery,12,4,8
Nastynutshot,stormscale,384,hunter,beastmastery,12,4,8
Hattorisama,ghostlands,384,hunter,beastmastery,12,4,8
Izummii,sylvanas,384,hunter,beastmastery,12,4,8
Dissectiøn,hyjal,384,hunter,beastmastery,12,4,8
Greim,blackmoore,384,hunter,beastmastery,12,4,8
Horxxa,kul-tiras,384,hunter,beastmastery,12,4,8
Biciclentiu,twisting-nether,384,hunter,beastmastery,12,4,8
Bæbækk,frostmane,384,hunter,beastmastery,12,4,8
Nizzoz,blackmoore,384,hunter,beastmastery,12,4,8
Chui,twisting-nether,384,hunter,beastmastery,12,4,8
Sharpeneye,ragnaros,384,hunter,beastmastery,12,4,8
Вейзу,ashenvale,384,hunter,beastmastery,12,4,8
Solomonse,silvermoon,384,hunter,beastmastery,12,4,8
Thérón,ravencrest,384,hunter,beastmastery,12,4,8
Willzz,ravencrest,384,hunter,beastmastery,12,4,8
Örjans,tarren-mill,384,hunter,beastmastery,12,4,8
Brønkø,azshara,384,hunter,beastmastery,12,4,8
Neocb,ravencrest,384,hunter,beastmastery,12,4,8
Malromero,outland,384,hunter,beastmastery,12,4,8
Bobtroll,twisting-nether,384,hunter,beastmastery,12,4,8
Somethíngmad,stormscale,384,hunter,beastmastery,12,4,8
Sîriell,arthas,384,hunter,beastmastery,12,4,8
Серцебиение,soulflayer,384,hunter,beastmastery,12,4,8
Xavers,outland,384,hunter,beastmastery,12,4,8
Tøixøna,tyrande,384,hunter,beastmastery,12,4,8
Nßatrapper,outland,384,hunter,beastmastery,12,4,8
Valomeere,tarren-mill,384,hunter,beastmastery,12,4,8
Zippyzen,twisting-nether,384,hunter,beastmastery,12,4,8
Zakert,zuljin,384,hunter,beastmastery,12,4,8
Staynador,turalyon,384,hunter,beastmastery,12,4,8
Petshopbøy,veklor,384,hunter,beastmastery,13,4,9
Rkast,silvermoon,384,hunter,beastmastery,13,4,9
Дланьгоспода,soulflayer,384,hunter,beastmastery,13,4,9
Киллкук,howling-fjord,384,hunter,beastmastery,15,4,11
Gps,twilights-hammer,384,hunter,beastmastery,18,4,14
Ímpulsion,stormscale,384,hunter,beastmastery,18,4,14
Tervueren,burning-blade,384,hunter,beastmastery,18,4,14
Juhiu,hyjal,384,hunter,beastmastery,18,4,14
Kayvaal,kaelthas,384,hunter,beastmastery,18,4,14
Darts,outland,384,hunter,beastmastery,18,4,14
Mélovéa,sinstralis,384,hunter,beastmastery,18,4,14
Døgtamer,twisting-nether,384,hunter,beastmastery,18,4,14
Xscaper,twilights-hammer,383,hunter,beastmastery,6,4,2
Resonate,stormreaver,383,hunter,beastmastery,6,4,2
Zrip,kazzak,383,hunter,beastmastery,6,4,2
Whyareurunin,silvermoon,383,hunter,beastmastery,6,4,2
Moggbang,ravencrest,383,hunter,beastmastery,6,4,2
Lyute,draenor,383,hunter,beastmastery,6,4,2
Steez,hyjal,383,hunter,beastmastery,12,4,8
Luvnoc,hyjal,383,hunter,beastmastery,12,4,8
Greenhorned,antonidas,383,hunter,beastmastery,12,4,8
Doguago,draenor,383,hunter,beastmastery,12,4,8
Enerhunt,ysondre,383,hunter,beastmastery,12,4,8
Зукипер,borean-tundra,383,hunter,beastmastery,12,4,8
Nuyy,blackrock,383,hunter,beastmastery,12,4,8
Lalluna,malganis,383,hunter,beastmastery,12,4,8
Åhman,defias-brotherhood,383,hunter,beastmastery,12,4,8
Aaxecute,silvermoon,383,hunter,beastmastery,12,4,8
Huntseeker,draenor,383,hunter,beastmastery,12,4,8
Machini,terokkar,383,hunter,beastmastery,17,4,13
Mugiwaras,eldrethalas,383,hunter,beastmastery,18,4,14
Neuwi,stormreaver,382,hunter,beastmastery,12,4,8
Яугеныч,blackscar,381,hunter,beastmastery,12,4,8
Sanite,dun-morogh,381,hunter,beastmastery,12,4,8
Jolox,blackrock,379,hunter,beastmastery,12,4,8
Thelasiel,aerie-peak,379,hunter,beastmastery,14,4,10
Стрижкакаре,soulflayer,367,hunter,beastmastery,11,4,7
Masarusan,eredar,366,hunter,beastmastery,17,4,13
Løssen,outland,352,hunter,beastmastery,10,4,6
Zakos,kirin-tor,351,hunter,beastmastery,17,4,13
Jaszczomp,magtheridon,350,hunter,beastmastery,16,4,12
Meridià,malorne,336,hunter,beastmastery,9,4,5
Harpers,kazzak,336,hunter,beastmastery,15,4,11
Trayomrusnik,stormscale,330,hunter,beastmastery,13,6,7
Itzcritch,tarren-mill,330,hunter,beastmastery,14,5,9
Skyh,outland,330,hunter,beastmastery,16,5,11
Foxielove,ghostlands,330,hunter,beastmastery,18,5,13
Wofer,burning-steppes,319,hunter,beastmastery,5,4,1
Greinktar,archimonde,317,hunter,beastmastery,10,4,6
Sebikh,ravencrest,288,hunter,beastmastery,6,3,3
Kondirox,twisting-nether,288,hunter,beastmastery,6,3,3
Скукота,grom,288,hunter,beastmastery,6,3,3
Артекриогг,soulflayer,288,hunter,beastmastery,6,3,3
Trapshot,frostwolf,288,hunter,beastmastery,6,3,3
Кромен,eversong,288,hunter,beastmastery,6,3,3
Ruttless,tarren-mill,288,hunter,beastmastery,6,3,3
Moccapudding,stormreaver,288,hunter,beastmastery,6,3,3
Kronkh,nemesis,288,hunter,beastmastery,6,3,3
Стингергодх,gordunni,288,hunter,beastmastery,6,3,3
Calyssae,shattered-halls,288,hunter,beastmastery,6,3,3
Bârli,amanthul,288,hunter,beastmastery,6,3,3
Lûnelle,argent-dawn,288,hunter,beastmastery,6,3,3
Färsgöesovs,ravencrest,288,hunter,beastmastery,6,3,3
Микихаса,galakrond,288,hunter,beastmastery,6,3,3
Pispirelul,ravencrest,288,hunter,beastmastery,6,3,3
Ellemanae,dalaran,288,hunter,beastmastery,6,3,3
Элаган,soulflayer,288,hunter,beastmastery,6,3,3
Atromist,argent-dawn,288,hunter,beastmastery,6,3,3
Huntsolo,ravencrest,288,hunter,beastmastery,6,3,3
Yssup,frostmane,288,hunter,beastmastery,6,3,3
Люциферо,goldrinn,288,hunter,beastmastery,6,3,3
Kragán,silvermoon,288,hunter,beastmastery,6,3,3
Killkekmand,ravencrest,288,hunter,beastmastery,6,3,3
Tokkie,burning-blade,288,hunter,beastmastery,6,3,3
Оркос,deathweaver,288,hunter,beastmastery,6,3,3
Prurt,pozzo-delleternità,288,hunter,beastmastery,6,3,3
Тохаад,eversong,288,hunter,beastmastery,6,3,3
Delaghettoo,kilrogg,288,hunter,beastmastery,6,3,3
Randire,guldan,288,hunter,beastmastery,6,3,3
Mooj,malganis,288,hunter,beastmastery,6,3,3
Колтрэйнборз,blackscar,288,hunter,beastmastery,6,3,3
Goldenböw,ravencrest,288,hunter,beastmastery,6,3,3
Hinorist,ravencrest,288,hunter,beastmastery,6,3,3
Ártemide,pozzo-delleternità,288,hunter,beastmastery,6,3,3
Ликсандор,gordunni,288,hunter,beastmastery,6,3,3
Lebatsare,archimonde,288,hunter,beastmastery,6,3,3
Козладой,gordunni,288,hunter,beastmastery,6,3,3
Trapbing,ravencrest,288,hunter,beastmastery,6,3,3
Bawzé,archimonde,288,hunter,beastmastery,6,3,3
Steenzor,twisting-nether,288,hunter,beastmastery,6,3,3
Дедзловред,eversong,288,hunter,beastmastery,6,3,3
Denaris,silvermoon,288,hunter,beastmastery,6,3,3
Cooroona,stormrage,288,hunter,beastmastery,6,3,3
Sakaryali,silvermoon,288,hunter,beastmastery,6,3,3
Placeebow,ravencrest,288,hunter,beastmastery,6,3,3
Humanoidorc,the-maelstrom,288,hunter,beastmastery,6,3,3
Lunastrike,frostwolf,288,hunter,beastmastery,6,3,3
Bòw,antonidas,288,hunter,beastmastery,6,3,3
Janoh,dalaran,288,hunter,beastmastery,6,3,3
Chassgirlz,archimonde,288,hunter,beastmastery,6,3,3
Káfros,ravencrest,288,hunter,beastmastery,6,3,3
Lookmyezzy,ravencrest,288,hunter,beastmastery,6,3,3
Daela,elune,288,hunter,beastmastery,6,3,3
Будкусломаю,grom,288,hunter,beastmastery,6,3,3
Nervetøxin,ravencrest,288,hunter,beastmastery,6,3,3
Dashaft,kazzak,288,hunter,beastmastery,6,3,3
Kxx,kazzak,288,hunter,beastmastery,6,3,3
Akahr,thrall,288,hunter,beastmastery,6,3,3
Fangzahn,aegwynn,288,hunter,beastmastery,6,3,3
Fedya,kazzak,288,hunter,beastmastery,6,3,3
Anhur,blackmoore,288,hunter,beastmastery,6,3,3
Hunterbestie,eredar,288,hunter,beastmastery,6,3,3
Taurïel,stormscale,288,hunter,beastmastery,6,3,3
Frendo,stormscale,288,hunter,beastmastery,6,3,3
Râkim,blackmoore,288,hunter,beastmastery,6,3,3
Scartet,blackmoore,288,hunter,beastmastery,6,3,3
Kíllshot,blades-edge,288,hunter,beastmastery,6,3,3
Eatmenow,antonidas,288,hunter,beastmastery,6,3,3
Dryko,silvermoon,288,hunter,beastmastery,6,3,3
Mikâil,blackmoore,288,hunter,beastmastery,6,3,3
Zdravkomamic,kazzak,288,hunter,beastmastery,6,3,3
Verøx,kazzak,288,hunter,beastmastery,6,3,3
Трапавграунд,howling-fjord,288,hunter,beastmastery,6,3,3
Chrønôs,archimonde,288,hunter,beastmastery,6,3,3
Деллвиш,howling-fjord,288,hunter,beastmastery,6,3,3
Jodd,ragnaros,288,hunter,beastmastery,6,3,3
Noop,sylvanas,288,hunter,beastmastery,6,3,3
Dragnial,kazzak,288,hunter,beastmastery,6,3,3
Nathah,burning-legion,288,hunter,beastmastery,6,3,3
Whitehor,ragnaros,288,hunter,beastmastery,6,3,3
Innaria,argent-dawn,288,hunter,beastmastery,6,3,3
Blazeblue,hyjal,288,hunter,beastmastery,6,3,3
Knallêrbse,blackmoore,288,hunter,beastmastery,6,3,3
Ilovejwrld,dun-modr,288,hunter,beastmastery,6,3,3
Kyudoka,sylvanas,288,hunter,beastmastery,6,3,3
Zoophobiaqt,silvermoon,288,hunter,beastmastery,6,3,3
Stitcha,doomhammer,288,hunter,beastmastery,6,3,3
Luccus,kazzak,288,hunter,beastmastery,6,3,3
Japuog,kazzak,288,hunter,beastmastery,6,3,3
Arcô,dun-modr,288,hunter,beastmastery,6,3,3
Anayhh,dun-modr,288,hunter,beastmastery,6,3,3
Haeero,archimonde,288,hunter,beastmastery,6,3,3
Jennïfer,archimonde,288,hunter,beastmastery,6,3,3
Hùntård,hyjal,288,hunter,beastmastery,6,3,3
Shallia,thrall,288,hunter,beastmastery,6,3,3
Демела,gordunni,288,hunter,beastmastery,6,3,3
Unferth,the-venture-co,288,hunter,beastmastery,6,3,3
Sugutor,malfurion,288,hunter,beastmastery,6,3,3
Grincas,kazzak,288,hunter,beastmastery,6,3,3
Adewale,archimonde,288,hunter,beastmastery,6,3,3
Kanwfulldmg,stormscale,288,hunter,beastmastery,6,3,3
Rhyle,hyjal,288,hunter,beastmastery,6,3,3
Shedzargo,twisting-nether,288,hunter,beastmastery,6,3,3
Djtrapyasis,blackmoore,288,hunter,beastmastery,6,3,3
Køhr,archimonde,288,hunter,beastmastery,6,3,3
Datagrám,kazzak,288,hunter,beastmastery,6,3,3
Svinaset,shattered-hand,288,hunter,beastmastery,6,3,3
Chasseeur,archimonde,288,hunter,beastmastery,6,3,3
Nestereo,zirkel-des-cenarius,288,hunter,beastmastery,6,3,3
Bugspitz,outland,288,hunter,beastmastery,6,3,3
Кискавтесте,gordunni,288,hunter,beastmastery,6,3,3
Gehrketrap,silvermoon,288,hunter,beastmastery,6,3,3
Nelf,shattered-hand,288,hunter,beastmastery,6,3,3
Natashä,area-52,288,hunter,beastmastery,6,3,3
Heskel,hyjal,288,hunter,beastmastery,6,3,3
Elbatale,sylvanas,288,hunter,beastmastery,6,3,3
Huntaloko,outland,288,hunter,beastmastery,6,3,3
Heîsì,eredar,288,hunter,beastmastery,6,3,3
Katzchen,burning-legion,288,hunter,beastmastery,6,3,3
Keyshu,die-aldor,288,hunter,beastmastery,6,3,3
Dreystah,aegwynn,288,hunter,beastmastery,6,3,3
Доррети,howling-fjord,288,hunter,beastmastery,6,3,3
Nyedard,hyjal,288,hunter,beastmastery,6,3,3
Наладдчик,howling-fjord,288,hunter,beastmastery,6,3,3
Birdwatcher,kazzak,288,hunter,beastmastery,6,3,3
Pîngkongx,antonidas,288,hunter,beastmastery,6,3,3
Cartuzinho,twisting-nether,288,hunter,beastmastery,6,3,3
Varøsch,thrall,288,hunter,beastmastery,6,3,3
Visas,burning-legion,288,hunter,beastmastery,6,3,3
Popofles,outland,288,hunter,beastmastery,6,3,3
Hexorn,ysondre,288,hunter,beastmastery,6,3,3
Ostia,stormscale,288,hunter,beastmastery,6,3,3
Lioneli,sylvanas,288,hunter,beastmastery,6,3,3
Enthur,sylvanas,288,hunter,beastmastery,6,3,3
Darthbow,outland,288,hunter,beastmastery,6,3,3
Skrag,outland,288,hunter,beastmastery,6,3,3
Шеннокс,howling-fjord,288,hunter,beastmastery,6,3,3
Rhaonor,draenor,288,hunter,beastmastery,6,3,3
Vanrazorz,darksorrow,288,hunter,beastmastery,6,3,3
Kelp,silvermoon,288,hunter,beastmastery,6,3,3
Erishunt,sargeras,288,hunter,beastmastery,6,3,3
Abonah,khaz-modan,288,hunter,beastmastery,6,3,3
Selvele,hyjal,288,hunter,beastmastery,6,3,3
Дамони,gordunni,288,hunter,beastmastery,6,3,3
Aimshot,ravencrest,288,hunter,beastmastery,6,3,3
Lofiel,aegwynn,288,hunter,beastmastery,6,3,3
Djihadi,ysondre,288,hunter,beastmastery,6,3,3
Müvészúr,ragnaros,288,hunter,beastmastery,6,3,3
Teasyh,sylvanas,288,hunter,beastmastery,6,3,3
Exquisitor,draenor,288,hunter,beastmastery,6,3,3
Боураш,gordunni,288,hunter,beastmastery,6,3,3
Lastshott,kazzak,288,hunter,beastmastery,6,3,3
Tonttulul,draenor,288,hunter,beastmastery,6,3,3
Heavenknøws,dun-modr,288,hunter,beastmastery,9,4,5
Irri,drakthul,288,hunter,beastmastery,10,4,6
Onlyarenaz,kazzak,288,hunter,beastmastery,10,4,6
Sìnøn,alleria,288,hunter,beastmastery,8,3,5
Tackleberry,ysondre,288,hunter,beastmastery,8,3,5
Chêckpvp,outland,288,hunter,beastmastery,9,3,6
Венгс,howling-fjord,288,hunter,beastmastery,12,3,9
Sabnak,burning-blade,288,hunter,beastmastery,12,3,9
Marusmaskin,kazzak,288,hunter,beastmastery,12,3,9
Teddy,perenolde,288,hunter,beastmastery,12,3,9
Braxxahr,antonidas,288,hunter,beastmastery,12,3,9
Zeanoff,ravencrest,288,hunter,beastmastery,12,3,9
Штейн,greymane,288,hunter,beastmastery,12,3,9
Síden,sylvanas,288,hunter,beastmastery,12,3,9
Undefine,outland,288,hunter,beastmastery,12,3,9
Rrushi,argent-dawn,288,hunter,beastmastery,12,3,9
Faelendal,darksorrow,288,hunter,beastmastery,12,3,9
Хансбург,howling-fjord,288,hunter,beastmastery,12,3,9
Cotxqt,outland,288,hunter,beastmastery,12,3,9
Jellyfat,silvermoon,288,hunter,beastmastery,12,3,9
Drakess,daggerspine,288,hunter,beastmastery,12,3,9
Krëmpai,frostmane,288,hunter,beastmastery,12,3,9
Bilbogodx,outland,288,hunter,beastmastery,12,3,9
Fmatzen,the-maelstrom,288,hunter,beastmastery,12,3,9
Perkxd,stormscale,288,hunter,beastmastery,12,3,9
Mârked,argent-dawn,288,hunter,beastmastery,12,3,9
Jamesbownd,ravencrest,288,hunter,beastmastery,12,3,9
Wildbeek,sanguino,288,hunter,beastmastery,12,3,9
Drherbs,bloodhoof,288,hunter,beastmastery,12,3,9
Mark,runetotem,288,hunter,beastmastery,12,3,9
Sokrám,sanguino,288,hunter,beastmastery,12,3,9
Anas,argent-dawn,288,hunter,beastmastery,12,3,9
Petitgreen,hyjal,288,hunter,beastmastery,12,3,9
Hante,ravencrest,288,hunter,beastmastery,12,3,9
Оскорбление,howling-fjord,288,hunter,beastmastery,12,3,9
Elgreedo,sylvanas,288,hunter,beastmastery,12,3,9
Götthunter,antonidas,288,hunter,beastmastery,12,3,9
Vèreesa,azjolnerub,288,hunter,beastmastery,12,3,9
Narziel,die-todeskrallen,288,hunter,beastmastery,12,3,9
Ядрис,gordunni,288,hunter,beastmastery,12,3,9
Эолиана,borean-tundra,288,hunter,beastmastery,12,3,9
Lethalhands,neptulon,288,hunter,beastmastery,12,3,9
Ønlýfans,ravencrest,288,hunter,beastmastery,12,3,9
Skirnier,blackrock,288,hunter,beastmastery,12,3,9
Liikes,arygos,288,hunter,beastmastery,12,3,9
Riik,ragnaros,288,hunter,beastmastery,12,3,9
Frikandelli,outland,288,hunter,beastmastery,12,3,9
Spakster,blackrock,288,hunter,beastmastery,12,3,9
Thrystana,kazzak,288,hunter,beastmastery,12,3,9
Phutkapre,doomhammer,288,hunter,beastmastery,12,3,9
Deathshots,ravencrest,288,hunter,beastmastery,12,3,9
Kitrinos,silvermoon,288,hunter,beastmastery,12,3,9
Fiveguys,ravencrest,288,hunter,beastmastery,12,3,9
Дварфмэн,gordunni,288,hunter,beastmastery,13,3,10
Drakono,draenor,288,hunter,beastmastery,18,3,15
Dexiji,ragnaros,288,hunter,beastmastery,18,3,15
Primeq,blackhand,288,hunter,beastmastery,18,3,15
Markaeria,stormreaver,288,hunter,beastmastery,19,3,16
Oneeyedjoe,the-maelstrom,287,hunter,beastmastery,6,3,3
Shogos,aggra-português,287,hunter,beastmastery,6,3,3
Annixa,ravencrest,287,hunter,beastmastery,6,3,3
Bloodkillzz,ragnaros,287,hunter,beastmastery,6,3,3
Jazminluv,blackrock,287,hunter,beastmastery,12,3,9
Промахнулся,gordunni,287,hunter,beastmastery,12,3,9
Voraxh,draenor,287,hunter,beastmastery,12,3,9
Oatmeal,dun-morogh,287,hunter,beastmastery,12,3,9
Huttser,silvermoon,286,hunter,beastmastery,6,3,3
Brynwolf,argent-dawn,286,hunter,beastmastery,6,3,3
Snehvit,bloodhoof,285,hunter,beastmastery,18,3,15
Trapgodz,ragnaros,271,hunter,beastmastery,11,3,8
Lightrandom,kazzak,269,hunter,beastmastery,11,3,8
Suetøløgx,emeriss,256,hunter,beastmastery,10,3,7
Psailaa,azjolnerub,256,hunter,beastmastery,22,3,19
Ватмано,gordunni,255,hunter,beastmastery,8,4,4
Sarblade,bronze-dragonflight,255,hunter,beastmastery,11,3,8
Shoothim,destromath,254,hunter,beastmastery,8,4,4
Кулерквест,soulflayer,240,hunter,beastmastery,9,3,6
Waresfido,nordrassil,239,hunter,beastmastery,5,3,2
Kasyuo,outland,239,hunter,beastmastery,5,3,2
Zion,kul-tiras,239,hunter,beastmastery,5,3,2
Eilosh,outland,239,hunter,beastmastery,15,3,12
Huntinger,twisting-nether,234,hunter,beastmastery,10,5,5
Sloter,stormscale,234,hunter,beastmastery,16,6,10
Слышумертвых,gordunni,234,hunter,beastmastery,15,5,10
Snakepit,archimonde,234,hunter,beastmastery,17,4,13
Beastmaster,ragnaros,233,hunter,beastmastery,16,4,12
Góllum,ravencrest,224,hunter,beastmastery,10,3,7
Shagora,dalaran,223,hunter,beastmastery,8,3,5
Fineas,theradras,192,hunter,beastmastery,4,3,1
Knatterpfeil,eredar,192,hunter,beastmastery,9,3,6
Chamillon,archimonde,192,hunter,beastmastery,6,2,4
Bæbåk,frostmane,192,hunter,beastmastery,6,2,4
Mabön,zuljin,192,hunter,beastmastery,6,2,4
Dentaar,draenor,192,hunter,beastmastery,6,2,4
Diabloiv,doomhammer,192,hunter,beastmastery,6,2,4
Edar,sanguino,192,hunter,beastmastery,6,2,4
Elastaplast,thunderhorn,192,hunter,beastmastery,6,2,4
Lágåta,outland,192,hunter,beastmastery,6,2,4
Marryme,blackhand,192,hunter,beastmastery,6,2,4
Dogstrust,stormscale,192,hunter,beastmastery,6,2,4
Znu,argent-dawn,192,hunter,beastmastery,6,2,4
Kxrmi,twilights-hammer,192,hunter,beastmastery,6,2,4
Шимэйла,gordunni,192,hunter,beastmastery,6,2,4
Bethenny,draenor,192,hunter,beastmastery,6,2,4
Tyrone,saurfang,192,hunter,beastmastery,6,2,4
Sizemattersx,kazzak,192,hunter,beastmastery,6,2,4
Cørvino,der-rat-von-dalaran,192,hunter,beastmastery,6,2,4
Neaife,ragnaros,192,hunter,beastmastery,6,2,4
Grytax,outland,192,hunter,beastmastery,6,2,4
Aillin,antonidas,192,hunter,beastmastery,6,2,4
Poccâ,die-nachtwache,192,hunter,beastmastery,6,2,4
Sarbacanes,hyjal,192,hunter,beastmastery,6,2,4
Какулимёт,gordunni,192,hunter,beastmastery,6,2,4
Zulldek,sanguino,192,hunter,beastmastery,6,2,4
Arankis,norgannon,192,hunter,beastmastery,6,2,4
Realbigwilly,outland,192,hunter,beastmastery,6,2,4
Longblow,outland,192,hunter,beastmastery,6,2,4
Спелла,goldrinn,192,hunter,beastmastery,6,2,4
Хароко,gordunni,192,hunter,beastmastery,6,2,4
Sinsirellam,twisting-nether,192,hunter,beastmastery,6,2,4
Cataleja,pozzo-delleternità,192,hunter,beastmastery,6,2,4
Bernhardoder,blackhand,192,hunter,beastmastery,6,2,4
Jalu,die-aldor,192,hunter,beastmastery,6,2,4
Aughtism,turalyon,192,hunter,beastmastery,6,2,4
Gilgharsh,rajaxx,192,hunter,beastmastery,6,2,4
Травок,gordunni,192,hunter,beastmastery,6,2,4
Fofoulinaki,silvermoon,192,hunter,beastmastery,6,2,4
Waveshoot,hyjal,192,hunter,beastmastery,6,2,4
Holytrapqt,aegwynn,192,hunter,beastmastery,6,2,4
Korrekt,stormscale,192,hunter,beastmastery,6,2,4
Arozar,ragnaros,192,hunter,beastmastery,6,2,4
Trickspar,bloodscalp,192,hunter,beastmastery,6,2,4
Jarran,karazhan,192,hunter,beastmastery,6,2,4
Skalgor,thrall,192,hunter,beastmastery,6,2,4
Kahoonas,silvermoon,192,hunter,beastmastery,6,2,4
Gunmeister,bronzebeard,192,hunter,beastmastery,6,2,4
Hatethis,kazzak,192,hunter,beastmastery,6,2,4
Mustásh,stormscale,192,hunter,beastmastery,6,2,4
Díkembe,aegwynn,192,hunter,beastmastery,6,2,4
Avp,sylvanas,192,hunter,beastmastery,6,2,4
Comegetme,auchindoun,192,hunter,beastmastery,6,2,4
Pets,aegwynn,192,hunter,beastmastery,6,2,4
Cøkø,sanguino,192,hunter,beastmastery,6,2,4
Snakepit,stormscale,192,hunter,beastmastery,6,2,4
Avâlos,dentarg,192,hunter,beastmastery,6,2,4
Myoui,silvermoon,192,hunter,beastmastery,6,2,4
Kimmimaru,draenor,192,hunter,beastmastery,6,2,4
Trollshadow,tarren-mill,192,hunter,beastmastery,6,2,4
Yaègar,twisting-nether,192,hunter,beastmastery,6,2,4
Patrouifort,ysondre,192,hunter,beastmastery,6,2,4
Scycs,nazjatar,192,hunter,beastmastery,6,2,4
Сайнтификх,eversong,192,hunter,beastmastery,6,2,4
Luuszapfae,aegwynn,192,hunter,beastmastery,6,2,4
Skydragøn,die-aldor,192,hunter,beastmastery,6,2,4
Bloópy,silvermoon,192,hunter,beastmastery,6,2,4
Deskö,shendralar,192,hunter,beastmastery,6,2,4
Superachmed,kazzak,192,hunter,beastmastery,6,2,4
Florindeel,die-aldor,192,hunter,beastmastery,6,2,4
Zarrøn,thrall,192,hunter,beastmastery,6,2,4
Bushwhack,outland,192,hunter,beastmastery,6,2,4
Não,onyxia,192,hunter,beastmastery,6,2,4
Véncsótány,ragnaros,192,hunter,beastmastery,6,2,4
Brummel,frostwolf,192,hunter,beastmastery,6,2,4
Sharrowkyn,twisting-nether,192,hunter,beastmastery,6,2,4
Talanar,tarren-mill,192,hunter,beastmastery,6,2,4
Sylasteria,twisting-nether,192,hunter,beastmastery,6,2,4
Meltox,blackhand,192,hunter,beastmastery,6,2,4
Brindefolìe,archimonde,192,hunter,beastmastery,6,2,4
Danstonpif,kaelthas,192,hunter,beastmastery,6,2,4
Teyo,blackhand,192,hunter,beastmastery,6,2,4
Miesmuschel,guldan,192,hunter,beastmastery,6,2,4
Фэйсконтроль,azuregos,192,hunter,beastmastery,6,2,4
Doraxa,sanguino,192,hunter,beastmastery,6,2,4
Deathhowl,stormscale,192,hunter,beastmastery,6,2,4
Starkt,ragnaros,192,hunter,beastmastery,6,2,4
Klittcrit,bloodhoof,192,hunter,beastmastery,6,2,4
Smekminbåge,tarren-mill,192,hunter,beastmastery,6,2,4
Thecorruptor,skullcrusher,192,hunter,beastmastery,6,2,4
Trapzy,stormscale,192,hunter,beastmastery,6,2,4
Pzz,archimonde,192,hunter,beastmastery,6,2,4
Feedbackloop,silvermoon,192,hunter,beastmastery,6,2,4
Nektard,ravencrest,192,hunter,beastmastery,6,2,4
Absolutenon,alakir,192,hunter,beastmastery,6,2,4
Ототрал,gordunni,192,hunter,beastmastery,6,2,4
Thorka,tarren-mill,192,hunter,beastmastery,6,2,4
Lørenzø,archimonde,192,hunter,beastmastery,6,2,4
Гусецап,gordunni,192,hunter,beastmastery,6,2,4
Tanjîrø,antonidas,192,hunter,beastmastery,6,2,4
Агушычь,howling-fjord,192,hunter,beastmastery,6,2,4
Maeba,shendralar,192,hunter,beastmastery,6,2,4
Yolo,drakthul,192,hunter,beastmastery,6,2,4
Aliyaan,twisting-nether,192,hunter,beastmastery,6,2,4
Xeragon,frostwolf,192,hunter,beastmastery,6,2,4
Foleck,aegwynn,192,hunter,beastmastery,6,2,4
Stronkbeast,kazzak,192,hunter,beastmastery,6,2,4
Sharshoor,twisting-nether,192,hunter,beastmastery,6,2,4
Earfalass,twisting-nether,192,hunter,beastmastery,6,2,4
Kirinó,ragnaros,192,hunter,beastmastery,6,2,4
Azahunt,kazzak,192,hunter,beastmastery,6,2,4
Phyllobates,blackrock,192,hunter,beastmastery,6,2,4
Stáyhigh,malfurion,192,hunter,beastmastery,6,2,4
Falconrok,antonidas,192,hunter,beastmastery,6,2,4
Gukéx,stormscale,192,hunter,beastmastery,6,2,4
Cranekickzhu,blackmoore,192,hunter,beastmastery,6,2,4
Ренектон,soulflayer,192,hunter,beastmastery,6,2,4
Thárkay,malygos,192,hunter,beastmastery,6,2,4
Nigina,ravencrest,192,hunter,beastmastery,6,2,4
Zaakolack,burning-legion,192,hunter,beastmastery,6,2,4
Dola,archimonde,192,hunter,beastmastery,6,2,4
Sotu,stormscale,192,hunter,beastmastery,6,2,4
Atylla,ravencrest,192,hunter,beastmastery,6,2,4
Риперквин,gordunni,192,hunter,beastmastery,6,2,4
Аматорика,howling-fjord,192,hunter,beastmastery,6,2,4
Botrol,argent-dawn,192,hunter,beastmastery,6,2,4
Shademd,ahnqiraj,192,hunter,beastmastery,6,2,4
Korlog,kragjin,192,hunter,beastmastery,6,2,4
Naid,lordaeron,192,hunter,beastmastery,6,2,4
Allessía,argent-dawn,192,hunter,beastmastery,6,2,4
Shinsey,antonidas,192,hunter,beastmastery,6,2,4
Droz,blackmoore,192,hunter,beastmastery,6,2,4
Ninielnienor,thrall,192,hunter,beastmastery,6,2,4
Одисенс,eversong,192,hunter,beastmastery,6,2,4
Cheesychees,sylvanas,192,hunter,beastmastery,6,2,4
Gunforhire,ravencrest,192,hunter,beastmastery,6,2,4
Mufassa,sinstralis,192,hunter,beastmastery,6,2,4
Nerfit,argent-dawn,192,hunter,beastmastery,6,2,4
Manatodamoon,aerie-peak,192,hunter,beastmastery,6,2,4
Raysist,arathor,192,hunter,beastmastery,6,2,4
Lifeiscool,drakthul,192,hunter,beastmastery,6,2,4
Triopas,silvermoon,192,hunter,beastmastery,6,2,4
Nythilia,blackrock,192,hunter,beastmastery,6,2,4
Privelle,argent-dawn,192,hunter,beastmastery,6,2,4
Phantoprowl,stormscale,192,hunter,beastmastery,6,2,4
Snôptas,blackmoore,192,hunter,beastmastery,6,2,4
Трольпифпаф,deathguard,192,hunter,beastmastery,6,2,4
Razzét,stormscale,192,hunter,beastmastery,6,2,4
Khaleezi,blackmoore,192,hunter,beastmastery,6,2,4
Satúhati,stormscale,192,hunter,beastmastery,6,2,4
Atticüs,burning-blade,192,hunter,beastmastery,6,2,4
Vôrtax,blackmoore,192,hunter,beastmastery,6,2,4
Huntzie,argent-dawn,192,hunter,beastmastery,6,2,4
Dragoki,blackmoore,192,hunter,beastmastery,6,2,4
Hvaskøduenme,stormscale,192,hunter,beastmastery,6,2,4
Marionhood,sylvanas,192,hunter,beastmastery,6,2,4
Legolex,burning-blade,192,hunter,beastmastery,6,2,4
Mâgnesium,blackmoore,192,hunter,beastmastery,6,2,4
Nikzeubii,archimonde,192,hunter,beastmastery,6,2,4
As,kazzak,192,hunter,beastmastery,6,2,4
Mkaymkay,drakthul,192,hunter,beastmastery,6,2,4
Arykes,drakthul,192,hunter,beastmastery,6,2,4
Zetaph,argent-dawn,192,hunter,beastmastery,6,2,4
Exæquo,archimonde,192,hunter,beastmastery,6,2,4
Фломидзе,gordunni,192,hunter,beastmastery,6,2,4
Wolfariana,chamber-of-aspects,192,hunter,beastmastery,6,2,4
Солевойбалон,gordunni,192,hunter,beastmastery,6,2,4
Clawy,auchindoun,192,hunter,beastmastery,6,2,4
Bradockk,blackrock,192,hunter,beastmastery,6,2,4
Sanjji,kazzak,192,hunter,beastmastery,6,2,4
Bøømshøtkill,blackrock,192,hunter,beastmastery,6,2,4
Progh,ragnaros,192,hunter,beastmastery,6,2,4
Фанатшла,gordunni,192,hunter,beastmastery,6,2,4
Килофвратх,gordunni,192,hunter,beastmastery,6,2,4
Dahunter,blackmoore,192,hunter,beastmastery,6,2,4
Yakayoshi,kazzak,192,hunter,beastmastery,6,2,4
Gandro,blackmoore,192,hunter,beastmastery,6,2,4
Жабра,gordunni,192,hunter,beastmastery,11,3,8
Shockzzyyh,ravencrest,192,hunter,beastmastery,9,2,7
Куджикс,soulflayer,192,hunter,beastmastery,19,4,15
Chillyourbon,ravencrest,192,hunter,beastmastery,12,2,10
Tyronjr,tarren-mill,192,hunter,beastmastery,12,2,10
Willýs,ysondre,192,hunter,beastmastery,12,2,10
Dorakor,ysondre,192,hunter,beastmastery,12,2,10
Zulkhan,nemesis,192,hunter,beastmastery,12,2,10
Calesthas,tarren-mill,192,hunter,beastmastery,12,2,10
Vadász,chamber-of-aspects,192,hunter,beastmastery,12,2,10
Schräubchen,antonidas,192,hunter,beastmastery,12,2,10
Saskatchewan,dun-modr,192,hunter,beastmastery,12,2,10
Elja,laughing-skull,192,hunter,beastmastery,12,2,10
Anhyzer,nemesis,192,hunter,beastmastery,12,2,10
Фомкалол,howling-fjord,192,hunter,beastmastery,12,2,10
Jeddaj,stormscale,192,hunter,beastmastery,12,2,10
Bloodking,madmortem,192,hunter,beastmastery,12,2,10
Bullebank,kazzak,192,hunter,beastmastery,12,2,10
Bleidarabm,silvermoon,192,hunter,beastmastery,12,2,10
Waraëlle,dalaran,192,hunter,beastmastery,12,2,10
Samodiva,twisting-nether,192,hunter,beastmastery,12,2,10
Pôîson,kazzak,192,hunter,beastmastery,12,2,10
Pasiõra,archimonde,192,hunter,beastmastery,18,2,16
Sërennà,chogall,192,hunter,beastmastery,18,2,16
Дальняя,soulflayer,192,hunter,beastmastery,18,2,16
Сыньйорита,howling-fjord,192,hunter,beastmastery,18,2,16
Slayman,kazzak,192,hunter,beastmastery,18,2,16
Ayda,zuljin,192,hunter,beastmastery,18,2,16
Ukkô,eredar,192,hunter,beastmastery,18,2,16
Myplague,darkmoon-faire,191,hunter,beastmastery,6,2,4
Charlet,archimonde,191,hunter,beastmastery,6,2,4
Сливочкии,goldrinn,191,hunter,beastmastery,6,2,4
Sylvíke,ragnaros,191,hunter,beastmastery,6,2,4
Kizscamander,magtheridon,191,hunter,beastmastery,12,2,10
Aewena,hyjal,190,hunter,beastmastery,12,2,10
Cucumbert,antonidas,190,hunter,beastmastery,12,2,10
Ônixpt,aggra-português,190,hunter,beastmastery,14,2,12
Trïsha,stormscale,180,hunter,beastmastery,17,6,11
Ozunâ,blackmoore,168,hunter,beastmastery,25,8,17
Ripulianneli,stormscale,159,hunter,beastmastery,6,3,3
Carru,blackrock,159,hunter,beastmastery,5,2,3
Dolwen,argent-dawn,159,hunter,beastmastery,5,2,3
Deuteríum,outland,159,hunter,beastmastery,5,2,3
Beastfather,twilights-hammer,159,hunter,beastmastery,5,2,3
Kalashnikov,onyxia,159,hunter,beastmastery,5,2,3
Rakmo,blackmoore,159,hunter,beastmastery,5,2,3
Сталька,blackscar,159,hunter,beastmastery,7,2,5
Phinox,sanguino,159,hunter,beastmastery,11,2,9
Cadier,argent-dawn,144,hunter,beastmastery,3,3,0
Gilgämesh,hyjal,138,hunter,beastmastery,9,4,5
Hakaîí,aegwynn,138,hunter,beastmastery,10,4,6
Tanteaab,blackmoore,138,hunter,beastmastery,11,4,7
Kobrán,gilneas,138,hunter,beastmastery,9,3,6
Kauli,turalyon,138,hunter,beastmastery,15,3,12
Elnazar,archimonde,128,hunter,beastmastery,4,2,2
Deathøfrats,ravencrest,128,hunter,beastmastery,4,2,2
Иттириса,gordunni,128,hunter,beastmastery,4,2,2
Bobihunt,argent-dawn,128,hunter,beastmastery,4,2,2
Laiguutan,blackmoore,128,hunter,beastmastery,4,2,2
Liscie,silvermoon,105,hunter,beastmastery,16,4,12
Derhùnethàl,hyjal,96,hunter,beastmastery,6,1,5
Rayana,garrosh,96,hunter,beastmastery,6,1,5
Anun,magtheridon,96,hunter,beastmastery,6,1,5
Masimo,emerald-dream,96,hunter,beastmastery,6,1,5
Xåndra,sylvanas,96,hunter,beastmastery,6,1,5
Ichbringbier,blackrock,96,hunter,beastmastery,6,1,5
Zurzok,blackrock,96,hunter,beastmastery,6,1,5
Hiddenstalk,outland,96,hunter,beastmastery,6,1,5
Сочнаятурель,howling-fjord,96,hunter,beastmastery,6,1,5
Syjinny,kazzak,96,hunter,beastmastery,6,1,5
Фекаладочка,howling-fjord,96,hunter,beastmastery,6,1,5
Deathtime,sanguino,96,hunter,beastmastery,6,1,5
Buoma,kazzak,96,hunter,beastmastery,6,1,5
Foxhunt,turalyon,96,hunter,beastmastery,6,1,5
Hashaya,hyjal,96,hunter,beastmastery,6,1,5
Warthugg,khaz-modan,96,hunter,beastmastery,6,1,5
Bowlox,kazzak,96,hunter,beastmastery,6,1,5
Drolarin,zuljin,96,hunter,beastmastery,6,1,5
Speedofpain,kazzak,96,hunter,beastmastery,6,1,5
Bloodfallen,onyxia,96,hunter,beastmastery,6,1,5
Airelina,kazzak,96,hunter,beastmastery,6,1,5
Babyfart,terenas,96,hunter,beastmastery,6,1,5
Exorbitant,blackrock,96,hunter,beastmastery,6,1,5
Platano,hyjal,96,hunter,beastmastery,6,1,5
Táráh,proudmoore,96,hunter,beastmastery,6,1,5
Rîsas,draenor,96,hunter,beastmastery,6,1,5
Noxxo,blackmoore,96,hunter,beastmastery,6,1,5
Huntze,kazzak,96,hunter,beastmastery,6,1,5
Dubtrap,blackmoore,96,hunter,beastmastery,6,1,5
Zogzøg,draenor,96,hunter,beastmastery,6,1,5
Hechozar,kazzak,96,hunter,beastmastery,6,1,5
Börjeson,ragnaros,96,hunter,beastmastery,6,1,5
Jackson,blackmoore,96,hunter,beastmastery,6,1,5
Béanz,blackmoore,96,hunter,beastmastery,6,1,5
Weafster,outland,96,hunter,beastmastery,6,1,5
Nomorex,frostwhisper,96,hunter,beastmastery,6,1,5
Justchill,ravencrest,96,hunter,beastmastery,6,1,5
Fizí,stormscale,96,hunter,beastmastery,6,1,5
Breidy,dun-modr,96,hunter,beastmastery,6,1,5
Jägerjokke,blackrock,96,hunter,beastmastery,6,1,5
Stfú,aegwynn,96,hunter,beastmastery,6,1,5
Artdragon,burning-legion,96,hunter,beastmastery,6,1,5
Maticshorter,blackmoore,96,hunter,beastmastery,6,1,5
Koraag,culte-de-la-rive-noire,96,hunter,beastmastery,6,1,5
Traptard,blackrock,96,hunter,beastmastery,6,1,5
Jakuken,dun-modr,96,hunter,beastmastery,6,1,5
Qeav,stormscale,96,hunter,beastmastery,6,1,5
Øô,blackrock,96,hunter,beastmastery,6,1,5
Doojas,archimonde,96,hunter,beastmastery,6,1,5
Hÿyrøk,ysondre,96,hunter,beastmastery,6,1,5
Opasan,nordrassil,96,hunter,beastmastery,6,1,5
Boudicok,archimonde,96,hunter,beastmastery,6,1,5
Золларис,deathguard,96,hunter,beastmastery,6,1,5
Hairyplottér,kazzak,96,hunter,beastmastery,6,1,5
Дочьпескова,gordunni,96,hunter,beastmastery,6,1,5
Nmrd,archimonde,96,hunter,beastmastery,6,1,5
Ríse,blackhand,96,hunter,beastmastery,6,1,5
Темикс,ashenvale,96,hunter,beastmastery,6,1,5
Clownchef,blackhand,96,hunter,beastmastery,6,1,5
Оркистор,eversong,96,hunter,beastmastery,6,1,5
Sláynôs,blackrock,96,hunter,beastmastery,6,1,5
Furheious,archimonde,96,hunter,beastmastery,6,1,5
Bensoussan,archimonde,96,hunter,beastmastery,6,1,5
Hntrix,grim-batol,96,hunter,beastmastery,6,1,5
Imahuntard,frostmane,96,hunter,beastmastery,6,1,5
Wórldz,dun-modr,96,hunter,beastmastery,6,1,5
Valiriz,blackmoore,96,hunter,beastmastery,6,1,5
Wideshut,eldrethalas,96,hunter,beastmastery,6,1,5
Vérfarkas,arathor,96,hunter,beastmastery,6,1,5
Луврен,deepholm,96,hunter,beastmastery,6,1,5
Deneja,kilrogg,96,hunter,beastmastery,6,1,5
Târâx,blackmoore,96,hunter,beastmastery,6,1,5
Loquenahak,grim-batol,96,hunter,beastmastery,6,1,5
Achiles,die-todeskrallen,96,hunter,beastmastery,6,1,5
Левери,gordunni,96,hunter,beastmastery,6,1,5
Буреклык,gordunni,96,hunter,beastmastery,6,1,5
Dugini,ravencrest,96,hunter,beastmastery,6,1,5
Shyla,anubarak,96,hunter,beastmastery,6,1,5
Furiouslao,eredar,96,hunter,beastmastery,6,1,5
Nicoh,elune,96,hunter,beastmastery,6,1,5
Xilo,eredar,96,hunter,beastmastery,6,1,5
Oneshotbaby,archimonde,96,hunter,beastmastery,6,1,5
Turtíe,argent-dawn,96,hunter,beastmastery,6,1,5
Hafarian,the-maelstrom,96,hunter,beastmastery,6,1,5
Ventaric,pozzo-delleternità,96,hunter,beastmastery,6,1,5
Gabrriel,ravencrest,96,hunter,beastmastery,6,1,5
Zugzlug,tarren-mill,96,hunter,beastmastery,6,1,5
Wræqraxx,ravencrest,96,hunter,beastmastery,6,1,5
Пиппиракон,soulflayer,96,hunter,beastmastery,6,1,5
Betarayjinx,kazzak,96,hunter,beastmastery,6,1,5
Craisax,nemesis,96,hunter,beastmastery,6,1,5
Hntudwn,azshara,96,hunter,beastmastery,6,1,5
Grutoss,eredar,96,hunter,beastmastery,6,1,5
Darkray,dalaran,96,hunter,beastmastery,6,1,5
Teedfredd,tarren-mill,96,hunter,beastmastery,6,1,5
Oneclickaway,tarren-mill,96,hunter,beastmastery,6,1,5
Травмаопасен,gordunni,96,hunter,beastmastery,6,1,5
Noxll,gorgonnash,96,hunter,beastmastery,6,1,5
Carrilynn,blackrock,96,hunter,beastmastery,6,1,5
Перидот,howling-fjord,96,hunter,beastmastery,6,1,5
Koróth,tarren-mill,96,hunter,beastmastery,6,1,5
Jozsiur,ragnaros,96,hunter,beastmastery,6,1,5
Zelesrian,twisting-nether,96,hunter,beastmastery,6,1,5
Настякобра,blackscar,96,hunter,beastmastery,6,1,5
Gurkans,aggramar,96,hunter,beastmastery,6,1,5
Billythree,argent-dawn,96,hunter,beastmastery,6,1,5
Вкинулматрас,gordunni,96,hunter,beastmastery,6,1,5
Ройзх,gordunni,96,hunter,beastmastery,6,1,5
Фредодопицца,gordunni,96,hunter,beastmastery,6,1,5
Leviaa,argent-dawn,96,hunter,beastmastery,6,1,5
Fakepvper,darksorrow,96,hunter,beastmastery,6,1,5
Imthatbtch,argent-dawn,96,hunter,beastmastery,6,1,5
Zergst,nathrezim,96,hunter,beastmastery,6,1,5
Odenssbest,silvermoon,96,hunter,beastmastery,6,1,5
Jackdaniéls,twisting-nether,96,hunter,beastmastery,6,1,5
Runescimmy,twisting-nether,96,hunter,beastmastery,6,1,5
Oou,auchindoun,96,hunter,beastmastery,6,1,5
Rezà,thrall,96,hunter,beastmastery,6,1,5
Dasmusdrückn,antonidas,96,hunter,beastmastery,6,1,5
Mistledove,lightbringer,96,hunter,beastmastery,12,1,11
Schmaikell,blackmoore,96,hunter,beastmastery,12,1,11
Patjuh,silvermoon,96,hunter,beastmastery,12,1,11
Arthass,die-aldor,96,hunter,beastmastery,12,1,11
Críted,blackmoore,96,hunter,beastmastery,12,1,11
Tsyapka,tarren-mill,96,hunter,beastmastery,12,1,11
Детмазай,soulflayer,96,hunter,beastmastery,12,1,11
Vandathien,stormrage,96,hunter,beastmastery,12,1,11
Plagktos,conseil-des-ombres,96,hunter,beastmastery,12,1,11
Thóorin,ravencrest,96,hunter,beastmastery,12,1,11
Lardobrave,blackhand,96,hunter,beastmastery,12,1,11
Лиасон,howling-fjord,96,hunter,beastmastery,12,1,11
Enfaktüs,silvermoon,96,hunter,beastmastery,12,1,11
Johnnygnus,drakthul,96,hunter,beastmastery,12,1,11
Milandria,antonidas,96,hunter,beastmastery,18,1,17
Бусюлька,gordunni,95,hunter,beastmastery,18,1,17
Beentrill,kazzak,79,hunter,beastmastery,5,1,4
Халфен,eversong,79,hunter,beastmastery,5,1,4
Youngjinh,ravencrest,64,hunter,beastmastery,4,1,3
Acuatropatas,sanguino,64,hunter,beastmastery,4,1,3
Yahamenistos,ysondre,64,hunter,beastmastery,4,1,3
Quiarà,elune,64,hunter,beastmastery,4,1,3
Currahee,kirin-tor,64,hunter,beastmastery,4,1,3
Flaregodx,twisting-nether,64,hunter,beastmastery,4,1,3
Illnysa,silvermoon,48,hunter,beastmastery,3,1,2
Huggiwuggi,tarren-mill,48,hunter,beastmastery,3,1,2
Графруру,soulflayer,48,hunter,beastmastery,3,1,2
Qqc,burning-legion,48,hunter,beastmastery,3,1,2
Æxinora,antonidas,42,hunter,beastmastery,8,2,6
Jamestráp,dun-morogh,42,hunter,beastmastery,9,2,7
Ржавченко,soulflayer,42,hunter,beastmastery,9,2,7
Тхойне,gordunni,42,hunter,beastmastery,10,2,8
Melloy,drakthul,31,hunter,beastmastery,2,1,1
Котюнечка,gordunni,31,hunter,beastmastery,2,1,1
Rockymarciaa,dalaran,31,hunter,beastmastery,2,1,1
Khâñ,kazzak,31,hunter,beastmastery,2,1,1
Martuk,aegwynn,31,hunter,beastmastery,2,1,1
Plaýs,outland,16,hunter,beastmastery,1,1,0
Apolix,ragnaros,16,hunter,beastmastery,1,1,0
Vethan,die-aldor,16,hunter,beastmastery,7,1,6
Gwaan,outland,9,hunter,beastmastery,6,2,4
Млдбоярин,gordunni,2180,mage,arcane,72,41,31
Макотшельник,gordunni,2163,mage,arcane,72,47,25
Boogeymanx,ravencrest,2052,mage,arcane,180,100,80
Проблембойх,gordunni,2024,mage,arcane,134,63,71
Cubis,archimonde,2022,mage,arcane,156,77,79
Aleteia,stormscale,1998,mage,arcane,228,114,114
Waterhagx,tarren-mill,1976,mage,arcane,71,49,22
Serctheone,ravencrest,1971,mage,arcane,69,35,34
Aleç,ravencrest,1971,mage,arcane,66,33,33
Magegôd,outland,1969,mage,arcane,81,44,37
Ånei,ravencrest,1903,mage,arcane,78,44,34
Tiqma,sylvanas,1868,mage,arcane,185,93,92
Choll,stormscale,1866,mage,arcane,30,20,10
Фоулли,howling-fjord,1864,mage,arcane,82,40,42
Бигдикмаг,soulflayer,1852,mage,arcane,107,52,55
Wàneís,ravencrest,1843,mage,arcane,78,38,40
Ephreaym,stormscale,1824,mage,arcane,207,103,104
Castorcato,kazzak,1823,mage,arcane,102,53,49
Obbcontrol,ravencrest,1820,mage,arcane,84,45,39
Нефростмаг,gordunni,1813,mage,arcane,336,171,165
Belthesad,twisting-nether,1806,mage,arcane,62,42,20
Lemaroxd,draenor,1801,mage,arcane,59,33,26
Nvpk,blackrock,1785,mage,arcane,84,46,38
Sallesauruus,outland,1785,mage,arcane,238,121,117
Tokerlol,stormscale,1780,mage,arcane,227,124,103
Рбгпотаскуха,gordunni,1777,mage,arcane,36,26,10
Wizpiz,kazzak,1766,mage,arcane,36,24,12
Hachiro,onyxia,1764,mage,arcane,96,49,47
Jînexo,shattrath,1748,mage,arcane,70,35,35
Uskomaaginen,ravencrest,1748,mage,arcane,77,37,40
Magijoana,silvermoon,1745,mage,arcane,50,26,24
Frostseeker,tarren-mill,1734,mage,arcane,84,45,39
Bebenm,archimonde,1727,mage,arcane,206,96,110
Derett,stormscale,1725,mage,arcane,48,22,26
Raíku,ravencrest,1723,mage,arcane,30,18,12
Sÿmera,dun-modr,1721,mage,arcane,103,51,52
Непутевыймаг,gordunni,1715,mage,arcane,24,23,1
Covran,stormscale,1715,mage,arcane,101,49,52
Mercem,stormscale,1711,mage,arcane,30,21,9
Abóve,outland,1707,mage,arcane,24,18,6
Dárdie,ravencrest,1697,mage,arcane,52,26,26
Wracrz,argent-dawn,1696,mage,arcane,114,61,53
Alustrasz,skullcrusher,1693,mage,arcane,155,85,70
Shirrunn,the-maelstrom,1687,mage,arcane,38,19,19
Ecovation,tarren-mill,1685,mage,arcane,133,72,61
Dardíe,ravencrest,1681,mage,arcane,54,31,23
Barbeuqxo,garona,1675,mage,arcane,191,100,91
Сизаам,howling-fjord,1667,mage,arcane,158,83,75
Fearbeäch,ravencrest,1666,mage,arcane,52,25,27
Ziao,outland,1660,mage,arcane,198,99,99
Breezzme,twisting-nether,1657,mage,arcane,84,40,44
Zischacetate,ravencrest,1653,mage,arcane,35,24,11
Astrryy,burning-legion,1650,mage,arcane,41,19,22
Uknowhowwedu,blackrock,1649,mage,arcane,36,22,14
Absie,tarren-mill,1645,mage,arcane,149,87,62
Димаскунфу,howling-fjord,1640,mage,arcane,154,76,78
Nelg,silvermoon,1635,mage,arcane,72,46,26
Bullegong,archimonde,1633,mage,arcane,72,38,34
Sérc,ravencrest,1626,mage,arcane,30,17,13
Медивера,gordunni,1622,mage,arcane,24,17,7
Orkamor,sylvanas,1622,mage,arcane,42,17,25
Jatha,turalyon,1619,mage,arcane,136,72,64
Burstology,kazzak,1612,mage,arcane,245,123,122
Barbeuqx,garona,1600,mage,arcane,344,176,168
Scoopssama,ravencrest,1598,mage,arcane,90,42,48
Фемна,soulflayer,1589,mage,arcane,111,55,56
Папущенный,soulflayer,1585,mage,arcane,187,89,98
Persi,dentarg,1582,mage,arcane,311,152,159
Vxvfrowstxvx,jaedenar,1579,mage,arcane,90,49,41
Liga,outland,1563,mage,arcane,23,17,6
Frostandrew,twisting-nether,1563,mage,arcane,42,27,15
Helloimgone,blackmoore,1550,mage,arcane,66,31,35
Radiantfury,outland,1533,mage,arcane,30,17,13
Shiranize,aegwynn,1528,mage,arcane,144,68,76
Inaruy,hyjal,1524,mage,arcane,47,25,22
Antaos,drakthul,1523,mage,arcane,222,117,105
Meløs,blackmoore,1522,mage,arcane,39,22,17
Манкай,fordragon,1514,mage,arcane,432,224,208
Ekelkreatur,blackmoore,1501,mage,arcane,30,22,8
Vaerén,malganis,1495,mage,arcane,55,32,23
Jukedstreet,outland,1493,mage,arcane,42,18,24
Råståfåri,uldum,1490,mage,arcane,107,60,47
Poochmage,archimonde,1488,mage,arcane,90,42,48
Samirra,stormscale,1487,mage,arcane,72,38,34
Nakamura,outland,1486,mage,arcane,344,171,173
Ekron,sanguino,1483,mage,arcane,737,371,366
Blinked,eredar,1481,mage,arcane,53,32,21
Xÿv,azshara,1467,mage,arcane,33,17,16
Portal,scarshield-legion,1459,mage,arcane,91,49,42
Десскельтер,deathguard,1454,mage,arcane,274,142,132
Akâri,silvermoon,1451,mage,arcane,119,68,51
Ahstin,teldrassil,1444,mage,arcane,24,18,6
Gypsymagic,doomhammer,1439,mage,arcane,154,76,78
Kudakto,ravencrest,1437,mage,arcane,42,15,27
Раканчик,gordunni,1434,mage,arcane,92,46,46
Манаманна,gordunni,1433,mage,arcane,1110,562,548
Ðøæø,twisting-nether,1433,mage,arcane,111,54,57
Ranyl,shattrath,1432,mage,arcane,30,15,15
Aristarco,outland,1426,mage,arcane,171,85,86
Даанрен,galakrond,1425,mage,arcane,60,25,35
Ogarcanefist,outland,1424,mage,arcane,69,35,34
Sapien,sanguino,1422,mage,arcane,88,40,48
Jhawkwizard,draenor,1421,mage,arcane,324,167,157
Scaleeth,kazzak,1418,mage,arcane,42,17,25
Nelluc,turalyon,1417,mage,arcane,74,40,34
Jayhó,outland,1411,mage,arcane,54,28,26
Sukalamink,alonsus,1405,mage,arcane,48,22,26
Faxchungus,argent-dawn,1401,mage,arcane,54,34,20
Aloxigozal,shendralar,1400,mage,arcane,24,17,7
Аненази,goldrinn,1400,mage,arcane,30,16,14
Techies,archimonde,1397,mage,arcane,24,15,9
Tokyodes,twisting-nether,1397,mage,arcane,338,174,164
Elor,eredar,1389,mage,arcane,69,36,33
Magikere,tarren-mill,1384,mage,arcane,131,76,55
Gravehagx,ravencrest,1381,mage,arcane,21,15,6
Barspin,lightnings-blade,1381,mage,arcane,207,107,100
Arkeus,turalyon,1380,mage,arcane,113,65,48
Diper,burning-legion,1379,mage,arcane,41,18,23
Rmnzr,blackrock,1377,mage,arcane,48,19,29
Másterdukè,silvermoon,1374,mage,arcane,199,94,105
Rayniß,blackmoore,1370,mage,arcane,30,17,13
Calientay,ragnaros,1366,mage,arcane,47,21,26
Lusionator,defias-brotherhood,1365,mage,arcane,60,33,27
Azuredragon,tarren-mill,1361,mage,arcane,61,30,31
Leanboy,dun-modr,1353,mage,arcane,55,24,31
Angryalways,stormscale,1350,mage,arcane,32,16,16
Hâplo,burning-legion,1348,mage,arcane,98,54,44
Wanrltw,ragnaros,1338,mage,arcane,30,14,16
Sszz,ravencrest,1335,mage,arcane,257,139,118
Trucy,eredar,1332,mage,arcane,186,88,98
Nefrendel,kazzak,1327,mage,arcane,133,67,66
Tnhigh,blackrock,1325,mage,arcane,81,42,39
Fadi,anachronos,1325,mage,arcane,30,14,16
Krykz,sanguino,1321,mage,arcane,60,26,34
Xiaomofashi,quelthalas,1320,mage,arcane,240,123,117
Ímnotback,outland,1319,mage,arcane,282,140,142
Aeghis,darkspear,1318,mage,arcane,30,15,15
Kaelasha,magtheridon,1314,mage,arcane,42,18,24
Mannenye,stormscale,1306,mage,arcane,47,17,30
Paradigma,sylvanas,1305,mage,arcane,30,14,16
Kazeen,silvermoon,1292,mage,arcane,106,60,46
Mäalaka,archimonde,1289,mage,arcane,42,16,26
Pradapimp,ravencrest,1286,mage,arcane,32,15,17
Nimdáá,stormscale,1286,mage,arcane,54,24,30
Bananflickan,kazzak,1285,mage,arcane,198,108,90
Venchimage,silvermoon,1284,mage,arcane,62,26,36
Spicymash,chogall,1275,mage,arcane,30,16,14
Estelliên,burning-legion,1273,mage,arcane,27,14,13
Весиал,deathguard,1262,mage,arcane,189,96,93
Валбериса,deepholm,1259,mage,arcane,83,49,34
Альтанис,howling-fjord,1258,mage,arcane,39,15,24
Säga,the-venture-co,1254,mage,arcane,177,86,91
Sydrel,ragnaros,1253,mage,arcane,48,25,23
Tiamorg,drakthul,1248,mage,arcane,23,14,9
Moxine,la-croisade-écarlate,1247,mage,arcane,95,44,51
Sadrã,kazzak,1247,mage,arcane,69,30,39
Яшабурстх,blackscar,1246,mage,arcane,30,13,17
Angélique,ragnaros,1244,mage,arcane,84,40,44
Oreog,ravencrest,1243,mage,arcane,36,13,23
Toshoin,defias-brotherhood,1240,mage,arcane,24,13,11
Nécrømage,confrérie-du-thorium,1235,mage,arcane,18,13,5
Gnarrly,tarren-mill,1235,mage,arcane,27,13,14
Æones,kult-der-verdammten,1233,mage,arcane,36,13,23
Beardmorph,auchindoun,1232,mage,arcane,47,19,28
Ozdewish,hyjal,1230,mage,arcane,159,77,82
Pearbear,argent-dawn,1222,mage,arcane,29,15,14
Канеллис,howling-fjord,1219,mage,arcane,49,20,29
Айсъмэджик,azuregos,1218,mage,arcane,149,72,77
Hardways,archimonde,1214,mage,arcane,405,197,208
Nïo,ravencrest,1199,mage,arcane,116,47,69
Hruon,ravenholdt,1195,mage,arcane,30,14,16
Kobrass,spinebreaker,1194,mage,arcane,85,36,49
Kuhbi,blackrock,1188,mage,arcane,72,33,39
Romethito,dun-modr,1186,mage,arcane,62,29,33
Noarcane,twisting-nether,1185,mage,arcane,183,98,85
Iwannakissu,gorgonnash,1184,mage,arcane,231,121,110
Meolchum,outland,1180,mage,arcane,51,23,28
Léa,rashgarroth,1175,mage,arcane,72,31,41
Нормалмап,soulflayer,1174,mage,arcane,72,27,45
Darmie,burning-legion,1167,mage,arcane,173,77,96
Clappycheeks,antonidas,1162,mage,arcane,66,25,41
Динэй,blackscar,1161,mage,arcane,30,16,14
Nelfchewer,ravencrest,1160,mage,arcane,29,13,16
Scaless,stormscale,1157,mage,arcane,52,19,33
Sulteaxion,garrosh,1154,mage,arcane,36,19,17
Demizboub,archimonde,1154,mage,arcane,168,85,83
Knúbbz,ravencrest,1147,mage,arcane,36,12,24
Minglul,archimonde,1142,mage,arcane,24,12,12
Arcanik,archimonde,1140,mage,arcane,68,29,39
Plor,exodar,1133,mage,arcane,38,21,17
Khadgia,argent-dawn,1126,mage,arcane,24,12,12
Zezt,tarren-mill,1109,mage,arcane,66,27,39
Icx,tarren-mill,1107,mage,arcane,61,34,27
Rezre,stormscale,1107,mage,arcane,125,60,65
Malshash,outland,1100,mage,arcane,42,21,21
Вадимодесса,soulflayer,1099,mage,arcane,113,62,51
Shedooxwrtx,antonidas,1092,mage,arcane,63,23,40
Oao,chamber-of-aspects,1081,mage,arcane,67,26,41
Netomb,kazzak,1080,mage,arcane,30,20,10
Antïsocïal,hyjal,1076,mage,arcane,84,41,43
Vaelwin,argent-dawn,1074,mage,arcane,65,31,34
Fôôxy,aegwynn,1059,mage,arcane,36,16,20
Elvesnomage,sylvanas,1057,mage,arcane,134,64,70
Kilstine,outland,1056,mage,arcane,30,12,18
Mëgu,silvermoon,1050,mage,arcane,68,33,35
Soulraider,tarren-mill,1050,mage,arcane,24,11,13
Дантрий,gordunni,1045,mage,arcane,42,24,18
Sosîbîos,blackmoore,1044,mage,arcane,60,34,26
Corlys,defias-brotherhood,1043,mage,arcane,24,15,9
Roulettefar,kazzak,1038,mage,arcane,24,11,13
Gorn,ravencrest,1035,mage,arcane,84,42,42
Burnqq,twisting-nether,1024,mage,arcane,157,76,81
Ihatemages,stormreaver,1002,mage,arcane,105,44,61
Sarjeta,grim-batol,1000,mage,arcane,42,16,26
Magitis,blackhand,995,mage,arcane,54,14,40
Mylord,bronze-dragonflight,993,mage,arcane,53,21,32
Кронни,razuvious,979,mage,arcane,23,11,12
Сморгонец,gordunni,962,mage,arcane,32,14,18
Banjó,twilights-hammer,959,mage,arcane,12,10,2
Arcticfury,ravencrest,959,mage,arcane,18,10,8
Исусина,borean-tundra,959,mage,arcane,54,28,26
Magiwan,silvermoon,959,mage,arcane,30,10,20
Jamzymage,emerald-dream,958,mage,arcane,15,11,4
Chrome,ysondre,957,mage,arcane,24,10,14
Niulita,outland,956,mage,arcane,18,10,8
Remantin,blackrock,956,mage,arcane,24,10,14
Иссэя,borean-tundra,954,mage,arcane,37,21,16
Чобон,soulflayer,952,mage,arcane,30,10,20
Дырявка,galakrond,949,mage,arcane,30,10,20
Alaryeth,chamber-of-aspects,948,mage,arcane,82,38,44
Sollemage,kazzak,942,mage,arcane,30,10,20
Brugg,antonidas,915,mage,arcane,30,15,15
Frostdeath,medivh,906,mage,arcane,24,10,14
Êigul,blackrock,894,mage,arcane,26,10,16
Puni,emerald-dream,864,mage,arcane,12,9,3
Uknowhowwedu,aegwynn,864,mage,arcane,12,9,3
Fuhry,tarren-mill,864,mage,arcane,12,9,3
Thegoodoctor,kazzak,864,mage,arcane,18,9,9
Letsa,stormscale,863,mage,arcane,12,9,3
Arcann,ravencrest,863,mage,arcane,18,9,9
Superduck,ragnaros,863,mage,arcane,24,9,15
Roughfked,silvermoon,862,mage,arcane,150,75,75
Médivh,archimonde,862,mage,arcane,18,9,9
Mðj,kazzak,862,mage,arcane,24,9,15
Zorqi,argent-dawn,860,mage,arcane,12,9,3
Julieliphie,silvermoon,860,mage,arcane,24,9,15
Caesarclown,silvermoon,857,mage,arcane,27,10,17
Neséri,blackmoore,855,mage,arcane,46,18,28
Kaevelin,argent-dawn,852,mage,arcane,24,9,15
Odor,haomarush,846,mage,arcane,54,26,28
Merlïne,les-clairvoyants,838,mage,arcane,72,31,41
Modjahead,tarren-mill,822,mage,arcane,29,9,20
Mageé,argent-dawn,807,mage,arcane,23,9,14
Bogher,pozzo-delleternità,799,mage,arcane,24,10,14
Diaflash,silvermoon,779,mage,arcane,76,31,45
Syltris,drakthul,771,mage,arcane,123,51,72
Zimbabweborc,burning-legion,768,mage,arcane,12,8,4
Moocan,twisting-nether,768,mage,arcane,12,8,4
Zehnvonzehn,antonidas,767,mage,arcane,18,8,10
Isralysa,ravencrest,767,mage,arcane,24,8,16
Bigbudda,hyjal,766,mage,arcane,12,8,4
Dudè,azshara,766,mage,arcane,18,8,10
Jambonpistol,archimonde,764,mage,arcane,24,8,16
Datamaster,burning-blade,761,mage,arcane,24,8,16
Tarryxa,kazzak,760,mage,arcane,18,8,10
Frendor,turalyon,753,mage,arcane,36,11,25
Phyzed,archimonde,735,mage,arcane,17,8,9
Sticlachivas,stormscale,730,mage,arcane,23,8,15
Dcolon,tarren-mill,719,mage,arcane,17,8,9
Зухвала,howling-fjord,708,mage,arcane,41,12,29
Pyroden,stormscale,700,mage,arcane,20,8,12
Seraf,argent-dawn,688,mage,arcane,25,8,17
Manafuzz,outland,672,mage,arcane,12,7,5
Aletheía,stormscale,672,mage,arcane,12,7,5
Jengele,argent-dawn,672,mage,arcane,12,7,5
Doryy,silvermoon,672,mage,arcane,12,7,5
Pizwiz,kazzak,672,mage,arcane,16,8,8
Ignyx,ragnaros,672,mage,arcane,24,7,17
Soulkinq,blackmoore,672,mage,arcane,24,7,17
Nötmârtònxø,ragnaros,671,mage,arcane,12,7,5
Adetin,tarren-mill,671,mage,arcane,12,7,5
Spellfolk,burning-legion,671,mage,arcane,18,7,11
Shockólot,outland,671,mage,arcane,24,7,17
Мистркорбэн,soulflayer,670,mage,arcane,12,7,5
Falzao,ravencrest,670,mage,arcane,12,7,5
Thorstäin,ragnaros,670,mage,arcane,18,7,11
Itzlucky,twisting-nether,670,mage,arcane,18,7,11
Mortlol,chamber-of-aspects,667,mage,arcane,18,7,11
Milton,dunemaul,666,mage,arcane,30,7,23
Schiattacap,doomhammer,663,mage,arcane,90,15,75
Morphous,eonar,648,mage,arcane,18,7,11
Roslinda,outland,641,mage,arcane,18,7,11
Nàtcho,tichondrius,623,mage,arcane,11,7,4
Nergl,darksorrow,623,mage,arcane,27,7,20
Xue,azshara,576,mage,arcane,6,6,0
Sheepthroat,forscherliga,576,mage,arcane,6,6,0
Pyllymake,kazzak,576,mage,arcane,12,6,6
Ãshs,archimonde,576,mage,arcane,12,6,6
Kold,stormscale,576,mage,arcane,12,6,6
Яайку,gordunni,576,mage,arcane,18,6,12
Meisterg,frostwolf,575,mage,arcane,9,7,2
Aod,chogall,575,mage,arcane,12,6,6
Mysticbeard,argent-dawn,575,mage,arcane,12,6,6
Shõrty,thrall,575,mage,arcane,12,6,6
Purrpl,twisting-nether,575,mage,arcane,12,6,6
Apc,sylvanas,575,mage,arcane,12,6,6
Tarovan,defias-brotherhood,575,mage,arcane,12,6,6
Карраско,soulflayer,575,mage,arcane,12,6,6
ßjwercke,stormscale,575,mage,arcane,18,6,12
Dareah,blackmoore,575,mage,arcane,18,6,12
Окости,howling-fjord,574,mage,arcane,12,6,6
Egirllover,hyjal,570,mage,arcane,21,6,15
Leil,die-todeskrallen,569,mage,arcane,24,6,18
Freshforces,ragnaros,553,mage,arcane,26,8,18
Héstia,sylvanas,544,mage,arcane,10,6,4
Sparrowixx,turalyon,537,mage,arcane,14,7,7
Línus,twisting-nether,480,mage,arcane,6,5,1
Tamtheone,frostwhisper,480,mage,arcane,6,5,1
Barryscótt,stormscale,480,mage,arcane,12,5,7
Magevnr,hyjal,480,mage,arcane,12,5,7
Pwntt,terenas,480,mage,arcane,12,5,7
Focusmage,outland,480,mage,arcane,12,5,7
Thamagus,burning-legion,480,mage,arcane,12,5,7
Alarak,drakthul,480,mage,arcane,12,5,7
Auchenax,argent-dawn,480,mage,arcane,12,5,7
Mupana,nagrand,480,mage,arcane,18,5,13
Киренка,gordunni,480,mage,arcane,18,5,13
Ледянойкекс,gordunni,480,mage,arcane,18,5,13
Ewina,twisting-nether,479,mage,arcane,6,5,1
Skankengine,twisting-nether,479,mage,arcane,6,5,1
Insømnium,stormscale,479,mage,arcane,12,5,7
Winterblues,frostmourne,479,mage,arcane,12,5,7
Dualin,sanguino,479,mage,arcane,18,5,13
Gripe,defias-brotherhood,478,mage,arcane,6,5,1
Reiggo,silvermoon,478,mage,arcane,9,6,3
Wizkhafury,ravencrest,384,mage,arcane,6,4,2
Thaldariel,blackmoore,384,mage,arcane,6,4,2
Эллестра,howling-fjord,384,mage,arcane,6,4,2
Harpelmage,auchindoun,384,mage,arcane,6,4,2
Hexmath,tarren-mill,384,mage,arcane,6,4,2
Ixv,stormscale,384,mage,arcane,6,4,2
Ccxz,draenor,384,mage,arcane,6,4,2
Trúkez,ragnaros,384,mage,arcane,6,4,2
Apollohouse,ravencrest,384,mage,arcane,6,4,2
Extracting,stormscale,384,mage,arcane,6,4,2
Rizzlybear,outland,384,mage,arcane,6,4,2
Yunox,stormscale,384,mage,arcane,6,4,2
Krispycreme,kazzak,384,mage,arcane,6,4,2
Мглавечная,azuregos,384,mage,arcane,6,4,2
Miine,ragnaros,384,mage,arcane,6,4,2
Plattyjoobs,draenor,384,mage,arcane,12,4,8
Boogeyone,drakthul,384,mage,arcane,12,4,8
Cysbb,arathi,384,mage,arcane,12,4,8
Uní,emerald-dream,384,mage,arcane,12,4,8
Zgnilakus,burning-legion,384,mage,arcane,12,4,8
Dambii,ravencrest,384,mage,arcane,12,4,8
Zoot,ravencrest,384,mage,arcane,12,4,8
Arimila,sylvanas,384,mage,arcane,12,4,8
Mikaelà,blackmoore,383,mage,arcane,6,4,2
Xèrec,ysondre,383,mage,arcane,6,4,2
Мюша,razuvious,382,mage,arcane,12,4,8
Khebu,anubarak,380,mage,arcane,12,4,8
Némmesis,zuljin,378,mage,arcane,12,4,8
Bigshape,frostwolf,351,mage,arcane,11,4,7
Sausage,chromaggus,330,mage,arcane,11,7,4
Ryalanna,silvermoon,313,mage,arcane,14,4,10
Roxolani,defias-brotherhood,303,mage,arcane,14,4,10
Datpyrotho,stormscale,288,mage,arcane,6,3,3
Choise,stormscale,288,mage,arcane,6,3,3
Núk,blackrock,288,mage,arcane,6,3,3
Euklid,ravencrest,288,mage,arcane,6,3,3
Bmbiscuit,ravencrest,288,mage,arcane,6,3,3
Gagaj,ravencrest,288,mage,arcane,6,3,3
Xirzy,silvermoon,288,mage,arcane,6,3,3
Keriios,sanguino,288,mage,arcane,6,3,3
Kyrn,zuljin,288,mage,arcane,6,3,3
Mylanq,ragnaros,288,mage,arcane,6,3,3
Euphorie,twisting-nether,288,mage,arcane,6,3,3
Szlay,blackmoore,288,mage,arcane,6,3,3
Havokh,blackmoore,288,mage,arcane,6,3,3
Rvca,shadowsong,288,mage,arcane,6,3,3
Khoshgele,draenor,288,mage,arcane,6,3,3
Seyece,silvermoon,288,mage,arcane,6,3,3
Suidas,auchindoun,288,mage,arcane,6,3,3
Takayaki,terokkar,288,mage,arcane,6,3,3
Zzpf,silvermoon,288,mage,arcane,6,3,3
Brokenlegman,defias-brotherhood,288,mage,arcane,6,3,3
Ovrpwrdxd,kazzak,288,mage,arcane,6,3,3
Astroknight,silvermoon,288,mage,arcane,6,3,3
Æskalatîøn,blackmoore,288,mage,arcane,6,3,3
Tìktokthot,outland,288,mage,arcane,6,3,3
Hógwarts,aegwynn,288,mage,arcane,6,3,3
Watchmeclick,archimonde,288,mage,arcane,6,3,3
Onlymage,outland,288,mage,arcane,6,3,3
Мактай,gordunni,288,mage,arcane,6,3,3
Колдрагос,gordunni,288,mage,arcane,6,3,3
Lesoleil,archimonde,288,mage,arcane,12,3,9
Sippebób,laughing-skull,288,mage,arcane,12,3,9
Schøkø,eredar,288,mage,arcane,12,3,9
Ionofrost,stormscale,288,mage,arcane,12,3,9
Noblockgødx,dun-modr,288,mage,arcane,12,3,9
Хблэйз,howling-fjord,288,mage,arcane,12,3,9
Эпсиха,lich-king,288,mage,arcane,18,3,15
Chimará,eredar,288,mage,arcane,18,3,15
Магборода,soulflayer,287,mage,arcane,6,3,3
Arcadua,sanguino,287,mage,arcane,6,3,3
Frökenfrost,stormscale,287,mage,arcane,6,3,3
Vaynes,stormscale,287,mage,arcane,6,3,3
Burnem,kult-der-verdammten,287,mage,arcane,6,3,3
Buttet,blackmoore,287,mage,arcane,18,3,15
Kasus,sporeggar,286,mage,arcane,6,3,3
Ivoc,drakthul,254,mage,arcane,11,3,8
Naween,hyjal,239,mage,arcane,5,3,2
Cris,azuremyst,239,mage,arcane,5,3,2
Rafixmag,chamber-of-aspects,238,mage,arcane,20,5,15
Kairøs,dragonblight,223,mage,arcane,16,3,13
Миднаит,gordunni,192,mage,arcane,6,2,4
Йяу,howling-fjord,192,mage,arcane,6,2,4
Соорка,gordunni,192,mage,arcane,6,2,4
Azoru,twisting-nether,192,mage,arcane,6,2,4
Partypower,twisting-nether,192,mage,arcane,6,2,4
Noxkin,stormscale,192,mage,arcane,6,2,4
Imbatto,quelthalas,192,mage,arcane,6,2,4
Nightplays,sylvanas,192,mage,arcane,6,2,4
Kjh,twisting-nether,192,mage,arcane,6,2,4
Галадриелька,gordunni,192,mage,arcane,6,2,4
Линклер,fordragon,192,mage,arcane,6,2,4
Kuhwar,echsenkessel,192,mage,arcane,6,2,4
Сонатра,howling-fjord,192,mage,arcane,6,2,4
Versachi,neptulon,192,mage,arcane,6,2,4
Mejtschazor,twisting-nether,192,mage,arcane,6,2,4
Spellonfire,ravencrest,192,mage,arcane,6,2,4
Lìx,ravencrest,192,mage,arcane,6,2,4
Capubell,nethersturm,192,mage,arcane,6,2,4
Bloodycast,archimonde,192,mage,arcane,6,2,4
Nerzzhul,burning-legion,192,mage,arcane,6,2,4
Génociidz,archimonde,192,mage,arcane,6,2,4
Леракобольд,gordunni,192,mage,arcane,6,2,4
Yungmago,ysondre,192,mage,arcane,6,2,4
Зерагуд,eversong,192,mage,arcane,6,2,4
Fàbious,ysondre,192,mage,arcane,6,2,4
Rommelo,ravencrest,192,mage,arcane,6,2,4
Ryûblast,archimonde,192,mage,arcane,6,2,4
Ashioth,argent-dawn,192,mage,arcane,6,2,4
Noviina,argent-dawn,192,mage,arcane,6,2,4
Naomypayton,tarren-mill,192,mage,arcane,6,2,4
Teeclis,twisting-nether,192,mage,arcane,6,2,4
Quaile,malygos,192,mage,arcane,6,2,4
Oorly,aegwynn,192,mage,arcane,6,2,4
Crinkles,laughing-skull,192,mage,arcane,6,2,4
Navolav,turalyon,192,mage,arcane,6,2,4
Rhodghar,ravencrest,192,mage,arcane,6,2,4
Hechicero,ravencrest,192,mage,arcane,6,2,4
Drinte,blackmoore,192,mage,arcane,6,2,4
Gôodgame,frostmane,192,mage,arcane,6,2,4
Sheeptowin,thrall,192,mage,arcane,6,2,4
Widepekka,ragnaros,192,mage,arcane,6,2,4
Kbd,outland,192,mage,arcane,6,2,4
Dramajohns,silvermoon,192,mage,arcane,6,2,4
Magepress,silvermoon,192,mage,arcane,6,2,4
Pølåris,outland,192,mage,arcane,6,2,4
Drencast,hyjal,192,mage,arcane,6,2,4
Äßäm,outland,192,mage,arcane,6,2,4
Аделфорн,eversong,192,mage,arcane,12,2,10
Rooven,aegwynn,192,mage,arcane,12,2,10
Smlx,outland,192,mage,arcane,12,2,10
Rusto,hellscream,192,mage,arcane,12,2,10
Farciminis,outland,192,mage,arcane,12,2,10
Veveroiu,defias-brotherhood,191,mage,arcane,6,2,4
Niphire,doomhammer,191,mage,arcane,6,2,4
Magse,kirin-tor,191,mage,arcane,6,2,4
Anderl,kirin-tor,191,mage,arcane,12,2,10
Gadeplan,argent-dawn,159,mage,arcane,5,2,3
Deadtedd,twisting-nether,138,mage,arcane,9,3,6
Døomey,ravencrest,138,mage,arcane,15,3,12
Carufera,defias-brotherhood,110,mage,arcane,7,2,5
Souldemon,burning-legion,96,mage,arcane,6,1,5
Калихор,gordunni,96,mage,arcane,6,1,5
Grönmonster,shattered-hand,96,mage,arcane,6,1,5
Thelastmage,outland,96,mage,arcane,6,1,5
Lumberth,sanguino,96,mage,arcane,6,1,5
Zadnik,tarren-mill,96,mage,arcane,6,1,5
Illil,deathwing,96,mage,arcane,6,1,5
Yungbambix,twisting-nether,96,mage,arcane,6,1,5
Криаркана,howling-fjord,96,mage,arcane,6,1,5
Мерац,howling-fjord,96,mage,arcane,6,1,5
Sorrow,outland,96,mage,arcane,6,1,5
Шпексх,soulflayer,96,mage,arcane,6,1,5
Саназэр,howling-fjord,96,mage,arcane,6,1,5
Рэймонд,howling-fjord,96,mage,arcane,6,1,5
Шарансул,soulflayer,96,mage,arcane,6,1,5
Bigkent,stormscale,96,mage,arcane,6,1,5
Moosemæn,stormscale,96,mage,arcane,6,1,5
Glacius,stormscale,96,mage,arcane,6,1,5
Karysta,blackhand,96,mage,arcane,6,1,5
Keltharus,kazzak,96,mage,arcane,6,1,5
Старкскрим,gordunni,96,mage,arcane,6,1,5
Sidildur,ravencrest,96,mage,arcane,6,1,5
Wushii,aggra-português,96,mage,arcane,6,1,5
Malicä,ravencrest,96,mage,arcane,6,1,5
Hotafazz,ravencrest,96,mage,arcane,6,1,5
Bakeren,frostmane,96,mage,arcane,6,1,5
Zerøsílgødx,antonidas,96,mage,arcane,6,1,5
Azakadabra,ysondre,96,mage,arcane,6,1,5
Адренохромх,gordunni,96,mage,arcane,6,1,5
Oz,frostmane,96,mage,arcane,6,1,5
Animaze,argent-dawn,96,mage,arcane,6,1,5
Kaiyn,argent-dawn,96,mage,arcane,6,1,5
Yanir,die-arguswacht,96,mage,arcane,6,1,5
Sîrã,tarren-mill,96,mage,arcane,6,1,5
Kalokoh,tarren-mill,96,mage,arcane,6,1,5
Facerollyo,tarren-mill,96,mage,arcane,6,1,5
Mfnz,stormreaver,96,mage,arcane,6,1,5
Spellwind,silvermoon,96,mage,arcane,6,1,5
Firehasse,draenor,96,mage,arcane,6,1,5
Hólmess,silvermoon,96,mage,arcane,6,1,5
Lêgólás,blackmoore,96,mage,arcane,6,1,5
Zeklo,frostmane,96,mage,arcane,6,1,5
Firerazer,hyjal,96,mage,arcane,6,1,5
Autramage,emerald-dream,96,mage,arcane,6,1,5
Bananaslam,silvermoon,96,mage,arcane,6,1,5
Akharthion,defias-brotherhood,96,mage,arcane,6,1,5
Dobbite,archimonde,96,mage,arcane,6,1,5
Nohbrain,blackmoore,96,mage,arcane,6,1,5
Varini,twisting-nether,96,mage,arcane,12,1,11
Patricstewrd,draenor,96,mage,arcane,12,1,11
Magicpowers,silvermoon,96,mage,arcane,12,1,11
Dârigaaz,blackmoore,96,mage,arcane,18,1,17
Damnlate,blackmoore,96,mage,arcane,18,1,17
Xläderz,ravencrest,79,mage,arcane,5,1,4
Barqan,alakir,79,mage,arcane,5,1,4
Манднесс,azuregos,79,mage,arcane,11,1,10
Zovos,sporeggar,79,mage,arcane,11,1,10
Vinlimar,drakthul,64,mage,arcane,4,1,3
Stümpy,ravencrest,64,mage,arcane,5,1,4
Baravar,blackrock,42,mage,arcane,11,3,8
Partypower,twisting-nether,2404,mage,fire,66,48,18
Laynerz,kazzak,2388,mage,fire,111,71,40
Raíku,ravencrest,2360,mage,fire,84,50,34
Барсуктри,deathguard,2322,mage,fire,154,95,59
Tommy,laughing-skull,2309,mage,fire,142,81,61
Hatsu,kazzak,2305,mage,fire,188,100,88
Gelußaßa,ravencrest,2244,mage,fire,101,57,44
Шипми,gordunni,2237,mage,fire,259,142,117
Jíncks,draenor,2216,mage,fire,178,97,81
Slôw,kazzak,2215,mage,fire,83,54,29
Milkenjoyer,ravencrest,2205,mage,fire,82,53,29
Thegoodoctor,kazzak,2203,mage,fire,454,235,219
Håtsu,ravencrest,2190,mage,fire,247,125,122
Oseri,defias-brotherhood,2189,mage,fire,220,115,105
Arnoldkelly,tarren-mill,2180,mage,fire,72,45,27
Watchmeclic,archimonde,2170,mage,fire,84,44,40
Рофкастер,gordunni,2169,mage,fire,304,155,149
Róseonly,ravencrest,2158,mage,fire,154,82,72
Nilitar,kazzak,2157,mage,fire,138,72,66
Smlx,outland,2146,mage,fire,142,83,59
Файрус,soulflayer,2132,mage,fire,176,94,82
Фоулли,howling-fjord,2130,mage,fire,235,129,106
Røysi,ravencrest,2128,mage,fire,141,80,61
Plexyoo,thrall,2123,mage,fire,74,40,34
Slashspít,ravencrest,2119,mage,fire,69,40,29
Søz,agamaggan,2115,mage,fire,78,49,29
Aleç,ravencrest,2114,mage,fire,69,43,26
Xinda,hellfire,2109,mage,fire,83,48,35
Twizzkek,silvermoon,2108,mage,fire,249,126,123
Fairus,ravencrest,2107,mage,fire,83,56,27
Lemaroxd,draenor,2102,mage,fire,116,66,50
Uniquenoodle,alakir,2101,mage,fire,128,69,59
Serctheone,ravencrest,2100,mage,fire,76,46,30
Файрусх,deathguard,2097,mage,fire,69,40,29
Magiwan,silvermoon,2095,mage,fire,159,89,70
Cörnflekz,stormscale,2091,mage,fire,110,70,40
Síckmode,khadgar,2082,mage,fire,251,140,111
Yh,ragnaros,2072,mage,fire,65,46,19
Frozentwink,kul-tiras,2066,mage,fire,208,112,96
Прауз,soulflayer,2063,mage,fire,175,96,79
Pisini,tarren-mill,2049,mage,fire,102,53,49
Tiáno,drakthul,2044,mage,fire,210,112,98
Uknowhowwedu,aegwynn,2043,mage,fire,54,33,21
Wheí,ravencrest,2038,mage,fire,96,60,36
Lisanalgaib,kilrogg,2037,mage,fire,105,59,46
Rizzlybear,outland,2035,mage,fire,87,45,42
Randommagexd,ravencrest,2034,mage,fire,65,40,25
Espressno,ravencrest,2030,mage,fire,42,35,7
Nuj,blackrock,2028,mage,fire,42,27,15
Excuséme,ravencrest,2024,mage,fire,69,38,31
Grumpié,ravencrest,2021,mage,fire,60,42,18
Ráìkù,ravencrest,2021,mage,fire,60,32,28
Ðevlqt,blackmoore,2018,mage,fire,257,142,115
Яшабурстх,blackscar,2018,mage,fire,327,168,159
Sóz,ravencrest,2017,mage,fire,53,35,18
Dyen,hyjal,2015,mage,fire,132,73,59
Nilitarrgh,outland,2012,mage,fire,56,29,27
Setyouoncs,ravencrest,2010,mage,fire,160,89,71
Uknowhowwedu,blackrock,2006,mage,fire,72,41,31
Шуткам,gordunni,2002,mage,fire,66,38,28
Диссоциация,greymane,2001,mage,fire,208,108,100
Gossipgirlz,outland,2000,mage,fire,159,92,67
Avizura,kazzak,1998,mage,fire,42,30,12
Cornfloax,ravencrest,1995,mage,fire,84,53,31
Octtmiss,twisting-nether,1989,mage,fire,110,64,46
Evovar,silvermoon,1988,mage,fire,332,170,162
Lilbolts,outland,1981,mage,fire,54,34,20
Spicyboi,archimonde,1978,mage,fire,53,37,16
Mssilvy,sylvanas,1976,mage,fire,263,145,118
Реордиан,gordunni,1975,mage,fire,86,38,48
Zoot,ravencrest,1974,mage,fire,143,74,69
Bigkent,stormscale,1964,mage,fire,86,44,42
Нереварин,soulflayer,1962,mage,fire,168,92,76
Håtemebaby,kazzak,1962,mage,fire,90,39,51
Magijoana,silvermoon,1958,mage,fire,132,70,62
Калихор,gordunni,1942,mage,fire,173,103,70
Ввнд,galakrond,1941,mage,fire,66,33,33
Aìnz,hyjal,1935,mage,fire,101,61,40
Evohz,stormscale,1932,mage,fire,91,49,42
Choll,stormscale,1932,mage,fire,249,133,116
Tpøtmenenø,ravencrest,1931,mage,fire,48,34,14
Ãshs,archimonde,1927,mage,fire,36,24,12
Tacomagex,kazzak,1927,mage,fire,136,86,50
Lyssæ,khaz-modan,1926,mage,fire,239,125,114
Navolav,turalyon,1924,mage,fire,65,43,22
Urkela,sylvanas,1923,mage,fire,168,92,76
Mejtschazor,silvermoon,1922,mage,fire,95,60,35
Skrex,blackrock,1917,mage,fire,548,291,257
Darkfiré,blackmoore,1917,mage,fire,128,65,63
Sleepingfate,stormscale,1913,mage,fire,80,44,36
Зефенжо,howling-fjord,1913,mage,fire,89,48,41
Symera,dun-modr,1910,mage,fire,89,58,31
Ygø,hyjal,1910,mage,fire,318,160,158
Magnopvp,sanguino,1909,mage,fire,59,37,22
Dazz,ravencrest,1909,mage,fire,383,191,192
Sanjoop,tarren-mill,1907,mage,fire,96,52,44
Noxkin,stormscale,1906,mage,fire,83,48,35
Mßs,outland,1905,mage,fire,101,52,49
Brokenlegman,defias-brotherhood,1903,mage,fire,42,26,16
Reyown,archimonde,1901,mage,fire,82,58,24
Dxdxdxdxdx,drakthul,1898,mage,fire,137,77,60
Obbcontrol,ravencrest,1894,mage,fire,240,130,110
Goomba,tarren-mill,1893,mage,fire,125,59,66
Djflashz,archimonde,1891,mage,fire,231,119,112
Ticklefinger,agamaggan,1886,mage,fire,30,21,9
Wwjd,darksorrow,1885,mage,fire,55,31,24
Tìktokthot,outland,1882,mage,fire,36,23,13
Nihilvm,dalaran,1882,mage,fire,130,68,62
Missl,draenor,1876,mage,fire,67,38,29
Worstdenmark,stormscale,1872,mage,fire,41,23,18
Altraftw,archimonde,1871,mage,fire,77,52,25
Uní,emerald-dream,1869,mage,fire,42,29,13
Rewq,twisting-nether,1866,mage,fire,98,62,36
Ilovedana,dun-modr,1865,mage,fire,60,42,18
Michellee,ravencrest,1865,mage,fire,54,31,23
Prácticemàge,archimonde,1864,mage,fire,54,35,19
Shíróyama,ravencrest,1864,mage,fire,110,68,42
Илайза,fordragon,1862,mage,fire,39,29,10
Medivqt,ragnaros,1858,mage,fire,60,44,16
Camefromzoo,outland,1856,mage,fire,44,28,16
Dardie,ravencrest,1856,mage,fire,54,33,21
Sticki,malganis,1855,mage,fire,48,34,14
Spelltastìc,blackmoore,1855,mage,fire,108,59,49
Carufera,defias-brotherhood,1854,mage,fire,326,180,146
Maguscarlsen,ravencrest,1853,mage,fire,186,111,75
Вовзон,howling-fjord,1851,mage,fire,203,111,92
Frøstqt,ravencrest,1851,mage,fire,65,30,35
Fireblood,runetotem,1848,mage,fire,108,57,51
Hazewrld,ravencrest,1848,mage,fire,132,62,70
Lotharie,aegwynn,1847,mage,fire,36,23,13
Sérum,drakthul,1847,mage,fire,54,33,21
Barbeuqxo,garona,1846,mage,fire,54,36,18
Spelltastíc,blackmoore,1844,mage,fire,54,34,20
Kindled,argent-dawn,1843,mage,fire,116,70,46
Larmp,outland,1842,mage,fire,72,39,33
Underscore,outland,1841,mage,fire,91,51,40
Stoychav,outland,1840,mage,fire,229,125,104
Covran,stormscale,1838,mage,fire,36,21,15
Timzør,outland,1837,mage,fire,60,37,23
Belled,silvermoon,1836,mage,fire,95,64,31
Колтрэйн,blackscar,1836,mage,fire,45,30,15
Hooksclay,archimonde,1836,mage,fire,78,45,33
Nøw,ravencrest,1835,mage,fire,75,40,35
Fuego,sylvanas,1834,mage,fire,285,151,134
Wenant,ravencrest,1834,mage,fire,285,144,141
Watchmeclick,archimonde,1833,mage,fire,29,20,9
Skylezy,blackrock,1833,mage,fire,71,37,34
Shavay,blackmoore,1832,mage,fire,62,31,31
Archíques,kazzak,1831,mage,fire,46,24,22
Dubbleblast,draenor,1830,mage,fire,54,34,20
Shîmmer,ravencrest,1830,mage,fire,48,23,25
Ipen,bloodfeather,1829,mage,fire,48,27,21
Jumpfanqt,stormscale,1827,mage,fire,42,30,12
Wàneís,ravencrest,1827,mage,fire,116,58,58
Aryasa,silvermoon,1824,mage,fire,42,28,14
Quentin,grim-batol,1824,mage,fire,320,169,151
Твейзи,blackscar,1823,mage,fire,40,24,16
Stepdaddyy,kazzak,1823,mage,fire,54,28,26
Dizzy,ahnqiraj,1823,mage,fire,286,141,145
Hey,khazgoroth,1821,mage,fire,203,109,94
Хехгодх,gordunni,1818,mage,fire,33,20,13
Stümpy,ravencrest,1818,mage,fire,126,75,51
Nøw,kazzak,1816,mage,fire,48,29,19
Hiryú,kazzak,1815,mage,fire,30,20,10
Cleophe,burning-legion,1815,mage,fire,122,78,44
Elmaestró,aegwynn,1815,mage,fire,48,30,18
Mohammedjiba,ragnaros,1815,mage,fire,128,71,57
Abruaa,tarren-mill,1815,mage,fire,65,34,31
Hólmess,silvermoon,1815,mage,fire,156,78,78
Magegodx,rexxar,1814,mage,fire,195,116,79
Smittywerbn,stormscale,1814,mage,fire,141,78,63
Asiman,eredar,1814,mage,fire,84,42,42
Ahstin,teldrassil,1813,mage,fire,102,68,34
Thughunterqt,silvermoon,1812,mage,fire,398,211,187
Рамблз,gordunni,1811,mage,fire,66,39,27
Lo,kilrogg,1811,mage,fire,145,85,60
Jirt,stormscale,1810,mage,fire,71,41,30
Khorosho,draenor,1810,mage,fire,54,26,28
Ókamí,ravencrest,1809,mage,fire,139,72,67
Cienaños,outland,1807,mage,fire,102,59,43
Миллерфест,howling-fjord,1807,mage,fire,88,47,41
Ширм,blackscar,1807,mage,fire,48,24,24
Divey,draenor,1805,mage,fire,304,166,138
Фюртэ,howling-fjord,1803,mage,fire,42,26,16
Nihiliz,twisting-nether,1803,mage,fire,47,27,20
Moojob,kazzak,1801,mage,fire,54,30,24
Harrisøn,dun-modr,1799,mage,fire,78,47,31
Anisovsky,archimonde,1797,mage,fire,82,39,43
Azety,archimonde,1796,mage,fire,42,29,13
Rambau,archimonde,1794,mage,fire,109,64,45
Isenhour,frostmane,1794,mage,fire,294,148,146
Деозар,eversong,1793,mage,fire,415,220,195
Borp,defias-brotherhood,1791,mage,fire,42,27,15
Lìx,ravencrest,1791,mage,fire,42,27,15
Volksmagier,ravencrest,1791,mage,fire,115,70,45
Sâkuya,blackrock,1790,mage,fire,100,57,43
Пыроженное,deathguard,1787,mage,fire,206,107,99
Roxxis,kazzak,1783,mage,fire,54,25,29
Djfrosty,kazzak,1782,mage,fire,194,109,85
Czd,outland,1779,mage,fire,285,139,146
Shahnoza,thrall,1775,mage,fire,51,31,20
Mowns,ravencrest,1775,mage,fire,48,21,27
Mathematik,outland,1773,mage,fire,66,26,40
Funkyfriday,twisting-nether,1770,mage,fire,36,20,16
Insaneex,aegwynn,1769,mage,fire,54,32,22
Consquens,aszune,1767,mage,fire,54,34,20
Excuses,chamber-of-aspects,1767,mage,fire,169,94,75
Takayaki,terokkar,1766,mage,fire,142,77,65
Faunas,kazzak,1765,mage,fire,185,115,70
Auchenax,argent-dawn,1764,mage,fire,97,55,42
Averus,outland,1763,mage,fire,55,32,23
Nebbur,dun-modr,1763,mage,fire,57,33,24
Äntigood,outland,1763,mage,fire,86,46,40
Agáné,ravencrest,1762,mage,fire,40,29,11
Meisterg,frostwolf,1762,mage,fire,54,30,24
Барсукже,howling-fjord,1761,mage,fire,42,28,14
Magicrex,alleria,1761,mage,fire,96,60,36
Blackmagiç,ravencrest,1759,mage,fire,24,20,4
Asterixus,sylvanas,1756,mage,fire,90,54,36
Алаурс,howling-fjord,1755,mage,fire,259,138,121
Arcticfury,ravencrest,1753,mage,fire,36,22,14
Rusdorcito,frostwhisper,1753,mage,fire,59,35,24
Nocturnes,sylvanas,1753,mage,fire,73,31,42
Büyübaba,twisting-nether,1752,mage,fire,189,99,90
Sèrum,drakthul,1749,mage,fire,65,30,35
Abêj,malygos,1747,mage,fire,62,34,28
Ecovation,tarren-mill,1747,mage,fire,92,46,46
Saiyangodx,twisting-nether,1745,mage,fire,114,58,56
Litshatter,ravencrest,1742,mage,fire,36,26,10
Titarie,ravencrest,1742,mage,fire,42,22,20
Cilaa,silvermoon,1740,mage,fire,47,29,18
Bezelgeuse,nemesis,1736,mage,fire,125,71,54
Гекомория,fordragon,1736,mage,fire,65,26,39
Nùts,archimonde,1735,mage,fire,102,50,52
Миднаит,gordunni,1733,mage,fire,190,106,84
Zzpf,silvermoon,1732,mage,fire,126,60,66
Cesi,silvermoon,1732,mage,fire,101,47,54
Macheat,kazzak,1731,mage,fire,152,81,71
Camelshaver,tarren-mill,1730,mage,fire,123,70,53
Brainsick,kazzak,1727,mage,fire,48,26,22
Келлазар,gordunni,1727,mage,fire,168,90,78
Htwhy,kazzak,1727,mage,fire,388,203,185
Двинск,soulflayer,1726,mage,fire,117,59,58
Frígíd,outland,1723,mage,fire,114,61,53
Robsn,blackrock,1722,mage,fire,36,25,11
Climatrix,twisting-nether,1721,mage,fire,59,41,18
Isildurone,ragnaros,1721,mage,fire,62,35,27
Haxyo,twisting-nether,1721,mage,fire,177,94,83
Проблембойх,gordunni,1719,mage,fire,60,25,35
Акиххабара,gordunni,1717,mage,fire,87,51,36
Enandia,darksorrow,1716,mage,fire,148,80,68
Aletheía,stormscale,1712,mage,fire,44,29,15
Cardioexpert,ravencrest,1711,mage,fire,36,29,7
Speedshatter,aegwynn,1711,mage,fire,36,22,14
Laciee,silvermoon,1711,mage,fire,80,44,36
Siérra,outland,1708,mage,fire,119,70,49
Авгурей,howling-fjord,1708,mage,fire,142,70,72
Equálity,blackrock,1707,mage,fire,90,53,37
Andors,conseil-des-ombres,1707,mage,fire,60,33,27
Kilstine,outland,1706,mage,fire,30,21,9
Tokerlol,stormscale,1706,mage,fire,81,49,32
Soxlol,sylvanas,1704,mage,fire,35,19,16
Snowbob,drakthul,1704,mage,fire,113,61,52
Magão,frostmane,1704,mage,fire,154,81,73
Rizzycakes,silvermoon,1703,mage,fire,106,53,53
Crooja,antonidas,1701,mage,fire,60,39,21
Rekzaop,ravencrest,1700,mage,fire,28,19,9
Hil,blackrock,1700,mage,fire,83,52,31
Magethings,kazzak,1700,mage,fire,196,104,92
Bumboozling,kazzak,1697,mage,fire,119,70,49
Sendro,twisting-nether,1697,mage,fire,69,40,29
Tfmchamp,ravencrest,1696,mage,fire,30,18,12
Baldazzor,ravencrest,1696,mage,fire,116,63,53
Сплитсистема,galakrond,1694,mage,fire,48,29,19
Достижений,soulflayer,1694,mage,fire,125,58,67
Wafflegodx,turalyon,1693,mage,fire,48,29,19
Yungbambix,twisting-nether,1693,mage,fire,74,38,36
Арара,gordunni,1693,mage,fire,42,20,22
Magnobi,sanguino,1692,mage,fire,42,24,18
Ðamage,sanguino,1691,mage,fire,39,21,18
Únna,sanguino,1691,mage,fire,66,35,31
Blix,sanguino,1690,mage,fire,60,34,26
Dázz,twisting-nether,1689,mage,fire,40,25,15
Einsmagus,blackrock,1687,mage,fire,189,103,86
Nàtcho,tichondrius,1685,mage,fire,71,35,36
Маяков,gordunni,1684,mage,fire,66,36,30
Barbeuqx,garona,1683,mage,fire,95,57,38
Blinkinpark,pozzo-delleternità,1683,mage,fire,63,37,26
Midooa,nerathor,1683,mage,fire,117,66,51
Pumped,haomarush,1683,mage,fire,105,54,51
Âcryz,blackrock,1682,mage,fire,111,55,56
Onkela,arygos,1681,mage,fire,36,34,2
Castorcato,kazzak,1681,mage,fire,48,21,27
Elldiamage,draenor,1680,mage,fire,57,31,26
Nurfdm,ravencrest,1679,mage,fire,41,28,13
Sidek,sylvanas,1679,mage,fire,36,18,18
Koltom,ravencrest,1676,mage,fire,36,26,10
Nelfchewer,ravencrest,1676,mage,fire,46,26,20
Kurtcobain,draenor,1676,mage,fire,85,48,37
Silmara,shadowsong,1675,mage,fire,66,39,27
Icoz,nemesis,1673,mage,fire,100,55,45
Relik,sylvanas,1673,mage,fire,60,31,29
Dantiqa,ravencrest,1673,mage,fire,747,379,368
Мосгормаг,gordunni,1671,mage,fire,77,43,34
Máximus,ravencrest,1671,mage,fire,54,30,24
Vulcanô,sanguino,1671,mage,fire,220,111,109
Hernêise,silvermoon,1670,mage,fire,245,128,117
Arcann,ravencrest,1669,mage,fire,84,51,33
Triplesevenx,silvermoon,1666,mage,fire,331,174,157
Felìá,kazzak,1665,mage,fire,54,32,22
Twoeightybpm,draenor,1664,mage,fire,58,33,25
Soz,agamaggan,1663,mage,fire,29,18,11
Sukky,todeswache,1663,mage,fire,66,40,26
Xîzy,outland,1663,mage,fire,48,24,24
Doonii,ragnaros,1661,mage,fire,71,34,37
Uskomaaginen,ravencrest,1660,mage,fire,77,45,32
Avæ,stormscale,1659,mage,fire,88,52,36
Texmexguden,tarren-mill,1659,mage,fire,72,40,32
Аквамэрис,gordunni,1658,mage,fire,36,21,15
Defrozen,twisting-nether,1656,mage,fire,124,66,58
Møøk,magtheridon,1654,mage,fire,30,19,11
Cenzored,chamber-of-aspects,1654,mage,fire,35,22,13
Aflamé,kilrogg,1654,mage,fire,109,65,44
Taddnor,ragnaros,1653,mage,fire,36,24,12
Ayoubz,outland,1653,mage,fire,77,44,33
Aprilfools,blackmoore,1653,mage,fire,36,19,17
Dcolon,tarren-mill,1650,mage,fire,54,28,26
Mëismz,hyjal,1649,mage,fire,46,26,20
Netrinkuet,outland,1648,mage,fire,41,21,20
Мактай,gordunni,1647,mage,fire,88,49,39
Firecold,silvermoon,1647,mage,fire,227,124,103
Shínsou,burning-blade,1645,mage,fire,194,106,88
Denaleidi,stormscale,1645,mage,fire,45,24,21
Knoxvit,tarren-mill,1644,mage,fire,36,24,12
Kickyaa,twisting-nether,1643,mage,fire,126,71,55
Azakadabra,ysondre,1643,mage,fire,105,59,46
Axhole,darksorrow,1642,mage,fire,46,31,15
Turbomedusa,draenor,1642,mage,fire,34,22,12
Нефростмаг,gordunni,1642,mage,fire,130,69,61
Sheepmeepbip,ravencrest,1642,mage,fire,178,84,94
Chrismage,argent-dawn,1641,mage,fire,109,60,49
Fessadimamt,draenor,1640,mage,fire,36,21,15
Elynaé,draenor,1639,mage,fire,48,26,22
Pluggis,the-maelstrom,1638,mage,fire,72,40,32
Yåsmine,outland,1638,mage,fire,84,43,41
Itrius,tarren-mill,1638,mage,fire,99,48,51
Magenerfed,archimonde,1637,mage,fire,42,21,21
Фроз,soulflayer,1635,mage,fire,140,76,64
Reqwyz,ragnaros,1634,mage,fire,86,51,35
Yanir,die-arguswacht,1634,mage,fire,36,19,17
Jezí,ghostlands,1633,mage,fire,31,21,10
Akrapovic,drakthul,1633,mage,fire,60,32,28
Fakeklepter,sylvanas,1631,mage,fire,30,21,9
Cheerió,aggramar,1631,mage,fire,377,197,180
Libre,stormscale,1631,mage,fire,566,289,277
Fuhrem,blackrock,1630,mage,fire,36,23,13
Gavno,ravencrest,1629,mage,fire,30,20,10
Backped,kazzak,1629,mage,fire,70,35,35
Benjibop,ravencrest,1628,mage,fire,29,21,8
Ayken,burning-legion,1628,mage,fire,42,26,16
Цепнойпёс,goldrinn,1627,mage,fire,53,31,22
Råståfåri,uldum,1627,mage,fire,87,47,40
Intz,twisting-nether,1627,mage,fire,105,55,50
Ênizt,archimonde,1626,mage,fire,58,34,24
Chucknoir,draenor,1626,mage,fire,72,42,30
Dannyvye,outland,1625,mage,fire,57,34,23
Yésdávé,stormscale,1624,mage,fire,24,17,7
Sany,anubarak,1624,mage,fire,30,20,10
Aestus,outland,1624,mage,fire,54,25,29
Aarsengel,ravencrest,1623,mage,fire,30,18,12
Radiantfury,outland,1623,mage,fire,88,41,47
Смилер,gordunni,1622,mage,fire,138,76,62
Satyrnaar,tarren-mill,1622,mage,fire,72,36,36
Игрдлпдров,gordunni,1621,mage,fire,163,91,72
Qqcult,ravencrest,1620,mage,fire,51,31,20
Rayniß,blackmoore,1620,mage,fire,177,94,83
Mariiejanee,nozdormu,1620,mage,fire,54,25,29
Джелиона,gordunni,1619,mage,fire,66,36,30
Naps,argent-dawn,1619,mage,fire,158,86,72
Aronnax,ravencrest,1619,mage,fire,99,51,48
Neird,sinstralis,1618,mage,fire,108,63,45
Combusturmum,outland,1617,mage,fire,36,19,17
Sinanspappa,argent-dawn,1616,mage,fire,24,18,6
Tdv,draenor,1616,mage,fire,42,24,18
Dbshèépgôdx,silvermoon,1616,mage,fire,48,27,21
Lilblinks,silvermoon,1616,mage,fire,126,67,59
Cameljoe,blackhand,1616,mage,fire,86,45,41
Hambones,outland,1616,mage,fire,68,30,38
Гунмаказ,gordunni,1615,mage,fire,58,35,23
Hængovêr,antonidas,1615,mage,fire,153,86,67
Xyfys,azshara,1613,mage,fire,36,22,14
Magikere,tarren-mill,1613,mage,fire,78,42,36
Flocca,argent-dawn,1612,mage,fire,50,26,24
Oneshotazor,silvermoon,1611,mage,fire,36,21,15
Itsøkay,archimonde,1611,mage,fire,36,21,15
Kbd,outland,1611,mage,fire,90,49,41
Витуз,gordunni,1610,mage,fire,66,35,31
Badguy,arathor,1610,mage,fire,42,21,21
Línus,twisting-nether,1609,mage,fire,24,21,3
Хблэйз,howling-fjord,1609,mage,fire,61,35,26
Fenrirson,drakthul,1609,mage,fire,399,216,183
Firedeáth,kazzak,1608,mage,fire,100,55,45
Akâri,silvermoon,1608,mage,fire,163,87,76
Resheep,kazzak,1608,mage,fire,107,57,50
Alluryeine,draenor,1607,mage,fire,54,30,24
Blackpowerrx,ravencrest,1606,mage,fire,60,35,25
Aimaniac,stormscale,1606,mage,fire,211,118,93
Jessaniel,chogall,1605,mage,fire,52,29,23
Sondremage,outland,1605,mage,fire,54,26,28
Тачитачи,gordunni,1604,mage,fire,125,71,54
Magegødx,eredar,1603,mage,fire,114,64,50
Neuralnetwrk,sylvanas,1603,mage,fire,60,32,28
Незерёб,soulflayer,1603,mage,fire,42,22,20
Whats,korgall,1602,mage,fire,112,61,51
Колдрагос,gordunni,1602,mage,fire,94,50,44
Shortchange,stormscale,1602,mage,fire,96,50,46
Дрраго,greymane,1601,mage,fire,254,134,120
Zimbabweborc,burning-legion,1600,mage,fire,36,25,11
Creak,blackhand,1600,mage,fire,87,51,36
Spellfaker,drakthul,1600,mage,fire,84,49,35
Xerces,the-maelstrom,1600,mage,fire,30,17,13
Layzzy,kazzak,1600,mage,fire,42,23,19
Glacialspike,eredar,1600,mage,fire,48,25,23
Emoden,silvermoon,1599,mage,fire,48,24,24
Yshax,malganis,1599,mage,fire,130,64,66
Adetin,tarren-mill,1598,mage,fire,38,27,11
Raikuswife,twisting-nether,1598,mage,fire,30,17,13
Witak,ysondre,1598,mage,fire,227,114,113
Nozarashí,hyjal,1594,mage,fire,56,32,24
Айслэнц,howling-fjord,1594,mage,fire,113,53,60
Oz,frostmane,1593,mage,fire,37,21,16
Слизерин,gordunni,1592,mage,fire,80,40,40
Petepan,argent-dawn,1591,mage,fire,42,24,18
Gaárá,stormscale,1591,mage,fire,582,292,290
Né,dalaran,1589,mage,fire,140,75,65
Greaterkick,blackrock,1588,mage,fire,46,27,19
Stickiburn,malganis,1586,mage,fire,30,19,11
Ustafrr,argent-dawn,1586,mage,fire,133,81,52
Carinuz,blackmoore,1585,mage,fire,162,82,80
Säroumäne,archimonde,1584,mage,fire,61,31,30
Ethiqq,gorgonnash,1584,mage,fire,60,28,32
Экзорсус,goldrinn,1583,mage,fire,326,167,159
Ahkkar,ravencrest,1583,mage,fire,60,30,30
Bebenm,archimonde,1582,mage,fire,47,20,27
Swizzy,arathor,1579,mage,fire,48,27,21
Frøzzen,blackrock,1578,mage,fire,62,37,25
Cooy,stormscale,1576,mage,fire,74,41,33
Realone,ragnaros,1576,mage,fire,42,21,21
Lïppoutou,archimonde,1575,mage,fire,30,17,13
Mëgu,silvermoon,1573,mage,fire,454,240,214
Fearbeäch,ravencrest,1570,mage,fire,77,41,36
Shinegami,hyjal,1569,mage,fire,48,27,21
Wenndrid,draenor,1569,mage,fire,533,279,254
Kold,stormscale,1569,mage,fire,48,24,24
Ënjaz,sylvanas,1568,mage,fire,67,35,32
Alni,thrall,1567,mage,fire,59,32,27
Sheepthrillz,blackmoore,1566,mage,fire,30,17,13
Xanaxgød,outland,1565,mage,fire,29,17,12
Qulinx,kazzak,1564,mage,fire,40,22,18
Аластормаг,deathweaver,1562,mage,fire,153,82,71
Lilkiki,archimonde,1559,mage,fire,36,22,14
Hardtimes,blackhand,1556,mage,fire,74,38,36
Êigul,blackrock,1556,mage,fire,65,28,37
Shainax,dun-modr,1554,mage,fire,49,24,25
Meign,eredar,1553,mage,fire,54,29,25
Petar,tarren-mill,1553,mage,fire,157,79,78
Darríck,argent-dawn,1552,mage,fire,119,63,56
Zíru,outland,1552,mage,fire,115,57,58
Jonku,tarren-mill,1550,mage,fire,84,52,32
Hardelf,kazzak,1549,mage,fire,31,22,9
Cryptik,blackmoore,1549,mage,fire,145,80,65
Gagaj,ravencrest,1549,mage,fire,66,32,34
Sekulicgoga,draenor,1548,mage,fire,162,97,65
Liendri,aegwynn,1548,mage,fire,120,64,56
Koreanbbq,outland,1548,mage,fire,42,22,20
Utarii,deathwing,1548,mage,fire,136,70,66
Dauwen,silvermoon,1548,mage,fire,78,40,38
Whócárés,dragonmaw,1546,mage,fire,30,17,13
Apócalyptic,tarren-mill,1546,mage,fire,249,130,119
Kippercarry,outland,1545,mage,fire,32,24,8
Магмагистр,blackscar,1545,mage,fire,168,84,84
Natchèl,ysondre,1544,mage,fire,42,25,17
Invinsible,xavius,1544,mage,fire,54,30,24
Terlon,ragnaros,1543,mage,fire,186,99,87
Poporciné,archimonde,1542,mage,fire,30,20,10
Bclaudiu,terokkar,1542,mage,fire,168,92,76
Гнилоглазка,howling-fjord,1542,mage,fire,136,73,63
ßerkoßaggins,ravencrest,1542,mage,fire,152,80,72
Banausisch,blackmoore,1541,mage,fire,64,34,30
Kjh,twisting-nether,1540,mage,fire,26,17,9
Hcs,dalaran,1539,mage,fire,54,25,29
Razrkh,ragnaros,1536,mage,fire,123,68,55
Kyrn,zuljin,1536,mage,fire,194,102,92
Noblockgødx,dun-modr,1536,mage,fire,82,39,43
Avb,twisting-nether,1535,mage,fire,24,16,8
Эарвенн,galakrond,1535,mage,fire,60,35,25
Héffér,outland,1535,mage,fire,89,49,40
Djdankzter,outland,1534,mage,fire,30,16,14
Consulalgeri,archimonde,1534,mage,fire,54,26,28
Твейдей,blackscar,1533,mage,fire,30,16,14
Séptímus,kazzak,1532,mage,fire,127,72,55
Letsa,stormscale,1531,mage,fire,30,19,11
Bloodycast,archimonde,1531,mage,fire,153,79,74
Steveishigh,tarren-mill,1531,mage,fire,68,35,33
Rilac,nordrassil,1530,mage,fire,111,59,52
Hbarftw,ravencrest,1528,mage,fire,30,20,10
Sîrã,tarren-mill,1528,mage,fire,24,16,8
Stîckî,malganis,1528,mage,fire,29,19,10
Дэлос,gordunni,1526,mage,fire,41,20,21
Reeceburton,stormscale,1525,mage,fire,24,16,8
Fïttan,stormscale,1525,mage,fire,45,24,21
Extracting,stormscale,1525,mage,fire,394,206,188
Æones,kult-der-verdammten,1525,mage,fire,137,69,68
Bònk,sylvanas,1524,mage,fire,78,42,36
Flypz,stormscale,1523,mage,fire,120,68,52
Caesarclown,silvermoon,1523,mage,fire,501,266,235
Аквамелис,gordunni,1522,mage,fire,84,36,48
Sedmaka,neptulon,1519,mage,fire,122,65,57
Hexmath,tarren-mill,1518,mage,fire,53,30,23
Xaynny,alakir,1518,mage,fire,149,74,75
Imtrynasheep,kazzak,1517,mage,fire,72,41,31
Mons,the-venture-co,1517,mage,fire,338,173,165
Smxkýÿ,eredar,1512,mage,fire,24,16,8
Baxeraa,draenor,1512,mage,fire,97,56,41
Xqtmage,blackhand,1511,mage,fire,24,16,8
Tromie,archimonde,1511,mage,fire,156,84,72
Pradapimp,ravencrest,1511,mage,fire,92,48,44
Спэйсбарелла,soulflayer,1510,mage,fire,202,101,101
Нерария,howling-fjord,1509,mage,fire,60,35,25
Нетлель,soulflayer,1506,mage,fire,119,65,54
Aisha,neptulon,1506,mage,fire,33,18,15
Insanewizard,kazzak,1505,mage,fire,74,38,36
Mieria,argent-dawn,1504,mage,fire,54,30,24
Naidm,blackmoore,1504,mage,fire,36,17,19
Ohateyz,burning-legion,1503,mage,fire,54,28,26
Sakuranosuke,twisting-nether,1503,mage,fire,48,23,25
Primodious,kazzak,1502,mage,fire,53,37,16
Draquengar,tyrande,1501,mage,fire,34,18,16
Aulny,kaelthas,1501,mage,fire,153,78,75
Mensonger,archimonde,1500,mage,fire,139,68,71
Polyvon,ravencrest,1500,mage,fire,36,17,19
Buzzcraft,draenor,1496,mage,fire,128,74,54
Frostfettlol,onyxia,1496,mage,fire,39,19,20
Watchmepanda,ravencrest,1496,mage,fire,45,20,25
Wambamm,ravencrest,1495,mage,fire,129,60,69
Neférú,thrall,1494,mage,fire,52,27,25
Gnomag,argent-dawn,1494,mage,fire,306,156,150
Blinked,eredar,1493,mage,fire,66,40,26
Morphis,talnivarr,1493,mage,fire,56,30,26
Zensheep,silvermoon,1493,mage,fire,54,28,26
Räikü,ravencrest,1490,mage,fire,66,42,24
Doparismenos,twisting-nether,1490,mage,fire,84,47,37
Scoopssama,ravencrest,1490,mage,fire,108,56,52
Mante,antonidas,1490,mage,fire,353,175,178
Glïder,archimonde,1490,mage,fire,59,27,32
Coqo,silvermoon,1490,mage,fire,78,35,43
Töframaður,draenor,1489,mage,fire,138,78,60
Moistsocks,outland,1489,mage,fire,53,29,24
Shockólot,outland,1487,mage,fire,47,25,22
Revanov,outland,1486,mage,fire,48,29,19
Aikamie,draenor,1486,mage,fire,270,139,131
Halfanapple,the-maelstrom,1485,mage,fire,54,25,29
Manvo,bloodscalp,1484,mage,fire,270,143,127
Pandathis,frostwolf,1482,mage,fire,36,24,12
Ларавэл,blackscar,1481,mage,fire,33,19,14
Paradigma,sylvanas,1481,mage,fire,49,27,22
Fireghost,antonidas,1480,mage,fire,52,26,26
Bobbasor,defias-brotherhood,1479,mage,fire,148,78,70
Ízumi,stormscale,1479,mage,fire,54,28,26
Calientay,ragnaros,1479,mage,fire,72,34,38
Ziao,outland,1478,mage,fire,47,23,24
Интровертка,blackscar,1477,mage,fire,52,27,25
Бингчилинг,howling-fjord,1476,mage,fire,54,25,29
Nécrømage,confrérie-du-thorium,1474,mage,fire,32,17,15
Ghalanz,ravencrest,1474,mage,fire,141,70,71
Мозифорест,gordunni,1474,mage,fire,78,37,41
Skaleech,draenor,1474,mage,fire,42,18,24
Mikefires,blackrock,1473,mage,fire,34,21,13
Пирабластер,gordunni,1472,mage,fire,45,27,18
Garbedge,silvermoon,1472,mage,fire,34,17,17
Rockyballboa,silvermoon,1471,mage,fire,68,39,29
Tomia,burning-legion,1471,mage,fire,169,84,85
Slite,nazjatar,1469,mage,fire,60,39,21
Sukalamink,alonsus,1469,mage,fire,110,61,49
Diper,burning-legion,1469,mage,fire,148,76,72
Camiina,shattered-hand,1468,mage,fire,167,86,81
Wizandor,tarren-mill,1467,mage,fire,77,44,33
Alystan,burning-blade,1467,mage,fire,108,50,58
Moleester,twisting-nether,1467,mage,fire,54,24,30
Drcs,kazzak,1466,mage,fire,48,33,15
Karima,drekthar,1465,mage,fire,40,22,18
Robowhoore,silvermoon,1465,mage,fire,92,49,43
Durdi,silvermoon,1463,mage,fire,179,99,80
Delieth,nemesis,1463,mage,fire,33,18,15
Волшпробуда,gordunni,1462,mage,fire,88,52,36
Ãzi,ravencrest,1462,mage,fire,36,19,17
Sippebób,laughing-skull,1462,mage,fire,34,17,17
Auzt,kazzak,1461,mage,fire,75,38,37
Mouhlaghofrr,ysondre,1461,mage,fire,85,34,51
Yatsune,defias-brotherhood,1460,mage,fire,60,41,19
Qusx,malganis,1460,mage,fire,29,16,13
Goodopeners,outland,1460,mage,fire,71,37,34
Alorin,dun-modr,1460,mage,fire,86,40,46
Arandartis,kazzak,1459,mage,fire,42,26,16
Weedup,zuljin,1459,mage,fire,72,36,36
Versachi,neptulon,1458,mage,fire,54,30,24
Alèxjones,stormscale,1458,mage,fire,42,18,24
Zøe,aggra-português,1457,mage,fire,23,16,7
Obosmage,blackmoore,1457,mage,fire,42,25,17
Dorá,azjolnerub,1457,mage,fire,106,51,55
Anthrex,drakthul,1456,mage,fire,66,27,39
Hansdrol,outland,1455,mage,fire,60,33,27
Fortian,boulderfist,1455,mage,fire,36,19,17
Plætinum,ravencrest,1455,mage,fire,134,68,66
Вендайса,soulflayer,1455,mage,fire,36,18,18
Lokilus,dalaran,1454,mage,fire,99,55,44
Antaos,drakthul,1453,mage,fire,43,20,23
Røvso,ragnaros,1452,mage,fire,60,27,33
Atixx,aegwynn,1450,mage,fire,84,42,42
Cinoox,blackrock,1449,mage,fire,255,137,118
Musfis,burning-legion,1449,mage,fire,89,43,46
Ascik,dalaran,1449,mage,fire,41,18,23
Estelliên,burning-legion,1448,mage,fire,54,25,29
Fingolfin,amanthul,1447,mage,fire,659,330,329
Pyrobomb,sylvanas,1447,mage,fire,108,49,59
Arckaen,elune,1445,mage,fire,77,46,31
Elcølgaø,sanguino,1443,mage,fire,143,69,74
Xue,azshara,1442,mage,fire,23,18,5
Magicdingo,lightnings-blade,1442,mage,fire,59,33,26
Zazatorica,tarren-mill,1442,mage,fire,222,116,106
Tûttifrutti,ravencrest,1442,mage,fire,84,41,43
Burstology,kazzak,1440,mage,fire,28,16,12
Marøjuniõr,draenor,1439,mage,fire,24,15,9
Secretagent,aegwynn,1439,mage,fire,66,37,29
Wizkidcutt,tarren-mill,1439,mage,fire,61,34,27
Akhali,chamber-of-aspects,1438,mage,fire,140,77,63
Uppara,stormrage,1437,mage,fire,54,30,24
Чобон,soulflayer,1437,mage,fire,48,23,25
Smíte,kazzak,1437,mage,fire,36,16,20
Seeva,kazzak,1437,mage,fire,89,39,50
Lmåo,ravencrest,1435,mage,fire,25,15,10
Гатмир,gordunni,1435,mage,fire,145,80,65
Nihilum,dalaran,1435,mage,fire,42,15,27
Marybaguette,archimonde,1434,mage,fire,24,15,9
Bloodymage,zenedar,1432,mage,fire,28,16,12
Sadrã,kazzak,1432,mage,fire,141,69,72
Kappotjeplif,ravencrest,1431,mage,fire,120,64,56
Mäalaka,archimonde,1430,mage,fire,78,41,37
Blinklolz,ysondre,1430,mage,fire,46,23,23
Nøstradanus,archimonde,1428,mage,fire,126,77,49
Iceorb,azshara,1428,mage,fire,89,46,43
Snaapz,kazzak,1428,mage,fire,54,26,28
Quie,stormscale,1427,mage,fire,36,21,15
Альвиам,borean-tundra,1426,mage,fire,39,23,16
Usèless,blackmoore,1426,mage,fire,62,30,32
Otpmage,tarren-mill,1425,mage,fire,24,15,9
Mikaelà,blackmoore,1423,mage,fire,66,40,26
Shizzy,onyxia,1423,mage,fire,63,33,30
Sheepwithmeh,blackrock,1423,mage,fire,30,15,15
Ice,sargeras,1423,mage,fire,47,22,25
Ryzea,ravencrest,1422,mage,fire,125,67,58
Zeklo,frostmane,1422,mage,fire,74,39,35
Guilty,naxxramas,1422,mage,fire,30,15,15
Zéngã,kazzak,1420,mage,fire,86,44,42
Vizarden,stormscale,1418,mage,fire,30,15,15
Kleisli,draenor,1418,mage,fire,57,26,31
Ncs,hellfire,1418,mage,fire,36,15,21
Aylamo,outland,1417,mage,fire,36,22,14
Roohna,blackmoore,1417,mage,fire,139,76,63
Jemppai,outland,1417,mage,fire,48,25,23
Nohbrain,blackmoore,1417,mage,fire,163,84,79
Pepsimaxlord,silvermoon,1417,mage,fire,30,15,15
Semiron,twisting-nether,1417,mage,fire,55,26,29
Muzbi,turalyon,1415,mage,fire,115,60,55
Mostevildude,blackhand,1414,mage,fire,24,15,9
Gpye,archimonde,1414,mage,fire,54,26,28
Charizard,emerald-dream,1413,mage,fire,21,16,5
Noviina,argent-dawn,1411,mage,fire,90,48,42
Rictue,silvermoon,1410,mage,fire,90,50,40
Xÿv,azshara,1409,mage,fire,24,15,9
Gødstopmeplz,aegwynn,1409,mage,fire,35,17,18
Szlay,blackmoore,1409,mage,fire,54,24,30
Meskay,ravencrest,1407,mage,fire,165,81,84
Anagramix,silvermoon,1406,mage,fire,27,15,12
Yenkonidas,blackmoore,1405,mage,fire,48,26,22
Elesios,blackmoore,1402,mage,fire,111,51,60
Exitelol,blackrock,1401,mage,fire,34,22,12
Kalokoh,tarren-mill,1401,mage,fire,54,27,27
Mejtschazor,twisting-nether,1400,mage,fire,29,16,13
Goldensands,stormscale,1398,mage,fire,26,16,10
Колинас,soulflayer,1398,mage,fire,59,25,34
Naissa,arathor,1398,mage,fire,36,15,21
Slimugur,sylvanas,1397,mage,fire,82,48,34
Mínêrvâ,blackrock,1397,mage,fire,47,24,23
Argø,ysondre,1396,mage,fire,30,17,13
Luxxurious,xavius,1396,mage,fire,93,51,42
Sunlolly,terokkar,1395,mage,fire,60,33,27
Decemba,kirin-tor,1393,mage,fire,30,16,14
Critr,sylvanas,1392,mage,fire,301,160,141
Zaruna,arathor,1392,mage,fire,30,15,15
Рифтиг,howling-fjord,1392,mage,fire,136,67,69
Calegos,twisting-nether,1390,mage,fire,54,29,25
Ледянойкекс,gordunni,1390,mage,fire,52,26,26
Mythiox,antonidas,1387,mage,fire,53,31,22
Gêrky,drakthul,1387,mage,fire,30,15,15
Gôodgame,frostmane,1386,mage,fire,30,18,12
Babidi,nemesis,1386,mage,fire,140,66,74
Júñ,silvermoon,1385,mage,fire,61,34,27
Tragíc,blackmoore,1383,mage,fire,29,15,14
Jääpuikko,grim-batol,1381,mage,fire,34,19,15
Pawah,exodar,1380,mage,fire,48,28,20
Animaze,argent-dawn,1380,mage,fire,144,79,65
Icepiece,tarren-mill,1380,mage,fire,51,23,28
Malshash,outland,1379,mage,fire,60,31,29
Shreedmage,blackmoore,1378,mage,fire,133,65,68
Xdu,silvermoon,1378,mage,fire,68,23,45
Kinetiq,kazzak,1377,mage,fire,36,17,19
Heimer,ravencrest,1376,mage,fire,90,48,42
Гунмаказ,soulflayer,1376,mage,fire,48,24,24
Bceps,stormscale,1376,mage,fire,152,73,79
Fullpolly,twisting-nether,1376,mage,fire,36,17,19
Rèsí,dun-morogh,1375,mage,fire,97,58,39
Kusikikkeli,stormreaver,1375,mage,fire,42,21,21
Vali,drakthul,1374,mage,fire,48,20,28
Azadan,pozzo-delleternità,1373,mage,fire,30,20,10
Ratedr,silvermoon,1373,mage,fire,47,26,21
Searchy,blackhand,1373,mage,fire,557,289,268
Freeyourmind,kazzak,1371,mage,fire,74,35,39
Anshara,stormscale,1370,mage,fire,102,63,39
Óoj,outland,1370,mage,fire,57,32,25
Aeghis,darkspear,1370,mage,fire,36,20,16
Vanser,kazzak,1370,mage,fire,42,22,20
Дырявка,galakrond,1370,mage,fire,124,64,60
Frostytutes,ragnaros,1369,mage,fire,132,69,63
Varenca,blackrock,1367,mage,fire,117,60,57
Camaeel,aegwynn,1367,mage,fire,47,21,26
Spellsteal,antonidas,1366,mage,fire,126,54,72
Stylaaz,twisting-nether,1365,mage,fire,89,47,42
Wëylin,chogall,1364,mage,fire,51,28,23
Krykz,sanguino,1364,mage,fire,87,41,46
Kundry,tarren-mill,1363,mage,fire,42,19,23
Zigøuillette,hyjal,1363,mage,fire,48,20,28
Sylvîe,tarren-mill,1362,mage,fire,107,53,54
Drwrey,tarren-mill,1361,mage,fire,53,29,24
Бабайбайкала,gordunni,1361,mage,fire,295,147,148
Tigerblod,tarren-mill,1360,mage,fire,28,16,12
Lompenlouder,ragnaros,1360,mage,fire,29,15,14
Justjunzy,archimonde,1360,mage,fire,40,20,20
Immortanjoe,thrall,1359,mage,fire,105,55,50
Spispi,burning-legion,1359,mage,fire,44,19,25
Финиси,gordunni,1358,mage,fire,23,15,8
Wumz,blackrock,1358,mage,fire,69,33,36
Исендэя,gordunni,1358,mage,fire,69,28,41
Pewwpewwpeww,doomhammer,1354,mage,fire,161,81,80
Ønlyfünds,archimonde,1354,mage,fire,81,37,44
Lupuus,anubarak,1354,mage,fire,42,17,25
Dubstep,blackrock,1353,mage,fire,84,47,37
Magmarro,burning-legion,1350,mage,fire,155,78,77
Kamatschu,blackrock,1348,mage,fire,47,21,26
Loøgaã,ysondre,1347,mage,fire,66,33,33
Hoodmago,blackrock,1346,mage,fire,30,15,15
Capz,outland,1346,mage,fire,48,22,26
Jorik,burning-legion,1344,mage,fire,45,24,21
Айсфурия,gordunni,1344,mage,fire,49,24,25
Ckrax,sanguino,1343,mage,fire,29,15,14
Pyrobro,the-venture-co,1342,mage,fire,132,67,65
Darkice,sanguino,1342,mage,fire,195,97,98
Snogagane,ravencrest,1341,mage,fire,18,14,4
Росвенд,gordunni,1341,mage,fire,24,14,10
Kînn,blackrock,1341,mage,fire,60,31,29
Magegôd,outland,1340,mage,fire,24,14,10
Hérä,archimonde,1337,mage,fire,24,14,10
Teaeeth,silvermoon,1337,mage,fire,42,24,18
Jennao,stormscale,1336,mage,fire,24,14,10
Pyro,eldrethalas,1336,mage,fire,63,28,35
Gandelfmaly,burning-legion,1335,mage,fire,24,14,10
Firever,sanguino,1335,mage,fire,72,32,40
Spacehoe,stormscale,1335,mage,fire,36,14,22
Belgravia,silvermoon,1334,mage,fire,24,14,10
Bullegong,archimonde,1334,mage,fire,24,14,10
Yoken,tarren-mill,1334,mage,fire,24,14,10
Djpørtnite,blackrock,1334,mage,fire,48,19,29
Zumbacafew,twisting-nether,1333,mage,fire,24,14,10
Olzaa,outland,1333,mage,fire,24,14,10
Pyroden,stormscale,1332,mage,fire,60,36,24
Onlymage,ravencrest,1332,mage,fire,71,39,32
Vyuca,argent-dawn,1332,mage,fire,32,16,16
Edelvise,azjolnerub,1331,mage,fire,44,22,22
Stønéy,outland,1330,mage,fire,36,20,16
Nïo,ravencrest,1330,mage,fire,158,74,84
Bustymage,tarren-mill,1330,mage,fire,44,19,25
Фирдаркнесс,howling-fjord,1330,mage,fire,41,16,25
Baconlife,tarren-mill,1329,mage,fire,77,50,27
Zjap,argent-dawn,1327,mage,fire,48,25,23
Plessx,sylvanas,1326,mage,fire,51,35,16
Quiwi,dun-modr,1325,mage,fire,72,43,29
Illius,kelthuzad,1325,mage,fire,62,32,30
Pwntt,terenas,1325,mage,fire,54,26,28
Xianji,ragnaros,1325,mage,fire,30,14,16
Màzikeen,stormscale,1324,mage,fire,30,14,16
Lepeps,silvermoon,1323,mage,fire,73,34,39
Criticaldmg,malganis,1322,mage,fire,60,30,30
Feuererdnuss,blackhand,1321,mage,fire,86,46,40
Chïll,ragnaros,1320,mage,fire,33,16,17
Rapidfrost,drakthul,1319,mage,fire,85,54,31
Orphx,draenor,1319,mage,fire,53,23,30
Mirobol,hyjal,1318,mage,fire,60,29,31
Martiqabelle,dun-morogh,1316,mage,fire,45,24,21
Мерджреквест,howling-fjord,1315,mage,fire,78,40,38
Shinzel,hyjal,1314,mage,fire,83,44,39
Sonofdragon,frostwolf,1314,mage,fire,36,19,17
Magicalmig,draenor,1313,mage,fire,129,76,53
Gregoss,elune,1313,mage,fire,67,35,32
Tombkiller,kult-der-verdammten,1313,mage,fire,162,80,82
Jockin,stormrage,1312,mage,fire,30,15,15
Drëâms,archimonde,1310,mage,fire,30,15,15
Skarxaa,sanguino,1310,mage,fire,126,59,67
Drunkpunk,kazzak,1309,mage,fire,121,72,49
Xkod,draenor,1309,mage,fire,66,33,33
Necro,zuljin,1309,mage,fire,80,39,41
Shiftea,argent-dawn,1307,mage,fire,30,16,14
Illurya,aegwynn,1307,mage,fire,36,17,19
Tiltedpapi,ravencrest,1307,mage,fire,92,40,52
Wormhole,kazzak,1305,mage,fire,40,15,25
Anthyria,blackmoore,1299,mage,fire,24,16,8
Cutiepanda,defias-brotherhood,1298,mage,fire,72,28,44
Nuvx,ravencrest,1296,mage,fire,90,51,39
Benihimé,doomhammer,1296,mage,fire,30,14,16
Milgha,nemesis,1292,mage,fire,48,24,24
Bakeren,frostmane,1290,mage,fire,30,14,16
Даатхедра,booty-bay,1290,mage,fire,36,14,22
Troldejan,stormscale,1289,mage,fire,24,14,10
Аваон,deathguard,1289,mage,fire,136,67,69
Momomagic,silvermoon,1289,mage,fire,70,33,37
Hahahehe,aegwynn,1288,mage,fire,45,24,21
Nightplays,sylvanas,1285,mage,fire,36,19,17
Gerdâ,chants-éternels,1285,mage,fire,113,59,54
Zorw,aggra-português,1285,mage,fire,66,29,37
Cruscru,stormscale,1284,mage,fire,129,59,70
Babymagici,kazzak,1282,mage,fire,30,18,12
Jointsmøker,outland,1281,mage,fire,71,38,33
Fiveboyjr,tarren-mill,1279,mage,fire,90,46,44
Slíps,silvermoon,1279,mage,fire,65,29,36
Blackpantha,blackmoore,1278,mage,fire,56,31,25
Iulie,kazzak,1275,mage,fire,43,20,23
Sqwiz,outland,1273,mage,fire,63,30,33
Быкуня,gordunni,1270,mage,fire,108,56,52
Insømnium,stormscale,1270,mage,fire,31,16,15
Ziscine,tarren-mill,1270,mage,fire,63,28,35
Ihatemages,stormreaver,1270,mage,fire,66,27,39
Romethito,dun-modr,1269,mage,fire,48,31,17
Mauvé,blades-edge,1266,mage,fire,65,33,32
Greey,blackhand,1265,mage,fire,44,22,22
Tygaone,tirion,1264,mage,fire,76,33,43
Cyrîll,malygos,1263,mage,fire,133,75,58
Zyreanx,blackrock,1263,mage,fire,25,14,11
Эпсиха,lich-king,1263,mage,fire,36,19,17
Zionara,stormscale,1263,mage,fire,214,108,106
Dobbite,archimonde,1261,mage,fire,80,49,31
Rhodghar,ravencrest,1259,mage,fire,60,24,36
Svalbard,ragnaros,1259,mage,fire,48,17,31
Mohovik,wildhammer,1258,mage,fire,24,14,10
Мегумин,galakrond,1257,mage,fire,131,69,62
Däpper,ragnaros,1256,mage,fire,26,14,12
Fleqs,antonidas,1256,mage,fire,36,14,22
Ethélinda,kirin-tor,1256,mage,fire,54,19,35
Dmme,dun-morogh,1255,mage,fire,42,18,24
Jhawkwizard,draenor,1254,mage,fire,43,28,15
Eddiee,outland,1252,mage,fire,156,73,83
Lerdasza,exodar,1252,mage,fire,51,17,34
Валбериса,deepholm,1249,mage,fire,28,20,8
Шеллестун,soulflayer,1249,mage,fire,48,28,20
Megancox,blackmoore,1249,mage,fire,62,35,27
Kuríbo,gorgonnash,1249,mage,fire,63,34,29
Ezìl,nemesis,1249,mage,fire,42,17,25
Lyrath,tarren-mill,1247,mage,fire,18,13,5
Usererror,ravencrest,1247,mage,fire,18,13,5
Фрозитв,blackscar,1247,mage,fire,18,13,5
Wizmec,silvermoon,1247,mage,fire,207,98,109
Knulljonný,kazzak,1247,mage,fire,30,13,17
Ямм,blackscar,1247,mage,fire,60,25,35
Monkeydmafia,blackrock,1246,mage,fire,18,13,5
Jörs,stormreaver,1246,mage,fire,18,13,5
Shirrunn,the-maelstrom,1246,mage,fire,24,13,11
Mangiafuoco,nemesis,1246,mage,fire,30,13,17
Ioriyagami,dragonmaw,1245,mage,fire,23,14,9
Èverix,ravencrest,1245,mage,fire,24,13,11
Johnnydeepp,archimonde,1244,mage,fire,18,13,5
Xläderz,ravencrest,1244,mage,fire,24,13,11
Stickydog,blackmoore,1243,mage,fire,24,13,11
Letstryfrost,ragnaros,1243,mage,fire,54,29,25
Dsmoke,ravencrest,1242,mage,fire,24,13,11
Flødeost,outland,1241,mage,fire,24,13,11
Самза,howling-fjord,1240,mage,fire,90,51,39
Hógwarts,aegwynn,1240,mage,fire,24,13,11
Diffa,tarren-mill,1240,mage,fire,24,13,11
Zivac,kazzak,1240,mage,fire,24,13,11
Freezeballs,blackmoore,1240,mage,fire,48,21,27
Вельдрик,soulflayer,1239,mage,fire,104,50,54
Astaden,die-aldor,1239,mage,fire,30,13,17
Zestrax,kazzak,1238,mage,fire,60,34,26
Magicshow,arathor,1238,mage,fire,30,13,17
Vxvfrowstxvx,jaedenar,1237,mage,fire,24,13,11
Dwang,nemesis,1236,mage,fire,24,13,11
Grandbasile,hyjal,1235,mage,fire,42,13,29
Zadnik,tarren-mill,1234,mage,fire,75,37,38
Занерзулаа,soulflayer,1234,mage,fire,35,14,21
Omegadrill,frostmane,1233,mage,fire,24,13,11
Magechonk,kazzak,1233,mage,fire,30,13,17
Вселениум,razuvious,1232,mage,fire,63,32,31
Дмблдр,soulflayer,1232,mage,fire,45,22,23
Estwald,arathor,1232,mage,fire,47,22,25
Themagîcian,silvermoon,1232,mage,fire,33,14,19
Isiah,kaelthas,1231,mage,fire,178,88,90
Grep,stormscale,1231,mage,fire,90,38,52
Wushii,aggra-português,1231,mage,fire,44,17,27
Banjó,twilights-hammer,1230,mage,fire,30,13,17
Khalkazzar,darkspear,1230,mage,fire,42,17,25
Susantek,antonidas,1228,mage,fire,30,13,17
Fritmckhaine,archimonde,1227,mage,fire,108,61,47
Warwizz,sanguino,1226,mage,fire,24,13,11
Rutemarlene,ravencrest,1225,mage,fire,46,21,25
Zuckerzimt,ravencrest,1224,mage,fire,30,13,17
Silatara,twisting-nether,1223,mage,fire,24,13,11
Majinbo,doomhammer,1221,mage,fire,36,21,15
Mayoeba,twisting-nether,1220,mage,fire,63,35,28
Ràyden,khaz-modan,1219,mage,fire,36,18,18
Hidrax,outland,1219,mage,fire,64,28,36
Magicuze,argent-dawn,1217,mage,fire,90,37,53
Roey,defias-brotherhood,1214,mage,fire,60,30,30
Айсбоунт,eversong,1214,mage,fire,72,30,42
Брюнхильда,deepholm,1211,mage,fire,33,15,18
Shadowmag,burning-legion,1209,mage,fire,207,104,103
Джеззабэль,ashenvale,1204,mage,fire,24,15,9
Magicarno,kazzak,1204,mage,fire,78,37,41
Zaci,argent-dawn,1201,mage,fire,30,14,16
Wankel,blackmoore,1201,mage,fire,89,38,51
Эстерленс,gordunni,1199,mage,fire,199,108,91
Neoreactor,ravencrest,1198,mage,fire,24,13,11
Wîtchcurse,dentarg,1197,mage,fire,36,15,21
Kilféfroid,ysondre,1196,mage,fire,70,38,32
Sephron,malganis,1192,mage,fire,47,16,31
Slashkiiss,archimonde,1188,mage,fire,146,75,71
Tehotyttö,dragonblight,1188,mage,fire,105,43,62
Nezousta,sinstralis,1187,mage,fire,42,21,21
Haelia,ysondre,1186,mage,fire,44,28,16
Hargun,the-maelstrom,1184,mage,fire,48,17,31
Init,argent-dawn,1183,mage,fire,76,29,47
Bonto,tarren-mill,1182,mage,fire,52,23,29
Blasic,stormscale,1182,mage,fire,41,18,23
Фрайзо,gordunni,1181,mage,fire,108,49,59
Specta,tarren-mill,1181,mage,fire,35,14,21
Wapity,archimonde,1178,mage,fire,40,14,26
Ærrøx,hyjal,1177,mage,fire,54,22,32
Athenå,dalaran,1176,mage,fire,48,21,27
Clappycheeks,antonidas,1175,mage,fire,90,39,51
Линклер,fordragon,1175,mage,fire,54,23,31
Blitzo,madmortem,1174,mage,fire,53,29,24
Sam,outland,1170,mage,fire,23,13,10
Jipa,tarren-mill,1168,mage,fire,48,18,30
Ccxz,draenor,1166,mage,fire,17,13,4
Darkoftw,ysondre,1166,mage,fire,25,13,12
Spártá,ragnaros,1166,mage,fire,83,41,42
Dóncójones,blackrock,1166,mage,fire,113,51,62
Xânârchy,minahonda,1164,mage,fire,42,17,25
Tratuf,hyjal,1163,mage,fire,27,13,14
Азгас,soulflayer,1160,mage,fire,72,38,34
Critzeklein,antonidas,1158,mage,fire,66,25,41
Corpusqq,eredar,1156,mage,fire,29,13,16
Querasimar,blackrock,1154,mage,fire,30,14,16
Larah,les-clairvoyants,1154,mage,fire,42,19,23
Linyah,arathor,1154,mage,fire,36,16,20
Posthúme,hyjal,1154,mage,fire,36,14,22
Máurus,antonidas,1153,mage,fire,46,15,31
Dzomage,kazzak,1152,mage,fire,30,14,16
Neverblockx,blackrock,1151,mage,fire,18,12,6
Praison,defias-brotherhood,1151,mage,fire,18,12,6
Bzzr,tarren-mill,1150,mage,fire,18,12,6
Kaki,stormscale,1150,mage,fire,36,19,17
Palpfiction,silvermoon,1150,mage,fire,24,12,12
Azulêera,archimonde,1149,mage,fire,24,12,12
Córgi,ravencrest,1149,mage,fire,24,12,12
Koreanbbq,kazzak,1148,mage,fire,18,12,6
Wizarð,archimonde,1147,mage,fire,35,14,21
Tarporion,culte-de-la-rive-noire,1145,mage,fire,24,12,12
Demensida,ravencrest,1145,mage,fire,28,13,15
Bamz,malganis,1144,mage,fire,24,12,12
Taylorswîft,ragnaros,1143,mage,fire,18,12,6
Purrpl,twisting-nether,1143,mage,fire,27,14,13
Avakadaver,draenor,1143,mage,fire,24,12,12
Drfröst,kazzak,1143,mage,fire,24,12,12
Saturator,burning-legion,1142,mage,fire,53,17,36
Ronnyraggare,silvermoon,1141,mage,fire,24,12,12
Frostwaffles,draenor,1141,mage,fire,24,12,12
Crackheads,hyjal,1141,mage,fire,24,12,12
Xèrec,ysondre,1141,mage,fire,32,14,18
Zhazam,blades-edge,1141,mage,fire,54,23,31
Inaruy,hyjal,1141,mage,fire,30,12,18
Themagicguy,silvermoon,1140,mage,fire,24,12,12
Aûrûm,silvermoon,1140,mage,fire,24,12,12
Skitsó,shadowsong,1139,mage,fire,48,29,19
Oiklo,eitrigg,1139,mage,fire,42,25,17
Khronic,darksorrow,1139,mage,fire,24,12,12
Castaneda,hellfire,1138,mage,fire,121,69,52
Tessai,sargeras,1138,mage,fire,24,12,12
Frozeh,archimonde,1137,mage,fire,24,12,12
Fäust,drakthul,1136,mage,fire,52,16,36
Gàtsby,outland,1132,mage,fire,36,12,24
Асидочка,soulflayer,1130,mage,fire,129,63,66
Vurtnez,kazzak,1129,mage,fire,42,19,23
Metaboi,ragnaros,1128,mage,fire,24,12,12
Didub,outland,1128,mage,fire,36,15,21
Gavra,ravencrest,1127,mage,fire,24,12,12
Lanadorei,stormscale,1126,mage,fire,53,26,27
Hiimlynx,sylvanas,1124,mage,fire,29,12,17
Rasputina,blackrock,1121,mage,fire,89,45,44
Kebkhadar,ravencrest,1121,mage,fire,36,14,22
Ðjwåtermeløn,ravencrest,1119,mage,fire,23,12,11
Lybazinga,frostmane,1118,mage,fire,55,25,30
Incenia,ravencrest,1117,mage,fire,35,14,21
Mohrgan,malorne,1115,mage,fire,38,13,25
Frøze,twisting-nether,1113,mage,fire,111,53,58
Maggresive,sylvanas,1112,mage,fire,100,47,53
Jaídy,aegwynn,1111,mage,fire,135,65,70
Leontus,outland,1110,mage,fire,30,16,14
Buuszek,outland,1109,mage,fire,53,28,25
Скиллао,gordunni,1109,mage,fire,59,28,31
Illiaria,antonidas,1108,mage,fire,66,30,36
Zedsdeadbaby,argent-dawn,1107,mage,fire,54,27,27
Xblaz,draenor,1106,mage,fire,26,13,13
Verygoodgame,blackrock,1102,mage,fire,17,12,5
Секвой,soulflayer,1099,mage,fire,21,12,9
Worstlove,blackrock,1099,mage,fire,44,23,21
Мизерун,deathguard,1099,mage,fire,231,111,120
Rmforever,archimonde,1096,mage,fire,88,46,42
Focusnik,silvermoon,1095,mage,fire,23,12,11
Xenodike,blackrock,1094,mage,fire,60,34,26
Магниффика,blackscar,1094,mage,fire,48,24,24
Piscialetto,nemesis,1094,mage,fire,88,39,49
Cexxar,kazzak,1093,mage,fire,102,45,57
Mansnotbløck,ravencrest,1086,mage,fire,17,12,5
Phenoxi,sylvanas,1083,mage,fire,20,12,8
Underground,naxxramas,1082,mage,fire,22,12,10
Roberx,sanguino,1079,mage,fire,28,12,16
Prskalica,kazzak,1075,mage,fire,49,18,31
Iwannakissu,gorgonnash,1072,mage,fire,47,27,20
Gorleg,draenor,1072,mage,fire,47,17,30
Newtwo,ravencrest,1070,mage,fire,25,12,13
Blazenaa,drakthul,1069,mage,fire,43,23,20
Zeddic,burning-legion,1067,mage,fire,235,114,121
Kalyipso,blackrock,1067,mage,fire,54,21,33
Kazekudo,archimonde,1066,mage,fire,17,12,5
Bambaga,kazzak,1061,mage,fire,31,19,12
Deadsmells,ragnaros,1060,mage,fire,117,47,70
Mirajânê,blackmoore,1059,mage,fire,28,12,16
Bördanqt,twisting-nether,1056,mage,fire,12,11,1
Ilikesheep,blackmoore,1056,mage,fire,18,11,7
Kaeser,ravencrest,1055,mage,fire,18,11,7
Sylbris,outland,1055,mage,fire,18,11,7
Pævl,drakthul,1055,mage,fire,18,11,7
Träshxd,sanguino,1055,mage,fire,24,11,13
Джинетикс,deathguard,1054,mage,fire,18,11,7
Ference,tichondrius,1054,mage,fire,31,12,19
Döom,chamber-of-aspects,1053,mage,fire,30,11,19
Permafrost,drakthul,1053,mage,fire,34,12,22
Мьёрэ,soulflayer,1052,mage,fire,30,15,15
Coken,trollbane,1052,mage,fire,24,11,13
Merlindo,outland,1052,mage,fire,24,11,13
Zerøsílgødx,antonidas,1051,mage,fire,21,12,9
Pyrokariolis,argent-dawn,1051,mage,fire,24,11,13
Kanjani,antonidas,1051,mage,fire,28,12,16
Zisseron,frostmane,1051,mage,fire,66,20,46
Icebane,blackrock,1049,mage,fire,48,15,33
Suggestion,ragnaros,1048,mage,fire,12,11,1
Dibzz,sanguino,1048,mage,fire,18,11,7
Kogeren,tarren-mill,1048,mage,fire,24,11,13
Barspin,lightnings-blade,1047,mage,fire,18,11,7
Fireboss,the-maelstrom,1046,mage,fire,24,14,10
Sokardes,the-maelstrom,1046,mage,fire,28,12,16
Pablø,blackrock,1043,mage,fire,58,29,29
Shalima,nethersturm,1043,mage,fire,24,11,13
Ярелия,soulflayer,1043,mage,fire,46,14,32
Laetitiah,archimonde,1042,mage,fire,26,11,15
Kyani,mannoroth,1042,mage,fire,34,12,22
Вираи,soulflayer,1041,mage,fire,30,11,19
Spader,argent-dawn,1040,mage,fire,30,12,18
Rõdokunohi,darksorrow,1039,mage,fire,46,18,28
Pipihu,silvermoon,1038,mage,fire,28,12,16
Dyx,nemesis,1036,mage,fire,89,42,47
Szarbán,ragnaros,1035,mage,fire,29,11,18
Mgtt,defias-brotherhood,1033,mage,fire,80,28,52
Zymage,silvermoon,1030,mage,fire,33,12,21
Devilpain,zuluhed,1027,mage,fire,60,26,34
Anghim,tarren-mill,1025,mage,fire,18,11,7
Tóadette,die-aldor,1022,mage,fire,88,39,49
Draenaya,forscherliga,1011,mage,fire,38,16,22
Непоняли,gordunni,1008,mage,fire,74,30,44
Севериан,gordunni,1004,mage,fire,51,23,28
Хээйлии,goldrinn,1001,mage,fire,30,15,15
Dualin,sanguino,1001,mage,fire,99,45,54
Jobarttrach,les-clairvoyants,996,mage,fire,127,58,69
Комонщик,howling-fjord,993,mage,fire,30,11,19
Icx,tarren-mill,989,mage,fire,120,61,59
Arcáge,azjolnerub,988,mage,fire,29,14,15
Зубарол,gordunni,984,mage,fire,49,24,25
Lovesosa,malorne,977,mage,fire,45,21,24
Aurelius,kargath,971,mage,fire,19,11,8
Plazem,argent-dawn,971,mage,fire,54,20,34
Vêganêr,blackmoore,965,mage,fire,65,37,28
Freezandrun,tarren-mill,962,mage,fire,71,35,36
Cräzÿfrøst,archimonde,961,mage,fire,25,11,14
Sukmikok,twisting-nether,960,mage,fire,12,10,2
Benzol,eredar,960,mage,fire,18,10,8
Misay,outland,960,mage,fire,24,10,14
Stabmagey,twisting-nether,959,mage,fire,12,10,2
Jarim,alleria,959,mage,fire,15,11,4
Cÿa,tarren-mill,959,mage,fire,18,10,8
Questgrills,kazzak,959,mage,fire,18,10,8
Astrryy,burning-legion,959,mage,fire,18,10,8
Soulraider,tarren-mill,959,mage,fire,18,10,8
Coldikay,archimonde,959,mage,fire,18,10,8
Drè,daggerspine,959,mage,fire,18,10,8
Kirbi,blackmoore,959,mage,fire,18,10,8
Chareyla,argent-dawn,959,mage,fire,18,10,8
Firen,thrall,959,mage,fire,51,27,24
Lazuly,blackhand,959,mage,fire,117,51,66
Dalaras,archimonde,959,mage,fire,24,10,14
Choccookies,lordaeron,959,mage,fire,33,11,22
Gelubabadook,ravencrest,958,mage,fire,12,10,2
Ахиригиз,gordunni,958,mage,fire,18,10,8
Sorrow,outland,958,mage,fire,24,10,14
Мелми,howling-fjord,958,mage,fire,36,10,26
Nergl,darksorrow,957,mage,fire,24,10,14
Нехай,ashenvale,957,mage,fire,24,10,14
Alyraza,chamber-of-aspects,957,mage,fire,24,10,14
Hotafazz,ravencrest,956,mage,fire,18,10,8
Люртакз,gordunni,956,mage,fire,24,10,14
Mìsaki,hellscream,955,mage,fire,24,10,14
Trenpapi,twisting-nether,955,mage,fire,24,10,14
Internals,tarren-mill,955,mage,fire,24,10,14
Shìnra,ravencrest,955,mage,fire,24,10,14
Furoranight,malfurion,955,mage,fire,73,30,43
Ccoco,anetheron,955,mage,fire,30,11,19
Jambonpistol,archimonde,954,mage,fire,18,10,8
Njl,blackmoore,954,mage,fire,18,10,8
Dätox,kazzak,953,mage,fire,18,10,8
Çana,thrall,952,mage,fire,30,10,20
Shealá,blackhand,951,mage,fire,24,10,14
Firewitch,blackhand,950,mage,fire,24,10,14
Boumayé,archimonde,949,mage,fire,24,10,14
Hopewell,aszune,949,mage,fire,30,10,20
Crashice,blackmoore,944,mage,fire,18,10,8
Glacìal,ravencrest,943,mage,fire,30,10,20
Mässîvècøx,ragnaros,940,mage,fire,23,10,13
Пиньон,borean-tundra,937,mage,fire,25,11,14
Кельтаз,soulflayer,932,mage,fire,30,15,15
Pyro,daggerspine,924,mage,fire,60,32,28
Häddës,archimonde,919,mage,fire,54,31,23
Netherstorm,chogall,917,mage,fire,102,49,53
Warpx,aegwynn,913,mage,fire,364,183,181
Naxeos,turalyon,911,mage,fire,23,10,13
Sagregas,silvermoon,908,mage,fire,192,92,100
Flamya,stormscale,905,mage,fire,23,10,13
Tarryxa,kazzak,905,mage,fire,35,10,25
Texhex,ahnqiraj,905,mage,fire,42,11,31
Nakamura,outland,901,mage,fire,26,11,15
Laviathan,die-aldor,896,mage,fire,26,14,12
Santoz,blackrock,893,mage,fire,220,109,111
Cheeku,outland,892,mage,fire,23,10,13
Nåzmyz,outland,891,mage,fire,23,10,13
Evrem,karazhan,886,mage,fire,24,12,12
Vantimere,twisting-nether,886,mage,fire,31,11,20
Magyxk,blackmoore,881,mage,fire,14,10,4
Smî,aegwynn,875,mage,fire,48,24,24
Twizzax,silvermoon,864,mage,fire,12,9,3
Mmrlancer,blackmoore,864,mage,fire,12,9,3
Joqz,tarren-mill,864,mage,fire,12,9,3
Magebraín,ravencrest,864,mage,fire,12,9,3
Elysiar,kazzak,864,mage,fire,12,9,3
Kiey,silvermoon,864,mage,fire,12,9,3
Magerocks,ragnaros,864,mage,fire,12,9,3
Abóve,outland,864,mage,fire,12,9,3
Dastion,sylvanas,864,mage,fire,12,9,3
Внд,gordunni,864,mage,fire,17,9,8
Tills,kargath,864,mage,fire,18,9,9
Pyllymake,kazzak,864,mage,fire,18,9,9
Símple,sylvanas,864,mage,fire,18,9,9
Drfeeldgoodd,mazrigos,864,mage,fire,18,9,9
Gadeplan,sylvanas,864,mage,fire,18,9,9
Razx,stormscale,864,mage,fire,24,9,15
Tagrine,kaelthas,863,mage,fire,12,9,3
Katzron,twisting-nether,863,mage,fire,18,9,9
Инкрионити,gordunni,863,mage,fire,18,9,9
Frostyflakés,stormscale,863,mage,fire,18,9,9
Vixis,dalaran,863,mage,fire,18,9,9
Feath,ravencrest,863,mage,fire,18,9,9
Pelsky,zenedar,863,mage,fire,18,9,9
Sheepo,tarren-mill,863,mage,fire,18,9,9
Wizkhafury,ravencrest,863,mage,fire,18,9,9
Spellhaze,outland,863,mage,fire,24,9,15
Idron,dunemaul,863,mage,fire,24,9,15
Brãein,uldaman,862,mage,fire,12,9,3
Cesirys,silvermoon,862,mage,fire,12,9,3
Ardu,burning-legion,862,mage,fire,18,9,9
Marðuk,blackmoore,862,mage,fire,18,9,9
Onebutononly,stormrage,862,mage,fire,18,9,9
Internèthùlk,ravencrest,862,mage,fire,20,9,11
Феновар,goldrinn,862,mage,fire,24,9,15
Hokuspokicus,ravencrest,862,mage,fire,24,9,15
Adinferno,zenedar,861,mage,fire,12,9,3
Abocajarro,dun-modr,861,mage,fire,18,9,9
Sszz,ravencrest,861,mage,fire,24,9,15
Jæel,archimonde,860,mage,fire,114,41,73
Reeroll,arthas,860,mage,fire,30,9,21
Чоуза,gordunni,858,mage,fire,24,9,15
Неуклюжый,soulflayer,858,mage,fire,24,9,15
Drewna,silvermoon,856,mage,fire,16,10,6
Houdiní,stormscale,855,mage,fire,24,10,14
Bigbazzabean,silvermoon,849,mage,fire,42,17,25
Halbattar,garona,846,mage,fire,123,58,65
Ofeu,archimonde,845,mage,fire,29,9,20
Nagano,deathwing,827,mage,fire,23,9,14
Veveroiu,defias-brotherhood,822,mage,fire,51,22,29
Ølórin,silvermoon,820,mage,fire,72,24,48
Aetaliken,eredar,815,mage,fire,17,9,8
Liloz,aegwynn,815,mage,fire,21,10,11
Nightnovae,ravencrest,810,mage,fire,19,10,9
Malicä,ravencrest,794,mage,fire,96,40,56
Løxyy,ysondre,793,mage,fire,36,12,24
Apollohouse,ravencrest,768,mage,fire,12,8,4
Lestrangé,azjolnerub,768,mage,fire,12,8,4
Panikdoktor,silvermoon,768,mage,fire,12,8,4
Spellonfire,ravencrest,768,mage,fire,12,8,4
Riboe,outland,768,mage,fire,12,8,4
Stockfísh,ravencrest,768,mage,fire,12,8,4
Wilhélm,twisting-nether,768,mage,fire,12,8,4
Bràndy,twisting-nether,768,mage,fire,12,8,4
Dardíe,ravencrest,768,mage,fire,12,8,4
Seshlad,stormscale,768,mage,fire,12,8,4
Sölø,stormscale,768,mage,fire,12,8,4
Matsuratkø,nemesis,768,mage,fire,12,8,4
Папущенный,soulflayer,768,mage,fire,12,8,4
Макотшельник,gordunni,768,mage,fire,12,8,4
Авгурей,galakrond,768,mage,fire,12,8,4
Mlodysimba,burning-legion,768,mage,fire,12,8,4
Dampgame,twisting-nether,768,mage,fire,18,8,10
Zelimeth,outland,768,mage,fire,18,8,10
Procahontas,ravencrest,768,mage,fire,18,8,10
Airo,drakthul,768,mage,fire,24,8,16
Mðj,kazzak,768,mage,fire,24,8,16
Чиллмен,ashenvale,767,mage,fire,12,8,4
Génociidz,archimonde,767,mage,fire,12,8,4
Fatefully,ravencrest,767,mage,fire,12,8,4
Grailandia,uldum,767,mage,fire,18,8,10
Tainted,eredar,767,mage,fire,18,8,10
Ephai,tarren-mill,767,mage,fire,18,8,10
Sapien,sanguino,767,mage,fire,18,8,10
Testzerodeux,archimonde,767,mage,fire,18,8,10
Coldwanderer,kazzak,767,mage,fire,18,8,10
Codeincassie,blackhand,767,mage,fire,18,8,10
Suma,archimonde,767,mage,fire,18,8,10
Elreas,blackmoore,767,mage,fire,18,8,10
Эммилиарда,gordunni,767,mage,fire,18,8,10
Dynamica,ravencrest,767,mage,fire,18,8,10
Silvermage,eonar,767,mage,fire,24,8,16
Takiix,antonidas,766,mage,fire,12,8,4
Faithlessma,azshara,766,mage,fire,12,8,4
Тереньтьев,goldrinn,766,mage,fire,18,8,10
Zoba,sylvanas,766,mage,fire,18,8,10
Onemanrave,ravencrest,766,mage,fire,18,8,10
Schøkø,eredar,766,mage,fire,24,8,16
Copiüm,kazzak,765,mage,fire,18,8,10
Quente,aegwynn,765,mage,fire,24,8,16
Perk,grim-batol,765,mage,fire,59,12,47
Louiewiz,outland,764,mage,fire,12,8,4
Solarian,nemesis,764,mage,fire,18,8,10
Exxylia,aegwynn,763,mage,fire,18,8,10
Iamslow,sylvanas,762,mage,fire,12,8,4
Elterion,sylvanas,760,mage,fire,24,8,16
Mogettemagic,ysondre,760,mage,fire,33,9,24
Убегай,soulflayer,759,mage,fire,24,8,16
Arcadua,sanguino,758,mage,fire,12,8,4
Йяу,howling-fjord,758,mage,fire,24,8,16
Bladzior,burning-legion,757,mage,fire,18,8,10
Damnlate,blackmoore,753,mage,fire,32,11,21
Фиеран,grom,747,mage,fire,26,10,16
Rosady,ragnaros,745,mage,fire,19,10,9
Kalyypso,arygos,735,mage,fire,16,9,7
Gotone,tarren-mill,734,mage,fire,20,9,11
Mitchmage,ravencrest,732,mage,fire,17,8,9
Нубарь,thermaplugg,731,mage,fire,18,8,10
Gûl,kazzak,726,mage,fire,143,38,105
Mercem,stormscale,719,mage,fire,11,8,3
Bjay,hyjal,719,mage,fire,17,8,9
Haileigh,tarren-mill,715,mage,fire,111,41,70
Monfisback,archimonde,703,mage,fire,11,8,3
Genviedgiclé,arathi,703,mage,fire,17,8,9
Käd,la-croisade-écarlate,703,mage,fire,17,8,9
Сенсемилия,soulflayer,702,mage,fire,20,8,12
Vallas,drakthul,688,mage,fire,13,8,5
Тудысюдым,eversong,684,mage,fire,19,8,11
Pàntera,blackmoore,683,mage,fire,31,8,23
Magicspark,madmortem,674,mage,fire,87,39,48
Wizbiz,lightbringer,672,mage,fire,12,7,5
Gnðmeonfire,sylvanas,672,mage,fire,12,7,5
Barzle,blackmoore,672,mage,fire,12,7,5
Pïeck,archimonde,672,mage,fire,12,7,5
Euklid,ravencrest,672,mage,fire,12,7,5
Tirenia,bloodfeather,672,mage,fire,12,7,5
Highrollerqt,tarren-mill,672,mage,fire,12,7,5
Fckkicks,thrall,672,mage,fire,12,7,5
Coombuster,kazzak,672,mage,fire,12,7,5
Mylanq,ragnaros,672,mage,fire,12,7,5
Sainth,sanguino,672,mage,fire,12,7,5
Кодимагх,gordunni,672,mage,fire,12,7,5
Учительйода,ashenvale,672,mage,fire,12,7,5
Bananflickan,kazzak,672,mage,fire,12,7,5
Melíssa,silvermoon,672,mage,fire,12,7,5
Sykz,hyjal,672,mage,fire,12,7,5
Mfnz,stormreaver,672,mage,fire,12,7,5
Necizbored,tarren-mill,672,mage,fire,12,7,5
Iconic,eredar,672,mage,fire,12,7,5
Rotøk,burning-legion,672,mage,fire,12,7,5
Pyromaníac,blackrock,672,mage,fire,16,8,8
Анзот,howling-fjord,672,mage,fire,18,7,11
Anaxtra,guldan,672,mage,fire,18,7,11
Waan,sylvanas,672,mage,fire,18,7,11
Wmp,ravencrest,672,mage,fire,18,7,11
Billzibub,doomhammer,672,mage,fire,18,7,11
Ødegaård,argent-dawn,671,mage,fire,12,7,5
Azîlko,frostwolf,671,mage,fire,12,7,5
Mumpii,blackrock,671,mage,fire,12,7,5
Uwutehe,ravencrest,671,mage,fire,12,7,5
Mansnotblock,antonidas,671,mage,fire,18,7,11
Hasslad,tarren-mill,671,mage,fire,18,7,11
Cammly,drakthul,671,mage,fire,18,7,11
Magichalek,burning-legion,671,mage,fire,18,7,11
Hacksopa,twisting-nether,671,mage,fire,18,7,11
Julieliphie,silvermoon,671,mage,fire,18,7,11
Ceinxjk,ravencrest,670,mage,fire,12,7,5
Arhan,argent-dawn,670,mage,fire,12,7,5
Yennéfér,outland,670,mage,fire,18,7,11
Crackcocainx,blackrock,670,mage,fire,18,7,11
Жгумпель,howling-fjord,670,mage,fire,24,7,17
Awart,burning-legion,670,mage,fire,24,7,17
Vanah,the-maelstrom,669,mage,fire,12,7,5
Magicalpit,magtheridon,669,mage,fire,24,7,17
Harmal,nemesis,668,mage,fire,18,7,11
Flammiwa,confrérie-du-thorium,668,mage,fire,36,7,29
Briner,ravencrest,667,mage,fire,18,7,11
Kaktuzze,antonidas,664,mage,fire,24,7,17
Elypøde,ysondre,657,mage,fire,12,7,5
Ðonkeykong,outland,654,mage,fire,17,7,10
Vulcanx,stormscale,638,mage,fire,17,7,10
Eatmybarrage,ragnaros,638,mage,fire,17,7,10
ßåsåñ,archimonde,623,mage,fire,11,7,4
Ассих,soulflayer,622,mage,fire,24,7,17
Goukakyu,ravencrest,618,mage,fire,11,7,4
Blueoid,ravencrest,617,mage,fire,19,8,11
Elcritadoré,ragnaros,617,mage,fire,20,8,12
Nabucor,culte-de-la-rive-noire,616,mage,fire,49,11,38
Medium,der-rat-von-dalaran,576,mage,fire,6,6,0
Apcg,sylvanas,576,mage,fire,6,6,0
Sumecm,alexstrasza,576,mage,fire,6,6,0
Gitgud,haomarush,576,mage,fire,6,6,0
Paiz,tarren-mill,576,mage,fire,6,6,0
Ózí,ravencrest,576,mage,fire,6,6,0
Linkxd,stormscale,576,mage,fire,6,6,0
Bestowalfaun,blackmoore,576,mage,fire,10,7,3
Mm,twisting-nether,576,mage,fire,13,7,6
Crinkles,laughing-skull,576,mage,fire,12,6,6
Frôstît,aegwynn,576,mage,fire,12,6,6
Потныйдпс,eversong,576,mage,fire,12,6,6
Bobdacreator,stormscale,576,mage,fire,12,6,6
Derchong,kazzak,576,mage,fire,12,6,6
Ёшимитсо,howling-fjord,576,mage,fire,12,6,6
Magekaoz,sylvanas,576,mage,fire,12,6,6
Needforsheep,archimonde,576,mage,fire,12,6,6
Johannlafer,ravencrest,576,mage,fire,12,6,6
Frostys,les-sentinelles,576,mage,fire,12,6,6
Êgôn,perenolde,576,mage,fire,12,6,6
Suñshiny,ragnaros,576,mage,fire,12,6,6
Canceled,kazzak,576,mage,fire,12,6,6
Qtpoof,sylvanas,576,mage,fire,12,6,6
Zaralarssòn,ravencrest,576,mage,fire,12,6,6
Aurorax,ravencrest,576,mage,fire,12,6,6
Azraiël,burning-legion,576,mage,fire,12,6,6
Aelín,argent-dawn,576,mage,fire,12,6,6
Facerollyo,tarren-mill,576,mage,fire,12,6,6
Alterwhite,archimonde,576,mage,fire,12,6,6
Línays,dalaran,576,mage,fire,12,6,6
Skylez,blackrock,576,mage,fire,12,6,6
Macey,ravencrest,576,mage,fire,12,6,6
Frostvirgin,twisting-nether,576,mage,fire,12,6,6
Blästz,hyjal,576,mage,fire,12,6,6
Santriss,defias-brotherhood,576,mage,fire,12,6,6
Mfu,blackmoore,576,mage,fire,12,6,6
Saucise,hyjal,576,mage,fire,12,6,6
Мэджу,gordunni,576,mage,fire,12,6,6
Naween,hyjal,576,mage,fire,12,6,6
Trucy,eredar,576,mage,fire,12,6,6
Tragìc,blackmoore,576,mage,fire,12,6,6
Jengele,argent-dawn,576,mage,fire,12,6,6
Lovësosa,hyjal,576,mage,fire,16,7,9
Qwibbly,kazzak,576,mage,fire,18,6,12
Gunglefutz,the-maelstrom,576,mage,fire,18,6,12
Nötmârtònxø,ragnaros,576,mage,fire,18,6,12
Burnchildren,burning-steppes,575,mage,fire,12,6,6
Machydapha,outland,575,mage,fire,12,6,6
Ogj,ravencrest,575,mage,fire,12,6,6
Kitchimage,ravencrest,575,mage,fire,12,6,6
Sickles,thrall,575,mage,fire,12,6,6
Crusa,burning-blade,575,mage,fire,18,6,12
Lifymage,sylvanas,575,mage,fire,18,6,12
Lorthizas,azjolnerub,575,mage,fire,18,6,12
Arhi,silvermoon,575,mage,fire,18,6,12
Cuishle,kaelthas,575,mage,fire,18,6,12
Levora,ragnaros,575,mage,fire,18,6,12
Choons,twisting-nether,575,mage,fire,18,6,12
Umaguma,elune,575,mage,fire,18,6,12
Explosìve,arthas,574,mage,fire,12,6,6
Shâykó,sylvanas,573,mage,fire,12,6,6
Roythelan,steamwheedle-cartel,573,mage,fire,18,6,12
Mononokeeh,turalyon,572,mage,fire,6,6,0
Melimar,khaz-modan,572,mage,fire,12,6,6
Поймайбелку,booty-bay,572,mage,fire,12,6,6
Труупоед,borean-tundra,571,mage,fire,12,6,6
Arcanespell,ravencrest,544,mage,fire,10,6,4
Mirlan,malganis,543,mage,fire,8,7,1
Iceelance,tarren-mill,542,mage,fire,17,6,11
Nâmiz,blackrock,528,mage,fire,9,6,3
Мэдраша,gordunni,527,mage,fire,23,6,17
Xoløtl,ravencrest,522,mage,fire,17,7,10
Шарансул,soulflayer,521,mage,fire,21,8,13
Dárdie,ravencrest,512,mage,fire,10,6,4
Shimo,aegwynn,511,mage,fire,11,6,5
Магуччи,gordunni,480,mage,fire,6,5,1
Полеморв,soulflayer,480,mage,fire,6,5,1
Kudakto,ravencrest,480,mage,fire,6,5,1
Addícted,thrall,480,mage,fire,6,5,1
Tenetic,thrall,480,mage,fire,6,5,1
Fiagra,draenor,480,mage,fire,6,5,1
Dastion,ravencrest,480,mage,fire,6,5,1
Ицка,fordragon,480,mage,fire,6,5,1
Yoku,nethersturm,480,mage,fire,6,5,1
Xigore,blackrock,480,mage,fire,6,5,1
Arýà,blackmoore,480,mage,fire,6,5,1
Jél,stormscale,480,mage,fire,6,5,1
Helloimgone,blackmoore,480,mage,fire,6,5,1
Liga,outland,480,mage,fire,6,5,1
Oriliana,azjolnerub,480,mage,fire,6,5,1
Darkcrespø,dun-modr,480,mage,fire,12,5,7
Lenzalol,nemesis,480,mage,fire,12,5,7
Acidboltz,kazzak,480,mage,fire,12,5,7
ßigzok,kazzak,480,mage,fire,12,5,7
Kúmblåstgødx,archimonde,480,mage,fire,12,5,7
Sused,outland,480,mage,fire,12,5,7
Ovrhà,kazzak,480,mage,fire,12,5,7
Teeclis,twisting-nether,480,mage,fire,12,5,7
Arcandor,tarren-mill,480,mage,fire,12,5,7
Kaevelin,argent-dawn,480,mage,fire,12,5,7
Kàtsu,tarren-mill,480,mage,fire,12,5,7
Grìmmjow,tarren-mill,480,mage,fire,12,5,7
Palyd,the-maelstrom,480,mage,fire,12,5,7
Bírbeck,silvermoon,480,mage,fire,12,5,7
Cerewyn,ravencrest,480,mage,fire,12,5,7
Cleancc,blackhand,480,mage,fire,12,5,7
Хаскивсказке,gordunni,480,mage,fire,12,5,7
Kioor,ravencrest,480,mage,fire,12,5,7
Grodez,archimonde,480,mage,fire,12,5,7
Artikotchoin,archimonde,480,mage,fire,12,5,7
Srema,thrall,480,mage,fire,12,5,7
Augustusi,argent-dawn,480,mage,fire,12,5,7
Shifteurprõ,hyjal,480,mage,fire,12,5,7
Namemage,stormscale,480,mage,fire,12,5,7
Iceterror,ravencrest,480,mage,fire,12,5,7
Runbabyrun,hyjal,480,mage,fire,12,5,7
Polÿmorph,stormscale,480,mage,fire,12,5,7
Щавзорву,gordunni,480,mage,fire,12,5,7
Quincy,frostwolf,480,mage,fire,12,5,7
Mobjar,twisting-nether,480,mage,fire,12,5,7
Jazzi,blackrock,480,mage,fire,15,6,9
Ysari,ravencrest,480,mage,fire,18,5,13
Infamage,draenor,480,mage,fire,18,5,13
Исполлин,howling-fjord,480,mage,fire,18,5,13
Dríme,ravencrest,479,mage,fire,12,5,7
Eluniara,frostmane,479,mage,fire,18,5,13
Jimcarey,sylvanas,479,mage,fire,18,5,13
Heleng,draenor,479,mage,fire,18,5,13
Beardmorph,auchindoun,479,mage,fire,18,5,13
Enkida,exodar,479,mage,fire,18,5,13
Incendi,ravencrest,479,mage,fire,18,5,13
Bhalïn,dun-modr,479,mage,fire,36,5,31
Oneal,the-maelstrom,478,mage,fire,12,5,7
Magimikey,tarren-mill,477,mage,fire,12,5,7
Exorifrigo,dun-modr,477,mage,fire,22,5,17
Eldiablo,dun-modr,476,mage,fire,12,5,7
Begra,silvermoon,472,mage,fire,12,5,7
Thatblink,twisting-nether,448,mage,fire,16,5,11
Oreog,ravencrest,432,mage,fire,21,5,16
Xxi,gorgonnash,416,mage,fire,10,5,5
Jondahr,emerald-dream,416,mage,fire,16,5,11
Сморгонец,gordunni,412,mage,fire,14,5,9
Blinker,frostwhisper,384,mage,fire,6,4,2
Chírla,blackrock,384,mage,fire,6,4,2
Bazemage,twisting-nether,384,mage,fire,6,4,2
Kkohp,ravencrest,384,mage,fire,6,4,2
Cyser,kazzak,384,mage,fire,6,4,2
Bergillos,sanguino,384,mage,fire,6,4,2
Xsro,blackrock,384,mage,fire,6,4,2
Pogböss,malorne,384,mage,fire,6,4,2
Aern,sinstralis,384,mage,fire,6,4,2
Оай,gordunni,384,mage,fire,6,4,2
Тонисмок,gordunni,384,mage,fire,6,4,2
Drfunk,shadowsong,384,mage,fire,6,4,2
Chièlui,silvermoon,384,mage,fire,6,4,2
Doryy,silvermoon,384,mage,fire,6,4,2
Zezzim,draenor,384,mage,fire,6,4,2
Saryotheone,silvermoon,384,mage,fire,6,4,2
Whìtewalker,pozzo-delleternità,384,mage,fire,6,4,2
Proffset,ravencrest,384,mage,fire,6,4,2
Extol,tarren-mill,384,mage,fire,6,4,2
Yenneferr,magtheridon,384,mage,fire,6,4,2
Pavlé,draenor,384,mage,fire,6,4,2
Tadaa,blackmoore,384,mage,fire,6,4,2
Wopi,sylvanas,384,mage,fire,6,4,2
Vorst,shattered-hand,384,mage,fire,6,4,2
Blackfirez,ravencrest,384,mage,fire,6,4,2
Suzanne,earthen-ring,384,mage,fire,6,4,2
Jínró,draenor,384,mage,fire,6,4,2
Zirelian,ravencrest,384,mage,fire,6,4,2
Eìnì,kazzak,384,mage,fire,6,4,2
Nellý,stormreaver,384,mage,fire,6,4,2
Shyasianmage,area-52,384,mage,fire,6,4,2
Botbotamba,hyjal,384,mage,fire,6,4,2
Fkndog,ravencrest,384,mage,fire,6,4,2
Ovrpwrdxd,kazzak,384,mage,fire,6,4,2
Waterhagx,tarren-mill,384,mage,fire,6,4,2
Gennésïs,darksorrow,384,mage,fire,6,4,2
Âres,kargath,384,mage,fire,6,4,2
Mnday,ravencrest,384,mage,fire,6,4,2
Аристраз,soulflayer,384,mage,fire,6,4,2
Curran,ravencrest,384,mage,fire,6,4,2
Nelway,hyjal,384,mage,fire,6,4,2
Pstkstpst,ravencrest,384,mage,fire,6,4,2
Гандолъер,soulflayer,384,mage,fire,6,4,2
Iceiceice,stormscale,384,mage,fire,6,4,2
Stíckí,malganis,384,mage,fire,6,4,2
Magmâr,ravencrest,384,mage,fire,6,4,2
Naote,blackhand,384,mage,fire,6,4,2
Интродюс,soulflayer,384,mage,fire,6,4,2
Kyomachix,ahnqiraj,384,mage,fire,6,4,2
Farmassist,stormscale,384,mage,fire,6,4,2
Смоукиайс,blackscar,384,mage,fire,6,4,2
Kenjablejz,the-maelstrom,384,mage,fire,6,4,2
Esculapìo,nemesis,384,mage,fire,6,4,2
Zanmalath,stormscale,384,mage,fire,8,4,4
Henqo,burning-legion,384,mage,fire,15,5,10
Аркагос,gordunni,384,mage,fire,12,4,8
Дантрий,gordunni,384,mage,fire,12,4,8
Diji,the-maelstrom,384,mage,fire,12,4,8
Aláz,twisting-nether,384,mage,fire,12,4,8
Сенсивьера,gordunni,384,mage,fire,12,4,8
Bananabread,the-maelstrom,384,mage,fire,12,4,8
Øtemplmag,dun-modr,384,mage,fire,12,4,8
Padavoane,khaz-modan,384,mage,fire,12,4,8
Раканчик,gordunni,384,mage,fire,12,4,8
Флоррет,gordunni,384,mage,fire,12,4,8
Викликс,borean-tundra,384,mage,fire,12,4,8
Hord,zuljin,384,mage,fire,12,4,8
Деорро,gordunni,384,mage,fire,12,4,8
Bænoß,ravencrest,384,mage,fire,12,4,8
Гелиадо,soulflayer,384,mage,fire,12,4,8
Khadgia,argent-dawn,384,mage,fire,12,4,8
Imelin,silvermoon,384,mage,fire,12,4,8
Muchmage,silvermoon,384,mage,fire,12,4,8
Zeromagic,tarren-mill,384,mage,fire,12,4,8
Kisik,die-ewige-wacht,384,mage,fire,12,4,8
Jåvåscript,stormscale,384,mage,fire,12,4,8
Magoy,ysondre,384,mage,fire,12,4,8
Nelfpanda,ravencrest,384,mage,fire,12,4,8
Exael,ravencrest,384,mage,fire,12,4,8
Kazeen,silvermoon,384,mage,fire,12,4,8
Mystiqu,ravencrest,384,mage,fire,12,4,8
Rooven,aegwynn,384,mage,fire,12,4,8
Aarcheon,kazzak,384,mage,fire,12,4,8
Sylênna,kazzak,384,mage,fire,12,4,8
Warfio,garona,384,mage,fire,12,4,8
Pølåris,outland,384,mage,fire,12,4,8
Redsparrow,frostwolf,384,mage,fire,12,4,8
Feuern,antonidas,384,mage,fire,12,4,8
Popbg,outland,384,mage,fire,12,4,8
Dueudafrøven,stormscale,384,mage,fire,12,4,8
Néiloth,frostmane,384,mage,fire,12,4,8
Lonero,antonidas,384,mage,fire,12,4,8
Djblink,twisting-nether,384,mage,fire,18,4,14
Кешунчик,soulflayer,384,mage,fire,18,4,14
Lusionator,defias-brotherhood,384,mage,fire,18,4,14
Drgyo,blackrock,384,mage,fire,18,4,14
Арканмета,howling-fjord,384,mage,fire,18,4,14
Кеото,gordunni,384,mage,fire,18,4,14
Bonî,dun-modr,384,mage,fire,18,4,14
Magibeck,ravencrest,384,mage,fire,18,4,14
Reapor,draenor,384,mage,fire,18,4,14
Swansea,emeriss,384,mage,fire,20,4,16
Birdlort,draenor,383,mage,fire,6,4,2
Timbaa,veklor,383,mage,fire,6,4,2
Unhedged,eredar,383,mage,fire,12,4,8
Мэджиксул,grom,383,mage,fire,12,4,8
Ildrøv,stormscale,383,mage,fire,12,4,8
Tekuard,ravencrest,383,mage,fire,18,4,14
Chroniikk,hyjal,381,mage,fire,12,4,8
Chimará,eredar,367,mage,fire,17,4,13
Stillfrostin,blackrock,352,mage,fire,10,4,6
Тельмион,howling-fjord,351,mage,fire,17,4,13
Lusifera,outland,336,mage,fire,9,4,5
Niivel,ysondre,336,mage,fire,15,4,11
Kiwik,kazzak,335,mage,fire,15,5,10
Fkeverybody,ravencrest,330,mage,fire,8,5,3
Anev,sylvanas,330,mage,fire,11,5,6
Nékrà,archimonde,330,mage,fire,14,5,9
Xùrg,stormscale,328,mage,fire,25,5,20
Helioserebus,burning-legion,320,mage,fire,26,5,21
Frostspree,wildhammer,319,mage,fire,5,4,1
Doidadetanga,aggra-português,319,mage,fire,9,4,5
Songosuu,eredar,319,mage,fire,20,4,16
Drfrostfire,drakthul,319,mage,fire,22,4,18
Tvångstralla,tarren-mill,304,mage,fire,7,4,3
Гамаюнх,deathguard,304,mage,fire,7,4,3
Mimicassa,defias-brotherhood,301,mage,fire,38,18,20
Adónis,drakthul,288,mage,fire,6,3,3
Valimage,twisting-nether,288,mage,fire,6,3,3
Mladina,drakthul,288,mage,fire,6,3,3
Discast,anetheron,288,mage,fire,6,3,3
Yasinthêdon,ravencrest,288,mage,fire,6,3,3
Kebabenjoyer,ravencrest,288,mage,fire,6,3,3
Seb,wildhammer,288,mage,fire,6,3,3
Trxkxx,ragnaros,288,mage,fire,6,3,3
Cubis,archimonde,288,mage,fire,6,3,3
Tharillion,drakthul,288,mage,fire,6,3,3
Ghylias,kazzak,288,mage,fire,6,3,3
Lëyra,ysondre,288,mage,fire,6,3,3
Modrone,ragnaros,288,mage,fire,6,3,3
Сизаам,howling-fjord,288,mage,fire,6,3,3
Elor,eredar,288,mage,fire,6,3,3
Xáví,kazzak,288,mage,fire,6,3,3
Mauiry,drakthul,288,mage,fire,6,3,3
Legaliser,outland,288,mage,fire,6,3,3
Zheakz,kazzak,288,mage,fire,6,3,3
Darkseidez,alonsus,288,mage,fire,6,3,3
Álco,outland,288,mage,fire,6,3,3
Driana,dragonmaw,288,mage,fire,6,3,3
Capphaow,ravencrest,288,mage,fire,6,3,3
Manafuzz,outland,288,mage,fire,6,3,3
Insómniac,ravencrest,288,mage,fire,6,3,3
Clitch,blutkessel,288,mage,fire,6,3,3
Kryptass,aegwynn,288,mage,fire,6,3,3
Maveya,blackmoore,288,mage,fire,6,3,3
Yasuomain,ragnaros,288,mage,fire,6,3,3
Coachrmp,ravencrest,288,mage,fire,6,3,3
Ignyx,ragnaros,288,mage,fire,6,3,3
Säradok,outland,288,mage,fire,6,3,3
Onlymage,outland,288,mage,fire,6,3,3
Alearis,die-aldor,288,mage,fire,6,3,3
Matroze,sylvanas,288,mage,fire,6,3,3
Frozonë,draenor,288,mage,fire,6,3,3
Samirra,stormscale,288,mage,fire,6,3,3
Snexo,kazzak,288,mage,fire,6,3,3
Calyppo,sanguino,288,mage,fire,6,3,3
Dødo,archimonde,288,mage,fire,6,3,3
Shermî,blackrock,288,mage,fire,6,3,3
Makez,draenor,288,mage,fire,6,3,3
Glindalefay,silvermoon,288,mage,fire,6,3,3
Botstyle,ravencrest,288,mage,fire,6,3,3
Shinigamí,blackrock,288,mage,fire,6,3,3
Trowbe,blackmoore,288,mage,fire,6,3,3
Brandonjames,ragnaros,288,mage,fire,6,3,3
Хаппер,deathguard,288,mage,fire,6,3,3
Kokirii,doomhammer,288,mage,fire,6,3,3
Zehnvonzehn,antonidas,288,mage,fire,6,3,3
Portalpotty,sylvanas,288,mage,fire,6,3,3
Frøstdream,dun-modr,288,mage,fire,6,3,3
Hasbe,kazzak,288,mage,fire,6,3,3
Narexa,silvermoon,288,mage,fire,6,3,3
Zenó,blackrock,288,mage,fire,6,3,3
Kaizeri,draenor,288,mage,fire,6,3,3
Memanja,tarren-mill,288,mage,fire,6,3,3
Mihisa,outland,288,mage,fire,6,3,3
Malanti,grim-batol,288,mage,fire,6,3,3
Fatcasts,silvermoon,288,mage,fire,6,3,3
Fötmslävé,tarren-mill,288,mage,fire,6,3,3
Balderk,sanguino,288,mage,fire,6,3,3
Abovè,outland,288,mage,fire,6,3,3
Fuchso,area-52,288,mage,fire,6,3,3
Sleîhg,sanguino,288,mage,fire,6,3,3
Sonybonanza,kazzak,288,mage,fire,6,3,3
Wracrz,argent-dawn,288,mage,fire,6,3,3
Rayqtx,blackmoore,288,mage,fire,6,3,3
Xlarb,kazzak,288,mage,fire,6,3,3
Feuertonne,blackmoore,288,mage,fire,6,3,3
Блья,howling-fjord,288,mage,fire,6,3,3
Kèj,kazzak,288,mage,fire,6,3,3
Rmage,kazzak,288,mage,fire,6,3,3
Hansknechtt,frostwolf,288,mage,fire,6,3,3
Serclulz,ravencrest,288,mage,fire,6,3,3
Mága,grim-batol,288,mage,fire,6,3,3
Fleurdelacur,ravencrest,288,mage,fire,6,3,3
Torbalan,kazzak,288,mage,fire,6,3,3
Texita,sylvanas,288,mage,fire,6,3,3
Inyøurassx,hyjal,288,mage,fire,6,3,3
Dollzer,khaz-modan,288,mage,fire,6,3,3
Ørka,stormscale,288,mage,fire,6,3,3
Ozdewish,hyjal,288,mage,fire,6,3,3
Homellander,silvermoon,288,mage,fire,6,3,3
Salvadordalí,ravencrest,288,mage,fire,6,3,3
Avizura,argent-dawn,288,mage,fire,6,3,3
Freelegend,ravencrest,288,mage,fire,6,3,3
Tildetbfa,antonidas,288,mage,fire,6,3,3
Deadmagix,ravencrest,288,mage,fire,6,3,3
Rebelions,hyjal,288,mage,fire,6,3,3
Couñterspell,eredar,288,mage,fire,6,3,3
Rìhanna,antonidas,288,mage,fire,6,3,3
Tyronesbone,stormscale,288,mage,fire,6,3,3
Braiñ,dethecus,288,mage,fire,6,3,3
Choise,stormscale,288,mage,fire,6,3,3
Azriath,darksorrow,288,mage,fire,6,3,3
Jamesbang,blackmoore,288,mage,fire,7,3,4
Frökenfrost,stormscale,288,mage,fire,12,3,9
Shiiron,blackrock,288,mage,fire,12,3,9
Milton,dunemaul,288,mage,fire,12,3,9
Kampam,draenor,288,mage,fire,12,3,9
Poochmage,archimonde,288,mage,fire,12,3,9
Magicalstove,draenor,288,mage,fire,12,3,9
Иньфанта,deathguard,288,mage,fire,12,3,9
Lëfay,argent-dawn,288,mage,fire,12,3,9
Aylan,kazzak,288,mage,fire,12,3,9
Овеча,gordunni,288,mage,fire,12,3,9
Saivedija,blackmoore,288,mage,fire,12,3,9
Pixlld,aegwynn,288,mage,fire,12,3,9
Lenka,ravencrest,288,mage,fire,12,3,9
Rasaku,argent-dawn,288,mage,fire,12,3,9
Juicedup,blackrock,288,mage,fire,12,3,9
Oblív,ravencrest,288,mage,fire,12,3,9
Raiko,spinebreaker,288,mage,fire,12,3,9
Suidas,auchindoun,288,mage,fire,12,3,9
Nyíks,blackhand,288,mage,fire,12,3,9
Шишиня,gordunni,288,mage,fire,12,3,9
Шмыгамаг,eversong,288,mage,fire,12,3,9
Timeforplanb,frostwolf,288,mage,fire,12,3,9
Рровер,eversong,288,mage,fire,12,3,9
Bigbadmage,silvermoon,288,mage,fire,12,3,9
Tsubas,blackmoore,288,mage,fire,12,3,9
Xlity,silvermoon,288,mage,fire,12,3,9
Megart,stormscale,288,mage,fire,12,3,9
Arkanieer,blackrock,287,mage,fire,6,3,3
Rosenkrauz,kul-tiras,287,mage,fire,6,3,3
Maaleki,dalaran,287,mage,fire,6,3,3
Хадя,blackscar,287,mage,fire,6,3,3
Ceanna,argent-dawn,287,mage,fire,12,3,9
Kyrox,ysondre,287,mage,fire,12,3,9
Bulma,khaz-modan,286,mage,fire,6,3,3
Regenn,kazzak,286,mage,fire,6,3,3
Magiérin,antonidas,286,mage,fire,6,3,3
Skwinette,hyjal,286,mage,fire,10,3,7
Ionofrost,stormscale,272,mage,fire,7,5,2
Венлич,gordunni,271,mage,fire,9,4,5
Festers,kazzak,271,mage,fire,11,3,8
Mostevilgirl,blackhand,265,mage,fire,13,5,8
Alarak,drakthul,256,mage,fire,10,3,7
Tahiti,twisting-nether,255,mage,fire,11,3,8
Novalia,wrathbringer,239,mage,fire,5,3,2
Arcitech,tarren-mill,239,mage,fire,5,3,2
Khalix,blackmoore,239,mage,fire,5,3,2
Szusigombóc,ragnaros,234,mage,fire,10,6,4
Søphiâ,thrall,234,mage,fire,10,4,6
Ludak,stormscale,234,mage,fire,22,5,17
Lhynd,kirin-tor,234,mage,fire,22,5,17
Valij,blackrock,224,mage,fire,10,3,7
Ixbllyix,alonsus,223,mage,fire,8,3,5
Donishakur,ragnaros,223,mage,fire,14,3,11
Hakapelto,lightbringer,208,mage,fire,7,3,4
Worstwòrld,draenor,208,mage,fire,7,3,4
Roast,ahnqiraj,192,mage,fire,4,3,1
Gadeplan,argent-dawn,192,mage,fire,6,2,4
Гнег,gordunni,192,mage,fire,6,2,4
Magewarr,stormscale,192,mage,fire,6,2,4
Nolifér,magtheridon,192,mage,fire,6,2,4
Thylren,argent-dawn,192,mage,fire,6,2,4
Ôbsury,hyjal,192,mage,fire,6,2,4
Мистркорбэн,soulflayer,192,mage,fire,6,2,4
Djbjmage,ravencrest,192,mage,fire,6,2,4
Arycia,tarren-mill,192,mage,fire,6,2,4
Belthesad,twisting-nether,192,mage,fire,6,2,4
Maxik,outland,192,mage,fire,6,2,4
Sickßlink,outland,192,mage,fire,6,2,4
Charwizard,outland,192,mage,fire,6,2,4
Гендральф,soulflayer,192,mage,fire,6,2,4
Faitha,ravencrest,192,mage,fire,6,2,4
Yushinó,antonidas,192,mage,fire,6,2,4
Skyliné,ravencrest,192,mage,fire,6,2,4
Milminmage,ravencrest,192,mage,fire,6,2,4
Decedé,dun-modr,192,mage,fire,6,2,4
Zeusmon,ragnaros,192,mage,fire,6,2,4
Cortis,outland,192,mage,fire,6,2,4
ßalca,twisting-nether,192,mage,fire,6,2,4
Oizar,hyjal,192,mage,fire,6,2,4
Jjustice,outland,192,mage,fire,6,2,4
Skankengine,twisting-nether,192,mage,fire,6,2,4
Naykor,dalaran,192,mage,fire,6,2,4
Caliwee,eredar,192,mage,fire,6,2,4
Solitaria,tarren-mill,192,mage,fire,6,2,4
Blinkblank,ravencrest,192,mage,fire,6,2,4
Fantâz,tarren-mill,192,mage,fire,6,2,4
Majnoun,archimonde,192,mage,fire,6,2,4
Femboywaifu,stormscale,192,mage,fire,6,2,4
Hêra,archimonde,192,mage,fire,6,2,4
Audraptor,medivh,192,mage,fire,6,2,4
Bannana,dun-modr,192,mage,fire,6,2,4
Dnt,twilights-hammer,192,mage,fire,6,2,4
Компромис,howling-fjord,192,mage,fire,6,2,4
Summermàge,ravencrest,192,mage,fire,6,2,4
Exitalis,outland,192,mage,fire,6,2,4
Quínt,blackhand,192,mage,fire,6,2,4
Дарнивил,gordunni,192,mage,fire,6,2,4
Nøxas,archimonde,192,mage,fire,6,2,4
Интенса,gordunni,192,mage,fire,6,2,4
Itrixx,outland,192,mage,fire,6,2,4
Архиусэх,howling-fjord,192,mage,fire,6,2,4
Fadbunny,outland,192,mage,fire,6,2,4
Krëkk,ragnaros,192,mage,fire,6,2,4
Nyskal,tarren-mill,192,mage,fire,6,2,4
Hurtinlo,dun-modr,192,mage,fire,6,2,4
Дэката,grom,192,mage,fire,6,2,4
Candyløve,ravencrest,192,mage,fire,6,2,4
Deathzzaky,ravencrest,192,mage,fire,6,2,4
Letitsnow,ravencrest,192,mage,fire,6,2,4
Leafløver,ravencrest,192,mage,fire,6,2,4
Flizwiz,ragnaros,192,mage,fire,6,2,4
Wortyvery,outland,192,mage,fire,6,2,4
Бигдикмаг,soulflayer,192,mage,fire,6,2,4
Мэжжик,howling-fjord,192,mage,fire,6,2,4
Lilekx,archimonde,192,mage,fire,6,2,4
Halcyón,ravencrest,192,mage,fire,6,2,4
Armystik,drakthul,192,mage,fire,6,2,4
Khoshgele,draenor,192,mage,fire,6,2,4
Kapueca,jaedenar,192,mage,fire,6,2,4
Alubi,blackrock,192,mage,fire,6,2,4
Ruhea,silvermoon,192,mage,fire,6,2,4
Jokiss,draenor,192,mage,fire,6,2,4
Akyrâz,blackrock,192,mage,fire,6,2,4
Рэймонд,howling-fjord,192,mage,fire,6,2,4
Ghosty,festung-der-stürme,192,mage,fire,6,2,4
Abiogenesis,silvermoon,192,mage,fire,6,2,4
Lindsaylohan,silvermoon,192,mage,fire,6,2,4
Revelio,blackrock,192,mage,fire,6,2,4
Magenox,blackrock,192,mage,fire,6,2,4
Blasty,guldan,192,mage,fire,6,2,4
Kenjos,silvermoon,192,mage,fire,6,2,4
Lêgólás,blackmoore,192,mage,fire,6,2,4
Shyoxmage,rexxar,192,mage,fire,6,2,4
Ekron,karazhan,192,mage,fire,6,2,4
Mupana,nagrand,192,mage,fire,6,2,4
Transformo,draenor,192,mage,fire,6,2,4
Mahote,draenor,192,mage,fire,6,2,4
Eksl,draenor,192,mage,fire,6,2,4
Scoodles,kazzak,192,mage,fire,6,2,4
Alberdoor,blackmoore,192,mage,fire,6,2,4
Shédudé,silvermoon,192,mage,fire,6,2,4
Tudorthemage,xavius,192,mage,fire,6,2,4
Kalterfurz,thrall,192,mage,fire,6,2,4
Minae,stormscale,192,mage,fire,6,2,4
Kairøs,dragonblight,192,mage,fire,6,2,4
Isaru,draenor,192,mage,fire,6,2,4
Atzin,sanguino,192,mage,fire,6,2,4
Lancelotta,blackmoore,192,mage,fire,6,2,4
Puracz,defias-brotherhood,192,mage,fire,6,2,4
Gacosane,chamber-of-aspects,192,mage,fire,6,2,4
Ikefire,draenor,192,mage,fire,6,2,4
Saveq,kazzak,192,mage,fire,6,2,4
Izhi,arathor,192,mage,fire,6,2,4
Димаскунфу,howling-fjord,192,mage,fire,6,2,4
Apc,sylvanas,192,mage,fire,6,2,4
Wetx,kilrogg,192,mage,fire,6,2,4
Cytotoxic,emerald-dream,192,mage,fire,6,2,4
Zerobelow,silvermoon,192,mage,fire,6,2,4
Tacto,ravencrest,192,mage,fire,7,2,5
Harpelmage,auchindoun,192,mage,fire,7,2,5
Xatures,tarren-mill,192,mage,fire,12,2,10
Buzzgnom,malfurion,192,mage,fire,12,2,10
Bekkmzi,drakthul,192,mage,fire,12,2,10
Zagori,sylvanas,192,mage,fire,12,2,10
Çatàclysmík,kazzak,192,mage,fire,12,2,10
Psilocybea,defias-brotherhood,192,mage,fire,12,2,10
Пиромансик,gordunni,192,mage,fire,12,2,10
Лордбелиал,soulflayer,192,mage,fire,12,2,10
Symbiano,twisting-nether,192,mage,fire,12,2,10
Хопкиллер,ashenvale,192,mage,fire,12,2,10
Firelight,argent-dawn,192,mage,fire,12,2,10
Stepsiss,magtheridon,192,mage,fire,12,2,10
Zarigani,kazzak,192,mage,fire,12,2,10
Mesvef,archimonde,192,mage,fire,12,2,10
Optimelk,bronzebeard,192,mage,fire,12,2,10
Toxttr,drakthul,192,mage,fire,13,2,11
Kenny,nerzhul,192,mage,fire,24,2,22
Måya,dun-modr,191,mage,fire,8,2,6
Kirripirri,doomhammer,191,mage,fire,12,2,10
Mamacitá,ravencrest,175,mage,fire,11,2,9
Kokoshanel,burning-legion,159,mage,fire,5,2,3
Magusbabus,ravencrest,159,mage,fire,5,2,3
Gensorèd,darksorrow,159,mage,fire,5,2,3
Azegodxlul,kazzak,159,mage,fire,5,2,3
Kathago,antonidas,154,mage,fire,12,4,8
Doglordx,lightbringer,144,mage,fire,3,3,0
Snowberry,blackrock,138,mage,fire,6,3,3
Xhal,hyjal,138,mage,fire,9,3,6
Bratnasty,neptulon,138,mage,fire,11,3,8
Явернулси,soulflayer,138,mage,fire,20,3,17
Catafract,kazzak,128,mage,fire,4,2,2
Rukiax,blackrock,128,mage,fire,4,2,2
Imnis,outland,112,mage,fire,7,2,5
Etherìon,los-errantes,96,mage,fire,3,2,1
Cbumm,sanguino,96,mage,fire,3,2,1
Zïa,kazzak,96,mage,fire,6,1,5
Zomas,kazzak,96,mage,fire,6,1,5
Crankjuice,argent-dawn,96,mage,fire,6,1,5
Камаёри,howling-fjord,96,mage,fire,6,1,5
Plsquit,stormscale,96,mage,fire,6,1,5
Farciminis,outland,96,mage,fire,6,1,5
Anzzmage,kazzak,96,mage,fire,6,1,5
Kushuka,burning-legion,96,mage,fire,6,1,5
Nerzzhul,burning-legion,96,mage,fire,6,1,5
Magicían,sylvanas,96,mage,fire,6,1,5
Sheepurcheap,draenor,96,mage,fire,6,1,5
Yerro,kazzak,96,mage,fire,6,1,5
Jeiqfogjioqs,archimonde,96,mage,fire,6,1,5
Rbý,outland,96,mage,fire,6,1,5
Evilmagíc,tarren-mill,96,mage,fire,6,1,5
Куканыч,fordragon,96,mage,fire,6,1,5
Arempy,tarren-mill,96,mage,fire,6,1,5
Procrank,forscherliga,96,mage,fire,6,1,5
Billî,stormscale,96,mage,fire,6,1,5
Vorsi,tarren-mill,96,mage,fire,6,1,5
Zakardo,kazzak,96,mage,fire,6,1,5
Dingin,bronze-dragonflight,96,mage,fire,6,1,5
Amarántha,kazzak,96,mage,fire,6,1,5
Georgé,stormscale,96,mage,fire,6,1,5
Mageé,argent-dawn,96,mage,fire,6,1,5
Aurayaa,teldrassil,96,mage,fire,6,1,5
Kangwizard,kazzak,96,mage,fire,6,1,5
Grimrreaper,stormscale,96,mage,fire,6,1,5
Alexandra,turalyon,96,mage,fire,6,1,5
Masseman,sylvanas,96,mage,fire,6,1,5
Каппашилка,gordunni,96,mage,fire,6,1,5
Perfection,cthun,96,mage,fire,6,1,5
Amalou,stormscale,96,mage,fire,6,1,5
Saüron,burning-legion,96,mage,fire,6,1,5
Gehrkeblock,silvermoon,96,mage,fire,6,1,5
Messatsux,tarren-mill,96,mage,fire,6,1,5
Boredpeon,burning-legion,96,mage,fire,6,1,5
Kaì,twisting-nether,96,mage,fire,6,1,5
Caststuffatu,sylvanas,96,mage,fire,6,1,5
Дизордерх,gordunni,96,mage,fire,6,1,5
Sniperorb,sylvanas,96,mage,fire,6,1,5
Polilla,jaedenar,96,mage,fire,6,1,5
Martixx,stormscale,96,mage,fire,6,1,5
Варриморыч,soulflayer,96,mage,fire,6,1,5
Tokyodes,twisting-nether,96,mage,fire,6,1,5
Stromz,silvermoon,96,mage,fire,6,1,5
Fumachustas,kazzak,96,mage,fire,6,1,5
Akadran,blackmoore,96,mage,fire,6,1,5
Laenadria,argent-dawn,96,mage,fire,6,1,5
Westx,blackmoore,96,mage,fire,6,1,5
Alteretime,ravencrest,96,mage,fire,6,1,5
Sunburstz,sylvanas,96,mage,fire,6,1,5
Johnnyblazin,outland,96,mage,fire,6,1,5
Satheril,argent-dawn,96,mage,fire,6,1,5
Litheon,drakthul,96,mage,fire,6,1,5
Prinskoekie,twisting-nether,96,mage,fire,6,1,5
Leonora,blackhand,96,mage,fire,6,1,5
Alaster,culte-de-la-rive-noire,96,mage,fire,6,1,5
Sikici,aegwynn,96,mage,fire,6,1,5
Меззамоор,soulflayer,96,mage,fire,6,1,5
Rivií,drakthul,96,mage,fire,6,1,5
Loof,zenedar,96,mage,fire,6,1,5
Thoria,sylvanas,96,mage,fire,6,1,5
Rmnzr,blackrock,96,mage,fire,6,1,5
Slïnks,stormscale,96,mage,fire,6,1,5
Tsungy,twisting-nether,96,mage,fire,6,1,5
Queuefiend,eredar,96,mage,fire,6,1,5
Kaevos,ravencrest,96,mage,fire,6,1,5
Allattar,drakthul,96,mage,fire,6,1,5
Одз,grom,96,mage,fire,6,1,5
Êmmá,blackmoore,96,mage,fire,6,1,5
Hellburn,stormrage,96,mage,fire,6,1,5
Фантомланс,howling-fjord,96,mage,fire,6,1,5
Gabbaq,blackrock,96,mage,fire,6,1,5
Slashlife,wrathbringer,96,mage,fire,6,1,5
Nodnarb,dragonblight,96,mage,fire,6,1,5
Arcanik,archimonde,96,mage,fire,6,1,5
Пламяорды,soulflayer,96,mage,fire,6,1,5
Pÿromaniac,ravencrest,96,mage,fire,6,1,5
Малесгос,gordunni,96,mage,fire,6,1,5
Zalfax,sinstralis,96,mage,fire,6,1,5
Mexxî,thrall,96,mage,fire,6,1,5
Joulz,ravencrest,96,mage,fire,6,1,5
Satoryu,silvermoon,96,mage,fire,6,1,5
Cavadrex,arathor,96,mage,fire,6,1,5
Hotpockets,die-aldor,96,mage,fire,6,1,5
Дивеансерт,blackscar,96,mage,fire,6,1,5
Lowdam,dun-modr,96,mage,fire,7,1,6
Serlath,defias-brotherhood,96,mage,fire,12,1,11
Flamz,blackrock,96,mage,fire,12,1,11
Ilikepoly,blackmoore,96,mage,fire,12,1,11
Lebron,blackrock,96,mage,fire,12,1,11
Latiny,blackrock,96,mage,fire,12,1,11
Maybeblood,kazzak,96,mage,fire,12,1,11
Yesuz,blackhand,96,mage,fire,12,1,11
Maregom,dun-modr,96,mage,fire,12,1,11
Mallph90A0B8,archimonde,96,mage,fire,12,1,11
Miyukì,dun-morogh,96,mage,fire,12,1,11
Tachipiirina,nemesis,96,mage,fire,12,1,11
Scitzy,ragnaros,96,mage,fire,12,1,11
Syltris,drakthul,96,mage,fire,18,1,17
Pyrias,sylvanas,95,mage,fire,6,1,5
Shâdozy,blackmoore,89,mage,fire,6,3,3
Сонатра,howling-fjord,79,mage,fire,5,1,4
Hecht,burning-legion,64,mage,fire,4,1,3
Alkhazzar,defias-brotherhood,64,mage,fire,4,1,3
Унитазныймаг,howling-fjord,63,mage,fire,2,2,0
Манапич,soulflayer,48,mage,fire,3,1,2
Preí,archimonde,42,mage,fire,12,3,9
Озобочений,greymane,31,mage,fire,2,1,1
Nøøkîè,antonidas,31,mage,fire,2,1,1
Hyènedeneige,dalaran,31,mage,fire,2,1,1
Drakura,burning-legion,31,mage,fire,2,1,1
Annamage,tarren-mill,31,mage,fire,6,2,4
Ðøæø,twisting-nether,16,mage,fire,1,1,0
Petronillo,dun-modr,16,mage,fire,1,1,0
Fayja,draenor,16,mage,fire,7,1,6
Mercem,stormscale,2351,mage,frost,80,50,30
Ðeejkñ,archimonde,2315,mage,frost,102,61,41
Aleç,ravencrest,2270,mage,frost,134,71,63
Laynerz,kazzak,2254,mage,frost,109,61,48
Gelußaßa,ravencrest,2209,mage,frost,109,58,51
Philoû,archimonde,2205,mage,frost,157,82,75
Медивера,gordunni,2200,mage,frost,185,99,86
Chikounet,archimonde,2188,mage,frost,150,78,72
Ràiku,ravencrest,2184,mage,frost,78,43,35
Dodgezdream,kazzak,2165,mage,frost,201,123,78
Tommy,laughing-skull,2148,mage,frost,136,67,69
Sìckofme,aegwynn,2143,mage,frost,72,46,26
Usererror,ravencrest,2139,mage,frost,137,69,68
Dastion,ravencrest,2138,mage,frost,103,52,51
Partypower,twisting-nether,2137,mage,frost,297,147,150
Avizura,kazzak,2134,mage,frost,60,35,25
Fakér,ravencrest,2130,mage,frost,190,94,96
Watchmeclic,archimonde,2126,mage,frost,108,54,54
Kilstine,outland,2126,mage,frost,78,39,39
Kurtkiels,draenor,2112,mage,frost,96,49,47
Akyrâz,blackrock,2108,mage,frost,277,138,139
Ãshs,archimonde,2103,mage,frost,259,129,130
Яшабурстх,blackscar,2101,mage,frost,101,59,42
Фоулли,howling-fjord,2100,mage,frost,99,56,43
Søz,agamaggan,2059,mage,frost,161,79,82
Crylz,kazzak,2044,mage,frost,83,42,41
Serctheone,ravencrest,2038,mage,frost,244,121,123
Oscarwizyo,ravencrest,2038,mage,frost,107,50,57
Ðazzftw,archimonde,2033,mage,frost,75,53,22
Макотшельник,gordunni,2033,mage,frost,91,55,36
Naynn,archimonde,2033,mage,frost,295,151,144
Sóz,ravencrest,2033,mage,frost,109,51,58
Neverblockx,blackrock,2028,mage,frost,64,44,20
Efes,dun-modr,2021,mage,frost,218,106,112
Drfeeldgoodd,mazrigos,2018,mage,frost,327,165,162
Frostboltop,ravencrest,2011,mage,frost,83,39,44
Ticklefinger,agamaggan,2004,mage,frost,59,40,19
Kalamaras,quelthalas,1999,mage,frost,291,145,146
Arnoldkelly,tarren-mill,1998,mage,frost,55,32,23
Барсуктри,deathguard,1984,mage,frost,60,30,30
Elgriefo,sylvanas,1981,mage,frost,84,36,48
Lyndsey,dalaran,1973,mage,frost,89,44,45
Highrollerqt,tarren-mill,1971,mage,frost,192,111,81
Незерёб,soulflayer,1959,mage,frost,168,87,81
Gavno,ravencrest,1955,mage,frost,54,26,28
Ввнд,galakrond,1953,mage,frost,108,50,58
Jíncks,anachronos,1946,mage,frost,48,28,20
Unsaìntly,kult-der-verdammten,1946,mage,frost,81,37,44
Mizt,ragnaros,1943,mage,frost,102,45,57
Прауз,soulflayer,1941,mage,frost,62,36,26
Ëloenn,dalaran,1935,mage,frost,83,39,44
Whïm,ysondre,1930,mage,frost,167,82,85
Setyouoncs,ravencrest,1927,mage,frost,84,42,42
Abovè,outland,1918,mage,frost,54,23,31
Wmp,ravencrest,1917,mage,frost,66,31,35
Missl,draenor,1916,mage,frost,92,47,45
Øscarwizyo,ravencrest,1916,mage,frost,212,103,109
Oseri,defias-brotherhood,1915,mage,frost,161,77,84
Gossipgirlz,outland,1913,mage,frost,292,151,141
Sukmikok,twisting-nether,1911,mage,frost,190,94,96
Evovar,silvermoon,1911,mage,frost,254,124,130
Nilitar,kazzak,1910,mage,frost,60,24,36
Watchmeclick,archimonde,1909,mage,frost,36,20,16
Thegoodoctor,kazzak,1904,mage,frost,86,55,31
Môv,tarren-mill,1902,mage,frost,63,31,32
Нереварин,soulflayer,1895,mage,frost,108,48,60
Santriss,defias-brotherhood,1894,mage,frost,125,63,62
Барсукже,howling-fjord,1893,mage,frost,60,40,20
Aìnz,hyjal,1893,mage,frost,120,58,62
Аресуперпрес,gordunni,1893,mage,frost,85,40,45
Azrx,blackmoore,1892,mage,frost,88,43,45
Калихор,gordunni,1891,mage,frost,119,70,49
Slôw,kazzak,1891,mage,frost,54,26,28
Funkyfriday,twisting-nether,1889,mage,frost,48,23,25
Rosady,ragnaros,1884,mage,frost,200,102,98
Shîmmer,ravencrest,1877,mage,frost,48,28,20
Zimbabweborc,burning-legion,1875,mage,frost,100,62,38
Bigkent,stormscale,1870,mage,frost,78,38,40
Лемозяра,gordunni,1862,mage,frost,40,26,14
Eìnì,kazzak,1860,mage,frost,37,22,15
Zhodusqt,ragnaros,1859,mage,frost,54,27,27
Ráìkù,ravencrest,1857,mage,frost,42,27,15
Rufatopapari,ravencrest,1856,mage,frost,112,54,58
Henqo,burning-legion,1856,mage,frost,64,30,34
Jocelynn,aggramar,1854,mage,frost,125,59,66
Cleophe,burning-legion,1853,mage,frost,81,44,37
Praison,defias-brotherhood,1853,mage,frost,81,41,40
Lìx,ravencrest,1852,mage,frost,53,26,27
Reðemption,dun-modr,1848,mage,frost,53,35,18
Wickedblink,ravencrest,1848,mage,frost,80,37,43
Sunehx,blackrock,1842,mage,frost,84,46,38
Watchmylance,blackrock,1842,mage,frost,48,23,25
Ironhood,nemesis,1841,mage,frost,66,42,24
Mlogic,tarren-mill,1841,mage,frost,148,78,70
Voerk,twisting-nether,1840,mage,frost,118,57,61
Лакифриз,gordunni,1839,mage,frost,284,157,127
Tadaa,blackmoore,1839,mage,frost,60,32,28
Ogfreshlance,stormscale,1837,mage,frost,158,85,73
Chazs,kazzak,1836,mage,frost,78,41,37
Babyboyj,blackmoore,1835,mage,frost,60,27,33
Datpolytho,twisting-nether,1834,mage,frost,205,121,84
Unsaîntly,kult-der-verdammten,1833,mage,frost,46,20,26
Sìsia,ragnaros,1832,mage,frost,42,24,18
Exone,sylvanas,1828,mage,frost,66,32,34
Shakeándbake,ravencrest,1828,mage,frost,82,38,44
Laurents,silvermoon,1825,mage,frost,128,86,42
Titsu,stormreaver,1825,mage,frost,143,73,70
Soz,agamaggan,1823,mage,frost,42,23,19
Shíróyama,ravencrest,1823,mage,frost,229,125,104
Knometsj,ravencrest,1823,mage,frost,54,29,25
Arkhaen,archimonde,1822,mage,frost,106,53,53
Goneforever,draenor,1820,mage,frost,42,27,15
Heathrow,ravencrest,1820,mage,frost,278,158,120
Quadekun,tarren-mill,1820,mage,frost,48,27,21
Lolmageop,aegwynn,1817,mage,frost,160,81,79
Nightnovae,ravencrest,1817,mage,frost,157,76,81
Shunii,ravencrest,1817,mage,frost,55,24,31
Novaco,ravencrest,1816,mage,frost,65,30,35
Унитазныймаг,howling-fjord,1815,mage,frost,36,19,17
Мэтаскрим,soulflayer,1815,mage,frost,194,95,99
Yshax,malganis,1814,mage,frost,108,51,57
Stîckî,malganis,1814,mage,frost,69,31,38
Djdankzter,outland,1812,mage,frost,42,19,23
Деорро,gordunni,1809,mage,frost,84,45,39
Máximus,ravencrest,1809,mage,frost,53,27,26
Reflexz,thrall,1805,mage,frost,42,25,17
Snowsánji,blackmoore,1805,mage,frost,57,31,26
Xmoo,blackrock,1805,mage,frost,48,24,24
Mßs,outland,1804,mage,frost,48,24,24
Baconlance,stormscale,1803,mage,frost,42,23,19
Tellysia,blackmoore,1802,mage,frost,47,26,21
Ghettomagé,aegwynn,1802,mage,frost,42,22,20
Lzd,ravencrest,1802,mage,frost,54,28,26
Símple,sylvanas,1802,mage,frost,60,27,33
Nickg,ravencrest,1801,mage,frost,60,30,30
Lidely,kazzak,1800,mage,frost,30,19,11
Takayaki,terokkar,1800,mage,frost,187,103,84
Emoden,silvermoon,1800,mage,frost,331,171,160
Medara,darkspear,1799,mage,frost,84,45,39
Sâkuya,blackrock,1799,mage,frost,169,85,84
Ånei,ravencrest,1798,mage,frost,36,26,10
Whócárés,dragonmaw,1798,mage,frost,45,32,13
Løwskìll,outland,1795,mage,frost,95,53,42
Valyndra,twisting-nether,1793,mage,frost,162,87,75
Einsmagus,blackrock,1793,mage,frost,60,31,29
Sorrow,outland,1792,mage,frost,96,46,50
Ovrpwrdxd,kazzak,1790,mage,frost,60,39,21
Transformo,draenor,1789,mage,frost,42,23,19
Blasty,guldan,1787,mage,frost,154,79,75
Silverlining,ravencrest,1787,mage,frost,264,134,130
Rambau,archimonde,1786,mage,frost,353,177,176
Néiloth,frostmane,1786,mage,frost,77,34,43
Zoot,ravencrest,1785,mage,frost,119,55,64
Rekzaop,ravencrest,1785,mage,frost,144,66,78
Gegovski,ravencrest,1784,mage,frost,42,25,17
Kahyo,argent-dawn,1784,mage,frost,65,34,31
Pryt,ragnaros,1783,mage,frost,148,82,66
Auchenax,argent-dawn,1783,mage,frost,173,85,88
Onnÿy,dun-modr,1781,mage,frost,80,37,43
Maege,ragnaros,1780,mage,frost,74,47,27
Mlodysimba,burning-legion,1776,mage,frost,76,36,40
Polÿmorph,stormscale,1774,mage,frost,65,33,32
Риктусемпра,ashenvale,1773,mage,frost,111,72,39
Knulljonný,kazzak,1773,mage,frost,54,24,30
Sheepmaster,aegwynn,1771,mage,frost,66,37,29
Targaryen,haomarush,1768,mage,frost,70,43,27
Rere,zenedar,1766,mage,frost,38,21,17
Stickiburn,malganis,1766,mage,frost,99,47,52
Zøe,aggra-português,1762,mage,frost,90,51,39
Мибринк,soulflayer,1762,mage,frost,186,96,90
Donishakur,ragnaros,1762,mage,frost,90,45,45
Lorothar,blackhand,1762,mage,frost,72,30,42
Crzyubrdrver,blackrock,1761,mage,frost,36,21,15
Shakéx,outland,1758,mage,frost,51,26,25
Róseonly,ravencrest,1758,mage,frost,135,65,70
Леракобольд,gordunni,1755,mage,frost,56,30,26
Farciminis,outland,1754,mage,frost,298,157,141
Èverix,ravencrest,1750,mage,frost,136,59,77
Колинас,soulflayer,1749,mage,frost,107,53,54
Kõl,ravencrest,1748,mage,frost,78,42,36
Mexxî,thrall,1747,mage,frost,78,41,37
Nightfee,eredar,1745,mage,frost,42,21,21
Vareesy,drakthul,1743,mage,frost,171,97,74
Tagrine,kaelthas,1742,mage,frost,182,92,90
Ôbsury,hyjal,1739,mage,frost,142,79,63
Ephixis,ravencrest,1738,mage,frost,128,58,70
Helloimgone,blackmoore,1737,mage,frost,59,27,32
Mumage,blackrock,1735,mage,frost,60,32,28
Senedai,stormscale,1734,mage,frost,133,71,62
Bestial,alexstrasza,1734,mage,frost,188,95,93
Ганссмаг,soulflayer,1734,mage,frost,60,29,31
Emerlyn,ragnaros,1732,mage,frost,42,23,19
Icydeadsheep,draenor,1732,mage,frost,107,52,55
Ioriyagami,dragonmaw,1732,mage,frost,94,45,49
Fireblood,runetotem,1730,mage,frost,96,45,51
Darkoftw,ysondre,1729,mage,frost,125,58,67
Kyomachix,ahnqiraj,1727,mage,frost,60,31,29
Jamzymage,emerald-dream,1727,mage,frost,86,44,42
Neymar,aszune,1725,mage,frost,35,24,11
Blackfirez,ravencrest,1725,mage,frost,30,18,12
Xall,silvermoon,1725,mage,frost,193,105,88
Гелиадо,soulflayer,1724,mage,frost,42,19,23
Okayhehexd,dun-morogh,1723,mage,frost,162,92,70
Naylz,archimonde,1723,mage,frost,62,34,28
Nilitarrgh,outland,1721,mage,frost,36,18,18
Dastion,sylvanas,1718,mage,frost,36,18,18
Arimila,sylvanas,1717,mage,frost,334,171,163
Secretagent,aegwynn,1716,mage,frost,42,30,12
Swizzy,arathor,1716,mage,frost,76,42,34
Sweetcandy,outland,1715,mage,frost,107,62,45
Äntigood,outland,1715,mage,frost,306,156,150
Mystikj,arathor,1715,mage,frost,72,35,37
Esscheppert,blackrock,1713,mage,frost,299,145,154
Мэдвэйз,gordunni,1710,mage,frost,118,62,56
Tabueno,kazzak,1709,mage,frost,150,70,80
Klueless,ravencrest,1708,mage,frost,30,19,11
Covran,stormscale,1706,mage,frost,149,75,74
Hambones,outland,1706,mage,frost,86,39,47
Babidi,nemesis,1704,mage,frost,66,36,30
Charliezard,argent-dawn,1704,mage,frost,42,18,24
Marybaguette,archimonde,1702,mage,frost,54,25,29
Calina,azshara,1700,mage,frost,53,32,21
Axhole,darksorrow,1700,mage,frost,54,26,28
Tfmchamp,ravencrest,1698,mage,frost,33,22,11
Сизаам,howling-fjord,1697,mage,frost,54,34,20
Borêta,blackrock,1697,mage,frost,217,114,103
Andors,conseil-des-ombres,1697,mage,frost,42,18,24
Wàneís,ravencrest,1697,mage,frost,66,26,40
Альмодера,gordunni,1696,mage,frost,60,35,25
Wracrz,argent-dawn,1696,mage,frost,102,51,51
Barryscótt,stormscale,1695,mage,frost,30,21,9
Seikatsu,sylvanas,1694,mage,frost,42,20,22
Bigacombusta,tarren-mill,1693,mage,frost,134,65,69
Melíssa,silvermoon,1692,mage,frost,36,25,11
Elrorfiniel,draenor,1692,mage,frost,56,29,27
Vilain,tarren-mill,1692,mage,frost,88,44,44
Alearis,die-aldor,1690,mage,frost,72,38,34
Frostgodxqt,ravencrest,1689,mage,frost,105,58,47
Grandbasile,hyjal,1689,mage,frost,72,33,39
Jennao,stormscale,1686,mage,frost,47,26,21
Scoodles,kazzak,1685,mage,frost,48,26,22
Lilblinks,silvermoon,1683,mage,frost,203,108,95
Raíner,eredar,1683,mage,frost,155,82,73
Xep,ragnaros,1682,mage,frost,54,27,27
Bombswag,bloodhoof,1682,mage,frost,329,163,166
Kiirin,drakthul,1682,mage,frost,140,69,71
Khimeron,twisting-nether,1682,mage,frost,108,48,60
Kaeser,ravencrest,1681,mage,frost,151,79,72
Jenggot,ravencrest,1681,mage,frost,35,18,17
Cavadrex,arathor,1677,mage,frost,102,54,48
Xirrasho,argent-dawn,1677,mage,frost,42,22,20
Fîsheye,blackrock,1676,mage,frost,30,18,12
Алаурс,howling-fjord,1676,mage,frost,194,94,100
Манахк,gordunni,1674,mage,frost,48,22,26
Tiqma,sylvanas,1673,mage,frost,42,23,19
Jezí,ghostlands,1673,mage,frost,96,44,52
Ishimura,eredar,1669,mage,frost,96,51,45
Afterimage,zuljin,1669,mage,frost,199,99,100
Озобочений,greymane,1667,mage,frost,223,114,109
Sylbris,outland,1667,mage,frost,177,84,93
Саваннхмаег,blackscar,1665,mage,frost,57,34,23
Espressno,ravencrest,1664,mage,frost,35,22,13
Tánu,quelthalas,1664,mage,frost,323,158,165
Lïppoutou,archimonde,1663,mage,frost,35,18,17
Wýr,archimonde,1661,mage,frost,157,80,77
Synblink,eredar,1659,mage,frost,98,47,51
Nozarashí,hyjal,1656,mage,frost,225,114,111
Boomboomciao,nemesis,1656,mage,frost,203,102,101
Mgtowforlife,ravencrest,1656,mage,frost,365,179,186
Dsmoke,ravencrest,1656,mage,frost,81,39,42
Ahdetärjag,silvermoon,1655,mage,frost,59,32,27
Gensorèd,darksorrow,1655,mage,frost,74,36,38
Trowbe,blackmoore,1654,mage,frost,48,26,22
Гекомория,fordragon,1654,mage,frost,74,39,35
Viro,defias-brotherhood,1654,mage,frost,63,33,30
Fboltprocd,ragnaros,1654,mage,frost,47,23,24
Манакса,gordunni,1654,mage,frost,54,24,30
Bebenm,archimonde,1653,mage,frost,84,42,42
Knúbbz,ravencrest,1652,mage,frost,90,45,45
Smashdown,blackrock,1651,mage,frost,66,36,30
Chíefsheep,thrall,1651,mage,frost,71,33,38
Firzen,defias-brotherhood,1650,mage,frost,38,20,18
Nebbur,dun-modr,1650,mage,frost,54,25,29
Anniemykween,ravencrest,1649,mage,frost,184,103,81
Slobbery,aggramar,1649,mage,frost,95,48,47
Lo,kilrogg,1649,mage,frost,120,57,63
Shattermaybe,blackrock,1646,mage,frost,36,21,15
Johnnydeepp,archimonde,1646,mage,frost,36,18,18
Soloqtarget,archimonde,1645,mage,frost,223,108,115
Rukiax,blackrock,1645,mage,frost,54,18,36
Løxyy,ysondre,1644,mage,frost,206,111,95
Botanicula,the-maelstrom,1644,mage,frost,42,20,22
Shizzy,onyxia,1644,mage,frost,66,31,35
Djflashz,archimonde,1644,mage,frost,42,18,24
Firebaw,tarren-mill,1643,mage,frost,36,25,11
Helminsterr,archimonde,1642,mage,frost,90,47,43
Muchmage,silvermoon,1642,mage,frost,125,59,66
Dostoïevskix,hyjal,1640,mage,frost,30,19,11
Jedite,die-todeskrallen,1640,mage,frost,385,206,179
Schmutzki,eredar,1638,mage,frost,113,63,50
Astaden,die-aldor,1637,mage,frost,105,61,44
Icekíss,hyjal,1637,mage,frost,103,55,48
Jirø,cthun,1637,mage,frost,226,110,116
Вольняша,azuregos,1637,mage,frost,244,118,126
Slithìce,kazzak,1637,mage,frost,54,22,32
Emesarry,scarshield-legion,1636,mage,frost,29,18,11
Magerocks,ragnaros,1635,mage,frost,36,20,16
Sondremage,outland,1635,mage,frost,134,60,74
Фристейт,soulflayer,1635,mage,frost,84,34,50
Brolyzerr,archimonde,1634,mage,frost,43,23,20
Kythie,thrall,1634,mage,frost,156,75,81
Tærrëñshíll,tarren-mill,1634,mage,frost,48,22,26
Obbcontrol,ravencrest,1633,mage,frost,48,21,27
Vilenciaga,kazzak,1632,mage,frost,72,37,35
Mecharience,rexxar,1632,mage,frost,62,31,31
Jaimey,blackhand,1632,mage,frost,167,76,91
Scorchira,outland,1631,mage,frost,30,18,12
Asiman,eredar,1631,mage,frost,51,22,29
Skretx,archimonde,1630,mage,frost,72,46,26
Frígíd,outland,1630,mage,frost,54,25,29
Ákyraz,blackrock,1630,mage,frost,47,21,26
Naween,hyjal,1629,mage,frost,42,24,18
Frostique,kazzak,1629,mage,frost,175,99,76
Thesiôu,ravencrest,1629,mage,frost,36,20,16
Buddi,burning-blade,1629,mage,frost,287,148,139
Akâri,silvermoon,1629,mage,frost,91,42,49
Ønlyfünds,archimonde,1628,mage,frost,48,32,16
Bzzr,tarren-mill,1627,mage,frost,66,42,24
Sinanspappa,argent-dawn,1627,mage,frost,30,18,12
Проблембойх,gordunni,1627,mage,frost,36,20,16
Gødstopmeplz,aegwynn,1627,mage,frost,52,28,24
Nightseven,emeriss,1626,mage,frost,36,24,12
Thinamerican,defias-brotherhood,1626,mage,frost,60,34,26
Аквамелис,gordunni,1626,mage,frost,132,60,72
Venque,blackrock,1625,mage,frost,72,33,39
Glowie,stormreaver,1623,mage,frost,36,20,16
Lyramage,draenor,1623,mage,frost,66,32,34
Xenant,ravencrest,1623,mage,frost,42,18,24
Rusdor,frostwhisper,1622,mage,frost,96,43,53
Kaì,twisting-nether,1621,mage,frost,160,91,69
Jonku,tarren-mill,1621,mage,frost,65,33,32
Pharohe,stormscale,1621,mage,frost,86,40,46
Scaleeth,kazzak,1620,mage,frost,82,44,38
Akúmã,stormscale,1619,mage,frost,396,209,187
Maquiwizz,aggra-português,1618,mage,frost,85,49,36
Digi,ravencrest,1617,mage,frost,57,22,35
Find,archimonde,1616,mage,frost,232,118,114
Anaxtra,guldan,1616,mage,frost,165,79,86
Walian,burning-blade,1615,mage,frost,60,36,24
Layzzy,kazzak,1614,mage,frost,268,128,140
Pezi,outland,1613,mage,frost,67,39,28
Sykz,hyjal,1612,mage,frost,101,53,48
Shøcked,blackrock,1612,mage,frost,114,56,58
Манаксаа,gordunni,1612,mage,frost,45,21,24
Джейнанис,gordunni,1611,mage,frost,88,50,38
Xæll,silvermoon,1611,mage,frost,120,64,56
Qtpoof,sylvanas,1610,mage,frost,42,22,20
Фирдаркнесс,howling-fjord,1610,mage,frost,78,40,38
Únna,sanguino,1609,mage,frost,99,58,41
Isralysa,ravencrest,1609,mage,frost,344,181,163
Shainax,dun-modr,1609,mage,frost,301,158,143
Nelfchewer,ravencrest,1609,mage,frost,56,25,31
Mollymorph,ragnaros,1609,mage,frost,54,21,33
Frostandrew,twisting-nether,1608,mage,frost,41,23,18
Mupana,nagrand,1607,mage,frost,150,76,74
Shalien,tarren-mill,1607,mage,frost,83,41,42
Focusmage,outland,1606,mage,frost,82,47,35
Miokimijima,draenor,1606,mage,frost,38,21,17
Tills,kargath,1606,mage,frost,42,20,22
Zauberdose,blackhand,1605,mage,frost,42,20,22
Келлазар,gordunni,1605,mage,frost,83,38,45
Razx,stormscale,1605,mage,frost,140,63,77
Манахк,blackscar,1605,mage,frost,53,21,32
Hardtimes,blackhand,1604,mage,frost,35,27,8
Quinella,ravencrest,1604,mage,frost,155,80,75
Copyright,deathwing,1604,mage,frost,36,17,19
Sandalf,lightnings-blade,1603,mage,frost,73,42,31
Noxkin,stormscale,1603,mage,frost,36,17,19
Magethings,kazzak,1603,mage,frost,54,25,29
Søbert,hyjal,1602,mage,frost,47,25,22
Мэдраша,gordunni,1602,mage,frost,116,50,66
Réd,earthen-ring,1601,mage,frost,77,36,41
Vyuca,argent-dawn,1599,mage,frost,82,44,38
Absoluteswag,tarren-mill,1598,mage,frost,39,22,17
Itzlucky,twisting-nether,1598,mage,frost,214,108,106
Rihnou,blackmoore,1597,mage,frost,197,96,101
Rinuria,blackrock,1596,mage,frost,30,19,11
Sam,outland,1595,mage,frost,36,22,14
Êgôn,perenolde,1595,mage,frost,47,24,23
Инфолфг,gordunni,1594,mage,frost,30,17,13
Tromie,archimonde,1594,mage,frost,221,115,106
Tableau,blackrock,1592,mage,frost,62,31,31
Sersei,garona,1590,mage,frost,36,17,19
Hógwarts,aegwynn,1588,mage,frost,90,46,44
Rankonedeep,kazzak,1587,mage,frost,63,34,29
Tjq,ravencrest,1586,mage,frost,664,337,327
Råståfåri,uldum,1586,mage,frost,191,95,96
Rodeyy,nathrezim,1583,mage,frost,130,68,62
Sheepthrillz,blackmoore,1583,mage,frost,65,34,31
Joulz,ravencrest,1583,mage,frost,200,94,106
Ёкай,soulflayer,1581,mage,frost,432,227,205
Iceteen,aegwynn,1579,mage,frost,42,22,20
Óuíja,outland,1576,mage,frost,51,31,20
Nimdáá,stormscale,1575,mage,frost,204,113,91
Demensida,ravencrest,1574,mage,frost,268,137,131
Bumbumdead,sylvanas,1573,mage,frost,66,33,33
Hectiickz,bloodhoof,1572,mage,frost,36,18,18
Hazzá,ravencrest,1571,mage,frost,36,17,19
Opíum,tarren-mill,1570,mage,frost,48,27,21
Dubbleblast,draenor,1570,mage,frost,48,25,23
Корадо,gordunni,1570,mage,frost,327,161,166
Ингилейф,howling-fjord,1570,mage,frost,46,18,28
Realone,ragnaros,1569,mage,frost,81,39,42
Manafuzz,outland,1569,mage,frost,48,22,26
Marikisanx,blackmoore,1568,mage,frost,42,22,20
Microsmag,thrall,1566,mage,frost,24,17,7
Azakadabra,ysondre,1566,mage,frost,75,46,29
Phonkim,stormscale,1566,mage,frost,36,18,18
Iroya,festung-der-stürme,1565,mage,frost,529,265,264
Bodyrocker,sylvanas,1564,mage,frost,35,17,18
Dubstep,blackrock,1561,mage,frost,60,27,33
Порнушный,gordunni,1560,mage,frost,60,31,29
Nilys,chogall,1559,mage,frost,78,50,28
Вендайса,soulflayer,1558,mage,frost,274,156,118
Chareyla,argent-dawn,1558,mage,frost,83,42,41
Xawokem,outland,1558,mage,frost,42,18,24
Sakuranosuke,twisting-nether,1557,mage,frost,72,39,33
Snaapz,kazzak,1557,mage,frost,54,23,31
Gaduz,kazzak,1556,mage,frost,72,31,41
Autramage,emerald-dream,1555,mage,frost,66,35,31
Ímback,outland,1554,mage,frost,60,31,29
Labyssra,argent-dawn,1553,mage,frost,80,37,43
Samath,conseil-des-ombres,1552,mage,frost,78,34,44
Discomorph,the-maelstrom,1551,mage,frost,34,21,13
Tdv,draenor,1551,mage,frost,111,52,59
Pølåris,outland,1550,mage,frost,155,82,73
Elcritadoré,ragnaros,1550,mage,frost,52,26,26
Гамаюнх,deathguard,1550,mage,frost,60,28,32
Bananabread,the-maelstrom,1549,mage,frost,105,51,54
Xyfys,azshara,1547,mage,frost,41,23,18
Misslance,kazzak,1547,mage,frost,48,26,22
Mxrrz,kazzak,1547,mage,frost,211,111,100
Phélenia,sargeras,1546,mage,frost,244,123,121
Delvir,stormreaver,1546,mage,frost,96,46,50
Ghalanz,ravencrest,1545,mage,frost,60,29,31
Petepan,argent-dawn,1543,mage,frost,115,55,60
Бингчилинг,howling-fjord,1543,mage,frost,64,30,34
Naissa,arathor,1542,mage,frost,60,23,37
Llura,ragnaros,1541,mage,frost,66,32,34
Koreanbbq,outland,1541,mage,frost,42,18,24
Marcotekk,dun-modr,1539,mage,frost,68,36,32
Doidadetanga,aggra-português,1539,mage,frost,93,47,46
Fullpolly,twisting-nether,1538,mage,frost,47,29,18
Райоми,fordragon,1538,mage,frost,397,198,199
Ozon,sylvanas,1538,mage,frost,60,29,31
Girldalf,silvermoon,1537,mage,frost,231,113,118
Borko,rashgarroth,1536,mage,frost,42,23,19
Hendersson,blackrock,1536,mage,frost,48,21,27
Nàtcho,tichondrius,1535,mage,frost,60,35,25
Sickofme,aegwynn,1535,mage,frost,30,16,14
Alicánte,silvermoon,1535,mage,frost,126,65,61
Comodus,ragnaros,1534,mage,frost,148,74,74
Iverson,kazzak,1534,mage,frost,130,60,70
Fïttan,stormscale,1533,mage,frost,143,72,71
Apeex,chamber-of-aspects,1532,mage,frost,160,77,83
Aurelius,kargath,1531,mage,frost,42,24,18
Gêrky,drakthul,1531,mage,frost,140,73,67
Homellander,silvermoon,1531,mage,frost,535,273,262
Миднаит,gordunni,1531,mage,frost,111,50,61
Elldiamage,draenor,1531,mage,frost,36,16,20
Karstnstenzl,blackrock,1530,mage,frost,78,39,39
Pronyma,outland,1530,mage,frost,91,44,47
Dumblemore,ragnaros,1529,mage,frost,66,38,28
Hbarftw,ravencrest,1528,mage,frost,71,35,36
Roberx,sanguino,1528,mage,frost,101,48,53
Styxmg,blackhand,1526,mage,frost,42,18,24
Мосгормаг,gordunni,1525,mage,frost,55,28,27
Leafløver,ravencrest,1525,mage,frost,95,46,49
Ковенн,howling-fjord,1525,mage,frost,54,26,28
Кварийм,howling-fjord,1524,mage,frost,192,99,93
Evilmagíc,tarren-mill,1523,mage,frost,30,16,14
ßalca,twisting-nether,1522,mage,frost,50,27,23
Beaun,tarren-mill,1522,mage,frost,225,115,110
Homper,argent-dawn,1521,mage,frost,36,19,17
Свдпро,deathguard,1521,mage,frost,88,44,44
Icefix,dun-modr,1520,mage,frost,159,84,75
Qùb,eldrethalas,1519,mage,frost,42,23,19
Grumpyorc,ravencrest,1519,mage,frost,405,203,202
Excuses,chamber-of-aspects,1519,mage,frost,314,155,159
Tvångstralla,tarren-mill,1519,mage,frost,79,38,41
Arcticfury,ravencrest,1518,mage,frost,30,16,14
Xue,azshara,1518,mage,frost,60,29,31
Aoes,twisting-nether,1518,mage,frost,47,21,26
Ghosty,festung-der-stürme,1517,mage,frost,24,16,8
Airo,drakthul,1517,mage,frost,66,40,26
Larmp,outland,1517,mage,frost,42,16,26
Ney,drakthul,1516,mage,frost,24,16,8
Exelo,rashgarroth,1516,mage,frost,61,34,27
Sekulicgoga,draenor,1515,mage,frost,309,168,141
Xoouuboo,eredar,1513,mage,frost,30,16,14
Qqpwn,ragnaros,1512,mage,frost,106,54,52
Næj,hyjal,1512,mage,frost,67,29,38
Mohovik,wildhammer,1510,mage,frost,42,23,19
Метох,soulflayer,1510,mage,frost,219,106,113
Adagar,chamber-of-aspects,1509,mage,frost,101,55,46
Kukerr,burning-legion,1507,mage,frost,57,32,25
Ðíø,twisting-nether,1507,mage,frost,94,49,45
Thamagus,burning-legion,1507,mage,frost,52,26,26
Track,blackhand,1507,mage,frost,53,22,31
Amyseven,kazzak,1506,mage,frost,120,55,65
Rexør,frostwolf,1505,mage,frost,54,31,23
Denaleidi,stormscale,1505,mage,frost,54,30,24
Alluryeine,draenor,1505,mage,frost,65,36,29
Chicke,outland,1504,mage,frost,70,36,34
Ckrax,sanguino,1504,mage,frost,48,24,24
Newintown,blackmoore,1503,mage,frost,62,32,30
Snakebit,kazzak,1502,mage,frost,198,101,97
Tarkún,dun-modr,1501,mage,frost,122,73,49
Arridon,echsenkessel,1500,mage,frost,122,68,54
Confine,twisting-nether,1498,mage,frost,180,95,85
Spellcast,ravencrest,1496,mage,frost,33,18,15
Нонекс,soulflayer,1496,mage,frost,118,59,59
Fyriel,burning-legion,1495,mage,frost,42,20,22
Wslyx,dun-morogh,1494,mage,frost,96,41,55
Митгори,gordunni,1493,mage,frost,74,39,35
Trais,blackrock,1492,mage,frost,57,35,22
Lukewizard,twisting-nether,1492,mage,frost,110,63,47
Aeternitaz,outland,1492,mage,frost,53,28,25
Isenhour,frostmane,1491,mage,frost,51,23,28
Averus,outland,1490,mage,frost,36,21,15
Velâska,malganis,1490,mage,frost,136,79,57
Drmng,stormscale,1490,mage,frost,39,18,21
Мозифрост,gordunni,1490,mage,frost,62,23,39
Сосулькина,gordunni,1488,mage,frost,95,50,45
Kokenn,hyjal,1485,mage,frost,114,61,53
Hetaxata,kazzak,1484,mage,frost,66,36,30
Kleptocracy,stormscale,1483,mage,frost,52,24,28
Lesoleil,archimonde,1479,mage,frost,48,28,20
Мэлфариус,soulflayer,1478,mage,frost,48,27,21
Addew,the-maelstrom,1478,mage,frost,107,57,50
Wukidiwn,draenor,1478,mage,frost,107,49,58
Lÿra,chants-éternels,1478,mage,frost,42,19,23
Drandis,blackmoore,1478,mage,frost,36,16,20
Kelthuzed,twisting-nether,1477,mage,frost,54,28,26
Frostspree,wildhammer,1476,mage,frost,55,30,25
Octtmiss,twisting-nether,1476,mage,frost,33,17,16
Nutsa,silvermoon,1476,mage,frost,52,25,27
Оай,gordunni,1476,mage,frost,90,40,50
Maxik,outland,1474,mage,frost,63,31,32
Spamblink,archimonde,1474,mage,frost,63,18,45
Lyès,uldaman,1473,mage,frost,42,21,21
Vannq,silvermoon,1473,mage,frost,124,55,69
Zaruna,arathor,1472,mage,frost,87,45,42
Sciren,nagrand,1471,mage,frost,31,16,15
Ромзесх,howling-fjord,1469,mage,frost,38,25,13
Widmage,silvermoon,1469,mage,frost,140,63,77
Destrech,aggra-português,1467,mage,frost,36,21,15
Phenoxi,sylvanas,1466,mage,frost,72,36,36
Filoux,frostwolf,1465,mage,frost,50,20,30
Фемна,soulflayer,1464,mage,frost,166,87,79
Stace,area-52,1463,mage,frost,54,19,35
Caststuffatu,sylvanas,1462,mage,frost,125,62,63
Warwizz,sanguino,1461,mage,frost,57,30,27
Рэймонд,howling-fjord,1461,mage,frost,47,19,28
Shêepwithme,ravencrest,1459,mage,frost,59,35,24
Saucise,hyjal,1459,mage,frost,102,51,51
Novalia,wrathbringer,1457,mage,frost,131,70,61
Аваон,deathguard,1457,mage,frost,153,76,77
Derbomber,guldan,1456,mage,frost,53,22,31
Aceripper,ragnaros,1455,mage,frost,182,96,86
Diji,the-maelstrom,1455,mage,frost,36,17,19
Spellfaker,drakthul,1454,mage,frost,27,18,9
Файрусх,blackscar,1454,mage,frost,78,43,35
Анзот,howling-fjord,1453,mage,frost,82,47,35
Knoxvit,tarren-mill,1453,mage,frost,63,35,28
Ia,kirin-tor,1452,mage,frost,46,25,21
Badguy,arathor,1452,mage,frost,40,18,22
Sangumage,silvermoon,1451,mage,frost,54,25,29
Stillfrostin,blackrock,1449,mage,frost,99,59,40
Necizbored,tarren-mill,1449,mage,frost,61,33,28
Plætinum,ravencrest,1449,mage,frost,216,108,108
Dllarky,drakthul,1448,mage,frost,48,24,24
Zenó,blackrock,1448,mage,frost,42,17,25
Badcouz,dalaran,1447,mage,frost,41,21,20
Woorm,sylvanas,1446,mage,frost,76,44,32
Tôke,kaelthas,1446,mage,frost,114,61,53
Bebarz,darksorrow,1446,mage,frost,184,96,88
Цепнойпёс,goldrinn,1446,mage,frost,46,24,22
Azadan,pozzo-delleternità,1446,mage,frost,47,23,24
Старкскрим,gordunni,1445,mage,frost,130,60,70
Gàtsby,outland,1444,mage,frost,138,73,65
Datakrigern,tarren-mill,1444,mage,frost,81,41,40
Summermàge,ravencrest,1444,mage,frost,60,29,31
Енотмаг,gordunni,1443,mage,frost,100,52,48
Tàylerdarden,nemesis,1443,mage,frost,142,69,73
Rodatudo,ravencrest,1443,mage,frost,213,101,112
Afklow,pozzo-delleternità,1442,mage,frost,39,21,18
Darkseidez,alonsus,1442,mage,frost,90,44,46
Eldariel,ravencrest,1442,mage,frost,101,48,53
Rusdorcito,frostwhisper,1442,mage,frost,51,18,33
Gyanni,blackmoore,1441,mage,frost,30,17,13
Учительйода,ashenvale,1440,mage,frost,96,54,42
Elcølgaø,sanguino,1440,mage,frost,162,76,86
Frostvirgin,twisting-nether,1438,mage,frost,54,24,30
Sukky,todeswache,1438,mage,frost,82,36,46
Kèj,kazzak,1438,mage,frost,69,30,39
Tìktokthot,outland,1437,mage,frost,24,15,9
Sippebób,laughing-skull,1437,mage,frost,100,55,45
Umaguma,elune,1437,mage,frost,106,54,52
Bengeezuz,silvermoon,1437,mage,frost,42,15,27
Shnitz,stormscale,1436,mage,frost,24,15,9
Ceillech,blackrock,1436,mage,frost,112,52,60
Nevaehine,ravencrest,1435,mage,frost,313,163,150
Pipihu,silvermoon,1435,mage,frost,72,37,35
Mclancealot,tarren-mill,1435,mage,frost,111,51,60
Tnhigh,blackrock,1434,mage,frost,33,24,9
Ímnotback,outland,1434,mage,frost,450,228,222
Инкрионити,gordunni,1433,mage,frost,29,16,13
Smöked,tarren-mill,1433,mage,frost,402,207,195
Jakuub,outland,1432,mage,frost,48,24,24
Firemindz,argent-dawn,1430,mage,frost,24,15,9
Surlancealot,outland,1428,mage,frost,95,42,53
Destruct,doomhammer,1426,mage,frost,269,143,126
Пиньон,borean-tundra,1425,mage,frost,36,21,15
Дарнивил,gordunni,1425,mage,frost,218,110,108
Фростидзе,gordunni,1425,mage,frost,96,45,51
Aileean,burning-legion,1422,mage,frost,125,71,54
Medium,der-rat-von-dalaran,1422,mage,frost,120,67,53
Fontaíne,doomhammer,1422,mage,frost,30,15,15
Gûl,kazzak,1422,mage,frost,30,15,15
Eclyftw,blackmoore,1422,mage,frost,60,29,31
Tainted,eredar,1422,mage,frost,89,43,46
Koreanbbq,kazzak,1422,mage,frost,65,31,34
Däpper,ragnaros,1421,mage,frost,72,33,39
Snîrs,thrall,1420,mage,frost,36,17,19
Reblink,draenor,1420,mage,frost,36,15,21
Pixlet,kazzak,1420,mage,frost,66,25,41
Drfröst,kazzak,1419,mage,frost,24,15,9
Alkhazzar,defias-brotherhood,1419,mage,frost,514,253,261
Béboutosaure,varimathras,1419,mage,frost,42,18,24
Iceiceice,stormscale,1418,mage,frost,54,30,24
Spellsteal,antonidas,1418,mage,frost,135,65,70
Гатмир,gordunni,1417,mage,frost,375,187,188
Hellionblast,ragnaros,1416,mage,frost,30,15,15
Frèézê,frostwolf,1416,mage,frost,54,26,28
Сэрруденкент,soulflayer,1414,mage,frost,42,23,19
Ilovedana,dun-modr,1414,mage,frost,56,16,40
Саккер,gordunni,1413,mage,frost,30,15,15
Hexmath,tarren-mill,1413,mage,frost,30,15,15
Messatsux,tarren-mill,1411,mage,frost,30,15,15
Dïabolike,archimonde,1410,mage,frost,102,58,44
Fistersfrizz,aegwynn,1410,mage,frost,76,42,34
Zionw,frostwolf,1410,mage,frost,121,60,61
Dzikk,silvermoon,1410,mage,frost,97,46,51
Phaynz,cthun,1408,mage,frost,42,25,17
Seyece,silvermoon,1408,mage,frost,59,34,25
Lepeps,silvermoon,1408,mage,frost,77,29,48
Esculapìo,nemesis,1407,mage,frost,370,192,178
Лрее,gordunni,1406,mage,frost,95,46,49
Манднесс,azuregos,1405,mage,frost,60,32,28
Aern,sinstralis,1405,mage,frost,53,25,28
Викликс,borean-tundra,1404,mage,frost,94,53,41
Lusionator,defias-brotherhood,1404,mage,frost,124,67,57
Illius,kelthuzad,1404,mage,frost,198,101,97
Grismage,twisting-nether,1404,mage,frost,60,21,39
Ayoubz,outland,1403,mage,frost,35,16,19
Sixx,aegwynn,1402,mage,frost,152,76,76
Shagee,stormscale,1399,mage,frost,30,16,14
Crackheads,hyjal,1398,mage,frost,96,48,48
Kippercarry,outland,1398,mage,frost,30,15,15
Pluribusunum,outland,1398,mage,frost,38,17,21
Justleblanc,dalaran,1397,mage,frost,106,53,53
Kanjani,antonidas,1397,mage,frost,72,34,38
Flavie,hellfire,1395,mage,frost,35,24,11
Hernêise,silvermoon,1395,mage,frost,185,94,91
Elynaé,draenor,1395,mage,frost,70,33,37
Tìnder,tarren-mill,1394,mage,frost,161,84,77
Raikøn,blackmoore,1394,mage,frost,56,29,27
Mdog,stormreaver,1393,mage,frost,102,55,47
Azkarr,stormscale,1393,mage,frost,65,34,31
Archyl,kazzak,1393,mage,frost,30,15,15
Apócalyptic,tarren-mill,1392,mage,frost,76,44,32
Hoodmago,blackrock,1392,mage,frost,53,30,23
Manôu,kirin-tor,1391,mage,frost,60,24,36
Faunas,kazzak,1390,mage,frost,115,58,57
Свиноколдун,howling-fjord,1390,mage,frost,91,41,50
Khivax,twisting-nether,1390,mage,frost,126,55,71
Lole,uldum,1389,mage,frost,174,94,80
Wormhole,kazzak,1389,mage,frost,42,17,25
Quilava,ghostlands,1388,mage,frost,61,34,27
Vignoni,the-maelstrom,1382,mage,frost,130,74,56
Katarapower,silvermoon,1382,mage,frost,511,254,257
Pyro,eldrethalas,1382,mage,frost,99,48,51
Icé,auchindoun,1382,mage,frost,80,33,47
Tyronesbone,stormscale,1380,mage,frost,53,28,25
Leonora,blackhand,1380,mage,frost,60,22,38
Luxxurious,xavius,1379,mage,frost,70,30,40
Azegodxlul,kazzak,1379,mage,frost,36,15,21
Nøw,kazzak,1378,mage,frost,39,16,23
Sleîhg,sanguino,1376,mage,frost,82,40,42
Ãzi,ravencrest,1375,mage,frost,52,30,22
Lumberth,sanguino,1375,mage,frost,30,16,14
Spiridrell,silvermoon,1375,mage,frost,51,17,34
Quail,anubarak,1372,mage,frost,267,132,135
Тачмахал,soulflayer,1372,mage,frost,115,54,61
Lsdt,stormscale,1372,mage,frost,42,16,26
Oizar,hyjal,1371,mage,frost,48,25,23
Shüri,kazzak,1370,mage,frost,84,46,38
Xîzy,outland,1370,mage,frost,28,15,13
Javelintouch,eldrethalas,1370,mage,frost,45,22,23
Nodmg,nefarian,1368,mage,frost,45,29,16
Nellý,stormreaver,1368,mage,frost,30,18,12
Delieth,nemesis,1367,mage,frost,51,27,24
Hayaka,sanguino,1367,mage,frost,125,61,64
Орижн,howling-fjord,1366,mage,frost,53,29,24
Psika,kazzak,1366,mage,frost,177,82,95
Mínêrvâ,blackrock,1365,mage,frost,34,19,15
Àrtix,silvermoon,1364,mage,frost,30,16,14
Iceorb,azshara,1364,mage,frost,114,52,62
Arlunea,blackmoore,1364,mage,frost,50,20,30
Iulie,kazzak,1363,mage,frost,225,112,113
Myes,stormscale,1363,mage,frost,36,17,19
Laenadria,argent-dawn,1363,mage,frost,121,55,66
Фрайбл,gordunni,1361,mage,frost,31,16,15
Cheerió,aggramar,1360,mage,frost,254,118,136
Feuererdnuss,blackhand,1359,mage,frost,41,18,23
Ibexia,blackrock,1358,mage,frost,53,19,34
Insømnium,stormscale,1357,mage,frost,29,15,14
Ymirë,khaz-modan,1357,mage,frost,51,22,29
Cardioexpert,ravencrest,1356,mage,frost,25,15,10
Иксайс,soulflayer,1356,mage,frost,57,24,33
Partagedeco,dalaran,1355,mage,frost,30,16,14
Abolf,twisting-nether,1354,mage,frost,58,31,27
Kyraja,arthas,1354,mage,frost,72,31,41
Гунмаказ,soulflayer,1353,mage,frost,58,34,24
Cuishle,kaelthas,1353,mage,frost,42,17,25
Alktraz,outland,1352,mage,frost,102,48,54
Tuxedo,thrall,1349,mage,frost,31,15,16
Inaruy,hyjal,1347,mage,frost,26,15,11
Sylênna,kazzak,1347,mage,frost,60,30,30
Corpusqq,eredar,1347,mage,frost,54,26,28
Shroomie,eredar,1346,mage,frost,214,107,107
Morphees,twisting-nether,1345,mage,frost,42,25,17
Zwölfte,outland,1345,mage,frost,148,84,64
Bolesnimage,draenor,1345,mage,frost,59,33,26
Firehasse,draenor,1345,mage,frost,126,67,59
Widurr,burning-legion,1345,mage,frost,78,34,44
Manvo,bloodscalp,1345,mage,frost,60,23,37
Nightplays,sylvanas,1344,mage,frost,54,29,25
Preí,archimonde,1344,mage,frost,37,15,22
Shédudé,silvermoon,1343,mage,frost,36,19,17
Dabka,argent-dawn,1341,mage,frost,378,188,190
Daneliam,outland,1341,mage,frost,61,30,31
Ledenata,twisting-nether,1341,mage,frost,80,31,49
Dmmeforcam,archimonde,1340,mage,frost,26,15,11
Jokiss,draenor,1339,mage,frost,114,57,57
Лемозюка,gordunni,1338,mage,frost,24,14,10
Iggilaus,blackhand,1338,mage,frost,487,245,242
Cinoox,blackrock,1337,mage,frost,40,15,25
Crooja,antonidas,1337,mage,frost,45,15,30
Mogettemagic,ysondre,1336,mage,frost,118,59,59
Glöden,ravencrest,1336,mage,frost,44,20,24
Хоф,deathguard,1336,mage,frost,53,24,29
Kraliz,ysondre,1336,mage,frost,69,30,39
Zvezdica,kilrogg,1336,mage,frost,39,15,24
Xläderz,ravencrest,1335,mage,frost,24,14,10
Моритакаа,gordunni,1335,mage,frost,172,86,86
Frostytutes,ragnaros,1335,mage,frost,59,28,31
Mfnz,stormreaver,1335,mage,frost,41,18,23
Tirenia,bloodfeather,1335,mage,frost,41,15,26
Fractox,ysondre,1334,mage,frost,182,94,88
Spelltastíc,blackmoore,1333,mage,frost,24,14,10
Navolav,turalyon,1332,mage,frost,24,14,10
Imbatto,quelthalas,1332,mage,frost,42,20,22
Zôë,twisting-nether,1331,mage,frost,24,14,10
Badphaz,frostmane,1331,mage,frost,30,16,14
Lovma,doomhammer,1331,mage,frost,54,27,27
Karliah,azshara,1331,mage,frost,62,27,35
Shinzel,hyjal,1331,mage,frost,64,26,38
Sqwiz,outland,1330,mage,frost,96,41,55
Suidas,auchindoun,1329,mage,frost,118,58,60
Atixx,aegwynn,1329,mage,frost,54,18,36
Кройзис,howling-fjord,1328,mage,frost,80,46,34
Iceterror,ravencrest,1328,mage,frost,76,40,36
Xânârchy,minahonda,1327,mage,frost,84,42,42
Игрдлпдров,gordunni,1327,mage,frost,72,34,38
Кеото,gordunni,1326,mage,frost,24,14,10
Magegodx,rexxar,1325,mage,frost,81,39,42
Nuvx,ravencrest,1325,mage,frost,44,19,25
Braxxorz,chamber-of-aspects,1324,mage,frost,59,38,21
Veemi,blackmoore,1324,mage,frost,125,63,62
Zanazanelor,twisting-nether,1324,mage,frost,42,21,21
Caesarclown,silvermoon,1324,mage,frost,171,84,87
Bumboozling,kazzak,1324,mage,frost,30,14,16
Westellion,stormreaver,1323,mage,frost,41,20,21
Lorakruul,sanguino,1323,mage,frost,48,23,25
Iìíìíìíìíl,ravencrest,1323,mage,frost,47,19,28
Nyskal,tarren-mill,1322,mage,frost,53,24,29
Sused,outland,1321,mage,frost,30,16,14
Morozuvko,tarren-mill,1321,mage,frost,30,15,15
Kleini,die-aldor,1320,mage,frost,55,32,23
Ewina,twisting-nether,1320,mage,frost,30,16,14
Pruneau,hyjal,1320,mage,frost,101,52,49
Texita,sylvanas,1319,mage,frost,83,42,41
Icexx,outland,1319,mage,frost,30,15,15
Frostyfart,tarren-mill,1319,mage,frost,30,15,15
Jackin,burning-legion,1319,mage,frost,101,50,51
Nïo,ravencrest,1318,mage,frost,36,19,17
Driäm,ragnaros,1317,mage,frost,30,15,15
Rektd,blackhand,1317,mage,frost,222,110,112
Remantin,blackrock,1317,mage,frost,116,54,62
Vioulette,elune,1317,mage,frost,66,27,39
Meydoum,archimonde,1316,mage,frost,30,17,13
Лутиум,howling-fjord,1315,mage,frost,223,121,102
Dyx,nemesis,1315,mage,frost,114,54,60
Iceym,ravencrest,1313,mage,frost,41,17,24
Cunnus,stormreaver,1312,mage,frost,24,14,10
Bænoß,ravencrest,1312,mage,frost,30,16,14
Фиджарь,soulflayer,1312,mage,frost,165,83,82
Jemppai,outland,1312,mage,frost,51,19,32
Selith,magtheridon,1310,mage,frost,42,21,21
Bantos,khadgar,1309,mage,frost,78,29,49
Левченкопро,soulflayer,1308,mage,frost,261,132,129
Immobilizer,eredar,1307,mage,frost,150,74,76
Thry,bronzebeard,1307,mage,frost,146,69,77
Bobbasor,defias-brotherhood,1307,mage,frost,43,17,26
Куканыч,fordragon,1306,mage,frost,24,14,10
Aûrûm,silvermoon,1306,mage,frost,90,44,46
Vrajitöru,doomhammer,1304,mage,frost,26,16,10
Zisseron,frostmane,1303,mage,frost,42,20,22
Animaze,argent-dawn,1302,mage,frost,185,102,83
Keathlin,hyjal,1302,mage,frost,55,26,29
Intêrnet,archimonde,1302,mage,frost,44,16,28
Magitron,wildhammer,1301,mage,frost,35,18,17
Frostburns,stormscale,1300,mage,frost,44,20,24
Psychosiss,kazzak,1298,mage,frost,49,27,22
Zice,antonidas,1298,mage,frost,61,27,34
Nuryielle,blackmoore,1296,mage,frost,42,21,21
Momolamoto,hyjal,1294,mage,frost,108,57,51
Xaerow,archimonde,1294,mage,frost,42,22,20
Skarxaa,sanguino,1293,mage,frost,95,50,45
Winterblues,frostmourne,1291,mage,frost,36,20,16
Mordy,stormreaver,1291,mage,frost,32,16,16
Tjayy,kazzak,1291,mage,frost,105,48,57
Beardyman,haomarush,1291,mage,frost,48,20,28
Odisea,dun-modr,1290,mage,frost,30,17,13
Estupen,sanguino,1290,mage,frost,67,33,34
Tradez,norgannon,1290,mage,frost,60,26,34
Соорка,gordunni,1290,mage,frost,51,18,33
Ryydee,silvermoon,1289,mage,frost,679,342,337
Kundry,tarren-mill,1289,mage,frost,42,16,26
Frostjävel,grim-batol,1288,mage,frost,46,24,22
Endymîøn,aegwynn,1288,mage,frost,33,15,18
Narzoul,ysondre,1285,mage,frost,88,50,38
Voldemort,bronzebeard,1284,mage,frost,51,24,27
Nups,ravencrest,1284,mage,frost,139,63,76
Gliffy,terokkar,1283,mage,frost,119,66,53
Bengé,ragnaros,1283,mage,frost,40,22,18
Zoubaz,archimonde,1281,mage,frost,43,21,22
Kaaguraa,ravencrest,1278,mage,frost,371,189,182
Гаразлик,howling-fjord,1278,mage,frost,198,92,106
Ilikepoly,blackmoore,1277,mage,frost,79,42,37
Хадъюич,grom,1277,mage,frost,36,18,18
Xhal,hyjal,1277,mage,frost,36,18,18
Orelox,kazzak,1277,mage,frost,35,14,21
Маушко,soulflayer,1276,mage,frost,188,94,94
Fleqs,antonidas,1276,mage,frost,61,30,31
Augustusi,argent-dawn,1276,mage,frost,90,39,51
Deepfeed,ravencrest,1275,mage,frost,20,14,6
Айсвеном,gordunni,1275,mage,frost,150,78,72
Lovësosa,hyjal,1275,mage,frost,59,28,31
Мемберсх,gordunni,1275,mage,frost,38,16,22
Vathalis,zuluhed,1274,mage,frost,143,65,78
Ellyson,silvermoon,1273,mage,frost,39,16,23
Шанлис,gordunni,1272,mage,frost,30,16,14
Silvariy,stormscale,1272,mage,frost,142,71,71
Funakin,blackrock,1272,mage,frost,88,38,50
Chread,bronze-dragonflight,1272,mage,frost,42,15,27
Teuboku,ysondre,1271,mage,frost,43,27,16
Frozenwisp,stormrage,1271,mage,frost,83,49,34
Fleurdelacur,ravencrest,1270,mage,frost,75,41,34
Осмотрфанеры,howling-fjord,1270,mage,frost,114,51,63
Asteria,twisting-nether,1268,mage,frost,190,91,99
Dabina,sanguino,1267,mage,frost,133,66,67
Amarántha,kazzak,1266,mage,frost,30,15,15
Вельдрик,soulflayer,1264,mage,frost,232,118,114
Kazekudo,archimonde,1264,mage,frost,54,23,31
Vaessi,doomhammer,1263,mage,frost,29,14,15
Cantbelieve,sylvanas,1262,mage,frost,72,34,38
Ramires,xavius,1258,mage,frost,36,19,17
Zoba,sylvanas,1258,mage,frost,47,18,29
Darríck,argent-dawn,1258,mage,frost,42,14,28
Сорримама,soulflayer,1256,mage,frost,36,14,22
Suikune,twisting-nether,1253,mage,frost,30,20,10
Popixx,magtheridon,1253,mage,frost,96,43,53
Kapueca,jaedenar,1251,mage,frost,63,42,21
Thoria,sylvanas,1251,mage,frost,186,91,95
Lupuus,anubarak,1251,mage,frost,56,26,30
Okey,frostwhisper,1251,mage,frost,54,19,35
Sikaia,twisting-nether,1250,mage,frost,99,47,52
ßooh,kazzak,1249,mage,frost,75,40,35
Sickofme,blackmoore,1248,mage,frost,24,13,11
Dríme,ravencrest,1248,mage,frost,30,14,16
Bambaga,kazzak,1248,mage,frost,66,27,39
Zérodose,dalaran,1247,mage,frost,32,19,13
Yvonnita,chamber-of-aspects,1247,mage,frost,30,16,14
Abruaa,tarren-mill,1246,mage,frost,18,13,5
Schaap,tarren-mill,1245,mage,frost,18,13,5
Apic,blackrock,1245,mage,frost,29,19,10
Sàltym,ravencrest,1245,mage,frost,24,13,11
Bceps,stormscale,1245,mage,frost,66,35,31
Pwntt,terenas,1245,mage,frost,183,87,96
Wartheur,sanguino,1245,mage,frost,74,33,41
Ehren,ravencrest,1243,mage,frost,38,16,22
Bokvar,twisting-nether,1242,mage,frost,54,29,25
Faycia,blackhand,1242,mage,frost,107,49,58
Oiklo,eitrigg,1242,mage,frost,61,25,36
Njl,blackmoore,1241,mage,frost,24,13,11
Løgi,drakthul,1241,mage,frost,30,13,17
Trìxì,draenor,1241,mage,frost,102,44,58
Máurus,antonidas,1241,mage,frost,66,25,41
Kleisli,draenor,1240,mage,frost,30,13,17
Блья,howling-fjord,1238,mage,frost,91,53,38
Tacto,ravencrest,1238,mage,frost,390,199,191
Titanshao,silvermoon,1237,mage,frost,24,16,8
Rafaeala,argent-dawn,1237,mage,frost,247,132,115
Bossgb,twisting-nether,1237,mage,frost,75,40,35
Дырявка,galakrond,1237,mage,frost,84,37,47
Вайконд,howling-fjord,1236,mage,frost,50,23,27
Maeflix,aegwynn,1235,mage,frost,29,17,12
Magicuze,argent-dawn,1235,mage,frost,65,31,34
Magicppl,kazzak,1235,mage,frost,32,15,17
Wumz,blackrock,1233,mage,frost,24,13,11
Camaeel,aegwynn,1233,mage,frost,32,14,18
Gameboycolor,ravencrest,1233,mage,frost,36,13,23
Jokèr,silvermoon,1232,mage,frost,31,17,14
Vermilia,darksorrow,1232,mage,frost,157,71,86
Isolia,silvermoon,1232,mage,frost,47,21,26
Loriana,tichondrius,1232,mage,frost,51,18,33
Жемчужина,eversong,1231,mage,frost,76,34,42
Colder,hyjal,1231,mage,frost,36,15,21
Lakénz,archimonde,1230,mage,frost,30,16,14
Cumburlok,silvermoon,1230,mage,frost,30,13,17
Heavyfire,kazzak,1226,mage,frost,53,27,26
Juicedup,blackrock,1226,mage,frost,30,13,17
Aelire,die-aldor,1226,mage,frost,57,23,34
Zevúlòs,ravencrest,1225,mage,frost,84,50,34
Stryee,ragnaros,1225,mage,frost,30,14,16
Seelengott,onyxia,1224,mage,frost,322,158,164
Zeusmon,ragnaros,1224,mage,frost,113,52,61
Pyroden,stormscale,1224,mage,frost,42,18,24
Zzombi,sylvanas,1222,mage,frost,87,44,43
Вескнам,lich-king,1222,mage,frost,102,46,56
Хблэйз,howling-fjord,1222,mage,frost,36,14,22
Nazø,archimonde,1221,mage,frost,138,67,71
Eléaena,argent-dawn,1221,mage,frost,30,13,17
Lalli,silvermoon,1221,mage,frost,108,46,62
Edelvise,azjolnerub,1219,mage,frost,102,39,63
Thalaja,kazzak,1216,mage,frost,36,15,21
Aeternà,elune,1215,mage,frost,60,28,32
Misskity,blackrock,1215,mage,frost,42,18,24
Deano,outland,1214,mage,frost,24,14,10
Scoxywoxy,ragnaros,1213,mage,frost,86,42,44
Metaboi,ragnaros,1213,mage,frost,142,66,76
Trøll,nemesis,1212,mage,frost,24,13,11
Klésh,nemesis,1210,mage,frost,24,13,11
Lenycz,burning-blade,1210,mage,frost,87,42,45
Dollzer,khaz-modan,1209,mage,frost,24,13,11
Pinkis,darkmoon-faire,1209,mage,frost,235,121,114
Криолетта,gordunni,1209,mage,frost,90,40,50
Bublesk,outland,1208,mage,frost,24,13,11
Kídnappér,twisting-nether,1207,mage,frost,24,13,11
Jaghahah,tarren-mill,1206,mage,frost,114,62,52
Nandie,stormreaver,1206,mage,frost,38,19,19
Olivaresa,ravencrest,1205,mage,frost,50,17,33
Zagori,sylvanas,1204,mage,frost,103,47,56
Momotemp,emerald-dream,1203,mage,frost,120,61,59
Qwixxis,sylvanas,1201,mage,frost,125,64,61
Irreversal,ravencrest,1200,mage,frost,155,80,75
Saphiregos,dalaran,1200,mage,frost,297,151,146
Boredpeon,burning-legion,1200,mage,frost,113,56,57
Noviina,argent-dawn,1198,mage,frost,100,45,55
Sheeppuncher,drakthul,1198,mage,frost,42,13,29
Zvuta,sanguino,1197,mage,frost,45,29,16
Gacosane,chamber-of-aspects,1197,mage,frost,129,59,70
Ananaskana,ragnaros,1196,mage,frost,36,23,13
Séptímus,kazzak,1195,mage,frost,64,28,36
Kosso,twisting-nether,1195,mage,frost,88,36,52
Trîîck,nethersturm,1194,mage,frost,23,13,10
Jodiefroster,bronzebeard,1194,mage,frost,82,44,38
Шеллестун,soulflayer,1192,mage,frost,55,28,27
Phaege,defias-brotherhood,1192,mage,frost,32,15,17
Shâykó,sylvanas,1191,mage,frost,26,14,12
Søphiâ,thrall,1191,mage,frost,72,38,34
Flamya,stormscale,1190,mage,frost,59,27,32
Shivah,onyxia,1190,mage,frost,160,72,88
Iceyvein,antonidas,1190,mage,frost,36,13,23
Vanser,kazzak,1189,mage,frost,36,13,23
Brutal,thrall,1187,mage,frost,36,14,22
Сибиди,gordunni,1185,mage,frost,24,13,11
Tylic,doomhammer,1184,mage,frost,72,30,42
Magicdingo,lightnings-blade,1183,mage,frost,36,13,23
Claramvi,lightnings-blade,1183,mage,frost,50,18,32
Хируэль,gordunni,1180,mage,frost,98,47,51
Maagni,outland,1179,mage,frost,24,13,11
Turandot,ravencrest,1178,mage,frost,42,28,14
Тонисмок,gordunni,1176,mage,frost,24,14,10
Scaless,stormscale,1176,mage,frost,77,37,40
Yenkonidas,blackmoore,1175,mage,frost,54,23,31
Rayniß,blackmoore,1175,mage,frost,32,13,19
Niivel,ysondre,1172,mage,frost,178,100,78
Hagiko,archimonde,1171,mage,frost,57,31,26
Rutemarlene,ravencrest,1171,mage,frost,88,45,43
Baravar,blackrock,1171,mage,frost,65,28,37
Sephis,anubarak,1170,mage,frost,50,15,35
Мрперут,eversong,1167,mage,frost,263,143,120
Cns,tarren-mill,1167,mage,frost,39,19,20
Salvijä,dun-modr,1166,mage,frost,59,27,32
Морозящий,howling-fjord,1162,mage,frost,165,84,81
Mutly,kazzak,1161,mage,frost,38,23,15
Escobar,frostmane,1161,mage,frost,60,22,38
Latiny,blackrock,1159,mage,frost,165,81,84
Broduy,draenor,1159,mage,frost,156,76,80
Icyshot,blackhand,1159,mage,frost,33,16,17
Rayiah,blackmoore,1159,mage,frost,60,24,36
Shallari,argent-dawn,1158,mage,frost,56,24,32
Fôôxy,aegwynn,1157,mage,frost,88,40,48
Синийлед,galakrond,1157,mage,frost,174,76,98
Machydapha,outland,1157,mage,frost,36,15,21
Брюнхильда,deepholm,1155,mage,frost,59,23,36
Ón,burning-steppes,1154,mage,frost,37,17,20
Zyxiie,sylvanas,1154,mage,frost,105,41,64
Uknowhowwedu,aegwynn,1152,mage,frost,24,12,12
Lilbolts,outland,1152,mage,frost,24,12,12
Balthezaj,defias-brotherhood,1151,mage,frost,18,12,6
Айсбоунт,eversong,1151,mage,frost,49,27,22
Sainth,sanguino,1151,mage,frost,24,12,12
Jesjess,ravencrest,1151,mage,frost,30,12,18
Amicuta,ravencrest,1150,mage,frost,60,30,30
Procahontas,ravencrest,1150,mage,frost,30,12,18
Sheepster,sylvanas,1149,mage,frost,55,31,24
Gladxp,outland,1149,mage,frost,24,12,12
Panlong,twisting-nether,1149,mage,frost,43,21,22
Aterso,azshara,1149,mage,frost,27,13,14
Rusto,hellscream,1149,mage,frost,36,13,23
Archilól,drakthul,1148,mage,frost,30,14,16
Quincy,frostwolf,1148,mage,frost,90,41,49
Gedzi,silvermoon,1147,mage,frost,36,24,12
Чистокрут,gordunni,1146,mage,frost,36,12,24
Jodíefroster,doomhammer,1145,mage,frost,24,12,12
Alytà,ravencrest,1145,mage,frost,24,12,12
Goukí,drakthul,1144,mage,frost,18,12,6
Paskius,defias-brotherhood,1143,mage,frost,18,12,6
Frostmyst,outland,1143,mage,frost,30,12,18
Tiltedpapi,ravencrest,1142,mage,frost,46,24,22
Магсимум,ashenvale,1142,mage,frost,37,18,19
Qulinx,kazzak,1142,mage,frost,29,13,16
Héidi,area-52,1141,mage,frost,30,15,15
Hotafazz,ravencrest,1141,mage,frost,57,21,36
Pariseta,ragnaros,1140,mage,frost,29,15,14
Maggresive,sylvanas,1140,mage,frost,30,15,15
Valkruz,nemesis,1140,mage,frost,30,12,18
Iceicebáby,draenor,1139,mage,frost,36,17,19
Elmaestró,aegwynn,1139,mage,frost,49,16,33
Flakeh,outland,1138,mage,frost,122,55,67
Illastrov,silvermoon,1138,mage,frost,30,12,18
Explosive,thunderhorn,1137,mage,frost,18,12,6
Sásen,blackrock,1137,mage,frost,93,41,52
Miidi,doomhammer,1136,mage,frost,48,29,19
Ørcan,azshara,1136,mage,frost,135,61,74
Arogance,archimonde,1135,mage,frost,78,43,35
Serclulz,ravencrest,1135,mage,frost,23,12,11
Oathkeepper,silvermoon,1135,mage,frost,124,60,64
Sântillius,twisting-nether,1134,mage,frost,48,28,20
Коласольдом,gordunni,1134,mage,frost,42,19,23
Fairysoul,ravencrest,1133,mage,frost,65,33,32
Souleh,ravencrest,1133,mage,frost,24,12,12
Kótaranka,kazzak,1133,mage,frost,89,41,48
Blinkfloyd,blackmoore,1133,mage,frost,39,15,24
Hourgen,ysondre,1132,mage,frost,24,12,12
Erzà,todeswache,1131,mage,frost,83,47,36
Dobbite,archimonde,1131,mage,frost,30,13,17
Iamslow,sylvanas,1130,mage,frost,18,12,6
Roxarch,nordrassil,1130,mage,frost,84,34,50
Adunaphel,blackmoore,1129,mage,frost,56,31,25
Unpleasant,hyjal,1129,mage,frost,36,15,21
Driana,dragonmaw,1127,mage,frost,18,12,6
Tomuru,draenor,1127,mage,frost,74,44,30
Shakamage,grim-batol,1127,mage,frost,93,48,45
Юлианх,gordunni,1127,mage,frost,485,244,241
Devon,haomarush,1126,mage,frost,71,27,44
Laggynoob,ravencrest,1124,mage,frost,24,12,12
Иньфанта,deathguard,1124,mage,frost,73,30,43
Naote,blackhand,1122,mage,frost,24,12,12
Brandonjames,ragnaros,1122,mage,frost,32,14,18
Thorstäin,ragnaros,1121,mage,frost,24,12,12
Длинныеухи,blackscar,1121,mage,frost,48,20,28
Darrnor,hyjal,1119,mage,frost,20,14,6
Lêgólás,blackmoore,1119,mage,frost,24,12,12
Bolthen,uldum,1119,mage,frost,36,13,23
Tiefkühler,norgannon,1118,mage,frost,63,36,27
Луциаз,gordunni,1117,mage,frost,116,62,54
Deymo,dun-modr,1117,mage,frost,42,19,23
Djblink,twisting-nether,1113,mage,frost,43,22,21
Qtiepatootie,silvermoon,1113,mage,frost,202,103,99
Lemonshelo,archimonde,1113,mage,frost,158,78,80
Schtenen,silvermoon,1112,mage,frost,397,194,203
Lenali,burning-legion,1111,mage,frost,42,18,24
Rüja,aegwynn,1110,mage,frost,24,12,12
Roey,defias-brotherhood,1110,mage,frost,30,14,16
Faithseed,dun-modr,1108,mage,frost,60,34,26
Шкиперок,gordunni,1107,mage,frost,24,12,12
Lylla,cthun,1107,mage,frost,48,14,34
Кельтузат,azuregos,1106,mage,frost,30,15,15
Килавый,eversong,1105,mage,frost,76,42,34
Боожженька,howling-fjord,1105,mage,frost,24,12,12
Сайджена,howling-fjord,1105,mage,frost,66,22,44
Vexperious,tarren-mill,1102,mage,frost,18,12,6
Arcáge,azjolnerub,1101,mage,frost,61,26,35
Blark,malygos,1099,mage,frost,30,13,17
Брэгг,gordunni,1098,mage,frost,44,20,24
Treyz,tichondrius,1098,mage,frost,30,12,18
Kalyipso,blackrock,1097,mage,frost,48,14,34
Дивеансерт,blackscar,1096,mage,frost,72,30,42
Саназэр,howling-fjord,1094,mage,frost,90,42,48
Kyrox,ysondre,1090,mage,frost,78,34,44
Prinskoekie,twisting-nether,1090,mage,frost,191,79,112
Melkyore,archimonde,1088,mage,frost,57,24,33
Нефростмаг,gordunni,1087,mage,frost,33,14,19
Nintho,ysondre,1086,mage,frost,54,27,27
Tsubas,blackmoore,1086,mage,frost,33,13,20
Æyhvr,hyjal,1084,mage,frost,46,26,20
Xblaze,balnazzar,1083,mage,frost,24,15,9
Euklid,ravencrest,1083,mage,frost,22,12,10
Sesseel,veklor,1083,mage,frost,72,35,37
Goeb,kazzak,1083,mage,frost,35,14,21
Aloona,malganis,1080,mage,frost,93,48,45
Tripel,blackmoore,1080,mage,frost,48,14,34
Roughfked,silvermoon,1079,mage,frost,118,62,56
Kadsy,tarren-mill,1079,mage,frost,53,24,29
Setyon,burning-legion,1079,mage,frost,38,14,24
Tygaone,tirion,1076,mage,frost,112,54,58
Iceinmyveinz,silvermoon,1075,mage,frost,48,17,31
Xenedra,twisting-nether,1074,mage,frost,56,21,35
Çxçx,dun-modr,1072,mage,frost,51,19,32
Galdrari,sylvanas,1071,mage,frost,30,13,17
Arkanieer,blackrock,1069,mage,frost,132,68,64
Ketem,dun-modr,1069,mage,frost,48,17,31
Yojimbot,archimonde,1065,mage,frost,48,15,33
Arcanik,archimonde,1065,mage,frost,49,14,35
Дедамаг,eversong,1064,mage,frost,36,18,18
Gnoumen,shadowsong,1061,mage,frost,62,32,30
Ryzea,ravencrest,1060,mage,frost,41,24,17
Xèrec,ysondre,1058,mage,frost,36,12,24
Cexxar,kazzak,1057,mage,frost,48,18,30
Decedé,dun-modr,1055,mage,frost,18,11,7
Altraftw,archimonde,1055,mage,frost,18,11,7
Gizzoo,draenor,1055,mage,frost,18,11,7
Tenetic,thrall,1055,mage,frost,20,11,9
Ramcoz,twisting-nether,1055,mage,frost,48,25,23
Stümpy,ravencrest,1055,mage,frost,24,11,13
Síckmode,khadgar,1055,mage,frost,36,11,25
Späcksi,amanthul,1054,mage,frost,18,11,7
Spacehoe,stormscale,1054,mage,frost,30,11,19
Mithrandíel,blackmoore,1053,mage,frost,18,11,7
Djeypoly,magtheridon,1053,mage,frost,18,11,7
Grömit,drakthul,1053,mage,frost,18,11,7
Chrome,ysondre,1053,mage,frost,24,11,13
Xzp,der-rat-von-dalaran,1052,mage,frost,24,11,13
Bengtzzon,aszune,1052,mage,frost,73,29,44
Vel,grim-batol,1051,mage,frost,18,11,7
Drencast,hyjal,1051,mage,frost,24,11,13
Рамблз,gordunni,1051,mage,frost,24,11,13
Винилочка,deathguard,1051,mage,frost,24,11,13
Bamz,malganis,1051,mage,frost,24,11,13
Khanno,twisting-nether,1051,mage,frost,30,11,19
Ízumi,stormscale,1051,mage,frost,30,11,19
Dueudafrøven,stormscale,1051,mage,frost,36,11,25
Primodious,kazzak,1050,mage,frost,30,11,19
Полеморв,soulflayer,1049,mage,frost,33,14,19
Magjaw,twisting-nether,1048,mage,frost,60,30,30
Chililol,dun-modr,1048,mage,frost,24,11,13
Шиллаа,blackscar,1048,mage,frost,30,13,17
Даатхедра,booty-bay,1046,mage,frost,24,11,13
Frozeh,archimonde,1046,mage,frost,24,11,13
Hasbe,kazzak,1046,mage,frost,36,11,25
Круксина,howling-fjord,1045,mage,frost,30,11,19
Férécide,ysondre,1045,mage,frost,30,11,19
Flocca,argent-dawn,1044,mage,frost,21,12,9
Atreu,mazrigos,1044,mage,frost,62,33,29
Jèphy,silvermoon,1044,mage,frost,24,12,12
Dominos,medivh,1044,mage,frost,64,26,38
Kyrn,zuljin,1044,mage,frost,30,11,19
Arcaneiun,nagrand,1043,mage,frost,30,11,19
Feuerquampfa,blackmoore,1042,mage,frost,22,12,10
Snowrain,chogall,1042,mage,frost,79,41,38
Razzìatore,pozzo-delleternità,1041,mage,frost,25,11,14
Blinklet,twisting-nether,1040,mage,frost,26,17,9
Nåzmyz,outland,1040,mage,frost,110,50,60
Fashes,sunstrider,1039,mage,frost,105,53,52
Khoshgele,draenor,1039,mage,frost,24,11,13
Astoriontv,elune,1039,mage,frost,30,11,19
Vamelia,blackmoore,1038,mage,frost,124,60,64
Ангилема,gordunni,1033,mage,frost,24,11,13
Ergonz,tarren-mill,1033,mage,frost,57,25,32
Clonefcf,sylvanas,1032,mage,frost,55,31,24
Flaire,thunderhorn,1028,mage,frost,66,37,29
Smõóve,hyjal,1028,mage,frost,169,75,94
Этридемус,howling-fjord,1028,mage,frost,113,43,70
Aériza,silvermoon,1026,mage,frost,29,14,15
Ptilouis,archimonde,1025,mage,frost,24,11,13
Skyra,les-sentinelles,1024,mage,frost,42,24,18
Soulspell,vashj,1023,mage,frost,65,33,32
Zeeker,mannoroth,1022,mage,frost,18,11,7
Yasheaa,ysondre,1020,mage,frost,23,11,12
Dumbledores,aegwynn,1018,mage,frost,65,28,37
Furoranight,malfurion,1016,mage,frost,78,39,39
Elesand,kazzak,1016,mage,frost,95,44,51
Edwiin,dun-morogh,1013,mage,frost,87,30,57
Shíntaro,stormscale,1013,mage,frost,41,12,29
Didub,outland,1010,mage,frost,60,26,34
Vurtnez,kazzak,1009,mage,frost,21,11,10
Mystto,silvermoon,1008,mage,frost,54,31,23
Илайла,booty-bay,1007,mage,frost,15,12,3
Pyllymake,kazzak,1007,mage,frost,17,11,6
Magenius,twisting-nether,1003,mage,frost,36,12,24
Экструдия,gordunni,1002,mage,frost,19,12,7
Бальзамон,eversong,1002,mage,frost,73,32,41
Tyrannith,argent-dawn,1000,mage,frost,91,39,52
Rillia,argent-dawn,999,mage,frost,27,12,15
Julieliphie,silvermoon,998,mage,frost,23,11,12
Misscandy,doomhammer,997,mage,frost,134,63,71
Saturator,burning-legion,993,mage,frost,29,11,18
Forestie,silvermoon,992,mage,frost,80,37,43
Xakiha,kazzak,989,mage,frost,23,11,12
Éasy,blackmoore,985,mage,frost,20,11,9
Maximilian,pozzo-delleternità,983,mage,frost,32,11,21
Nytram,terokkar,982,mage,frost,36,16,20
Kumakara,archimonde,981,mage,frost,24,12,12
Lunnysvet,blackrock,977,mage,frost,64,31,33
Bakeren,frostmane,976,mage,frost,20,11,9
Madbad,auchindoun,975,mage,frost,57,25,32
Chogger,blackmoore,974,mage,frost,42,24,18
Pinguíni,aegwynn,974,mage,frost,72,33,39
Dnt,twilights-hammer,974,mage,frost,24,11,13
Klita,blackmoore,974,mage,frost,83,36,47
Лордбелиал,soulflayer,973,mage,frost,48,21,27
Medíth,antonidas,971,mage,frost,42,19,23
Êmmá,blackmoore,969,mage,frost,84,40,44
Hargun,the-maelstrom,968,mage,frost,64,20,44
Coldstormz,terenas,968,mage,frost,42,13,29
Gravetaxi,twisting-nether,966,mage,frost,84,29,55
Líquiçìty,ragnaros,965,mage,frost,81,27,54
Мэджиксул,grom,963,mage,frost,24,11,13
Ezzekkiel,elune,962,mage,frost,36,18,18
Fujitoras,khaz-modan,961,mage,frost,71,34,37
Acx,drakthul,960,mage,frost,18,10,8
Cosmostms,ravencrest,960,mage,frost,18,10,8
Oblív,ravencrest,960,mage,frost,24,10,14
Chucknoir,draenor,959,mage,frost,12,10,2
Reákan,ragnaros,959,mage,frost,18,10,8
Утрус,soulflayer,959,mage,frost,18,10,8
Lunaviolence,silvermoon,959,mage,frost,18,10,8
Тортикток,soulflayer,959,mage,frost,24,10,14
Gønzô,blackmoore,959,mage,frost,55,22,33
Джинетикс,deathguard,958,mage,frost,18,10,8
Jaeske,sylvanas,958,mage,frost,18,10,8
Onemanrave,ravencrest,957,mage,frost,24,10,14
Salem,neptulon,956,mage,frost,73,19,54
Anthrex,drakthul,955,mage,frost,24,10,14
Wopi,sylvanas,954,mage,frost,47,21,26
Мбапи,soulflayer,954,mage,frost,24,10,14
Poter,silvermoon,953,mage,frost,18,10,8
Hotpockets,die-aldor,953,mage,frost,18,10,8
Йяу,howling-fjord,953,mage,frost,54,19,35
Zedsdeadbaby,argent-dawn,952,mage,frost,139,66,73
Чобон,soulflayer,952,mage,frost,24,10,14
Райдзен,greymane,952,mage,frost,80,31,49
Xerv,thrall,951,mage,frost,24,10,14
Broccosoup,kazzak,951,mage,frost,24,10,14
Бабайбайкала,gordunni,951,mage,frost,36,10,26
Dabzm,twisting-nether,950,mage,frost,24,10,14
Haljina,kazzak,949,mage,frost,255,117,138
Celdra,blackrock,949,mage,frost,24,10,14
Shanny,argent-dawn,948,mage,frost,18,10,8
Madzía,ravencrest,947,mage,frost,61,33,28
Maybeblood,kazzak,946,mage,frost,28,11,17
Frisstana,outland,946,mage,frost,30,10,20
Evuryl,nemesis,944,mage,frost,24,10,14
Lacondonxxl,minahonda,944,mage,frost,54,22,32
Ignöre,stormscale,943,mage,frost,36,10,26
Cybercommand,blackmoore,942,mage,frost,108,56,52
Lifemagic,chamber-of-aspects,942,mage,frost,139,70,69
Hakunaplz,twisting-nether,940,mage,frost,33,11,22
Тестостеронс,gordunni,939,mage,frost,18,10,8
Флоррет,gordunni,939,mage,frost,24,10,14
Qirko,drakthul,937,mage,frost,78,26,52
Ference,tichondrius,936,mage,frost,18,10,8
Qwibbly,kazzak,935,mage,frost,18,11,7
Obsidion,sporeggar,934,mage,frost,54,14,40
Margow,die-arguswacht,930,mage,frost,24,13,11
Coldnight,uldum,930,mage,frost,67,35,32
Speedshatter,aegwynn,928,mage,frost,22,10,12
Ghostgivree,archimonde,927,mage,frost,69,35,34
Terlon,ragnaros,925,mage,frost,23,10,13
Gíla,azjolnerub,921,mage,frost,23,10,13
Døliprane,garona,918,mage,frost,89,45,44
Boogiewizz,stormscale,916,mage,frost,46,16,30
Teals,turalyon,915,mage,frost,48,16,32
Jobarttrach,les-clairvoyants,911,mage,frost,270,135,135
Dumbledoré,frostwolf,910,mage,frost,84,43,41
Фростмага,gordunni,909,mage,frost,30,14,16
Toxttr,drakthul,908,mage,frost,18,11,7
Флоой,gordunni,906,mage,frost,28,11,17
Сенсемилия,soulflayer,902,mage,frost,24,11,13
Arttu,defias-brotherhood,902,mage,frost,116,49,67
Sinanogan,draenor,899,mage,frost,48,17,31
Iif,zirkel-des-cenarius,896,mage,frost,17,10,7
Fadead,stormreaver,896,mage,frost,28,10,18
Funnyzowie,minahonda,895,mage,frost,20,10,10
Няо,howling-fjord,894,mage,frost,20,10,10
Familyfrost,thunderhorn,894,mage,frost,24,10,14
Мистркорбэн,soulflayer,893,mage,frost,20,10,10
Çana,thrall,893,mage,frost,22,10,12
Ттэль,gordunni,892,mage,frost,123,58,65
Insanewizard,kazzak,890,mage,frost,16,10,6
Tharillion,drakthul,887,mage,frost,20,10,10
Magicoliwia,ysera,886,mage,frost,57,29,28
Eliosia,drakthul,884,mage,frost,17,10,7
Frigus,khaz-modan,884,mage,frost,33,10,23
Умелецмаг,gordunni,881,mage,frost,79,34,45
Juntara,stormscale,880,mage,frost,24,11,13
Осуждаюпве,gordunni,880,mage,frost,31,10,21
Щавзорву,gordunni,878,mage,frost,22,10,12
Kaptanati,silvermoon,874,mage,frost,30,15,15
Ordoño,cthun,871,mage,frost,30,15,15
Neps,chamber-of-aspects,868,mage,frost,54,24,30
Fakeklepter,sylvanas,864,mage,frost,12,9,3
Сайбри,gordunni,864,mage,frost,12,9,3
Bigbarrage,blackrock,864,mage,frost,12,9,3
Blockumad,ragnaros,864,mage,frost,18,9,9
Justvik,eredar,864,mage,frost,18,9,9
Lilekx,archimonde,864,mage,frost,24,9,15
Facerollyo,tarren-mill,864,mage,frost,24,9,15
Curran,ravencrest,864,mage,frost,24,9,15
Авгурей,howling-fjord,863,mage,frost,18,9,9
Ralfík,drakthul,863,mage,frost,18,9,9
Мирикон,gordunni,863,mage,frost,18,9,9
Qqcult,ravencrest,863,mage,frost,18,9,9
Ascik,dalaran,863,mage,frost,18,9,9
Casteerr,kazzak,863,mage,frost,18,9,9
Musé,kazzak,863,mage,frost,18,9,9
Moleester,twisting-nether,863,mage,frost,18,9,9
Nergl,darksorrow,863,mage,frost,22,10,12
Bloodycast,archimonde,863,mage,frost,24,9,15
Слизерин,gordunni,863,mage,frost,30,9,21
Izotza,ravencrest,863,mage,frost,36,9,27
Gotone,tarren-mill,862,mage,frost,18,9,9
Meroo,hyjal,862,mage,frost,24,9,15
Yajimage,archimonde,862,mage,frost,24,9,15
Shifteurprõ,hyjal,861,mage,frost,18,9,9
Strychne,ragnaros,860,mage,frost,12,9,3
Thairlas,ragnaros,860,mage,frost,131,48,83
Amazona,veklor,859,mage,frost,38,18,20
Querasimar,blackrock,859,mage,frost,24,9,15
Принцесса,howling-fjord,859,mage,frost,30,9,21
Nilslegend,tarren-mill,858,mage,frost,18,9,9
Ælirion,antonidas,858,mage,frost,18,9,9
Elitriz,grim-batol,857,mage,frost,12,9,3
Ravenice,sylvanas,857,mage,frost,21,10,11
Tobie,bladefist,856,mage,frost,18,9,9
Spankpróóf,kazzak,856,mage,frost,24,9,15
Markasaura,kazzak,856,mage,frost,38,11,27
Voralastor,doomhammer,855,mage,frost,12,9,3
Nargaroc,blackhand,855,mage,frost,24,9,15
Dzomage,kazzak,855,mage,frost,30,9,21
Farrä,dun-modr,854,mage,frost,53,26,27
Piego,turalyon,854,mage,frost,200,98,102
Бд,blackscar,854,mage,frost,24,9,15
Vaynes,stormscale,851,mage,frost,18,9,9
Laureen,outland,851,mage,frost,18,9,9
Tsr,burning-legion,851,mage,frost,31,10,21
Zaubererblod,silvermoon,849,mage,frost,78,28,50
Банана,lich-king,847,mage,frost,18,9,9
Bina,drakthul,846,mage,frost,25,12,13
Hérésïa,kirin-tor,846,mage,frost,24,9,15
Сэбат,soulflayer,846,mage,frost,24,9,15
Alefraide,la-croisade-écarlate,843,mage,frost,18,9,9
Rifinouu,archimonde,841,mage,frost,18,9,9
Sargelius,grim-batol,841,mage,frost,24,9,15
Larsimore,drakthul,839,mage,frost,24,9,15
Lonero,antonidas,835,mage,frost,12,9,3
Дроййд,gordunni,835,mage,frost,94,28,66
Rintoh,pozzo-delleternità,828,mage,frost,30,9,21
Ferqogool,kazzak,824,mage,frost,28,9,19
Lexalia,blackmoore,823,mage,frost,68,31,37
Arinel,stormreaver,823,mage,frost,83,23,60
Subzeraxo,archimonde,816,mage,frost,15,9,6
Aerius,lightnings-blade,813,mage,frost,21,9,12
Soulcatcheus,archimonde,811,mage,frost,30,10,20
Vraesh,blackrock,810,mage,frost,23,11,12
Королеваланс,deathguard,809,mage,frost,22,12,10
Пвнзглад,gordunni,809,mage,frost,22,10,12
Audraptor,medivh,806,mage,frost,37,10,27
Чвкашкалу,soulflayer,805,mage,frost,17,9,8
Jockin,stormrage,805,mage,frost,25,10,15
Ширм,blackscar,800,mage,frost,16,9,7
Pelsky,zenedar,799,mage,frost,22,9,13
Mackattack,nemesis,798,mage,frost,14,9,5
Xyhno,eredar,798,mage,frost,19,10,9
Allan,silvermoon,798,mage,frost,20,9,11
Hooffer,stormscale,797,mage,frost,28,9,19
Smõõve,hyjal,796,mage,frost,16,9,7
Lothymond,runetotem,793,mage,frost,26,9,17
Xæl,ravencrest,791,mage,frost,159,76,83
Явернулси,soulflayer,789,mage,frost,45,12,33
Yoxt,blackhand,781,mage,frost,20,9,11
Sammelbot,kargath,780,mage,frost,78,36,42
Méphis,eredar,768,mage,frost,12,8,4
Séxmachiné,draenor,768,mage,frost,12,8,4
Txsty,dalaran,768,mage,frost,12,8,4
Arunx,magtheridon,768,mage,frost,12,8,4
Trashmage,blackrock,768,mage,frost,12,8,4
Slôwz,kazzak,768,mage,frost,12,8,4
Ambulancex,kazzak,768,mage,frost,12,8,4
Urkela,sylvanas,768,mage,frost,15,9,6
Arempy,tarren-mill,768,mage,frost,18,8,10
Jarim,alleria,768,mage,frost,18,8,10
Wortyvery,outland,768,mage,frost,18,8,10
Mðj,kazzak,768,mage,frost,18,8,10
Väänik,draenor,768,mage,frost,18,8,10
Terash,ravencrest,768,mage,frost,18,8,10
Гдедипфриз,soulflayer,768,mage,frost,18,8,10
Срунапалмом,gordunni,768,mage,frost,18,8,10
Partypowér,twisting-nether,768,mage,frost,18,8,10
Fearbeäch,ravencrest,768,mage,frost,18,8,10
Jînexo,shattrath,768,mage,frost,21,8,13
Zelimeth,outland,768,mage,frost,24,8,16
Wambamm,ravencrest,768,mage,frost,24,8,16
Sheep,ravenholdt,767,mage,frost,12,8,4
Zili,draenor,767,mage,frost,12,8,4
Tajos,drakthul,767,mage,frost,12,8,4
Gagaj,ravencrest,767,mage,frost,12,8,4
Нуклер,howling-fjord,767,mage,frost,12,8,4
Next,ysondre,767,mage,frost,12,8,4
Goodheadcake,ragnaros,767,mage,frost,18,8,10
Alirya,stormscale,767,mage,frost,18,8,10
Рейенос,howling-fjord,767,mage,frost,18,8,10
Jingom,ravencrest,767,mage,frost,18,8,10
Vallas,drakthul,767,mage,frost,18,8,10
Magenox,blackrock,767,mage,frost,18,8,10
Переливпро,blackscar,767,mage,frost,18,8,10
Khorosho,draenor,767,mage,frost,24,8,16
Glar,defias-brotherhood,767,mage,frost,24,8,16
Vinlimar,drakthul,767,mage,frost,24,8,16
Héffér,outland,766,mage,frost,12,8,4
Anoez,kargath,766,mage,frost,18,8,10
Kàtsu,tarren-mill,766,mage,frost,18,8,10
Spell,blackmoore,766,mage,frost,18,8,10
Deathcast,ravencrest,766,mage,frost,18,8,10
Antaos,drakthul,766,mage,frost,24,8,16
Fatcasts,silvermoon,765,mage,frost,12,8,4
Illiaria,antonidas,765,mage,frost,12,8,4
Kuhwar,echsenkessel,765,mage,frost,18,8,10
Ærrflôw,frostwolf,765,mage,frost,18,8,10
Wîldcard,sylvanas,765,mage,frost,24,8,16
Marokanez,eredar,764,mage,frost,65,28,37
Skinirp,dun-modr,764,mage,frost,24,8,16
Hacimari,hyjal,764,mage,frost,30,8,22
Greey,blackhand,763,mage,frost,12,8,4
Oryom,blackhand,763,mage,frost,69,31,38
Ezìl,nemesis,763,mage,frost,27,9,18
Нитро,soulflayer,763,mage,frost,24,8,16
Braínfreeze,kazzak,763,mage,frost,24,8,16
Tekuard,ravencrest,763,mage,frost,82,24,58
Fumandalonso,sanguino,762,mage,frost,24,8,16
Frostytipz,tarren-mill,760,mage,frost,24,8,16
Saladora,anachronos,757,mage,frost,12,8,4
Tomjedusor,hyjal,757,mage,frost,12,8,4
Crashleaf,argent-dawn,755,mage,frost,77,16,61
Zenoss,khaz-modan,752,mage,frost,91,41,50
Maélïne,hyjal,750,mage,frost,12,8,4
Croaky,alleria,749,mage,frost,17,8,9
Мерджреквест,howling-fjord,745,mage,frost,17,8,9
Ploufatak,hyjal,743,mage,frost,84,27,57
Hurlscream,marécage-de-zangar,743,mage,frost,49,14,35
Pickaachu,doomhammer,739,mage,frost,46,22,24
Qqlool,draenor,735,mage,frost,23,8,15
Maglush,ysondre,732,mage,frost,78,31,47
Amalou,stormscale,729,mage,frost,32,9,23
Morrigane,shattered-hand,721,mage,frost,18,8,10
Magipus,anetheron,721,mage,frost,43,15,28
Mumpii,blackrock,719,mage,frost,23,8,15
Clitch,blutkessel,715,mage,frost,20,9,11
Bibidibabidi,nefarian,711,mage,frost,23,9,14
Neboonu,sylvanas,696,mage,frost,91,40,51
Aurayaa,teldrassil,688,mage,frost,47,15,32
Lanere,argent-dawn,684,mage,frost,19,8,11
Venu,dun-modr,677,mage,frost,77,40,37
Чогоце,eversong,673,mage,frost,114,32,82
Blinked,eredar,672,mage,frost,12,7,5
Clöse,ysondre,672,mage,frost,12,7,5
Andôkys,perenolde,672,mage,frost,12,7,5
Yobys,burning-legion,672,mage,frost,12,7,5
Sölø,stormscale,672,mage,frost,12,7,5
Icéy,kazzak,672,mage,frost,12,7,5
Skyblink,hyjal,672,mage,frost,12,7,5
Kold,stormscale,672,mage,frost,12,7,5
Agus,ravencrest,672,mage,frost,12,7,5
Ðevlqt,blackmoore,672,mage,frost,12,7,5
Gøsu,rexxar,672,mage,frost,12,7,5
Birckin,sanguino,672,mage,frost,12,7,5
Glindalefay,silvermoon,672,mage,frost,12,7,5
Neïgé,hyjal,672,mage,frost,12,7,5
Hérä,archimonde,672,mage,frost,12,7,5
Monkeydmafia,blackrock,672,mage,frost,12,7,5
Lillelord,defias-brotherhood,672,mage,frost,18,7,11
Larsisak,tarren-mill,672,mage,frost,18,7,11
Mageyreid,quelthalas,672,mage,frost,18,7,11
Drwrey,tarren-mill,672,mage,frost,18,7,11
Magekaoz,sylvanas,672,mage,frost,18,7,11
Candydead,alakir,672,mage,frost,18,7,11
Mezaiyh,blackmoore,672,mage,frost,18,7,11
Jakora,bronze-dragonflight,672,mage,frost,18,7,11
Dalaras,archimonde,672,mage,frost,18,7,11
Krookéd,tarren-mill,672,mage,frost,24,7,17
Wenndrid,draenor,672,mage,frost,30,7,23
Optimelk,bronzebeard,672,mage,frost,30,7,23
Droll,kazzak,671,mage,frost,12,7,5
Aughust,deathwing,671,mage,frost,12,7,5
Blitzo,madmortem,671,mage,frost,12,7,5
Nynduriella,teldrassil,671,mage,frost,12,7,5
Wîtchcurse,dentarg,671,mage,frost,12,7,5
Møstwãntêd,aegwynn,671,mage,frost,12,7,5
Поэтик,soulflayer,671,mage,frost,12,7,5
Geepie,twisting-nether,671,mage,frost,12,7,5
Effectxx,ravencrest,671,mage,frost,12,7,5
Strawßerry,sanguino,671,mage,frost,15,8,7
Bigraphael,ravencrest,671,mage,frost,18,7,11
Hardways,archimonde,671,mage,frost,18,7,11
Finkle,spinebreaker,671,mage,frost,18,7,11
ßaßastarz,archimonde,671,mage,frost,18,7,11
Alcatrax,bronze-dragonflight,671,mage,frost,18,7,11
Crayz,magtheridon,671,mage,frost,18,7,11
Ice,sargeras,671,mage,frost,18,7,11
Iceelance,tarren-mill,671,mage,frost,24,7,17
Huylusha,kazzak,671,mage,frost,24,7,17
Trytauern,stormscale,670,mage,frost,12,7,5
Ариманий,borean-tundra,670,mage,frost,12,7,5
Suitx,draenor,670,mage,frost,12,7,5
Hotpotatox,ravencrest,670,mage,frost,13,7,6
Nery,ravencrest,670,mage,frost,18,7,11
Ronnyraggare,silvermoon,670,mage,frost,18,7,11
Комонщик,howling-fjord,670,mage,frost,18,7,11
Placidius,twisting-nether,670,mage,frost,18,7,11
Unreadyx,archimonde,670,mage,frost,18,7,11
Elünia,ysondre,670,mage,frost,18,7,11
Luckymango,alakir,670,mage,frost,18,7,11
Quaile,malygos,670,mage,frost,24,7,17
Каперниан,fordragon,669,mage,frost,12,7,5
Schiniie,argent-dawn,669,mage,frost,16,7,9
Lyrika,sanguino,669,mage,frost,18,7,11
Luckydo,turalyon,669,mage,frost,18,7,11
Crematorium,argent-dawn,669,mage,frost,19,7,12
Kairøs,dragonblight,669,mage,frost,27,8,19
Zionara,stormscale,668,mage,frost,18,7,11
Allotropia,ravencrest,668,mage,frost,18,7,11
Diomaniaco,shattered-hand,668,mage,frost,18,7,11
Faldanor,archimonde,667,mage,frost,12,7,5
Неуклюжый,soulflayer,667,mage,frost,15,8,7
Depai,blackrock,666,mage,frost,21,8,13
Jknl,ravencrest,666,mage,frost,19,7,12
Carcan,aggramar,665,mage,frost,18,7,11
Listro,argent-dawn,664,mage,frost,12,7,5
Nortí,drakthul,664,mage,frost,18,7,11
Donfalken,anachronos,664,mage,frost,18,7,11
Mayalac,archimonde,663,mage,frost,30,7,23
Malicä,ravencrest,663,mage,frost,42,7,35
Nthya,kazzak,661,mage,frost,24,7,17
Xatures,tarren-mill,653,mage,frost,23,7,16
Expulse,blackmoore,639,mage,frost,11,7,4
Stasis,argent-dawn,639,mage,frost,17,7,10
Skyla,tarren-mill,638,mage,frost,14,8,6
Shínsou,burning-blade,637,mage,frost,17,7,10
Duhmeigo,antonidas,637,mage,frost,23,7,16
Margistikus,die-aldor,626,mage,frost,112,57,55
Lepronsito,kazzak,623,mage,frost,15,7,8
Skæde,ravencrest,618,mage,frost,17,11,6
Svanteg,kazzak,618,mage,frost,14,8,6
Transan,stormscale,618,mage,frost,16,9,7
Verygoodgame,blackrock,617,mage,frost,15,8,7
Hidrax,outland,617,mage,frost,21,9,12
Förstörarn,stormscale,606,mage,frost,20,7,13
Substitutes,draenor,606,mage,frost,26,7,19
Vønmûller,dalaran,576,mage,frost,6,6,0
Escapematrix,ravencrest,576,mage,frost,6,6,0
Abóve,outland,576,mage,frost,6,6,0
Khartx,silvermoon,576,mage,frost,6,6,0
Mohammedjiba,ragnaros,576,mage,frost,6,6,0
Estonka,ravencrest,576,mage,frost,6,6,0
Viky,zirkel-des-cenarius,576,mage,frost,6,6,0
Миллерфест,howling-fjord,576,mage,frost,12,6,6
Forgotenn,draenor,576,mage,frost,12,6,6
Halfanapple,the-maelstrom,576,mage,frost,12,6,6
Dragotus,dragonblight,576,mage,frost,12,6,6
Ecnaclappy,blackrock,576,mage,frost,12,6,6
Atioo,blackhand,576,mage,frost,12,6,6
Yexo,draenor,576,mage,frost,12,6,6
Magicsheep,nemesis,576,mage,frost,12,6,6
Creden,frostmane,576,mage,frost,12,6,6
Momrider,sanguino,576,mage,frost,12,6,6
Nøw,ravencrest,576,mage,frost,12,6,6
Adeftm,kazzak,576,mage,frost,12,6,6
Invinsible,xavius,576,mage,frost,12,6,6
Perfection,cthun,576,mage,frost,12,6,6
Olzaa,outland,576,mage,frost,12,6,6
Sekaia,hyjal,576,mage,frost,12,6,6
Ixbllyix,alonsus,576,mage,frost,12,6,6
Zírí,malygos,576,mage,frost,12,6,6
Kurtcobain,draenor,576,mage,frost,12,6,6
Wheí,ravencrest,576,mage,frost,12,6,6
Ballesteinen,outland,576,mage,frost,12,6,6
Hundredslaps,ragnaros,576,mage,frost,12,6,6
Ouija,kazzak,576,mage,frost,12,6,6
Søo,kazzak,576,mage,frost,12,6,6
Thughunterqt,silvermoon,576,mage,frost,12,6,6
Skdroople,ravencrest,576,mage,frost,12,6,6
Titarie,ravencrest,576,mage,frost,12,6,6
Адренохромх,gordunni,576,mage,frost,12,6,6
Froststarr,burning-legion,576,mage,frost,12,6,6
Nécrømage,confrérie-du-thorium,576,mage,frost,12,6,6
Necro,zuljin,576,mage,frost,12,6,6
Ury,hyjal,576,mage,frost,18,6,12
Айслэнц,howling-fjord,576,mage,frost,18,6,12
Articunoh,ravencrest,576,mage,frost,18,6,12
Деметрадон,gordunni,576,mage,frost,18,6,12
Reeroll,arthas,576,mage,frost,18,6,12
Zikyo,silvermoon,576,mage,frost,18,6,12
Kbd,outland,576,mage,frost,18,6,12
Зефенжо,howling-fjord,576,mage,frost,18,6,12
Диппро,soulflayer,576,mage,frost,24,6,18
Cafcaf,archimonde,575,mage,frost,12,6,6
Milminmage,ravencrest,575,mage,frost,12,6,6
Phaseshift,darkspear,575,mage,frost,12,6,6
Morteús,tarren-mill,575,mage,frost,12,6,6
Nanosh,kazzak,575,mage,frost,12,6,6
Zulko,krasus,575,mage,frost,12,6,6
Pitbones,archimonde,575,mage,frost,12,6,6
Firerazer,hyjal,575,mage,frost,15,7,8
Bloodymage,zenedar,575,mage,frost,18,6,12
Xcender,sylvanas,575,mage,frost,18,6,12
Kobana,ravencrest,575,mage,frost,18,6,12
Tricolos,sanguino,575,mage,frost,18,6,12
Pickindim,terokkar,575,mage,frost,19,6,13
Kaptenski,stormscale,575,mage,frost,24,6,18
Bhaâl,hyjal,574,mage,frost,12,6,6
Вхламинка,howling-fjord,574,mage,frost,12,6,6
Whitestiev,antonidas,574,mage,frost,18,6,12
Pumpzy,tarren-mill,574,mage,frost,18,6,12
Stilnox,nemesis,574,mage,frost,18,6,12
Lalaura,sanguino,573,mage,frost,12,6,6
Yennéfér,outland,573,mage,frost,30,6,24
Nortohg,ragnaros,572,mage,frost,12,6,6
Piscialetto,nemesis,572,mage,frost,18,6,12
Støneð,blackhand,571,mage,frost,12,6,6
Lightbínder,antonidas,569,mage,frost,24,6,18
Игаша,gordunni,568,mage,frost,12,6,6
Serlath,defias-brotherhood,565,mage,frost,12,6,6
Hadziaj,doomhammer,565,mage,frost,30,6,24
Milhoux,ysondre,559,mage,frost,17,6,11
Kaeki,khaz-modan,558,mage,frost,22,10,12
Maran,outland,555,mage,frost,24,6,18
Meign,eredar,537,mage,frost,22,8,14
Bessiie,ragnaros,536,mage,frost,16,6,10
Lidin,draenor,527,mage,frost,11,6,5
Nøxas,archimonde,527,mage,frost,17,6,11
Avb,twisting-nether,527,mage,frost,17,6,11
Consquens,aszune,522,mage,frost,24,7,17
Modjahead,tarren-mill,521,mage,frost,27,8,19
Tschelo,eredar,512,mage,frost,16,6,10
Quente,aegwynn,511,mage,frost,10,6,4
Stylaaz,twisting-nether,511,mage,frost,14,6,8
Miihawkk,khaz-modan,510,mage,frost,20,6,14
Regenn,kazzak,506,mage,frost,11,6,5
Magicstorm,anubarak,504,mage,frost,16,6,10
Fatefully,ravencrest,494,mage,frost,25,6,19
Flizwiz,ragnaros,491,mage,frost,25,6,19
Kiyubi,burning-blade,484,mage,frost,17,7,10
Oz,frostmane,480,mage,frost,6,5,1
Línus,twisting-nether,480,mage,frost,6,5,1
Zehnvonzehn,antonidas,480,mage,frost,6,5,1
Khronic,darksorrow,480,mage,frost,6,5,1
Crystalice,zuljin,480,mage,frost,6,5,1
Vorst,shattered-hand,480,mage,frost,6,5,1
Jasmira,kazzak,480,mage,frost,6,5,1
Iceage,nemesis,480,mage,frost,6,5,1
Jínró,draenor,480,mage,frost,6,5,1
Elodjn,nemesis,480,mage,frost,6,5,1
Magnopvp,sanguino,480,mage,frost,10,6,4
Meras,die-ewige-wacht,480,mage,frost,12,5,7
Bræckdønæs,sanguino,480,mage,frost,12,5,7
Radiantfury,outland,480,mage,frost,12,5,7
Reznøør,confrérie-du-thorium,480,mage,frost,12,5,7
Oxidoxy,ragnaros,480,mage,frost,12,5,7
Snowberry,blackrock,480,mage,frost,12,5,7
Javellja,ravencrest,480,mage,frost,12,5,7
Chubbyjoe,blackmoore,480,mage,frost,12,5,7
Fîrestorm,doomhammer,480,mage,frost,12,5,7
Chrømy,twisting-nether,480,mage,frost,12,5,7
Slite,nazjatar,480,mage,frost,12,5,7
Betomage,blackmoore,480,mage,frost,12,5,7
Barzle,blackmoore,480,mage,frost,12,5,7
Shatterdude,kazzak,480,mage,frost,12,5,7
Nyoto,silvermoon,480,mage,frost,12,5,7
Maestrá,outland,480,mage,frost,12,5,7
Milkenjoyer,ravencrest,480,mage,frost,12,5,7
Moffmage,sylvanas,480,mage,frost,12,5,7
Thelastmage,outland,480,mage,frost,12,5,7
Vapurx,blackmoore,480,mage,frost,12,5,7
Zaurok,sanguino,480,mage,frost,12,5,7
Секвой,soulflayer,480,mage,frost,12,5,7
Xÿv,azshara,480,mage,frost,12,5,7
Shirrunn,the-maelstrom,480,mage,frost,12,5,7
Витуз,gordunni,480,mage,frost,12,5,7
Lijla,blackrock,480,mage,frost,12,5,7
Médivh,archimonde,480,mage,frost,12,5,7
Pixlld,aegwynn,480,mage,frost,12,5,7
Burnit,dalaran,480,mage,frost,12,5,7
Ikefire,draenor,480,mage,frost,12,5,7
Dudè,azshara,480,mage,frost,12,5,7
Kleptomania,archimonde,480,mage,frost,12,5,7
Шипкастермвп,howling-fjord,480,mage,frost,18,5,13
Malygassa,ragnaros,480,mage,frost,18,5,13
Арара,gordunni,480,mage,frost,18,5,13
Trevise,ravencrest,480,mage,frost,18,5,13
Внд,gordunni,480,mage,frost,24,5,19
Restinnpiss,twisting-nether,479,mage,frost,6,5,1
Zyllu,argent-dawn,479,mage,frost,12,5,7
Wizart,moonglade,479,mage,frost,12,5,7
Xýton,azjolnerub,479,mage,frost,12,5,7
Olinourss,archimonde,479,mage,frost,12,5,7
Loøgaã,ysondre,479,mage,frost,12,5,7
Homeessa,stormreaver,479,mage,frost,12,5,7
Kalterfurz,thrall,479,mage,frost,12,5,7
Промагер,gordunni,479,mage,frost,12,5,7
Elreas,blackmoore,479,mage,frost,18,5,13
Deletron,ragnaros,479,mage,frost,18,5,13
Faitha,ravencrest,479,mage,frost,18,5,13
Quickbolt,ravencrest,479,mage,frost,18,5,13
Feuerflamme,theradras,478,mage,frost,12,5,7
Потныйдпс,eversong,478,mage,frost,16,6,10
Crypticc,dentarg,477,mage,frost,12,5,7
Valtarisoo,amanthul,477,mage,frost,12,5,7
Polflop,sylvanas,476,mage,frost,12,5,7
Мюша,razuvious,476,mage,frost,12,5,7
Phibonaci,sylvanas,475,mage,frost,12,5,7
Mëtåøra,khaz-modan,467,mage,frost,18,5,13
Icyfròst,ravencrest,462,mage,frost,13,6,7
Диссоциация,greymane,458,mage,frost,19,7,12
Blinkinggoat,ragnaros,448,mage,frost,18,5,13
Dcolon,tarren-mill,447,mage,frost,11,5,6
Aerathâ,blackrock,447,mage,frost,11,5,6
Blacksheep,ravencrest,447,mage,frost,14,6,8
Nebby,argent-dawn,447,mage,frost,17,5,12
Saytmage,ragnaros,447,mage,frost,17,5,12
Swemagus,outland,432,mage,frost,9,5,4
Bíscuít,ragnaros,431,mage,frost,11,5,6
Dozono,silvermoon,428,mage,frost,15,5,10
Whitecrown,draenor,426,mage,frost,10,6,4
Imnis,outland,425,mage,frost,12,6,6
Internals,tarren-mill,425,mage,frost,20,6,14
Kîshkamen,ravencrest,425,mage,frost,22,6,16
Торар,deathguard,415,mage,frost,16,5,11
Xerathon,ravencrest,414,mage,frost,16,5,11
Merdon,ravencrest,413,mage,frost,10,5,5
Redsparrow,frostwolf,400,mage,frost,13,5,8
Leylus,blackmoore,399,mage,frost,5,5,0
Xaramael,colinas-pardas,389,mage,frost,16,7,9
Belgravia,silvermoon,384,mage,frost,6,4,2
Тризельда,soulflayer,384,mage,frost,6,4,2
Fuhry,tarren-mill,384,mage,frost,6,4,2
Màgí,stormscale,384,mage,frost,6,4,2
Friedkek,ravencrest,384,mage,frost,6,4,2
Zerobelow,silvermoon,384,mage,frost,6,4,2
Targani,drakthul,384,mage,frost,6,4,2
Icescreamer,auchindoun,384,mage,frost,6,4,2
Minglul,archimonde,384,mage,frost,6,4,2
Sylvîe,tarren-mill,384,mage,frost,6,4,2
Hasslad,tarren-mill,384,mage,frost,6,4,2
Swoboswagins,draenor,384,mage,frost,6,4,2
Cesi,silvermoon,384,mage,frost,6,4,2
Spellhaze,outland,384,mage,frost,6,4,2
Doryy,silvermoon,384,mage,frost,6,4,2
Жестьх,blackscar,384,mage,frost,6,4,2
Deathzzaky,ravencrest,384,mage,frost,6,4,2
Zetstez,tarren-mill,384,mage,frost,6,4,2
Steveishigh,tarren-mill,384,mage,frost,6,4,2
Nötmârtònxø,ragnaros,384,mage,frost,6,4,2
Xaryi,blackhand,384,mage,frost,6,4,2
Anev,sylvanas,384,mage,frost,6,4,2
Папущенный,soulflayer,384,mage,frost,6,4,2
Dauwen,silvermoon,384,mage,frost,6,4,2
Ahøllic,frostwolf,384,mage,frost,6,4,2
Dwang,nemesis,384,mage,frost,6,4,2
Xifia,magtheridon,384,mage,frost,6,4,2
Сонатра,howling-fjord,384,mage,frost,6,4,2
Âres,kargath,384,mage,frost,6,4,2
Mowens,ravencrest,384,mage,frost,6,4,2
Zanmalath,stormscale,384,mage,frost,6,4,2
Saiyangodx,twisting-nether,384,mage,frost,6,4,2
Twoeightybpm,draenor,384,mage,frost,6,4,2
Génociidz,archimonde,384,mage,frost,6,4,2
Lusifera,outland,384,mage,frost,6,4,2
Nightcàller,pozzo-delleternità,384,mage,frost,6,4,2
Pinkusbruh,aggra-português,384,mage,frost,6,4,2
Arcitech,tarren-mill,384,mage,frost,6,4,2
Syráx,blackmoore,384,mage,frost,6,4,2
Saryotheone,silvermoon,384,mage,frost,6,4,2
Gravelegacy,quelthalas,384,mage,frost,6,4,2
Proudmøøre,argent-dawn,384,mage,frost,6,4,2
Sneakii,the-maelstrom,384,mage,frost,6,4,2
Rubzim,draenor,384,mage,frost,6,4,2
Elmînster,aerie-peak,384,mage,frost,6,4,2
Willmajacki,blackmoore,384,mage,frost,6,4,2
Maegisniec,ragnaros,384,mage,frost,6,4,2
Kirbi,blackmoore,384,mage,frost,10,5,5
Arýà,blackmoore,384,mage,frost,8,4,4
Sweekz,eredar,384,mage,frost,8,4,4
Shuty,hyjal,384,mage,frost,14,5,9
Frostyfox,aszune,384,mage,frost,15,5,10
Меддиус,gordunni,384,mage,frost,12,4,8
Magemeni,sylvanas,384,mage,frost,12,4,8
Gnðmeonfire,sylvanas,384,mage,frost,12,4,8
Odall,sylvanas,384,mage,frost,12,4,8
Managurke,blackrock,384,mage,frost,12,4,8
Yasuomain,ragnaros,384,mage,frost,12,4,8
Fikkamika,ragnaros,384,mage,frost,12,4,8
Rivií,drakthul,384,mage,frost,12,4,8
Magicrex,alleria,384,mage,frost,12,4,8
Fäust,drakthul,384,mage,frost,12,4,8
Sagdic,kazzak,384,mage,frost,12,4,8
Mopus,ravencrest,384,mage,frost,12,4,8
Гунмаказ,gordunni,384,mage,frost,12,4,8
Stellarie,sylvanas,384,mage,frost,12,4,8
Ринсвид,eversong,384,mage,frost,12,4,8
Stærq,blackrock,384,mage,frost,12,4,8
Felïnnayry,hyjal,384,mage,frost,12,4,8
Kaschnatze,blackmoore,384,mage,frost,12,4,8
Alithekuru,silvermoon,384,mage,frost,12,4,8
Prazilook,the-shatar,384,mage,frost,12,4,8
Elor,eredar,384,mage,frost,12,4,8
Ëgï,azshara,384,mage,frost,12,4,8
Jazzi,blackrock,384,mage,frost,12,4,8
Arszéllius,dalaran,384,mage,frost,12,4,8
Lambaa,thrall,384,mage,frost,12,4,8
Newtwo,ravencrest,384,mage,frost,12,4,8
Вулльф,gordunni,384,mage,frost,12,4,8
Flejb,kazzak,384,mage,frost,12,4,8
Индаррил,howling-fjord,384,mage,frost,12,4,8
Alterwhite,archimonde,384,mage,frost,12,4,8
Proffset,outland,384,mage,frost,12,4,8
Псайххо,soulflayer,384,mage,frost,12,4,8
Muntiks,ravencrest,384,mage,frost,12,4,8
Equálity,blackrock,384,mage,frost,12,4,8
Ðarkreaver,kaelthas,384,mage,frost,12,4,8
Baldazzor,ravencrest,384,mage,frost,12,4,8
Johnnyblazin,outland,384,mage,frost,12,4,8
Kebkhadar,ravencrest,384,mage,frost,12,4,8
Свитерок,soulflayer,384,mage,frost,12,4,8
Flywoman,ravencrest,384,mage,frost,12,4,8
Vorsi,tarren-mill,384,mage,frost,12,4,8
Пламяорды,soulflayer,384,mage,frost,12,4,8
Юджегс,soulflayer,384,mage,frost,12,4,8
Tarovan,defias-brotherhood,384,mage,frost,12,4,8
Acclay,malganis,384,mage,frost,12,4,8
Dphz,tarren-mill,384,mage,frost,12,4,8
Consulalgeri,archimonde,384,mage,frost,12,4,8
Wwjd,darksorrow,384,mage,frost,12,4,8
Ørixx,blackhand,384,mage,frost,12,4,8
Халадель,howling-fjord,384,mage,frost,12,4,8
Liinki,draenor,384,mage,frost,12,4,8
Ratamiel,tarren-mill,384,mage,frost,18,4,14
Krykz,sanguino,384,mage,frost,18,4,14
Gylith,kirin-tor,384,mage,frost,18,4,14
Ruténa,aegwynn,384,mage,frost,18,4,14
Watchmepanda,ravencrest,384,mage,frost,18,4,14
Mobjar,twisting-nether,384,mage,frost,18,4,14
Blinkmehome,silvermoon,384,mage,frost,18,4,14
Ripdeepfreez,culte-de-la-rive-noire,384,mage,frost,18,4,14
Бигдикмаг,soulflayer,384,mage,frost,18,4,14
Schwombette,blackmoore,383,mage,frost,6,4,2
Capyla,blackmoore,383,mage,frost,6,4,2
Wuffwuffspik,grim-batol,383,mage,frost,6,4,2
Magiocre,silvermoon,383,mage,frost,12,4,8
Khad,nemesis,383,mage,frost,12,4,8
Xenodike,blackrock,383,mage,frost,12,4,8
Nanet,cthun,383,mage,frost,12,4,8
Pwndyo,gilneas,383,mage,frost,12,4,8
Труупоед,borean-tundra,383,mage,frost,12,4,8
Скватро,gordunni,383,mage,frost,12,4,8
Zadnik,tarren-mill,383,mage,frost,15,4,11
Ashkalor,frostwolf,383,mage,frost,17,4,13
Asnesh,silvermoon,383,mage,frost,18,4,14
Kaiyn,argent-dawn,383,mage,frost,18,4,14
Perhorus,hyjal,382,mage,frost,6,4,2
Skankengine,twisting-nether,382,mage,frost,12,4,8
Gefríerpunkt,thrall,381,mage,frost,12,4,8
Bisuke,stormscale,367,mage,frost,11,4,7
Whosthemage,kazzak,351,mage,frost,8,5,3
Møøk,magtheridon,336,mage,frost,15,4,11
Frostitutíon,kazzak,336,mage,frost,15,4,11
Taelson,stormscale,335,mage,frost,11,4,7
Pringlesrör,ragnaros,332,mage,frost,15,4,11
Grönmonster,shattered-hand,330,mage,frost,13,5,8
Pascalmabite,outland,330,mage,frost,14,5,9
Leontus,outland,330,mage,frost,16,5,11
Distrophy,vashj,330,mage,frost,18,5,13
Waîdø,blackhand,328,mage,frost,14,7,7
Yinula,stormscale,320,mage,frost,10,4,6
Scras,ragnaros,320,mage,frost,10,4,6
Frostlocked,silvermoon,320,mage,frost,10,4,6
Tiduhasi,antonidas,319,mage,frost,11,4,7
Jambonpistol,archimonde,319,mage,frost,20,4,16
Tudorthemage,xavius,288,mage,frost,6,3,3
Blåskjell,kazzak,288,mage,frost,6,3,3
Marðuk,blackmoore,288,mage,frost,6,3,3
Bóósh,alakir,288,mage,frost,6,3,3
Skrba,kazzak,288,mage,frost,6,3,3
Mannefury,pozzo-delleternità,288,mage,frost,6,3,3
Hànsól,antonidas,288,mage,frost,6,3,3
Halø,bloodhoof,288,mage,frost,6,3,3
Cubis,archimonde,288,mage,frost,6,3,3
Cyser,kazzak,288,mage,frost,6,3,3
Rèkt,lightbringer,288,mage,frost,6,3,3
Narcîsa,sanguino,288,mage,frost,6,3,3
Pirileena,ravencrest,288,mage,frost,6,3,3
Timzør,outland,288,mage,frost,6,3,3
ßerkoßaggins,ravencrest,288,mage,frost,6,3,3
Mégaera,archimonde,288,mage,frost,6,3,3
Волшебну,soulflayer,288,mage,frost,6,3,3
Ghayaa,defias-brotherhood,288,mage,frost,6,3,3
ßjwercke,stormscale,288,mage,frost,6,3,3
Waysha,dun-modr,288,mage,frost,6,3,3
Дмблдр,soulflayer,288,mage,frost,6,3,3
Wúddy,blackrock,288,mage,frost,6,3,3
Gehrkeblock,silvermoon,288,mage,frost,6,3,3
Xlarb,kazzak,288,mage,frost,6,3,3
Swayyx,sylvanas,288,mage,frost,6,3,3
Trinki,bloodscalp,288,mage,frost,6,3,3
Gelubabadook,ravencrest,288,mage,frost,6,3,3
Bigburns,draenor,288,mage,frost,6,3,3
Amaterâsu,antonidas,288,mage,frost,6,3,3
Fízzií,wildhammer,288,mage,frost,6,3,3
Onegaisenpai,ragnaros,288,mage,frost,6,3,3
Brunettdelux,archimonde,288,mage,frost,6,3,3
Haginatorr,twisting-nether,288,mage,frost,6,3,3
Wingzz,outland,288,mage,frost,6,3,3
Aestus,outland,288,mage,frost,6,3,3
Martiqabelle,dun-morogh,288,mage,frost,6,3,3
Hassanabi,defias-brotherhood,288,mage,frost,6,3,3
Periphery,zenedar,288,mage,frost,6,3,3
Hachiro,onyxia,288,mage,frost,6,3,3
Овеча,gordunni,288,mage,frost,6,3,3
Fkeverybody,ravencrest,288,mage,frost,6,3,3
Zlacked,tarren-mill,288,mage,frost,6,3,3
Hutylo,ysondre,288,mage,frost,6,3,3
Тейемор,gordunni,288,mage,frost,6,3,3
Psicotropico,shendralar,288,mage,frost,6,3,3
Illîllîllî,blackrock,288,mage,frost,6,3,3
Makez,draenor,288,mage,frost,6,3,3
Vodjka,nemesis,288,mage,frost,6,3,3
Trúkez,ragnaros,288,mage,frost,6,3,3
Sozie,tarren-mill,288,mage,frost,6,3,3
Rohthalas,frostwolf,288,mage,frost,6,3,3
Diper,burning-legion,288,mage,frost,6,3,3
Thelaere,dun-modr,288,mage,frost,6,3,3
Håtemebaby,kazzak,288,mage,frost,6,3,3
Maybelline,frostwolf,288,mage,frost,6,3,3
Tommyboy,dragonblight,288,mage,frost,6,3,3
Astrryy,burning-legion,288,mage,frost,6,3,3
Zsage,ragnaros,288,mage,frost,6,3,3
Muuckie,blackrock,288,mage,frost,6,3,3
Alystra,kelthuzad,288,mage,frost,6,3,3
Sanderboy,twilights-hammer,288,mage,frost,6,3,3
Siérra,outland,288,mage,frost,6,3,3
Toastyhog,turalyon,288,mage,frost,6,3,3
Arandartis,kazzak,288,mage,frost,6,3,3
Lepapes,doomhammer,288,mage,frost,6,3,3
Frìsko,sylvanas,288,mage,frost,6,3,3
Nevertøxic,ravencrest,288,mage,frost,6,3,3
Айсъмэджик,azuregos,288,mage,frost,6,3,3
Kimfjongmajs,silvermoon,288,mage,frost,6,3,3
Abomiñatîøñ,ravencrest,288,mage,frost,6,3,3
Rhubydoo,quelthalas,288,mage,frost,6,3,3
Kao,ravencrest,288,mage,frost,6,3,3
Rebelions,hyjal,288,mage,frost,6,3,3
Zørïna,ysondre,288,mage,frost,6,3,3
Askannor,norgannon,288,mage,frost,6,3,3
Myuou,hyjal,288,mage,frost,6,3,3
Yésdávé,stormscale,288,mage,frost,6,3,3
Баблби,greymane,288,mage,frost,6,3,3
Frökenfrost,stormscale,288,mage,frost,6,3,3
Soulraider,tarren-mill,288,mage,frost,6,3,3
Triuno,sylvanas,288,mage,frost,10,4,6
Xtermi,zuljin,288,mage,frost,9,3,6
Janovawitnes,azuremyst,288,mage,frost,10,3,7
Schøkø,eredar,288,mage,frost,12,3,9
Whìtewalker,pozzo-delleternità,288,mage,frost,12,3,9
Kryptass,aegwynn,288,mage,frost,12,3,9
Zonium,twisting-nether,288,mage,frost,12,3,9
Harpelmage,auchindoun,288,mage,frost,12,3,9
Voraxma,draenor,288,mage,frost,12,3,9
Nùts,archimonde,288,mage,frost,12,3,9
Blastus,ragnaros,288,mage,frost,12,3,9
Paradigma,sylvanas,288,mage,frost,12,3,9
Avæ,stormscale,288,mage,frost,12,3,9
Waterhagx,tarren-mill,288,mage,frost,12,3,9
Котофайв,howling-fjord,288,mage,frost,12,3,9
Чоуза,gordunni,288,mage,frost,12,3,9
Эммилиарда,gordunni,288,mage,frost,12,3,9
Heatwavesa,ravencrest,288,mage,frost,12,3,9
Legedric,frostwolf,288,mage,frost,12,3,9
Jóhnnybravó,draenor,288,mage,frost,12,3,9
Sérum,drakthul,288,mage,frost,12,3,9
Ахиригиз,gordunni,288,mage,frost,12,3,9
Rachouu,archimonde,288,mage,frost,12,3,9
Скайлуйт,gordunni,288,mage,frost,12,3,9
Sérc,ravencrest,288,mage,frost,12,3,9
Хадя,blackscar,288,mage,frost,12,3,9
Barspin,lightnings-blade,288,mage,frost,12,3,9
Bumps,bronze-dragonflight,288,mage,frost,12,3,9
Subtempo,silvermoon,288,mage,frost,12,3,9
Fernandéz,ravencrest,288,mage,frost,12,3,9
Catafract,kazzak,288,mage,frost,12,3,9
Arcon,garrosh,288,mage,frost,12,3,9
Micklolz,blackmoore,288,mage,frost,12,3,9
Imasheeper,silvermoon,288,mage,frost,12,3,9
Gorrou,hyjal,288,mage,frost,12,3,9
Gogara,kazzak,288,mage,frost,12,3,9
Xeldary,blackmoore,288,mage,frost,12,3,9
Тудысюдым,eversong,288,mage,frost,12,3,9
Merlín,malganis,288,mage,frost,12,3,9
Rizzlybear,outland,288,mage,frost,12,3,9
Lycfatum,twisting-nether,288,mage,frost,12,3,9
Onlymage,outland,288,mage,frost,12,3,9
Äßäm,outland,288,mage,frost,12,3,9
Flarriux,twisting-nether,288,mage,frost,12,3,9
Darmie,burning-legion,288,mage,frost,12,3,9
Whïtebøy,hyjal,288,mage,frost,12,3,9
Kilféfroid,ysondre,288,mage,frost,13,3,10
Ypy,dragonmaw,288,mage,frost,14,3,11
Nerobus,malorne,288,mage,frost,18,3,15
Jâm,bronze-dragonflight,288,mage,frost,18,3,15
Icystar,antonidas,288,mage,frost,18,3,15
Zomas,kazzak,288,mage,frost,18,3,15
Cortis,outland,288,mage,frost,18,3,15
Эпсиха,lich-king,287,mage,frost,6,3,3
Reeyymmoo,draenor,287,mage,frost,6,3,3
Zuza,magtheridon,287,mage,frost,6,3,3
Magó,eredar,287,mage,frost,6,3,3
Напряжеметр,soulflayer,287,mage,frost,6,3,3
Zhazam,blades-edge,287,mage,frost,6,3,3
Fumachustas,kazzak,287,mage,frost,6,3,3
Mexxlaz,eredar,287,mage,frost,12,3,9
Kasus,sporeggar,287,mage,frost,12,3,9
Nekroulis,agamaggan,287,mage,frost,17,3,14
Gamah,exodar,287,mage,frost,18,3,15
Freeto,blackmoore,286,mage,frost,6,3,3
Rosenkrauz,kul-tiras,280,mage,frost,26,3,23
Torryel,silvermoon,256,mage,frost,10,3,7
Кагумми,gordunni,256,mage,frost,16,3,13
Колдунская,gordunni,255,mage,frost,11,3,8
Alèxjones,stormscale,239,mage,frost,5,3,2
Deepsteez,tarren-mill,239,mage,frost,5,3,2
Latory,aegwynn,239,mage,frost,5,3,2
Heimer,ravencrest,239,mage,frost,5,3,2
Eluniara,frostmane,224,mage,frost,10,3,7
Tehotyttö,dragonblight,224,mage,frost,16,3,13
Frostbringer,archimonde,192,mage,frost,6,2,4
Magovix,archimonde,192,mage,frost,6,2,4
Cyreniax,the-maelstrom,192,mage,frost,6,2,4
Frazztato,tarren-mill,192,mage,frost,6,2,4
Harzallane,kirin-tor,192,mage,frost,6,2,4
Brísingamen,outland,192,mage,frost,6,2,4
Merwido,the-maelstrom,192,mage,frost,6,2,4
Randommagexd,ravencrest,192,mage,frost,6,2,4
Adetin,tarren-mill,192,mage,frost,6,2,4
Шарансул,soulflayer,192,mage,frost,6,2,4
Ðøæø,twisting-nether,192,mage,frost,6,2,4
Malghar,rashgarroth,192,mage,frost,6,2,4
Liloz,aegwynn,192,mage,frost,6,2,4
Naldora,turalyon,192,mage,frost,6,2,4
Flanor,pozzo-delleternità,192,mage,frost,6,2,4
Qalisp,twisting-nether,192,mage,frost,6,2,4
Queuefiend,eredar,192,mage,frost,6,2,4
Animositymg,draenor,192,mage,frost,6,2,4
Zheakz,kazzak,192,mage,frost,6,2,4
Celestis,sylvanas,192,mage,frost,6,2,4
Shealá,blackhand,192,mage,frost,6,2,4
Бэкспейс,greymane,192,mage,frost,6,2,4
Héstia,sylvanas,192,mage,frost,6,2,4
Laciee,silvermoon,192,mage,frost,6,2,4
Crite,blackmoore,192,mage,frost,6,2,4
Helixmg,silvermoon,192,mage,frost,6,2,4
Alieni,stormreaver,192,mage,frost,6,2,4
Litheon,drakthul,192,mage,frost,6,2,4
Sperow,marécage-de-zangar,192,mage,frost,6,2,4
Smokedaddy,stormscale,192,mage,frost,6,2,4
Ipen,bloodfeather,192,mage,frost,6,2,4
Infamage,draenor,192,mage,frost,6,2,4
Zerøsílgødx,antonidas,192,mage,frost,6,2,4
Jengele,argent-dawn,192,mage,frost,6,2,4
Auzt,kazzak,192,mage,frost,6,2,4
Firecold,silvermoon,192,mage,frost,6,2,4
Mässîvècøx,ragnaros,192,mage,frost,6,2,4
Proxanlulz,ravencrest,192,mage,frost,6,2,4
Ellianor,drakthul,192,mage,frost,6,2,4
Эникор,gordunni,192,mage,frost,6,2,4
Usidore,sylvanas,192,mage,frost,6,2,4
Ingibjorg,auchindoun,192,mage,frost,6,2,4
Gandulf,malorne,192,mage,frost,6,2,4
Tomia,burning-legion,192,mage,frost,6,2,4
Budgetziqo,ravencrest,192,mage,frost,6,2,4
Yunion,burning-legion,192,mage,frost,6,2,4
Wroneq,burning-legion,192,mage,frost,6,2,4
Sebers,kazzak,192,mage,frost,6,2,4
Нетлель,soulflayer,192,mage,frost,6,2,4
Berylton,argent-dawn,192,mage,frost,6,2,4
Галадриелька,gordunni,192,mage,frost,6,2,4
Nypààx,anetheron,192,mage,frost,6,2,4
Ratedr,silvermoon,192,mage,frost,6,2,4
Maveya,blackmoore,192,mage,frost,6,2,4
Saveq,kazzak,192,mage,frost,6,2,4
Мегазад,gordunni,192,mage,frost,6,2,4
Венталис,gordunni,192,mage,frost,6,2,4
Etherìon,los-errantes,192,mage,frost,6,2,4
Barka,colinas-pardas,192,mage,frost,6,2,4
Atius,archimonde,192,mage,frost,6,2,4
Фроз,soulflayer,192,mage,frost,6,2,4
Haxyo,twisting-nether,192,mage,frost,6,2,4
Фрайзо,gordunni,192,mage,frost,6,2,4
Micro,auchindoun,192,mage,frost,6,2,4
Zeramage,eredar,192,mage,frost,6,2,4
Kasidead,archimonde,192,mage,frost,6,2,4
Kriokola,steamwheedle-cartel,192,mage,frost,6,2,4
Youded,arthas,192,mage,frost,6,2,4
Bananaslam,silvermoon,192,mage,frost,6,2,4
Goodopeners,outland,192,mage,frost,6,2,4
Mooryel,burning-legion,192,mage,frost,6,2,4
Ghuurall,burning-legion,192,mage,frost,6,2,4
Benthortm,tarren-mill,192,mage,frost,6,2,4
Xblaz,draenor,192,mage,frost,6,2,4
Noxia,minahonda,192,mage,frost,6,2,4
Колдрагос,gordunni,192,mage,frost,6,2,4
Robsn,blackrock,192,mage,frost,6,2,4
Missáh,archimonde,192,mage,frost,6,2,4
Mageta,silvermoon,192,mage,frost,6,2,4
Ahuenchik,stormscale,192,mage,frost,6,2,4
Creak,blackhand,192,mage,frost,6,2,4
Zilus,gilneas,192,mage,frost,6,2,4
Jeâns,alexstrasza,192,mage,frost,6,2,4
Ohateyz,burning-legion,192,mage,frost,6,2,4
Димаскунфу,howling-fjord,192,mage,frost,6,2,4
Levioosah,draenor,192,mage,frost,6,2,4
Swørd,aggra-português,192,mage,frost,6,2,4
Dxdxdxdxdx,drakthul,192,mage,frost,6,2,4
Alleii,kazzak,192,mage,frost,6,2,4
Sany,anubarak,192,mage,frost,6,2,4
Vaerén,malganis,192,mage,frost,6,2,4
Ðps,grim-batol,192,mage,frost,6,2,4
Ekron,sanguino,192,mage,frost,6,2,4
Kobrass,spinebreaker,192,mage,frost,6,2,4
Firen,thrall,192,mage,frost,6,2,4
Welt,drakthul,192,mage,frost,6,2,4
Exael,ravencrest,192,mage,frost,6,2,4
Tesho,sylvanas,192,mage,frost,6,2,4
Wizoz,blackrock,192,mage,frost,6,2,4
Jääpuikko,grim-batol,192,mage,frost,6,2,4
Gameart,alexstrasza,192,mage,frost,6,2,4
Burnem,kult-der-verdammten,192,mage,frost,6,2,4
Labius,dun-modr,192,mage,frost,6,2,4
Balmak,doomhammer,192,mage,frost,6,2,4
Ceinxjk,ravencrest,192,mage,frost,6,2,4
Zulkas,stormreaver,192,mage,frost,6,2,4
Uwutehe,ravencrest,192,mage,frost,6,2,4
Ehbehad,doomhammer,192,mage,frost,6,2,4
Вовзон,howling-fjord,192,mage,frost,6,2,4
Skylezy,blackrock,192,mage,frost,6,2,4
Джинжилах,gordunni,192,mage,frost,6,2,4
Feath,ravencrest,192,mage,frost,6,2,4
Banausisch,blackmoore,192,mage,frost,6,2,4
Hacksopa,twisting-nether,192,mage,frost,6,2,4
Meteofrost,draenor,192,mage,frost,6,2,4
Bugica,drakthul,192,mage,frost,6,2,4
Congelation,tarren-mill,192,mage,frost,6,2,4
Betoxin,dunemaul,192,mage,frost,7,2,5
Zugkzugk,eredar,192,mage,frost,9,2,7
Rapidfrost,drakthul,192,mage,frost,12,2,10
Nifer,tarren-mill,192,mage,frost,12,2,10
Illiot,twisting-nether,192,mage,frost,12,2,10
Nefine,azshara,192,mage,frost,12,2,10
Bêta,dun-modr,192,mage,frost,12,2,10
Shiftea,argent-dawn,192,mage,frost,12,2,10
Kaevelin,argent-dawn,192,mage,frost,12,2,10
Pogmage,blackrock,192,mage,frost,12,2,10
Mariujana,ravencrest,192,mage,frost,12,2,10
Blinkyrascal,silvermoon,192,mage,frost,12,2,10
Buzzcraft,draenor,192,mage,frost,12,2,10
Freezeballs,blackmoore,192,mage,frost,12,2,10
Flamê,ragnaros,192,mage,frost,12,2,10
Qtoli,tarren-mill,192,mage,frost,12,2,10
Shadyexd,ravencrest,192,mage,frost,12,2,10
Alystan,burning-blade,192,mage,frost,12,2,10
Myriel,thrall,192,mage,frost,12,2,10
Yerro,kazzak,192,mage,frost,12,2,10
Portnography,draenor,192,mage,frost,12,2,10
Магниффика,blackscar,192,mage,frost,12,2,10
Toyash,ragnaros,192,mage,frost,12,2,10
Atírpá,doomhammer,192,mage,frost,12,2,10
Hruon,ravenholdt,192,mage,frost,15,2,13
Blainemagus,arathor,192,mage,frost,17,2,15
Illusionx,grim-batol,191,mage,frost,6,2,4
Aaropalli,kazzak,191,mage,frost,6,2,4
Mallisto,magtheridon,191,mage,frost,6,2,4
Makkertje,silvermoon,191,mage,frost,6,2,4
Duncanidaho,throkferoth,191,mage,frost,6,2,4
Mátraxx,silvermoon,191,mage,frost,12,2,10
Enkida,exodar,191,mage,frost,18,2,16
Proxj,stormscale,175,mage,frost,11,2,9
Cerewyn,ravencrest,175,mage,frost,11,2,9
Dødo,archimonde,159,mage,frost,5,2,3
Kyan,burning-legion,159,mage,frost,5,2,3
Ivailo,ravencrest,159,mage,frost,5,2,3
Hord,zuljin,159,mage,frost,5,2,3
Натсумен,soulflayer,144,mage,frost,9,2,7
Codeincassie,blackhand,138,mage,frost,10,4,6
Zôot,ravencrest,138,mage,frost,11,4,7
Drinte,blackmoore,138,mage,frost,10,3,7
Asmodeuz,spinebreaker,138,mage,frost,10,3,7
Winswin,stormscale,138,mage,frost,11,3,8
Lovesosa,malorne,138,mage,frost,13,3,10
Ostentatious,twisting-nether,128,mage,frost,4,2,2
Швайго,gordunni,128,mage,frost,4,2,2
Anazolium,outland,128,mage,frost,4,2,2
Klivapå,aggramar,128,mage,frost,4,2,2
Felmington,silvermoon,127,mage,frost,4,2,2
Skitsó,shadowsong,127,mage,frost,4,2,2
Arghen,nemesis,105,mage,frost,13,3,10
Akharthion,defias-brotherhood,96,mage,frost,3,2,1
Ntintsec,tarren-mill,96,mage,frost,3,2,1
Firestárter,ravencrest,96,mage,frost,3,2,1
Муан,gordunni,96,mage,frost,9,2,7
Колтрэйн,blackscar,96,mage,frost,6,1,5
Rushhdj,exodar,96,mage,frost,6,1,5
Loskapaska,stormreaver,96,mage,frost,6,1,5
Babynilli,ravencrest,96,mage,frost,6,1,5
Coombuster,kazzak,96,mage,frost,6,1,5
Raktor,blackrock,96,mage,frost,6,1,5
Kalliston,tarren-mill,96,mage,frost,6,1,5
Magîny,antonidas,96,mage,frost,6,1,5
Rilac,nordrassil,96,mage,frost,6,1,5
Одз,grom,96,mage,frost,6,1,5
Rmforever,archimonde,96,mage,frost,6,1,5
Velkyn,ravencrest,96,mage,frost,6,1,5
Xqtmage,blackhand,96,mage,frost,6,1,5
Rezre,stormscale,96,mage,frost,6,1,5
Víóla,nagrand,96,mage,frost,6,1,5
Генстащитка,gordunni,96,mage,frost,6,1,5
Sløbinia,blackhand,96,mage,frost,6,1,5
Niladyel,hyjal,96,mage,frost,6,1,5
Nullso,zuljin,96,mage,frost,6,1,5
Silmara,shadowsong,96,mage,frost,6,1,5
Testoletku,twisting-nether,96,mage,frost,6,1,5
Adoptamage,hyjal,96,mage,frost,6,1,5
Aarcheon,kazzak,96,mage,frost,6,1,5
Kpacey,guldan,96,mage,frost,6,1,5
Vali,drakthul,96,mage,frost,6,1,5
Petri,laughing-skull,96,mage,frost,6,1,5
Bebelusa,agamaggan,96,mage,frost,6,1,5
Hisokâ,eitrigg,96,mage,frost,6,1,5
Rouxbignol,archimonde,96,mage,frost,6,1,5
Volksmagier,ravencrest,96,mage,frost,6,1,5
Dwarfyy,frostmane,96,mage,frost,6,1,5
Wingman,tarren-mill,96,mage,frost,6,1,5
Drfunk,shadowsong,96,mage,frost,6,1,5
Capz,outland,96,mage,frost,6,1,5
Wilhélm,twisting-nether,96,mage,frost,6,1,5
Pungvre,kazzak,96,mage,frost,6,1,5
Sendera,taerar,96,mage,frost,6,1,5
Chimará,eredar,96,mage,frost,6,1,5
Miyukì,dun-morogh,96,mage,frost,6,1,5
Imshilling,ravencrest,96,mage,frost,6,1,5
Feudobois,archimonde,96,mage,frost,6,1,5
Ibfear,twisting-nether,96,mage,frost,6,1,5
Poochmage,archimonde,96,mage,frost,6,1,5
Meisterg,frostwolf,96,mage,frost,6,1,5
Сморгонец,gordunni,96,mage,frost,6,1,5
Dyen,hyjal,96,mage,frost,6,1,5
Graell,archimonde,96,mage,frost,6,1,5
Bonzu,dethecus,96,mage,frost,6,1,5
Devòna,silvermoon,96,mage,frost,6,1,5
Ноусес,soulflayer,96,mage,frost,6,1,5
Serbzor,stormscale,96,mage,frost,6,1,5
Ледянойкекс,gordunni,96,mage,frost,6,1,5
Teeclis,twisting-nether,96,mage,frost,6,1,5
Deathbrínger,alakir,96,mage,frost,6,1,5
Trenpapi,twisting-nether,96,mage,frost,6,1,5
Mëgu,silvermoon,96,mage,frost,6,1,5
Pflanzenn,nozdormu,96,mage,frost,6,1,5
Vildfogel,tarren-mill,96,mage,frost,6,1,5
Ïcyveins,thrall,96,mage,frost,6,1,5
Froostii,aegwynn,96,mage,frost,6,1,5
Sílvér,draenor,96,mage,frost,6,1,5
Mésai,silvermoon,96,mage,frost,6,1,5
Eryssz,archimonde,96,mage,frost,6,1,5
Arcann,ravencrest,96,mage,frost,6,1,5
Keïji,khaz-modan,96,mage,frost,6,1,5
Shawarm,stormscale,96,mage,frost,6,1,5
Mgtt,defias-brotherhood,96,mage,frost,6,1,5
Slavaroski,khaz-modan,96,mage,frost,6,1,5
Dampgame,twisting-nether,96,mage,frost,6,1,5
Ghelder,drakthul,96,mage,frost,6,1,5
Hurtinlo,dun-modr,96,mage,frost,6,1,5
Чаклунхитрун,gordunni,96,mage,frost,6,1,5
Sheeptonreup,archimonde,96,mage,frost,6,1,5
Dphalos,ravencrest,96,mage,frost,6,1,5
Cheeku,outland,96,mage,frost,6,1,5
Cleanaf,hellfire,96,mage,frost,6,1,5
Xoløtl,ravencrest,96,mage,frost,6,1,5
Squìshy,magtheridon,96,mage,frost,6,1,5
Squirtee,drakthul,96,mage,frost,6,1,5
Холдми,gordunni,96,mage,frost,6,1,5
Ekyoo,blackrock,96,mage,frost,6,1,5
Alphaburstqx,ragnaros,96,mage,frost,6,1,5
Romaga,quelthalas,96,mage,frost,6,1,5
Dóncójones,blackrock,96,mage,frost,6,1,5
Vïto,zuljin,96,mage,frost,12,1,11
Fintexmex,ravencrest,96,mage,frost,12,1,11
Snowy,sargeras,96,mage,frost,12,1,11
Wàrpten,draenor,96,mage,frost,12,1,11
Pihkanaaras,stormscale,96,mage,frost,12,1,11
Floé,twisting-nether,95,mage,frost,6,1,5
Зухвала,howling-fjord,95,mage,frost,6,1,5
Elkayizer,archimonde,95,mage,frost,12,1,11
Bagss,ysondre,95,mage,frost,12,1,11
Nalord,saurfang,95,mage,frost,12,1,11
Hcs,dalaran,79,mage,frost,5,1,4
Levora,ragnaros,79,mage,frost,5,1,4
Каппашилка,gordunni,64,mage,frost,4,1,3
Хаскивсказке,gordunni,64,mage,frost,4,1,3
Gocu,tarren-mill,63,mage,frost,2,2,0
Magebraín,ravencrest,63,mage,frost,2,2,0
Деозар,eversong,63,mage,frost,2,2,0
Тачитачи,gordunni,48,mage,frost,3,1,2
Ямурайхо,howling-fjord,48,mage,frost,3,1,2
Avizura,argent-dawn,42,mage,frost,10,3,7
Frostjaw,burning-steppes,42,mage,frost,10,3,7
Aeghis,darkspear,42,mage,frost,10,3,7
Mayreel,antonidas,42,mage,frost,11,3,8
Stardawwg,ravencrest,42,mage,frost,9,2,7
Лайнэя,galakrond,42,mage,frost,10,2,8
Boned,ravencrest,42,mage,frost,17,3,14
Zibiz,outland,42,mage,frost,16,2,14
Sawaragi,blackmoore,31,mage,frost,2,1,1
Интровертка,blackscar,31,mage,frost,2,1,1
Jondahr,emerald-dream,31,mage,frost,8,1,7
Mauvé,blades-edge,19,mage,frost,16,5,11
Commadore,draenor,2339,monk,mistweaver,173,102,71
Cømmadore,sylvanas,2315,monk,mistweaver,115,70,45
Fister,zuljin,2305,monk,mistweaver,83,58,25
Fisterino,zuljin,2304,monk,mistweaver,54,42,12
Botweaver,tarren-mill,2297,monk,mistweaver,145,91,54
Nnsstt,zuljin,2290,monk,mistweaver,110,69,41
Cocojones,tarren-mill,2289,monk,mistweaver,209,143,66
Пиписечка,gordunni,2279,monk,mistweaver,132,84,48
Brickeduptwo,twisting-nether,2268,monk,mistweaver,180,132,48
Brickedup,twisting-nether,2267,monk,mistweaver,157,92,65
Лабирончик,blackscar,2263,monk,mistweaver,166,112,54
Lxstcxntury,stormscale,2254,monk,mistweaver,95,60,35
Фуфинус,gordunni,2254,monk,mistweaver,89,53,36
Kurbanov,stormscale,2249,monk,mistweaver,296,163,133
Vanost,kazzak,2247,monk,mistweaver,204,110,94
Керизз,gordunni,2245,monk,mistweaver,94,60,34
Bankmw,tarren-mill,2242,monk,mistweaver,107,70,37
Jimpaa,outland,2239,monk,mistweaver,173,113,60
Umadbrohuh,outland,2237,monk,mistweaver,99,60,39
Ltmxy,ravencrest,2235,monk,mistweaver,84,53,31
Ínsanez,dun-modr,2232,monk,mistweaver,138,82,56
Lp,mugthol,2231,monk,mistweaver,90,59,31
Chsx,ravencrest,2230,monk,mistweaver,180,121,59
Chichigneux,hyjal,2218,monk,mistweaver,134,87,47
Syy,medivh,2215,monk,mistweaver,84,48,36
Loiyah,dun-modr,2215,monk,mistweaver,138,75,63
Pivø,ravencrest,2212,monk,mistweaver,124,80,44
Nsnz,stormscale,2212,monk,mistweaver,209,121,88
Loiyh,dun-modr,2211,monk,mistweaver,144,77,67
Kanketoe,korgall,2210,monk,mistweaver,107,58,49
Sqxgodx,ragnaros,2209,monk,mistweaver,83,50,33
Kêkburagol,kazzak,2209,monk,mistweaver,246,148,98
Sâu,twisting-nether,2208,monk,mistweaver,134,83,51
Loiythree,dun-modr,2199,monk,mistweaver,120,65,55
Kåtsumi,sanguino,2198,monk,mistweaver,199,127,72
Lifelessons,blackrock,2198,monk,mistweaver,81,49,32
Djsqx,outland,2195,monk,mistweaver,70,41,29
Кимлейн,blackscar,2194,monk,mistweaver,78,46,32
Ðurîmar,ravencrest,2191,monk,mistweaver,115,68,47
Quendiz,frostwolf,2190,monk,mistweaver,96,52,44
Turricane,blackmoore,2178,monk,mistweaver,258,136,122
Gloon,ravencrest,2176,monk,mistweaver,81,50,31
Swoshz,ragnaros,2175,monk,mistweaver,72,39,33
Ltmdwarf,ravencrest,2171,monk,mistweaver,126,70,56
Monkdrak,eredar,2170,monk,mistweaver,75,48,27
Онимэшнеца,gordunni,2170,monk,mistweaver,77,48,29
Fortnitekid,outland,2167,monk,mistweaver,166,107,59
Ballademager,magtheridon,2167,monk,mistweaver,154,88,66
Tierrax,cthun,2166,monk,mistweaver,129,69,60
Buddiline,baelgun,2166,monk,mistweaver,126,67,59
Meliowo,ravencrest,2162,monk,mistweaver,108,62,46
Flowy,uldum,2162,monk,mistweaver,72,39,33
Problematic,blackmoore,2160,monk,mistweaver,142,85,57
Trashcarlita,eredar,2159,monk,mistweaver,120,67,53
Sofunny,blackrock,2157,monk,mistweaver,141,86,55
Ashm,shattered-halls,2157,monk,mistweaver,176,98,78
Tryhârdx,stormscale,2157,monk,mistweaver,156,83,73
Srdarr,kazzak,2156,monk,mistweaver,144,86,58
Zaerin,eredar,2155,monk,mistweaver,67,39,28
Bigbøøty,silvermoon,2154,monk,mistweaver,108,56,52
Quendi,frostwolf,2150,monk,mistweaver,358,181,177
Tigermw,twisting-nether,2149,monk,mistweaver,196,115,81
Nesedondondn,stormscale,2147,monk,mistweaver,101,64,37
Lyashi,dalaran,2147,monk,mistweaver,107,56,51
Кекичан,gordunni,2146,monk,mistweaver,167,107,60
Nawak,archimonde,2144,monk,mistweaver,201,108,93
Фунтос,soulflayer,2142,monk,mistweaver,72,45,27
Muixilis,dun-modr,2142,monk,mistweaver,156,96,60
Shonbadatret,argent-dawn,2141,monk,mistweaver,132,79,53
Loofey,ragnaros,2140,monk,mistweaver,242,140,102
Akanetsu,kazzak,2139,monk,mistweaver,138,80,58
Ðalvan,blackrock,2139,monk,mistweaver,114,62,52
Дамбмонк,blackscar,2138,monk,mistweaver,94,56,38
Zabjudah,stormscale,2134,monk,mistweaver,134,82,52
Montex,stormscale,2134,monk,mistweaver,227,116,111
Xámell,ravencrest,2133,monk,mistweaver,96,49,47
Lízãriñ,ravencrest,2132,monk,mistweaver,265,174,91
Pennøe,ravencrest,2132,monk,mistweaver,134,78,56
Mønkeÿ,ravencrest,2130,monk,mistweaver,70,42,28
Veganweaver,ravencrest,2129,monk,mistweaver,78,50,28
Mibe,alonsus,2127,monk,mistweaver,222,113,109
Vivie,destromath,2126,monk,mistweaver,78,48,30
Willxmonk,silvermoon,2126,monk,mistweaver,101,56,45
Shorus,blackmoore,2125,monk,mistweaver,132,84,48
Monkield,kazzak,2125,monk,mistweaver,400,230,170
Rocknreroll,executus,2124,monk,mistweaver,300,171,129
Гроксси,howling-fjord,2122,monk,mistweaver,206,127,79
Notzaele,zuljin,2122,monk,mistweaver,240,130,110
Sinted,blackmoore,2120,monk,mistweaver,107,65,42
Beetlejuicé,stormscale,2118,monk,mistweaver,42,28,14
Dollyqt,ravencrest,2118,monk,mistweaver,96,49,47
Mharlie,stormscale,2117,monk,mistweaver,291,158,133
Sookrates,ragnaros,2116,monk,mistweaver,176,101,75
Monkrah,blackmoore,2116,monk,mistweaver,138,75,63
Ûwù,ravencrest,2115,monk,mistweaver,72,55,17
Gresmar,defias-brotherhood,2115,monk,mistweaver,172,93,79
Bmane,archimonde,2114,monk,mistweaver,71,40,31
Bjj,blackrock,2113,monk,mistweaver,83,48,35
Bighealz,aggra-português,2113,monk,mistweaver,77,43,34
Dekaramw,ravencrest,2112,monk,mistweaver,42,33,9
Donitrivegas,blackrock,2112,monk,mistweaver,315,191,124
Brxndimonk,antonidas,2111,monk,mistweaver,117,68,49
Diorc,outland,2110,monk,mistweaver,212,116,96
Seeyoulater,nemesis,2110,monk,mistweaver,354,184,170
Cranex,terenas,2109,monk,mistweaver,118,72,46
Blacktee,eredar,2109,monk,mistweaver,78,44,34
Кулакх,blackscar,2109,monk,mistweaver,208,113,95
Egg,frostmane,2108,monk,mistweaver,96,62,34
Neszesmonk,ragnaros,2108,monk,mistweaver,391,210,181
Нимбмонк,soulflayer,2108,monk,mistweaver,89,45,44
Йорита,soulflayer,2107,monk,mistweaver,102,59,43
Fashion,outland,2106,monk,mistweaver,102,64,38
Mememaster,blackhand,2106,monk,mistweaver,172,105,67
Lmnsx,ravencrest,2106,monk,mistweaver,96,56,40
Elmezz,burning-legion,2106,monk,mistweaver,99,50,49
Deepl,dun-modr,2105,monk,mistweaver,78,45,33
Mergina,silvermoon,2105,monk,mistweaver,126,66,60
Meldi,ravencrest,2104,monk,mistweaver,78,46,32
Боецкфц,soulflayer,2104,monk,mistweaver,82,46,36
Bobthewild,draenor,2104,monk,mistweaver,449,233,216
Wajøba,blackhand,2103,monk,mistweaver,66,37,29
Fisterbean,outland,2103,monk,mistweaver,72,40,32
Tímmz,blackrock,2102,monk,mistweaver,131,76,55
Ruurruuru,archimonde,2102,monk,mistweaver,245,140,105
Кулачонка,blackscar,2102,monk,mistweaver,119,68,51
Blubberwurst,gorgonnash,2102,monk,mistweaver,130,74,56
Webhottie,twisting-nether,2102,monk,mistweaver,155,88,67
Karsat,hyjal,2102,monk,mistweaver,639,339,300
Wajoba,blackhand,2102,monk,mistweaver,114,58,56
Глитч,deepholm,2100,monk,mistweaver,66,43,23
Adgoh,tarren-mill,2100,monk,mistweaver,94,61,33
Hiryu,argent-dawn,2100,monk,mistweaver,125,75,50
Yellowtape,kiljaeden,2100,monk,mistweaver,215,127,88
Skïrmíshgødx,ravencrest,2100,monk,mistweaver,108,55,53
Fshn,sylvanas,2095,monk,mistweaver,49,33,16
Vienuolè,silvermoon,2093,monk,mistweaver,96,51,45
Lylleri,darksorrow,2089,monk,mistweaver,68,40,28
Qwertyxo,draenor,2087,monk,mistweaver,394,230,164
Кербю,gordunni,2083,monk,mistweaver,137,74,63
Iminar,blackrock,2082,monk,mistweaver,156,86,70
Zonsym,twisting-nether,2082,monk,mistweaver,264,144,120
Speedahx,dun-modr,2079,monk,mistweaver,196,115,81
Maybeexm,ravencrest,2077,monk,mistweaver,114,68,46
Анимешнеца,gordunni,2077,monk,mistweaver,78,41,37
Kaguræ,hyjal,2076,monk,mistweaver,95,57,38
Jmw,silvermoon,2074,monk,mistweaver,95,62,33
Monkeyi,silvermoon,2071,monk,mistweaver,155,79,76
Леолайт,borean-tundra,2069,monk,mistweaver,148,82,66
Strillen,twisting-nether,2069,monk,mistweaver,366,194,172
Lîlilîlîlîlí,stormscale,2066,monk,mistweaver,66,37,29
Кодизи,gordunni,2063,monk,mistweaver,83,53,30
Myeers,dun-modr,2063,monk,mistweaver,348,194,154
Zevenblad,stormscale,2063,monk,mistweaver,123,66,57
Jackìl,nemesis,2062,monk,mistweaver,108,74,34
Wrynja,blackmoore,2061,monk,mistweaver,121,73,48
Førzãlêvskî,ravencrest,2059,monk,mistweaver,105,70,35
Timmzý,blackmoore,2059,monk,mistweaver,179,105,74
Chichi,ravencrest,2059,monk,mistweaver,602,317,285
Marvboy,aegwynn,2055,monk,mistweaver,72,46,26
Fùckaround,emeriss,2055,monk,mistweaver,191,110,81
Uao,tarren-mill,2055,monk,mistweaver,90,38,52
Djreckx,kazzak,2052,monk,mistweaver,72,48,24
Swoshz,sylvanas,2051,monk,mistweaver,78,44,34
Kêza,culte-de-la-rive-noire,2050,monk,mistweaver,48,28,20
Marceliná,blackmoore,2048,monk,mistweaver,163,95,68
Maedicweaver,aegwynn,2047,monk,mistweaver,112,67,45
Mistkueefer,tarren-mill,2045,monk,mistweaver,60,34,26
Vienuole,silvermoon,2039,monk,mistweaver,101,53,48
Beili,ravencrest,2037,monk,mistweaver,109,60,49
Insanepace,blackmoore,2035,monk,mistweaver,283,148,135
Kêkbûrâgól,kazzak,2034,monk,mistweaver,199,108,91
Joke,ragnaros,2033,monk,mistweaver,144,72,72
Pizzabud,ravencrest,2031,monk,mistweaver,76,48,28
Фейкнаут,soulflayer,2031,monk,mistweaver,204,111,93
Ouhmaikgød,dun-modr,2028,monk,mistweaver,332,168,164
Loobee,ravencrest,2027,monk,mistweaver,66,37,29
Shanlle,dun-modr,2025,monk,mistweaver,155,77,78
Lanuia,aegwynn,2024,monk,mistweaver,69,45,24
Fusetonww,tarren-mill,2022,monk,mistweaver,99,58,41
Mugenzen,sanguino,2022,monk,mistweaver,60,30,30
Слишкомхорош,thermaplugg,2021,monk,mistweaver,53,38,15
Youkâi,blackrock,2020,monk,mistweaver,89,46,43
Frkn,blackrock,2019,monk,mistweaver,126,74,52
Marqinio,archimonde,2019,monk,mistweaver,102,57,45
Chitea,argent-dawn,2019,monk,mistweaver,88,47,41
Snówtea,silvermoon,2018,monk,mistweaver,74,40,34
Sushiroller,blackrock,2017,monk,mistweaver,126,70,56
Haìryplotter,kazzak,2017,monk,mistweaver,348,191,157
Roadrunnér,ravencrest,2017,monk,mistweaver,156,81,75
Ганссмонк,blackscar,2015,monk,mistweaver,239,125,114
Texiq,drakthul,2012,monk,mistweaver,512,285,227
Stringg,zuljin,2012,monk,mistweaver,360,196,164
Pwner,daggerspine,2012,monk,mistweaver,328,175,153
Féfè,archimonde,2012,monk,mistweaver,114,59,55
Shadezz,blackmoore,2011,monk,mistweaver,117,75,42
Toram,burning-legion,2011,monk,mistweaver,120,65,55
Zanzetsu,twisting-nether,2011,monk,mistweaver,303,164,139
Fåtjøë,ravencrest,2010,monk,mistweaver,48,31,17
Flandersmonk,ravencrest,2008,monk,mistweaver,96,60,36
Howtoown,burning-legion,2008,monk,mistweaver,72,42,30
Шортмневноги,howling-fjord,2008,monk,mistweaver,137,74,63
Øméga,ravencrest,2006,monk,mistweaver,218,141,77
Угвей,deepholm,2003,monk,mistweaver,52,38,14
Суммрачная,gordunni,2002,monk,mistweaver,144,89,55
Lanory,blackmoore,2000,monk,mistweaver,90,55,35
Pizelx,ravencrest,2000,monk,mistweaver,116,56,60
Zeoverx,ragnaros,2000,monk,mistweaver,84,39,45
Szerzetesý,ravencrest,1999,monk,mistweaver,45,27,18
Skailzkrtwo,hyjal,1996,monk,mistweaver,120,64,56
Darkllinè,twisting-nether,1996,monk,mistweaver,254,132,122
Xàmell,kazzak,1995,monk,mistweaver,50,33,17
Another,frostmourne,1993,monk,mistweaver,179,107,72
Mösêê,eredar,1992,monk,mistweaver,88,39,49
Melysà,antonidas,1991,monk,mistweaver,87,48,39
Bigmilkies,ysondre,1991,monk,mistweaver,200,108,92
Àjay,outland,1990,monk,mistweaver,66,45,21
Çoomðragon,stormscale,1989,monk,mistweaver,48,33,15
Judochops,sylvanas,1989,monk,mistweaver,72,37,35
Basilbrushxd,stormscale,1985,monk,mistweaver,66,39,27
Lanvia,argent-dawn,1985,monk,mistweaver,234,134,100
Wernos,archimonde,1983,monk,mistweaver,78,47,31
Holyrop,aegwynn,1982,monk,mistweaver,36,25,11
Кувырбек,howling-fjord,1982,monk,mistweaver,54,37,17
Abdulhealer,stormscale,1982,monk,mistweaver,96,46,50
Trifogeorge,archimonde,1981,monk,mistweaver,60,38,22
Djsnake,blackrock,1981,monk,mistweaver,102,59,43
Pyrìt,blackhand,1980,monk,mistweaver,129,78,51
Hélpx,stormscale,1980,monk,mistweaver,66,35,31
Mickeyworms,archimonde,1980,monk,mistweaver,87,41,46
Groyaboy,twisting-nether,1979,monk,mistweaver,84,58,26
Gronkr,draenor,1979,monk,mistweaver,285,148,137
Batmanwife,stormscale,1976,monk,mistweaver,89,48,41
Фунтос,gordunni,1975,monk,mistweaver,96,60,36
Demmonkz,stormreaver,1975,monk,mistweaver,90,53,37
Fullzi,dalaran,1973,monk,mistweaver,66,36,30
Hamsster,ravencrest,1971,monk,mistweaver,308,166,142
Bigbummer,blackmoore,1971,monk,mistweaver,324,166,158
Wèéman,grim-batol,1970,monk,mistweaver,66,44,22
Klischi,taerar,1970,monk,mistweaver,52,28,24
Jamiedhism,ravencrest,1970,monk,mistweaver,78,41,37
Jackål,silvermoon,1969,monk,mistweaver,109,60,49
Brofistmw,outland,1969,monk,mistweaver,247,133,114
Rolxx,twisting-nether,1969,monk,mistweaver,259,135,124
Goamix,ravencrest,1967,monk,mistweaver,58,33,25
Вульфхильда,soulflayer,1967,monk,mistweaver,288,159,129
Musclemage,turalyon,1965,monk,mistweaver,78,46,32
Nsq,ravencrest,1965,monk,mistweaver,90,48,42
Môûsè,ravencrest,1964,monk,mistweaver,216,117,99
Butterbean,conseil-des-ombres,1963,monk,mistweaver,109,66,43
Jinxini,twisting-nether,1962,monk,mistweaver,42,31,11
Wrathx,draenor,1962,monk,mistweaver,132,85,47
Çheeks,kazzak,1962,monk,mistweaver,72,38,34
Killibrew,ravencrest,1961,monk,mistweaver,138,84,54
Yexìu,kult-der-verdammten,1961,monk,mistweaver,72,41,31
Prototyp,burning-legion,1961,monk,mistweaver,184,96,88
Homes,blackmoore,1959,monk,mistweaver,176,96,80
Fansolini,burning-legion,1959,monk,mistweaver,81,44,37
Chailatte,kazzak,1958,monk,mistweaver,54,36,18
Neyoklol,blackrock,1958,monk,mistweaver,162,95,67
Kapud,twisting-nether,1958,monk,mistweaver,84,47,37
Фунтих,soulflayer,1957,monk,mistweaver,70,39,31
Phyxone,twisting-nether,1956,monk,mistweaver,72,40,32
Pabloboy,kazzak,1955,monk,mistweaver,112,49,63
Yoogychi,ravencrest,1953,monk,mistweaver,42,28,14
Jiest,outland,1952,monk,mistweaver,60,40,20
Lårsÿ,aegwynn,1952,monk,mistweaver,48,31,17
Wh,terenas,1952,monk,mistweaver,48,27,21
Erannas,turalyon,1952,monk,mistweaver,71,38,33
Perceptîon,thrall,1952,monk,mistweaver,174,93,81
Pennyflame,stormscale,1952,monk,mistweaver,149,77,72
Анстапоблх,grom,1951,monk,mistweaver,114,52,62
Jam,aerie-peak,1949,monk,mistweaver,54,35,19
Yuukiiqt,kult-der-verdammten,1949,monk,mistweaver,143,78,65
Manjini,blackhand,1949,monk,mistweaver,147,76,71
Xadez,ravencrest,1948,monk,mistweaver,134,76,58
Magixc,drakthul,1947,monk,mistweaver,158,90,68
Exbuddhist,outland,1947,monk,mistweaver,78,41,37
Srav,archimonde,1946,monk,mistweaver,152,85,67
Digzzy,draenor,1946,monk,mistweaver,140,76,64
Jiafei,tarren-mill,1946,monk,mistweaver,93,45,48
Wwvwwvwwvwwv,ragnaros,1946,monk,mistweaver,102,49,53
Alomonk,archimonde,1945,monk,mistweaver,40,29,11
Tjann,stormscale,1944,monk,mistweaver,138,90,48
Mistyhoe,twisting-nether,1944,monk,mistweaver,312,160,152
Selendis,terrordar,1944,monk,mistweaver,407,208,199
Амаранточка,howling-fjord,1943,monk,mistweaver,120,73,47
Ajay,outland,1942,monk,mistweaver,66,36,30
Aromipesäx,outland,1941,monk,mistweaver,107,57,50
Monkeymain,tarren-mill,1939,monk,mistweaver,136,68,68
Chanzey,silvermoon,1936,monk,mistweaver,342,189,153
Bads,sanguino,1935,monk,mistweaver,96,57,39
Lildaddymonk,ravencrest,1933,monk,mistweaver,89,39,50
Monkeystar,archimonde,1932,monk,mistweaver,161,85,76
Chisurgeon,outland,1931,monk,mistweaver,36,22,14
Incmines,ravencrest,1931,monk,mistweaver,92,50,42
Stemanit,draenor,1930,monk,mistweaver,112,65,47
Podekouil,ysondre,1929,monk,mistweaver,42,28,14
Tidemist,argent-dawn,1929,monk,mistweaver,77,50,27
Lildaddymunk,ravencrest,1928,monk,mistweaver,54,31,23
Trnd,draenor,1928,monk,mistweaver,80,37,43
Vingurd,terokkar,1927,monk,mistweaver,63,35,28
Seventhirty,ravencrest,1927,monk,mistweaver,42,22,20
Fistus,dentarg,1927,monk,mistweaver,74,38,36
Arenatwo,outland,1925,monk,mistweaver,93,56,37
Fistpunk,kazzak,1925,monk,mistweaver,75,40,35
Rokux,kazzak,1923,monk,mistweaver,115,56,59
Hajlong,outland,1922,monk,mistweaver,83,43,40
Machó,kazzak,1922,monk,mistweaver,71,36,35
Podrugabomja,outland,1921,monk,mistweaver,36,22,14
Péppy,aegwynn,1921,monk,mistweaver,64,38,26
Mëñghûøx,sylvanas,1920,monk,mistweaver,43,25,18
Déffly,ravencrest,1920,monk,mistweaver,72,38,34
Mafiazøo,hyjal,1919,monk,mistweaver,154,95,59
Cåpybårå,outland,1919,monk,mistweaver,422,222,200
Swagmonk,silvermoon,1919,monk,mistweaver,170,86,84
Gaalon,ravencrest,1916,monk,mistweaver,24,20,4
Øllen,stormscale,1916,monk,mistweaver,157,79,78
Døk,twisting-nether,1915,monk,mistweaver,54,35,19
Kratzl,blackrock,1915,monk,mistweaver,72,45,27
Æøwyn,ragnaros,1915,monk,mistweaver,178,106,72
Tinydolls,archimonde,1915,monk,mistweaver,42,24,18
Astromune,draenor,1915,monk,mistweaver,93,50,43
Panson,twisting-nether,1915,monk,mistweaver,90,45,45
Tanata,blackmoore,1914,monk,mistweaver,135,86,49
Kóan,stormscale,1914,monk,mistweaver,483,255,228
Brxmonki,antonidas,1912,monk,mistweaver,107,60,47
Porcman,archimonde,1912,monk,mistweaver,207,108,99
Kz,culte-de-la-rive-noire,1911,monk,mistweaver,30,20,10
Yoghurtz,frostmourne,1911,monk,mistweaver,276,148,128
Chijis,blackmoore,1910,monk,mistweaver,36,20,16
Residùe,kazzak,1909,monk,mistweaver,136,74,62
Brewstea,kazzak,1909,monk,mistweaver,156,83,73
Ræïzò,dun-morogh,1905,monk,mistweaver,76,45,31
Pudgefeed,silvermoon,1904,monk,mistweaver,119,69,50
Meemyo,blackmoore,1904,monk,mistweaver,83,34,49
Muchobijca,defias-brotherhood,1903,monk,mistweaver,84,47,37
Notachi,doomhammer,1903,monk,mistweaver,285,159,126
Justacomma,outland,1903,monk,mistweaver,66,33,33
Koguosa,outland,1902,monk,mistweaver,54,37,17
Sikaan,blackhand,1902,monk,mistweaver,54,32,22
Ipmanlol,archimonde,1902,monk,mistweaver,244,139,105
Nêøø,blackrock,1901,monk,mistweaver,367,219,148
Yadokaí,darkmoon-faire,1901,monk,mistweaver,84,47,37
Ilovesanrio,kazzak,1900,monk,mistweaver,110,69,41
Monkeycoke,ragnaros,1900,monk,mistweaver,47,29,18
Zoida,azuremyst,1900,monk,mistweaver,478,242,236
Poyi,ravencrest,1899,monk,mistweaver,36,25,11
ßockwurst,tarren-mill,1899,monk,mistweaver,53,29,24
Monkbtw,kazzak,1898,monk,mistweaver,42,32,10
Subàru,draenor,1898,monk,mistweaver,93,60,33
Alessîca,aegwynn,1898,monk,mistweaver,66,37,29
Halùnkè,eredar,1898,monk,mistweaver,281,153,128
Siignmonk,ravencrest,1898,monk,mistweaver,266,139,127
Ðêzø,stormscale,1897,monk,mistweaver,36,30,6
Фдма,soulflayer,1897,monk,mistweaver,95,52,43
Cítysushi,draenor,1897,monk,mistweaver,477,253,224
Poohya,silvermoon,1897,monk,mistweaver,54,27,27
Fistíe,sylvanas,1896,monk,mistweaver,45,32,13
Munktjejen,argent-dawn,1896,monk,mistweaver,36,20,16
Bekachu,ragnaros,1894,monk,mistweaver,48,34,14
Crñ,blackmoore,1894,monk,mistweaver,56,32,24
Couchfrmikea,twisting-nether,1894,monk,mistweaver,137,66,71
Bossmanfred,outland,1893,monk,mistweaver,96,66,30
Kéza,culte-de-la-rive-noire,1893,monk,mistweaver,40,25,15
Shirkán,ragnaros,1893,monk,mistweaver,168,92,76
Коконгкд,blackscar,1893,monk,mistweaver,532,277,255
Pizelx,alakir,1893,monk,mistweaver,142,72,70
Cptschneider,blackmoore,1892,monk,mistweaver,60,40,20
Lamasauce,ravencrest,1892,monk,mistweaver,30,20,10
Holymonkx,nagrand,1892,monk,mistweaver,117,73,44
Véxyra,draenor,1892,monk,mistweaver,60,36,24
Plânche,outland,1891,monk,mistweaver,72,48,24
Traickomonk,eredar,1891,monk,mistweaver,48,29,19
Shâng,blackhand,1891,monk,mistweaver,96,55,41
Ûnknöw,archimonde,1891,monk,mistweaver,78,44,34
Mistreeker,tarren-mill,1890,monk,mistweaver,48,37,11
Uwû,ravencrest,1890,monk,mistweaver,107,73,34
Waramow,eredar,1890,monk,mistweaver,48,32,16
Onaiâ,ravencrest,1890,monk,mistweaver,90,58,32
Jokkemonk,silvermoon,1890,monk,mistweaver,95,56,39
Luru,outland,1890,monk,mistweaver,89,51,38
Rayofa,garona,1890,monk,mistweaver,126,63,63
Zoruun,quelthalas,1889,monk,mistweaver,30,20,10
Yum,anetheron,1889,monk,mistweaver,126,67,59
Dmonk,aegwynn,1889,monk,mistweaver,226,107,119
Tøwtc,outland,1888,monk,mistweaver,102,64,38
Рендикаое,soulflayer,1888,monk,mistweaver,265,146,119
Zælyqt,archimonde,1887,monk,mistweaver,44,30,14
Babysaurus,ravencrest,1887,monk,mistweaver,120,78,42
Heartless,sporeggar,1885,monk,mistweaver,287,173,114
Pikemi,dun-modr,1883,monk,mistweaver,138,86,52
Muerb,die-arguswacht,1883,monk,mistweaver,57,35,22
Tedelbrew,kazzak,1883,monk,mistweaver,36,20,16
Jemp,ravencrest,1883,monk,mistweaver,604,333,271
Schøcker,blackmoore,1881,monk,mistweaver,77,42,35
Ønlyfäns,kazzak,1880,monk,mistweaver,130,78,52
Репабликус,gordunni,1880,monk,mistweaver,48,27,21
Cocacolazeró,draenor,1880,monk,mistweaver,42,20,22
Нопеурорсогп,soulflayer,1879,monk,mistweaver,60,35,25
Manatoiled,draenor,1879,monk,mistweaver,72,39,33
Эифорйя,howling-fjord,1879,monk,mistweaver,306,156,150
Vizfist,tarren-mill,1879,monk,mistweaver,60,29,31
Fredmonk,stormscale,1878,monk,mistweaver,78,43,35
Людзяо,galakrond,1878,monk,mistweaver,170,92,78
Babbub,tarren-mill,1877,monk,mistweaver,156,91,65
Atralês,azshara,1877,monk,mistweaver,111,64,47
Iliketofist,ravencrest,1877,monk,mistweaver,88,50,38
Jingfeng,arthas,1877,monk,mistweaver,212,110,102
Yungsooth,stormscale,1876,monk,mistweaver,107,68,39
Enoffovicz,archimonde,1876,monk,mistweaver,156,94,62
Voltzeig,dentarg,1876,monk,mistweaver,408,209,199
Nåwãk,archimonde,1875,monk,mistweaver,145,71,74
Holyropx,aegwynn,1874,monk,mistweaver,54,33,21
Tøxicweaver,kazzak,1873,monk,mistweaver,36,21,15
Mistyfox,aszune,1873,monk,mistweaver,119,59,60
Yamqt,thrall,1871,monk,mistweaver,63,39,24
Mugn,sanguino,1871,monk,mistweaver,50,30,20
Taeyhung,thrall,1870,monk,mistweaver,165,94,71
Pamtu,dun-modr,1869,monk,mistweaver,114,74,40
Минимонахх,blackscar,1869,monk,mistweaver,90,58,32
Karmasnitch,antonidas,1869,monk,mistweaver,114,64,50
Onlyfunds,blackrock,1868,monk,mistweaver,36,27,9
Fisterinos,blackrock,1868,monk,mistweaver,192,123,69
Ryx,twisting-nether,1868,monk,mistweaver,151,78,73
Qwértsy,stormscale,1867,monk,mistweaver,119,75,44
Crymonkya,aegwynn,1867,monk,mistweaver,256,150,106
Carlteaz,drakthul,1867,monk,mistweaver,198,114,84
Dr,sylvanas,1867,monk,mistweaver,60,34,26
Oikodomos,twisting-nether,1867,monk,mistweaver,142,79,63
Siphem,ravencrest,1867,monk,mistweaver,369,195,174
Séi,kazzak,1867,monk,mistweaver,48,25,23
Soulring,kazzak,1867,monk,mistweaver,75,38,37
Kungfublyat,twisting-nether,1865,monk,mistweaver,83,57,26
Флориусс,soulflayer,1865,monk,mistweaver,71,37,34
Hurricaine,hyjal,1864,monk,mistweaver,36,23,13
Факингдог,blackscar,1864,monk,mistweaver,45,26,19
Nuke,steamwheedle-cartel,1864,monk,mistweaver,98,48,50
Jabington,aegwynn,1863,monk,mistweaver,145,86,59
Patiencebro,archimonde,1863,monk,mistweaver,84,48,36
Wrox,sylvanas,1863,monk,mistweaver,220,125,95
Neyoklan,blackrock,1863,monk,mistweaver,132,73,59
Cptsensey,draenor,1861,monk,mistweaver,42,29,13
Zengrok,blackrock,1860,monk,mistweaver,48,33,15
Лемонк,gordunni,1860,monk,mistweaver,82,40,42
Ранки,lich-king,1860,monk,mistweaver,66,31,35
Wåñmëíßãøx,sylvanas,1859,monk,mistweaver,58,34,24
Nule,outland,1859,monk,mistweaver,59,31,28
Jayber,laughing-skull,1858,monk,mistweaver,84,57,27
Джулибубба,borean-tundra,1858,monk,mistweaver,105,67,38
Cæsifer,ungoro,1858,monk,mistweaver,59,33,26
Rullsimpa,ravencrest,1858,monk,mistweaver,83,37,46
Deeyna,defias-brotherhood,1857,monk,mistweaver,137,74,63
Dragzol,tarren-mill,1856,monk,mistweaver,162,81,81
Powerloom,aegwynn,1855,monk,mistweaver,66,47,19
Capkum,dun-modr,1855,monk,mistweaver,218,113,105
Crôcøpx,blackhand,1855,monk,mistweaver,78,39,39
Løta,blackmoore,1854,monk,mistweaver,101,64,37
Лиянь,soulflayer,1854,monk,mistweaver,126,73,53
Päws,kazzak,1854,monk,mistweaver,65,37,28
Flowey,uldum,1854,monk,mistweaver,48,21,27
Táy,ravencrest,1852,monk,mistweaver,114,68,46
Doffm,auchindoun,1851,monk,mistweaver,125,74,51
Playbîrd,archimonde,1851,monk,mistweaver,112,61,51
Crazyninja,arathor,1850,monk,mistweaver,102,60,42
Itwillbenice,archimonde,1849,monk,mistweaver,48,33,15
Мичан,howling-fjord,1849,monk,mistweaver,146,88,58
Grauwe,stormscale,1848,monk,mistweaver,63,39,24
Vöyage,kazzak,1848,monk,mistweaver,48,26,22
Schizacademy,draenor,1846,monk,mistweaver,91,51,40
Madraven,ravencrest,1846,monk,mistweaver,66,28,38
Tasteh,cthun,1844,monk,mistweaver,67,43,24
Zxcursèd,tarren-mill,1844,monk,mistweaver,60,36,24
Cdriscas,aggra-português,1844,monk,mistweaver,178,97,81
Hidekami,archimonde,1844,monk,mistweaver,192,97,95
Neisha,drakthul,1843,monk,mistweaver,108,66,42
Enveløp,stormscale,1842,monk,mistweaver,42,29,13
Chazu,outland,1842,monk,mistweaver,78,41,37
Thiiogg,archimonde,1842,monk,mistweaver,113,57,56
Zöumi,ravencrest,1841,monk,mistweaver,314,168,146
Peace,aerie-peak,1840,monk,mistweaver,47,33,14
Stdzym,tarren-mill,1840,monk,mistweaver,146,71,75
Bicmex,archimonde,1840,monk,mistweaver,120,57,63
Panicfist,stormscale,1839,monk,mistweaver,141,88,53
Legsweep,blackhand,1839,monk,mistweaver,187,115,72
Monkler,blackhand,1839,monk,mistweaver,114,57,57
Pøhx,ragnaros,1838,monk,mistweaver,132,74,58
Motang,blackmoore,1837,monk,mistweaver,68,38,30
Mwmonk,blackrock,1836,monk,mistweaver,65,42,23
Mommymonk,outland,1836,monk,mistweaver,103,57,46
Hurri,krasus,1835,monk,mistweaver,48,32,16
Bonnybravo,wildhammer,1834,monk,mistweaver,54,36,18
Ultdave,eredar,1834,monk,mistweaver,251,142,109
Yäffa,archimonde,1834,monk,mistweaver,156,87,69
Бадика,howling-fjord,1834,monk,mistweaver,343,183,160
Extrimist,sylvanas,1834,monk,mistweaver,358,190,168
Bmwmthree,draenor,1832,monk,mistweaver,165,84,81
Mikalou,sylvanas,1831,monk,mistweaver,34,25,9
Dojoman,draenor,1830,monk,mistweaver,48,35,13
Tmnmnk,alakir,1830,monk,mistweaver,29,20,9
Annoyingtwo,archimonde,1830,monk,mistweaver,90,56,34
Exru,draenor,1830,monk,mistweaver,45,26,19
Otemøøn,sanguino,1830,monk,mistweaver,87,48,39
Dmonkz,magtheridon,1829,monk,mistweaver,144,75,69
Кикподхвост,blackscar,1829,monk,mistweaver,102,52,50
Santoron,baelgun,1829,monk,mistweaver,75,36,39
Callysra,archimonde,1828,monk,mistweaver,58,40,18
Мефодийкун,howling-fjord,1828,monk,mistweaver,165,92,73
Xameht,the-maelstrom,1828,monk,mistweaver,301,163,138
Нубстриимс,gordunni,1828,monk,mistweaver,62,33,29
Саас,gordunni,1828,monk,mistweaver,107,56,51
Mêshuggâh,malganis,1828,monk,mistweaver,102,52,50
Kuug,ravencrest,1827,monk,mistweaver,107,65,42
Nouraxo,kazzak,1827,monk,mistweaver,286,152,134
Wrv,kazzak,1827,monk,mistweaver,409,213,196
Sonydl,archimonde,1827,monk,mistweaver,118,57,61
Soothz,uldaman,1824,monk,mistweaver,60,42,18
Scribzw,twisting-nether,1824,monk,mistweaver,77,43,34
Calmed,tarren-mill,1824,monk,mistweaver,295,163,132
Kareek,sylvanas,1824,monk,mistweaver,78,43,35
Элонхаск,gordunni,1824,monk,mistweaver,54,29,25
Sprutleif,auchindoun,1823,monk,mistweaver,112,77,35
Maesha,ahnqiraj,1823,monk,mistweaver,90,57,33
Infamøus,uldum,1823,monk,mistweaver,62,38,24
Campix,blackmoore,1823,monk,mistweaver,153,92,61
Fulgrem,stormscale,1823,monk,mistweaver,135,81,54
Dokternelg,silvermoon,1823,monk,mistweaver,54,32,22
Sugra,frostwolf,1823,monk,mistweaver,87,50,37
Actionsusi,area-52,1823,monk,mistweaver,54,31,23
Perelman,burning-legion,1823,monk,mistweaver,138,75,63
Cochonhalall,archimonde,1823,monk,mistweaver,102,53,49
Nèver,dalaran,1822,monk,mistweaver,48,29,19
Raveleth,silvermoon,1822,monk,mistweaver,90,53,37
Sadmw,archimonde,1822,monk,mistweaver,54,28,26
Teampro,ragnaros,1822,monk,mistweaver,371,189,182
Jongxina,ravencrest,1822,monk,mistweaver,73,34,39
Speedwalker,defias-brotherhood,1821,monk,mistweaver,24,19,5
Aessella,antonidas,1821,monk,mistweaver,48,29,19
Çhên,draenor,1821,monk,mistweaver,173,104,69
Шенген,soulflayer,1821,monk,mistweaver,198,108,90
Shehulkk,ravencrest,1821,monk,mistweaver,90,48,42
Libertrixm,defias-brotherhood,1820,monk,mistweaver,36,24,12
Räpeltäjä,stormreaver,1820,monk,mistweaver,114,69,45
Jiuhjitsu,blackmoore,1820,monk,mistweaver,60,34,26
Nqar,ravencrest,1820,monk,mistweaver,84,47,37
Zlodey,laughing-skull,1820,monk,mistweaver,127,70,57
Almonkdiga,sanguino,1819,monk,mistweaver,108,58,50
Sushirøll,draenor,1818,monk,mistweaver,73,47,26
Hokespokus,silvermoon,1818,monk,mistweaver,106,68,38
Камикадзэн,gordunni,1818,monk,mistweaver,156,100,56
Слишкомхорош,howling-fjord,1818,monk,mistweaver,30,19,11
Шэганэ,deathguard,1818,monk,mistweaver,74,45,29
Birgitbuddha,gorgonnash,1818,monk,mistweaver,90,53,37
Elamø,sanguino,1818,monk,mistweaver,131,77,54
Типмах,howling-fjord,1818,monk,mistweaver,92,54,38
Shushux,ysondre,1818,monk,mistweaver,36,21,15
Belärus,outland,1818,monk,mistweaver,78,44,34
Ariliaxo,blackhand,1817,monk,mistweaver,60,40,20
Natsuø,nemesis,1817,monk,mistweaver,78,46,32
Флориус,soulflayer,1817,monk,mistweaver,65,36,29
Claudiå,kazzak,1817,monk,mistweaver,111,56,55
Аци,blackscar,1816,monk,mistweaver,88,57,31
Endir,mazrigos,1816,monk,mistweaver,161,101,60
Палерм,gordunni,1816,monk,mistweaver,103,64,39
Menecares,blackhand,1816,monk,mistweaver,41,24,17
Precocconx,stormreaver,1816,monk,mistweaver,36,19,17
Твикса,soulflayer,1816,monk,mistweaver,114,54,60
Xarêlla,aegwynn,1815,monk,mistweaver,132,68,64
Papimonkx,garona,1815,monk,mistweaver,54,25,29
Mwaneu,archimonde,1814,monk,mistweaver,66,40,26
Devivify,twilights-hammer,1814,monk,mistweaver,162,96,66
Zulein,defias-brotherhood,1814,monk,mistweaver,36,21,15
Jolude,nemesis,1814,monk,mistweaver,212,115,97
Тамаз,gordunni,1814,monk,mistweaver,59,24,35
Mgp,the-maelstrom,1813,monk,mistweaver,156,90,66
Millhouse,die-aldor,1813,monk,mistweaver,128,69,59
Swaghäuser,blackmoore,1813,monk,mistweaver,338,179,159
Oukaläv,archimonde,1813,monk,mistweaver,113,59,54
Колтиняшка,blackscar,1812,monk,mistweaver,77,59,18
Seandyche,ravencrest,1812,monk,mistweaver,40,26,14
Inear,chogall,1812,monk,mistweaver,397,211,186
Kæmará,blackrock,1812,monk,mistweaver,98,52,46
Moariann,drakthul,1812,monk,mistweaver,150,75,75
Greentape,kiljaeden,1811,monk,mistweaver,54,35,19
Vxs,blackhand,1811,monk,mistweaver,72,45,27
Mônkykong,ravencrest,1811,monk,mistweaver,42,26,16
Sugermum,outland,1811,monk,mistweaver,60,34,26
Nrafflig,draenor,1810,monk,mistweaver,66,45,21
Errowin,blackmoore,1810,monk,mistweaver,153,93,60
Leiwill,stormreaver,1810,monk,mistweaver,100,59,41
Xoconut,kazzak,1810,monk,mistweaver,292,160,132
Shyheimyo,outland,1810,monk,mistweaver,54,27,27
Jades,emeriss,1810,monk,mistweaver,298,147,151
Оргриммен,soulflayer,1810,monk,mistweaver,173,85,88
Blantai,tarren-mill,1810,monk,mistweaver,114,54,60
Dewamønk,blackmoore,1809,monk,mistweaver,97,56,41
Ana,eredar,1809,monk,mistweaver,54,30,24
Fìstpwnjk,forscherliga,1808,monk,mistweaver,145,93,52
Päjcsi,ragnaros,1808,monk,mistweaver,60,35,25
Darlaa,ravencrest,1807,monk,mistweaver,71,42,29
Jpstwo,gorgonnash,1807,monk,mistweaver,114,67,47
Brysiqtx,aegwynn,1807,monk,mistweaver,87,45,42
Baatu,frostmane,1807,monk,mistweaver,317,159,158
Kamene,kazzak,1806,monk,mistweaver,119,88,31
Kyukoku,blackmoore,1806,monk,mistweaver,46,30,16
Дольчих,soulflayer,1806,monk,mistweaver,243,148,95
Фешнмонк,soulflayer,1806,monk,mistweaver,149,88,61
Lukeybabyy,defias-brotherhood,1806,monk,mistweaver,250,142,108
Temhota,perenolde,1806,monk,mistweaver,140,76,64
Kîrânâ,eredar,1806,monk,mistweaver,54,29,25
Rokou,blackmoore,1805,monk,mistweaver,98,58,40
Axelight,chants-éternels,1805,monk,mistweaver,54,31,23
Тащунаскилле,thermaplugg,1805,monk,mistweaver,86,48,38
Redneckfist,draenor,1804,monk,mistweaver,100,66,34
Ninetz,tarren-mill,1804,monk,mistweaver,51,31,20
Adis,nerathor,1804,monk,mistweaver,89,53,36
Rhatid,twisting-nether,1804,monk,mistweaver,377,200,177
Yto,gorgonnash,1804,monk,mistweaver,54,26,28
Uckkm,ragnaros,1803,monk,mistweaver,65,39,26
Yulonian,argent-dawn,1803,monk,mistweaver,206,123,83
Handarbetare,ravencrest,1803,monk,mistweaver,147,78,69
Monkgolitaxd,dun-modr,1803,monk,mistweaver,866,447,419
Sleepleaf,silvermoon,1803,monk,mistweaver,159,78,81
Vanicweaver,aegwynn,1802,monk,mistweaver,36,26,10
Syvimw,outland,1802,monk,mistweaver,65,43,22
Кроанла,howling-fjord,1802,monk,mistweaver,54,34,20
Xurf,draenor,1802,monk,mistweaver,184,108,76
Pogimonkey,ragnaros,1802,monk,mistweaver,120,64,56
Djpunchable,blackrock,1801,monk,mistweaver,50,38,12
Papours,ysondre,1801,monk,mistweaver,54,37,17
Zekm,alleria,1801,monk,mistweaver,132,83,49
Heramonk,dun-modr,1801,monk,mistweaver,58,30,28
Гачитварина,galakrond,1800,monk,mistweaver,114,72,42
Òó,vashj,1800,monk,mistweaver,195,111,84
Trollroll,defias-brotherhood,1800,monk,mistweaver,138,76,62
Репаблликуес,gordunni,1800,monk,mistweaver,52,28,24
Rogvi,argent-dawn,1800,monk,mistweaver,269,136,133
Evad,kazzak,1799,monk,mistweaver,124,74,50
Ричфлекс,howling-fjord,1799,monk,mistweaver,380,219,161
Wiwâ,outland,1798,monk,mistweaver,139,73,66
Mobrac,twisting-nether,1797,monk,mistweaver,80,39,41
Sukmadika,twisting-nether,1795,monk,mistweaver,58,34,24
Monkwithlove,blackhand,1795,monk,mistweaver,316,166,150
Барлиос,soulflayer,1794,monk,mistweaver,553,287,266
Limbaskalol,dun-modr,1794,monk,mistweaver,707,355,352
Gôky,stormscale,1792,monk,mistweaver,89,56,33
Behrens,defias-brotherhood,1791,monk,mistweaver,57,33,24
Bammemw,archimonde,1791,monk,mistweaver,60,27,33
Bearmw,draenor,1789,monk,mistweaver,71,44,27
Orcimon,draenor,1789,monk,mistweaver,42,24,18
Shishasho,stormreaver,1788,monk,mistweaver,125,66,59
Fersokä,dun-modr,1788,monk,mistweaver,48,22,26
Binkote,zuljin,1787,monk,mistweaver,292,165,127
Sosyc,malganis,1787,monk,mistweaver,71,36,35
Jorahmarmond,tarren-mill,1786,monk,mistweaver,48,35,13
Eshli,ahnqiraj,1786,monk,mistweaver,43,25,18
Сазуко,gordunni,1786,monk,mistweaver,306,156,150
Kaezm,blackrock,1785,monk,mistweaver,48,28,20
Callmeks,stormscale,1785,monk,mistweaver,234,124,110
Savagex,sanguino,1784,monk,mistweaver,100,51,49
Shortinlegs,silvermoon,1783,monk,mistweaver,84,44,40
Ashenore,outland,1783,monk,mistweaver,108,55,53
Sinnermonkk,outland,1782,monk,mistweaver,42,27,15
Monkiz,veknilash,1782,monk,mistweaver,59,35,24
Destom,archimonde,1782,monk,mistweaver,194,101,93
Gømbøz,tarren-mill,1781,monk,mistweaver,166,96,70
Nabsi,aegwynn,1780,monk,mistweaver,90,50,40
Frónzy,kazzak,1779,monk,mistweaver,282,158,124
Amzu,kazzak,1779,monk,mistweaver,84,44,40
Eradasmw,kazzak,1777,monk,mistweaver,36,22,14
Clemoine,archimonde,1777,monk,mistweaver,60,34,26
Eedaza,blackrock,1776,monk,mistweaver,205,123,82
Esriin,shattered-hand,1776,monk,mistweaver,66,38,28
Monknice,sylvanas,1776,monk,mistweaver,83,42,41
Shiftkin,stormscale,1776,monk,mistweaver,102,48,54
Kickin,burning-legion,1775,monk,mistweaver,82,48,34
Kungfupanda,stormscale,1775,monk,mistweaver,122,68,54
Flãay,ravencrest,1774,monk,mistweaver,30,19,11
Bluran,dalaran,1774,monk,mistweaver,111,60,51
Тсайм,howling-fjord,1774,monk,mistweaver,100,52,48
Threesíxníne,dun-morogh,1774,monk,mistweaver,162,83,79
Dihsa,ragnaros,1773,monk,mistweaver,30,23,7
Xeratino,ragnaros,1773,monk,mistweaver,107,64,43
Cøcøøn,blackrock,1773,monk,mistweaver,152,82,70
Inuria,ravencrest,1772,monk,mistweaver,153,89,64
Srchi,aggra-português,1772,monk,mistweaver,103,52,51
Mwrbg,shadowsong,1770,monk,mistweaver,137,77,60
Ignygodx,ragnaros,1770,monk,mistweaver,88,48,40
Fckisrael,archimonde,1770,monk,mistweaver,48,23,25
Foaqer,aegwynn,1769,monk,mistweaver,40,26,14
Akuuji,silvermoon,1768,monk,mistweaver,48,22,26
Djalexmw,kazzak,1767,monk,mistweaver,36,24,12
Sîono,antonidas,1766,monk,mistweaver,81,50,31
Xiâomèi,dun-modr,1766,monk,mistweaver,240,132,108
Shurdax,silvermoon,1766,monk,mistweaver,102,54,48
Olgachocolat,blackmoore,1765,monk,mistweaver,156,108,48
Mistur,blackrock,1765,monk,mistweaver,88,49,39
Jînex,shattrath,1763,monk,mistweaver,31,20,11
Onlyfunn,sanguino,1762,monk,mistweaver,133,74,59
Varea,blackrock,1762,monk,mistweaver,131,70,61
Brewnox,ragnaros,1762,monk,mistweaver,65,31,34
Maikez,stormreaver,1762,monk,mistweaver,100,47,53
Dodomino,archimonde,1761,monk,mistweaver,41,24,17
Izuwumi,ragnaros,1761,monk,mistweaver,48,27,21
Notfist,kazzak,1760,monk,mistweaver,90,64,26
Ahyllesmonk,azjolnerub,1759,monk,mistweaver,41,32,9
Kackwalker,blackmoore,1759,monk,mistweaver,40,29,11
Sícknéss,aegwynn,1759,monk,mistweaver,42,26,16
Rashakura,blackrock,1759,monk,mistweaver,83,50,33
Riendy,silvermoon,1759,monk,mistweaver,302,167,135
Idrdob,kazzak,1759,monk,mistweaver,447,239,208
Stonkss,ragnaros,1759,monk,mistweaver,237,116,121
Tavqtwo,tarren-mill,1759,monk,mistweaver,48,20,28
Blackphil,terenas,1758,monk,mistweaver,114,69,45
Jainagodxd,dun-modr,1758,monk,mistweaver,78,44,34
Soundzw,antonidas,1758,monk,mistweaver,90,48,42
Smitheal,outland,1757,monk,mistweaver,108,76,32
Bigmckoy,kazzak,1757,monk,mistweaver,39,27,12
Rascah,archimonde,1757,monk,mistweaver,166,89,77
Inlakech,auchindoun,1757,monk,mistweaver,225,110,115
Gréèñðrägôñ,stormscale,1756,monk,mistweaver,36,26,10
Wwception,blackrock,1756,monk,mistweaver,56,33,23
Harislkwamk,aegwynn,1756,monk,mistweaver,266,152,114
Konnîchîwa,kazzak,1756,monk,mistweaver,215,117,98
Yukimøn,hyjal,1755,monk,mistweaver,115,79,36
Diffenbachia,outland,1755,monk,mistweaver,140,89,51
Aseidith,tarren-mill,1755,monk,mistweaver,54,32,22
Cykatea,dun-modr,1755,monk,mistweaver,1381,707,674
Sniffn,ravencrest,1754,monk,mistweaver,54,35,19
Фучой,howling-fjord,1754,monk,mistweaver,87,51,36
Эрмонд,soulflayer,1754,monk,mistweaver,91,49,42
Kwondo,archimonde,1754,monk,mistweaver,66,35,31
Aryaz,ravencrest,1753,monk,mistweaver,117,67,50
Flãô,draenor,1753,monk,mistweaver,35,19,16
Merína,ragnaros,1753,monk,mistweaver,272,143,129
Januslapuce,culte-de-la-rive-noire,1752,monk,mistweaver,35,19,16
Йуппи,galakrond,1752,monk,mistweaver,48,26,22
Mâki,ravencrest,1752,monk,mistweaver,48,24,24
Sitekm,burning-legion,1750,monk,mistweaver,89,61,28
Polch,archimonde,1750,monk,mistweaver,96,44,52
Orfantal,ravencrest,1749,monk,mistweaver,128,77,51
Garcon,tarren-mill,1749,monk,mistweaver,189,105,84
Ainamw,ravencrest,1749,monk,mistweaver,38,21,17
Callim,blackrock,1748,monk,mistweaver,30,19,11
Blamethegame,hyjal,1748,monk,mistweaver,71,39,32
Chünlii,dun-modr,1748,monk,mistweaver,150,77,73
Glaphan,the-maelstrom,1747,monk,mistweaver,46,29,17
Tygertyger,silvermoon,1747,monk,mistweaver,48,25,23
Фонтамас,howling-fjord,1747,monk,mistweaver,48,25,23
Hôn,sanguino,1746,monk,mistweaver,53,36,17
Piedliés,ravencrest,1746,monk,mistweaver,160,75,85
Imeon,dun-modr,1744,monk,mistweaver,54,31,23
Neash,silvermoon,1744,monk,mistweaver,90,51,39
Craneovic,kult-der-verdammten,1744,monk,mistweaver,60,26,34
Gingerbrew,hyjal,1743,monk,mistweaver,39,26,13
Mcscrub,ragnaros,1743,monk,mistweaver,77,44,33
Bonbón,scarshield-legion,1743,monk,mistweaver,102,56,46
Milkhy,minahonda,1743,monk,mistweaver,233,118,115
Shouldbeokai,ravencrest,1742,monk,mistweaver,30,23,7
Teahihi,ravencrest,1742,monk,mistweaver,36,27,9
Xadoqt,aegwynn,1742,monk,mistweaver,35,24,11
Xado,aegwynn,1742,monk,mistweaver,48,32,16
Tallein,drakthul,1742,monk,mistweaver,204,116,88
Sigourney,ravencrest,1741,monk,mistweaver,72,42,30
Steveé,kazzak,1740,monk,mistweaver,47,33,14
Monkatapiti,malganis,1740,monk,mistweaver,66,41,25
Ультрадевка,blackscar,1740,monk,mistweaver,82,43,39
Cerrya,silvermoon,1740,monk,mistweaver,72,33,39
Frednmonk,twisting-nether,1738,monk,mistweaver,84,48,36
Lurklee,blackhand,1738,monk,mistweaver,70,38,32
Ofwgkta,moonglade,1738,monk,mistweaver,54,28,26
Fisterin,eredar,1737,monk,mistweaver,90,44,46
Donkeymønk,hyjal,1736,monk,mistweaver,367,195,172
Tîptâp,blackrock,1735,monk,mistweaver,33,23,10
Snookzlol,aegwynn,1735,monk,mistweaver,89,56,33
Seava,kazzak,1734,monk,mistweaver,90,55,35
Modequillo,blackmoore,1734,monk,mistweaver,127,65,62
Táuriéll,eredar,1734,monk,mistweaver,42,21,21
Mistchorus,argent-dawn,1733,monk,mistweaver,42,27,15
Rivasstv,grim-batol,1733,monk,mistweaver,49,31,18
Stifmeister,tarren-mill,1732,monk,mistweaver,153,80,73
Meoox,outland,1731,monk,mistweaver,87,51,36
Nognegodx,ravencrest,1731,monk,mistweaver,174,78,96
Papermakerx,blackrock,1730,monk,mistweaver,108,63,45
Deliveroo,twisting-nether,1729,monk,mistweaver,39,22,17
Ellimak,archimonde,1729,monk,mistweaver,64,36,28
Wørsthealxd,alakir,1728,monk,mistweaver,88,59,29
Fatdad,magtheridon,1728,monk,mistweaver,107,52,55
Monkiszonz,burning-legion,1727,monk,mistweaver,60,33,27
Súzy,stormscale,1727,monk,mistweaver,124,67,57
Myfresh,ysondre,1727,monk,mistweaver,121,65,56
Plaguer,nordrassil,1726,monk,mistweaver,104,64,40
Ziibaa,outland,1726,monk,mistweaver,81,48,33
Tû,nerathor,1726,monk,mistweaver,133,78,55
Dundermonken,silvermoon,1726,monk,mistweaver,48,28,20
Shiguru,dun-morogh,1726,monk,mistweaver,263,152,111
Taekwonroll,stormscale,1726,monk,mistweaver,48,25,23
Apolskis,ravencrest,1725,monk,mistweaver,66,46,20
Skailzkrt,hyjal,1725,monk,mistweaver,89,43,46
Zagar,emeriss,1725,monk,mistweaver,54,26,28
Bonk,defias-brotherhood,1725,monk,mistweaver,59,27,32
Таеуеоп,soulflayer,1724,monk,mistweaver,18,18,0
Théverre,uldaman,1724,monk,mistweaver,195,121,74
Notadrâgon,sylvanas,1724,monk,mistweaver,49,27,22
Olympiiee,archimonde,1721,monk,mistweaver,311,166,145
Zintsu,khaz-modan,1720,monk,mistweaver,64,37,27
Rsk,antonidas,1720,monk,mistweaver,82,47,35
Taylorghost,ravencrest,1720,monk,mistweaver,179,97,82
Nillebpgodx,kazzak,1720,monk,mistweaver,77,35,42
Hoschirama,antonidas,1719,monk,mistweaver,45,29,16
Assaalaria,argent-dawn,1719,monk,mistweaver,492,271,221
Cîanurø,zuljin,1719,monk,mistweaver,117,64,53
Simpavev,ravencrest,1719,monk,mistweaver,52,27,25
Risesx,blackmoore,1719,monk,mistweaver,103,53,50
Demakis,stormscale,1718,monk,mistweaver,161,99,62
Bidzi,kazzak,1718,monk,mistweaver,42,25,17
Chimara,kazzak,1718,monk,mistweaver,79,45,34
Nirexi,blackrock,1718,monk,mistweaver,99,55,44
Encanthar,blackhand,1718,monk,mistweaver,309,161,148
Boomxd,twisting-nether,1717,monk,mistweaver,67,41,26
Radamonk,drakthul,1717,monk,mistweaver,83,48,35
Çz,tarren-mill,1717,monk,mistweaver,86,48,38
Místborn,ravencrest,1716,monk,mistweaver,30,18,12
Calli,auchindoun,1716,monk,mistweaver,148,77,71
Финуправ,soulflayer,1715,monk,mistweaver,54,35,19
Эйдриса,howling-fjord,1715,monk,mistweaver,54,29,25
Kilograme,tarren-mill,1715,monk,mistweaver,95,47,48
Wisear,silvermoon,1715,monk,mistweaver,65,31,34
Galã,elune,1714,monk,mistweaver,228,124,104
Youssee,silvermoon,1714,monk,mistweaver,321,173,148
Effeots,blackrock,1714,monk,mistweaver,373,186,187
ßojo,kazzak,1713,monk,mistweaver,113,70,43
Deusfist,ravencrest,1713,monk,mistweaver,72,37,35
Tetetete,silvermoon,1712,monk,mistweaver,227,128,99
Albakauz,shattered-hand,1712,monk,mistweaver,36,18,18
Caipha,ravencrest,1711,monk,mistweaver,66,41,25
Atoóthéé,the-maelstrom,1711,monk,mistweaver,31,19,12
Tráïner,madmortem,1711,monk,mistweaver,287,143,144
Ilikeducks,ravencrest,1710,monk,mistweaver,241,142,99
Tríxìe,stormscale,1710,monk,mistweaver,146,80,66
Ashjaxa,silvermoon,1710,monk,mistweaver,42,18,24
Miînd,archimonde,1709,monk,mistweaver,132,80,52
Avizionqt,anachronos,1709,monk,mistweaver,103,62,41
Ultrasense,outland,1709,monk,mistweaver,30,18,12
Aklimist,stormscale,1709,monk,mistweaver,90,51,39
Tolachi,blackhand,1709,monk,mistweaver,45,22,23
Lyfah,archimonde,1708,monk,mistweaver,108,63,45
Pikachi,ysondre,1707,monk,mistweaver,36,22,14
Bigdaddypump,blackmoore,1707,monk,mistweaver,42,25,17
Zorkev,dun-modr,1707,monk,mistweaver,125,71,54
Quinnkesh,draenor,1706,monk,mistweaver,33,25,8
Farmander,silvermoon,1706,monk,mistweaver,293,172,121
Авентусс,howling-fjord,1706,monk,mistweaver,222,124,98
Cubw,archimonde,1706,monk,mistweaver,54,29,25
Mugotea,twisting-nether,1706,monk,mistweaver,220,112,108
Shyheim,outland,1705,monk,mistweaver,48,36,12
Saneshayne,ravencrest,1705,monk,mistweaver,35,21,14
Bruceliam,emerald-dream,1705,monk,mistweaver,102,60,42
Ulns,blackrock,1705,monk,mistweaver,114,58,56
ßsøßxx,hyjal,1704,monk,mistweaver,24,18,6
Öhlinmonk,outland,1704,monk,mistweaver,42,24,18
Kebabrolle,blackrock,1704,monk,mistweaver,42,21,21
Loddarita,ravencrest,1703,monk,mistweaver,84,60,24
Deniise,kult-der-verdammten,1703,monk,mistweaver,108,66,42
Caliban,defias-brotherhood,1703,monk,mistweaver,39,23,16
Фапдао,howling-fjord,1703,monk,mistweaver,302,161,141
Moontríx,kazzak,1703,monk,mistweaver,114,53,61
Nerdmonkx,tarren-mill,1702,monk,mistweaver,88,53,35
Даопецдын,howling-fjord,1702,monk,mistweaver,80,46,34
Teamviewer,blackmoore,1702,monk,mistweaver,125,66,59
Simòna,dun-modr,1702,monk,mistweaver,946,481,465
Hollymêdx,blackmoore,1701,monk,mistweaver,109,66,43
Mîstxd,kazzak,1701,monk,mistweaver,71,40,31
Samaja,aegwynn,1701,monk,mistweaver,36,19,17
Scribz,twisting-nether,1701,monk,mistweaver,36,18,18
Yörg,eredar,1700,monk,mistweaver,87,53,34
Proxxyqt,blackrock,1700,monk,mistweaver,120,73,47
Shigong,hellscream,1700,monk,mistweaver,66,36,30
Bananatux,tarren-mill,1699,monk,mistweaver,32,20,12
Mòñkêÿgøðx,outland,1699,monk,mistweaver,77,48,29
Shyrea,nazjatar,1699,monk,mistweaver,30,18,12
Ouaipäül,archimonde,1698,monk,mistweaver,54,31,23
Rullefald,stormscale,1697,monk,mistweaver,102,57,45
Zenmaster,grim-batol,1697,monk,mistweaver,91,42,49
Indris,dun-modr,1697,monk,mistweaver,53,24,29
Sweatymonkey,ravencrest,1696,monk,mistweaver,78,44,34
Coularx,stormscale,1696,monk,mistweaver,90,47,43
Selici,defias-brotherhood,1694,monk,mistweaver,174,99,75
Dicedkiwi,quelthalas,1694,monk,mistweaver,682,360,322
Slugerpigen,stormscale,1693,monk,mistweaver,464,255,209
Träskolasse,tarren-mill,1693,monk,mistweaver,56,29,27
Yapouw,garona,1693,monk,mistweaver,97,48,49
Pitrols,twisting-nether,1692,monk,mistweaver,237,134,103
Healingchan,outland,1691,monk,mistweaver,181,110,71
Smoothia,outland,1691,monk,mistweaver,199,114,85
Trónìq,outland,1690,monk,mistweaver,42,28,14
Neehl,aegwynn,1690,monk,mistweaver,41,24,17
Dearmw,silvermoon,1690,monk,mistweaver,138,76,62
Lünara,ambossar,1690,monk,mistweaver,108,57,51
Viggex,outland,1690,monk,mistweaver,42,18,24
Тоталиспайс,lich-king,1689,monk,mistweaver,131,78,53
Key,stormreaver,1689,monk,mistweaver,112,62,50
Doll,stormscale,1689,monk,mistweaver,36,18,18
Sinthorasas,blackrock,1688,monk,mistweaver,178,101,77
Mistïnguette,dalaran,1688,monk,mistweaver,406,222,184
Irêfutabil,sylvanas,1688,monk,mistweaver,63,34,29
Caniluvz,eredar,1687,monk,mistweaver,60,39,21
Minichi,aegwynn,1687,monk,mistweaver,62,35,27
Jûzô,illidan,1687,monk,mistweaver,42,23,19
Clydemonk,outland,1686,monk,mistweaver,24,18,6
Ness,hyjal,1686,monk,mistweaver,42,24,18
Kukn,twisting-nether,1686,monk,mistweaver,87,44,43
Iixil,sylvanas,1685,monk,mistweaver,54,32,22
Freyas,outland,1685,monk,mistweaver,125,71,54
Arcøtea,frostwolf,1685,monk,mistweaver,195,109,86
Эрумонк,gordunni,1685,monk,mistweaver,36,18,18
Esooz,defias-brotherhood,1682,monk,mistweaver,36,29,7
Bullergøjen,ravencrest,1682,monk,mistweaver,90,59,31
Ðarent,hyjal,1682,monk,mistweaver,48,28,20
Дилейнх,gordunni,1682,monk,mistweaver,66,36,30
Shinergy,sylvanas,1682,monk,mistweaver,85,45,40
Sanktxy,blackhand,1682,monk,mistweaver,129,63,66
Benenutz,archimonde,1681,monk,mistweaver,113,74,39
Lkä,hyjal,1681,monk,mistweaver,34,22,12
Aritisi,tarren-mill,1681,monk,mistweaver,42,23,19
Akkadianx,ravencrest,1680,monk,mistweaver,71,42,29
Mélêxe,ysondre,1680,monk,mistweaver,36,21,15
Brewsli,ragnaros,1680,monk,mistweaver,98,57,41
Kñútølåfx,sylvanas,1679,monk,mistweaver,37,20,17
Simonex,ravencrest,1678,monk,mistweaver,90,47,43
Trulor,draenor,1677,monk,mistweaver,40,30,10
Milksbtw,kazzak,1676,monk,mistweaver,113,79,34
Airgirl,terrordar,1676,monk,mistweaver,70,43,27
Вакидзави,gordunni,1676,monk,mistweaver,60,36,24
Лютыйкулак,borean-tundra,1675,monk,mistweaver,41,27,14
Quickmist,draenor,1675,monk,mistweaver,107,65,42
Æbscourgê,azjolnerub,1675,monk,mistweaver,90,50,40
Vayyn,kazzak,1674,monk,mistweaver,42,24,18
Mankee,kazzak,1674,monk,mistweaver,209,110,99
Elhäbedehä,eredar,1673,monk,mistweaver,372,187,185
Lonechi,sylvanas,1673,monk,mistweaver,60,24,36
Mkeev,blackrock,1672,monk,mistweaver,24,21,3
Jerymonk,tarren-mill,1672,monk,mistweaver,231,123,108
Shokko,uldaman,1672,monk,mistweaver,113,60,53
Asho,outland,1671,monk,mistweaver,62,37,25
Zarona,outland,1671,monk,mistweaver,60,34,26
Автотюн,gordunni,1671,monk,mistweaver,40,18,22
Tokz,ravencrest,1670,monk,mistweaver,72,49,23
Ähronius,stormscale,1670,monk,mistweaver,28,19,9
Deadlywuu,antonidas,1670,monk,mistweaver,89,56,33
Børis,draenor,1670,monk,mistweaver,171,100,71
Shixen,ragnaros,1670,monk,mistweaver,60,24,36
Артэкрио,soulflayer,1669,monk,mistweaver,54,37,17
Andoran,hyjal,1669,monk,mistweaver,42,26,16
Saibell,scarshield-legion,1669,monk,mistweaver,148,89,59
Gøøgodx,tarren-mill,1669,monk,mistweaver,59,33,26
Potkuri,stormreaver,1669,monk,mistweaver,36,18,18
Sigvald,kaelthas,1668,monk,mistweaver,60,34,26
Socialfailur,ravencrest,1667,monk,mistweaver,50,28,22
Notdearmw,shattered-hand,1666,monk,mistweaver,36,24,12
Mahhist,archimonde,1666,monk,mistweaver,47,30,17
Vregorx,twisting-nether,1666,monk,mistweaver,73,41,32
Junâ,les-sentinelles,1666,monk,mistweaver,43,23,20
Suliya,zuluhed,1666,monk,mistweaver,96,51,45
Marcjess,kazzak,1666,monk,mistweaver,48,24,24
Telder,sylvanas,1665,monk,mistweaver,62,37,25
Xanderpowa,sanguino,1665,monk,mistweaver,36,21,15
Dharmå,norgannon,1665,monk,mistweaver,62,32,30
Pafia,sargeras,1665,monk,mistweaver,168,79,89
Oneshotmacro,spinebreaker,1663,monk,mistweaver,42,26,16
Tîptap,blackrock,1663,monk,mistweaver,42,20,22
Nerfmonk,archimonde,1662,monk,mistweaver,24,18,6
Watchôut,blackmoore,1662,monk,mistweaver,264,143,121
Mistwave,eredar,1660,monk,mistweaver,40,28,12
Insømnia,ragnaros,1660,monk,mistweaver,34,21,13
Shailene,kazzak,1660,monk,mistweaver,450,251,199
Nylzz,archimonde,1660,monk,mistweaver,50,26,24
Yshaolin,tarren-mill,1660,monk,mistweaver,44,22,22
Midgetjas,outland,1659,monk,mistweaver,107,63,44
Needthát,twisting-nether,1658,monk,mistweaver,60,38,22
Aliyo,aegwynn,1658,monk,mistweaver,36,22,14
Twerki,grim-batol,1658,monk,mistweaver,82,45,37
Sploof,ravencrest,1657,monk,mistweaver,36,24,12
Chiit,outland,1657,monk,mistweaver,45,26,19
Búns,draenor,1657,monk,mistweaver,101,58,43
Jetleê,eredar,1657,monk,mistweaver,162,85,77
Аскмилол,deathweaver,1657,monk,mistweaver,136,71,65
Melamonk,ravencrest,1657,monk,mistweaver,359,187,172
Quotes,darksorrow,1657,monk,mistweaver,84,42,42
Èlesd,ravencrest,1656,monk,mistweaver,39,26,13
Cerrad,twisting-nether,1656,monk,mistweaver,36,23,13
Эддрос,gordunni,1655,monk,mistweaver,66,35,31
Mangi,rexxar,1655,monk,mistweaver,72,37,35
Xdhehehexd,twisting-nether,1655,monk,mistweaver,158,79,79
Lazyslooth,ravencrest,1655,monk,mistweaver,57,25,32
Kaàli,pozzo-delleternità,1654,monk,mistweaver,36,21,15
Swollboom,outland,1653,monk,mistweaver,45,24,21
Alprox,moonglade,1653,monk,mistweaver,194,93,101
Mástermônkèy,tarren-mill,1652,monk,mistweaver,30,21,9
Lacasyto,sanguino,1651,monk,mistweaver,60,43,17
Ohmegah,frostmane,1651,monk,mistweaver,73,49,24
Hotmiist,kazzak,1651,monk,mistweaver,77,44,33
Монккд,gordunni,1651,monk,mistweaver,224,124,100
Schmacke,stormscale,1650,monk,mistweaver,30,20,10
Zenmastêr,twisting-nether,1650,monk,mistweaver,255,144,111
Bamiegoreng,aegwynn,1650,monk,mistweaver,36,20,16
Saadlol,sanguino,1650,monk,mistweaver,42,23,19
Ellevance,draenor,1650,monk,mistweaver,66,34,32
Shinzaø,khaz-modan,1650,monk,mistweaver,54,27,27
Mezchi,blackhand,1649,monk,mistweaver,144,76,68
Sart,aerie-peak,1649,monk,mistweaver,72,38,34
Thänkky,kazzak,1648,monk,mistweaver,36,21,15
Shmanatik,nemesis,1648,monk,mistweaver,257,144,113
Milkabtw,kazzak,1648,monk,mistweaver,94,52,42
Stanimirov,outland,1648,monk,mistweaver,89,43,46
Supaverli,archimonde,1647,monk,mistweaver,30,21,9
Rebekko,pozzo-delleternità,1647,monk,mistweaver,371,193,178
Pepe,garona,1646,monk,mistweaver,74,48,26
Etzu,shattrath,1646,monk,mistweaver,72,43,29
Масакрейн,howling-fjord,1646,monk,mistweaver,645,326,319
Mÿsphere,archimonde,1645,monk,mistweaver,121,67,54
Бладмонки,soulflayer,1645,monk,mistweaver,102,56,46
Drugashe,archimonde,1645,monk,mistweaver,360,177,183
Эрмилинда,gordunni,1645,monk,mistweaver,120,55,65
Mikeson,sylvanas,1644,monk,mistweaver,80,49,31
Pundok,blackrock,1644,monk,mistweaver,182,107,75
Yumhai,dun-modr,1644,monk,mistweaver,101,59,42
Linshai,eredar,1644,monk,mistweaver,48,28,20
Plumb,archimonde,1644,monk,mistweaver,48,27,21
Chiuna,sylvanas,1644,monk,mistweaver,66,37,29
Smehonk,outland,1644,monk,mistweaver,48,26,22
Unsanegodx,ravencrest,1643,monk,mistweaver,54,38,16
Psychoo,ragnaros,1643,monk,mistweaver,66,41,25
Kazemja,ragnaros,1643,monk,mistweaver,69,42,27
Eugenn,alonsus,1643,monk,mistweaver,52,29,23
Invadem,shattered-hand,1642,monk,mistweaver,33,22,11
Пивкотянка,gordunni,1642,monk,mistweaver,95,60,35
Blondefurry,twisting-nether,1642,monk,mistweaver,92,56,36
Nepho,twisting-nether,1642,monk,mistweaver,38,23,15
Фистингкоуч,gordunni,1642,monk,mistweaver,97,54,43
Ilovesnoopy,blackmoore,1641,monk,mistweaver,42,25,17
Mimimatrick,hyjal,1641,monk,mistweaver,108,59,49
Brewteaful,outland,1641,monk,mistweaver,63,34,29
Leôlulu,blackmoore,1640,monk,mistweaver,86,59,27
Monkadorie,twisting-nether,1640,monk,mistweaver,97,65,32
Kaizetsu,drakthul,1640,monk,mistweaver,84,52,32
Fistify,destromath,1639,monk,mistweaver,24,20,4
Sèrafin,burning-legion,1639,monk,mistweaver,36,23,13
Leblatt,blackhand,1639,monk,mistweaver,136,80,56
Zahj,ysondre,1639,monk,mistweaver,195,113,82
Kâî,outland,1638,monk,mistweaver,48,31,17
Zikzer,darksorrow,1638,monk,mistweaver,87,52,35
Knucklejuice,kazzak,1638,monk,mistweaver,78,39,39
Кубермонкер,gordunni,1638,monk,mistweaver,48,24,24
Rexmonk,senjin,1637,monk,mistweaver,36,23,13
Турениш,soulflayer,1637,monk,mistweaver,46,27,19
Hoibglotzn,antonidas,1637,monk,mistweaver,86,39,47
Meltfistqt,ravencrest,1636,monk,mistweaver,208,101,107
Ricidora,nerathor,1635,monk,mistweaver,36,22,14
Karoou,kelthuzad,1635,monk,mistweaver,89,48,41
Jacksa,bronze-dragonflight,1635,monk,mistweaver,302,149,153
Yusomean,ravencrest,1634,monk,mistweaver,30,18,12
Fistymisty,ragnaros,1634,monk,mistweaver,66,36,30
Якунка,soulflayer,1634,monk,mistweaver,54,25,29
Zúlay,aegwynn,1633,monk,mistweaver,42,26,16
Pe,blackhand,1633,monk,mistweaver,106,58,48
Quikes,blackrock,1632,monk,mistweaver,177,103,74
Namelessmist,drakthul,1632,monk,mistweaver,90,52,38
Plancton,kazzak,1631,monk,mistweaver,24,17,7
Teninchwilly,outland,1631,monk,mistweaver,74,47,27
Energyqt,twisting-nether,1631,monk,mistweaver,42,22,20
Toadmuncher,eredar,1631,monk,mistweaver,64,29,35
Klischi,blackhand,1630,monk,mistweaver,30,21,9
Unbanplslol,ravencrest,1630,monk,mistweaver,34,23,11
Simbabsu,thrall,1630,monk,mistweaver,75,50,25
Syyn,twisting-nether,1630,monk,mistweaver,383,209,174
Shyreen,zirkel-des-cenarius,1630,monk,mistweaver,47,25,22
Sneptichitz,draenor,1630,monk,mistweaver,452,236,216
Xineeaa,outland,1629,monk,mistweaver,159,84,75
Amatör,frostwolf,1629,monk,mistweaver,180,93,87
Gôeller,stormscale,1629,monk,mistweaver,59,29,30
Ларкес,howling-fjord,1629,monk,mistweaver,77,36,41
Brüderlichke,elune,1629,monk,mistweaver,48,21,27
Kapitan,sanguino,1628,monk,mistweaver,123,72,51
Dachilla,gilneas,1628,monk,mistweaver,61,35,26
Fbmonk,kazzak,1628,monk,mistweaver,267,146,121
Macpunchy,defias-brotherhood,1628,monk,mistweaver,72,38,34
Angeryw,kazzak,1627,monk,mistweaver,30,20,10
Chundan,twisting-nether,1627,monk,mistweaver,129,81,48
Vooxis,drakthul,1627,monk,mistweaver,90,51,39
Arimira,outland,1627,monk,mistweaver,158,85,73
Sugmadigg,argent-dawn,1626,monk,mistweaver,55,40,15
Найтчерри,deathguard,1626,monk,mistweaver,257,140,117
Mistbringer,kazzak,1626,monk,mistweaver,607,313,294
Ðéliora,la-croisade-écarlate,1626,monk,mistweaver,60,30,30
Zaiyox,thrall,1626,monk,mistweaver,42,20,22
Twistie,aegwynn,1626,monk,mistweaver,36,17,19
Sindresa,outland,1625,monk,mistweaver,348,178,170
Старыйхиро,gordunni,1624,monk,mistweaver,24,17,7
Incapmaestro,doomhammer,1624,monk,mistweaver,71,50,21
Zenfir,sylvanas,1624,monk,mistweaver,92,56,36
Sooths,uldaman,1624,monk,mistweaver,43,25,18
Jeaylzxko,archimonde,1624,monk,mistweaver,48,25,23
Джисаку,gordunni,1624,monk,mistweaver,37,19,18
Elskling,earthen-ring,1624,monk,mistweaver,473,239,234
Endif,stormscale,1623,monk,mistweaver,76,41,35
Egï,azshara,1623,monk,mistweaver,82,43,39
Ukrytywaz,burning-legion,1623,monk,mistweaver,454,234,220
Chexmonk,silvermoon,1623,monk,mistweaver,184,94,90
Патаомальчик,blackscar,1622,monk,mistweaver,100,53,47
Akwaman,stormscale,1622,monk,mistweaver,54,23,31
Samxin,archimonde,1621,monk,mistweaver,53,36,17
Luciellie,archimonde,1621,monk,mistweaver,30,19,11
Pandare,bronze-dragonflight,1621,monk,mistweaver,86,51,35
Æctò,blackmoore,1621,monk,mistweaver,238,127,111
Córporation,outland,1621,monk,mistweaver,48,25,23
Varyat,uldum,1621,monk,mistweaver,83,43,40
Spinonyou,silvermoon,1620,monk,mistweaver,30,20,10
Äeøwyn,ragnaros,1620,monk,mistweaver,40,22,18
Issho,der-rat-von-dalaran,1620,monk,mistweaver,36,19,17
Qlmo,ravencrest,1619,monk,mistweaver,151,88,63
Biftas,nagrand,1619,monk,mistweaver,75,42,33
Moonloxe,silvermoon,1619,monk,mistweaver,35,19,16
Healinspam,twilights-hammer,1619,monk,mistweaver,138,66,72
Yotke,ravencrest,1618,monk,mistweaver,60,36,24
Tyzin,blackrock,1618,monk,mistweaver,166,97,69
Thorasobär,aegwynn,1618,monk,mistweaver,57,30,27
Chanjike,anetheron,1618,monk,mistweaver,78,39,39
Luvmollý,silvermoon,1618,monk,mistweaver,204,96,108
Xoleck,aegwynn,1618,monk,mistweaver,48,21,27
Gobssi,archimonde,1617,monk,mistweaver,120,77,43
Byoß,stormscale,1617,monk,mistweaver,91,54,37
Хилюзаоргазм,howling-fjord,1617,monk,mistweaver,86,50,36
Khaven,hyjal,1616,monk,mistweaver,29,24,5
Emblax,blackhand,1616,monk,mistweaver,48,29,19
Monkéy,blackhand,1616,monk,mistweaver,54,30,24
Refi,blackrock,1616,monk,mistweaver,175,96,79
Rheinair,antonidas,1616,monk,mistweaver,144,78,66
Kwa,grim-batol,1616,monk,mistweaver,69,37,32
Ðëvx,argent-dawn,1615,monk,mistweaver,173,104,69
Shkorwi,drakthul,1615,monk,mistweaver,78,40,38
Saduh,thrall,1615,monk,mistweaver,90,46,44
Makíima,blackrock,1615,monk,mistweaver,46,23,23
Hymonk,draenor,1614,monk,mistweaver,103,62,41
Fabulistic,outland,1614,monk,mistweaver,60,31,29
Breezegodx,stormscale,1614,monk,mistweaver,78,39,39
Stramonk,nemesis,1614,monk,mistweaver,267,129,138
Uftis,thrall,1613,monk,mistweaver,89,61,28
Toshi,argent-dawn,1613,monk,mistweaver,130,84,46
Sanchios,twisting-nether,1613,monk,mistweaver,30,18,12
Пнименяплиз,gordunni,1612,monk,mistweaver,45,27,18
Jeanmartin,hyjal,1612,monk,mistweaver,108,61,47
Xoonaki,turalyon,1612,monk,mistweaver,39,20,19
Zodyiac,blackrock,1611,monk,mistweaver,41,29,12
Garuda,darkspear,1611,monk,mistweaver,34,23,11
Липисинка,howling-fjord,1611,monk,mistweaver,93,53,40
Mönchalot,der-abyssische-rat,1611,monk,mistweaver,30,17,13
Izen,eredar,1611,monk,mistweaver,54,30,24
Hydrôlîcz,blackrock,1611,monk,mistweaver,48,26,22
Jian,tarren-mill,1611,monk,mistweaver,76,40,36
Koraxx,blackmoore,1611,monk,mistweaver,90,46,44
Zorxen,argent-dawn,1611,monk,mistweaver,42,20,22
Сэм,gordunni,1610,monk,mistweaver,30,21,9
Crazydingo,lightnings-blade,1610,monk,mistweaver,115,73,42
Аникибой,gordunni,1610,monk,mistweaver,109,69,40
Kernbohrung,ravencrest,1609,monk,mistweaver,36,23,13
Биак,howling-fjord,1609,monk,mistweaver,38,23,15
Windwalkergy,chamber-of-aspects,1609,monk,mistweaver,72,40,32
Plebmonkx,frostmane,1609,monk,mistweaver,185,98,87
Erapanzon,nemesis,1609,monk,mistweaver,106,55,51
Лолидевочка,soulflayer,1609,monk,mistweaver,61,24,37
Makïi,archimonde,1608,monk,mistweaver,291,164,127
Saeedki,wildhammer,1608,monk,mistweaver,67,37,30
Жариха,soulflayer,1607,monk,mistweaver,93,60,33
Кирэнви,soulflayer,1607,monk,mistweaver,54,34,20
Benzzy,ragnaros,1607,monk,mistweaver,110,68,42
Castrø,argent-dawn,1607,monk,mistweaver,108,62,46
Pembi,blades-edge,1607,monk,mistweaver,98,51,47
Esco,genjuros,1606,monk,mistweaver,95,53,42
Klotsobunidi,kazzak,1606,monk,mistweaver,191,100,91
Pìmpìnelle,garona,1606,monk,mistweaver,47,23,24
Civix,sanguino,1605,monk,mistweaver,225,131,94
Fluki,twisting-nether,1605,monk,mistweaver,90,50,40
Nastyføxÿ,ysondre,1605,monk,mistweaver,42,22,20
Spoompls,argent-dawn,1605,monk,mistweaver,78,40,38
Monkasape,nemesis,1605,monk,mistweaver,39,19,20
Lillklappz,outland,1604,monk,mistweaver,48,33,15
Pøwcow,blackrock,1604,monk,mistweaver,203,114,89
Rulletunna,grim-batol,1604,monk,mistweaver,78,42,36
Rngmåchínè,ravencrest,1604,monk,mistweaver,98,50,48
Zuvzuv,the-maelstrom,1604,monk,mistweaver,125,63,62
Uwugodx,archimonde,1603,monk,mistweaver,69,41,28
Waitaminute,outland,1603,monk,mistweaver,166,97,69
Ånåsenpåi,archimonde,1603,monk,mistweaver,47,27,20
Leesun,burning-legion,1603,monk,mistweaver,53,28,25
Thyrtyfive,chogall,1603,monk,mistweaver,120,61,59
Timboqt,blackmoore,1602,monk,mistweaver,82,48,34
Lizardspock,hyjal,1602,monk,mistweaver,30,17,13
Stealthsøul,outland,1602,monk,mistweaver,30,17,13
Räyh,outland,1602,monk,mistweaver,57,31,26
Groundnpound,silvermoon,1602,monk,mistweaver,72,38,34
Brummbierle,blackrock,1602,monk,mistweaver,46,24,22
Kurasaki,blackmoore,1601,monk,mistweaver,25,19,6
Leykom,ravencrest,1601,monk,mistweaver,27,18,9
Loma,drakthul,1601,monk,mistweaver,148,94,54
Kajï,frostmane,1601,monk,mistweaver,78,48,30
Edll,silvermoon,1601,monk,mistweaver,99,57,42
Мегаалюль,gordunni,1601,monk,mistweaver,42,19,23
Aebì,dalaran,1600,monk,mistweaver,87,55,32
Eluai,kilrogg,1600,monk,mistweaver,42,24,18
Setup,thrall,1600,monk,mistweaver,197,111,86
Onlyvegan,ravencrest,1600,monk,mistweaver,40,21,19
Buffmw,burning-steppes,1599,monk,mistweaver,41,29,12
Zentina,outland,1599,monk,mistweaver,206,119,87
Mjk,tarren-mill,1599,monk,mistweaver,114,64,50
Jum,blackhand,1599,monk,mistweaver,142,79,63
Psychocop,drakthul,1599,monk,mistweaver,547,277,270
Нийтринно,howling-fjord,1599,monk,mistweaver,180,91,89
Индоран,howling-fjord,1598,monk,mistweaver,78,55,23
Rokobasilisk,outland,1598,monk,mistweaver,42,19,23
Widsilson,hyjal,1596,monk,mistweaver,24,17,7
Aljabbar,ravencrest,1596,monk,mistweaver,42,23,19
Starside,tarren-mill,1596,monk,mistweaver,36,17,19
Akatzu,silvermoon,1595,monk,mistweaver,35,22,13
Uglyfister,kazzak,1595,monk,mistweaver,71,41,30
Sadcuzbad,thrall,1595,monk,mistweaver,30,17,13
Ivanzamonka,stormscale,1595,monk,mistweaver,113,64,49
Darkkmonk,dun-modr,1595,monk,mistweaver,167,87,80
Desmî,ravencrest,1594,monk,mistweaver,32,24,8
Ceeja,blackmoore,1594,monk,mistweaver,178,96,82
Wushin,antonidas,1594,monk,mistweaver,61,31,30
Venemy,sanguino,1593,monk,mistweaver,96,55,41
Zødiac,quelthalas,1593,monk,mistweaver,51,28,23
Sensorium,ravencrest,1593,monk,mistweaver,192,101,91
Punkfukanda,drakthul,1592,monk,mistweaver,69,41,28
Alë,argent-dawn,1592,monk,mistweaver,146,81,65
Yepp,blackmoore,1592,monk,mistweaver,86,34,52
Watchmedamp,draenor,1591,monk,mistweaver,218,124,94
Inthepoopa,outland,1591,monk,mistweaver,117,64,53
Kitingbuddha,aegwynn,1591,monk,mistweaver,120,64,56
Schane,zuluhed,1591,monk,mistweaver,94,50,44
Elmonkodonko,draenor,1590,monk,mistweaver,30,17,13
Boomboôom,outland,1590,monk,mistweaver,93,47,46
Aironqqt,blackhand,1589,monk,mistweaver,207,121,86
Monkymonka,antonidas,1589,monk,mistweaver,204,103,101
Yanuxî,aegwynn,1588,monk,mistweaver,82,47,35
Вдыхайтуман,gordunni,1588,monk,mistweaver,146,79,67
Windspiritt,ragnaros,1587,monk,mistweaver,96,52,44
Xiaokingqvq,silvermoon,1587,monk,mistweaver,126,68,58
Dmonk,alakir,1587,monk,mistweaver,136,69,67
Bankdream,bronze-dragonflight,1587,monk,mistweaver,96,48,48
Hulkules,blackhand,1586,monk,mistweaver,100,64,36
Kammia,drekthar,1585,monk,mistweaver,30,17,13
Monkim,chogall,1585,monk,mistweaver,48,27,21
Quehorror,dun-modr,1585,monk,mistweaver,55,29,26
Quezatrix,ravencrest,1585,monk,mistweaver,292,153,139
Phyro,uldum,1585,monk,mistweaver,104,50,54
Монккд,soulflayer,1584,monk,mistweaver,158,93,65
Xadu,frostwolf,1584,monk,mistweaver,101,56,45
Aldèbarån,nemesis,1583,monk,mistweaver,145,81,64
Шуруповеерт,soulflayer,1583,monk,mistweaver,84,46,38
Warsox,aegwynn,1583,monk,mistweaver,102,53,49
Igozoom,draenor,1582,monk,mistweaver,65,42,23
Glorytw,outland,1582,monk,mistweaver,72,44,28
Katmunk,kazzak,1582,monk,mistweaver,30,18,12
Факенщет,soulflayer,1581,monk,mistweaver,97,56,41
Parkroy,ravencrest,1581,monk,mistweaver,60,32,28
Brapbrap,stormscale,1581,monk,mistweaver,75,39,36
Chirukka,dun-modr,1580,monk,mistweaver,186,104,82
Крибл,howling-fjord,1580,monk,mistweaver,36,20,16
Chinmachine,kazzak,1580,monk,mistweaver,120,66,54
Pleasure,laughing-skull,1580,monk,mistweaver,66,35,31
Rogeri,kazzak,1579,monk,mistweaver,54,29,25
Mulfmonk,darksorrow,1578,monk,mistweaver,137,83,54
Dosakua,silvermoon,1578,monk,mistweaver,114,63,51
Áyell,archimonde,1578,monk,mistweaver,201,109,92
Larå,ravencrest,1578,monk,mistweaver,370,199,171
Hardi,chamber-of-aspects,1578,monk,mistweaver,151,74,77
Mythrixie,draenor,1577,monk,mistweaver,47,28,19
Taìka,archimonde,1577,monk,mistweaver,33,19,14
Тадоичи,soulflayer,1576,monk,mistweaver,114,71,43
Psychømonk,antonidas,1575,monk,mistweaver,36,21,15
Appéltje,ravencrest,1574,monk,mistweaver,30,17,13
Húrka,drakthul,1574,monk,mistweaver,64,36,28
Vanessaflexz,aegwynn,1574,monk,mistweaver,72,40,32
Yuyuni,laughing-skull,1574,monk,mistweaver,66,34,32
Knotseboenk,outland,1574,monk,mistweaver,205,102,103
Bitbird,zirkel-des-cenarius,1573,monk,mistweaver,48,29,19
Otuschxin,blackmoore,1573,monk,mistweaver,120,63,57
Slizzlie,outland,1573,monk,mistweaver,93,47,46
Mentonk,frostwolf,1572,monk,mistweaver,36,20,16
Statícx,twisting-nether,1572,monk,mistweaver,105,56,49
Mannmann,thrall,1572,monk,mistweaver,66,33,33
Vanoarabidze,ravencrest,1572,monk,mistweaver,78,36,42
Vasknem,hyjal,1571,monk,mistweaver,72,46,26
Børshka,nemesis,1571,monk,mistweaver,98,62,36
Medinâ,kult-der-verdammten,1571,monk,mistweaver,66,35,31
Zanizu,blackhand,1571,monk,mistweaver,96,50,46
Spicyrice,twisting-nether,1571,monk,mistweaver,357,178,179
Lenor,blackmoore,1571,monk,mistweaver,42,20,22
Wieseljäger,blackmoore,1570,monk,mistweaver,54,29,25
Headakzar,kazzak,1570,monk,mistweaver,108,52,56
Monkys,ravencrest,1570,monk,mistweaver,44,21,23
Zekunpow,zenedar,1569,monk,mistweaver,90,60,30
Vadrigar,drakthul,1569,monk,mistweaver,30,19,11
Уиннии,soulflayer,1569,monk,mistweaver,42,23,19
Calmpalms,tarren-mill,1569,monk,mistweaver,111,60,51
Orgasmix,tarren-mill,1569,monk,mistweaver,42,21,21
Ussak,stormreaver,1568,monk,mistweaver,119,74,45
Spîndêmôrt,stormscale,1568,monk,mistweaver,161,96,65
Jasonbbmist,stormscale,1568,monk,mistweaver,101,56,45
Brewsky,tarren-mill,1568,monk,mistweaver,60,29,31
Адольфвейпер,gordunni,1567,monk,mistweaver,32,25,7
Mâxs,archimonde,1567,monk,mistweaver,24,17,7
Kiziibrla,archimonde,1567,monk,mistweaver,66,34,32
Nurfdmonk,ravencrest,1566,monk,mistweaver,55,35,20
Lumpiiná,antonidas,1566,monk,mistweaver,114,69,45
Тучковский,lich-king,1565,monk,mistweaver,239,129,110
Gernokz,antonidas,1565,monk,mistweaver,485,254,231
Meuhporgg,hyjal,1564,monk,mistweaver,60,42,18
Progresse,tarren-mill,1564,monk,mistweaver,60,32,28
Monkini,kazzak,1563,monk,mistweaver,30,21,9
Mwmkgodxz,archimonde,1563,monk,mistweaver,27,18,9
Jacm,blackhand,1563,monk,mistweaver,53,30,23
Nihao,tarren-mill,1563,monk,mistweaver,115,62,53
Mistfeeder,burning-blade,1563,monk,mistweaver,36,19,17
Hokke,tarren-mill,1563,monk,mistweaver,66,34,32
Buspiron,ravencrest,1562,monk,mistweaver,48,26,22
Saitamä,archimonde,1562,monk,mistweaver,122,58,64
Fithz,kaelthas,1561,monk,mistweaver,60,43,17
Madafis,twisting-nether,1560,monk,mistweaver,42,28,14
Lilfist,thrall,1560,monk,mistweaver,68,44,24
Teacup,aegwynn,1560,monk,mistweaver,464,250,214
Hanhunden,grim-batol,1560,monk,mistweaver,367,195,172
Pitit,outland,1560,monk,mistweaver,84,33,51
Kylâas,die-ewige-wacht,1558,monk,mistweaver,66,33,33
Hokutoken,hyjal,1557,monk,mistweaver,42,26,16
Antinun,kazzak,1556,monk,mistweaver,208,115,93
Kbwser,silvermoon,1555,monk,mistweaver,54,32,22
Isadri,madmortem,1555,monk,mistweaver,36,21,15
Reyaiba,dalaran,1554,monk,mistweaver,30,21,9
Mushush,draenor,1554,monk,mistweaver,62,34,28
Salsina,nemesis,1554,monk,mistweaver,329,178,151
Mmrkick,kazzak,1554,monk,mistweaver,106,56,50
Hoshisora,ravencrest,1554,monk,mistweaver,42,22,20
Rolegsweep,arathor,1554,monk,mistweaver,106,55,51
Hullumunkki,blackmoore,1553,monk,mistweaver,28,18,10
Botspec,twisting-nether,1553,monk,mistweaver,81,48,33
Aaronijshn,silvermoon,1552,monk,mistweaver,121,70,51
Spiritualia,kazzak,1552,monk,mistweaver,265,143,122
Shreckmonk,burning-blade,1552,monk,mistweaver,104,56,48
Nexìan,kazzak,1551,monk,mistweaver,48,35,13
Rizzwalker,ravencrest,1551,monk,mistweaver,114,65,49
Musashiden,twisting-nether,1551,monk,mistweaver,87,47,40
Scpdevil,outland,1550,monk,mistweaver,117,67,50
Chikokon,silvermoon,1549,monk,mistweaver,105,64,41
Тевикс,gordunni,1549,monk,mistweaver,143,74,69
Happymonktwo,ravencrest,1549,monk,mistweaver,166,83,83
Spánkproóf,kazzak,1548,monk,mistweaver,36,22,14
Kattlåda,darkspear,1548,monk,mistweaver,36,21,15
Màru,blackrock,1548,monk,mistweaver,60,34,26
Rzi,amanthul,1548,monk,mistweaver,155,86,69
Elvand,twisting-nether,1548,monk,mistweaver,143,72,71
Ðisbalance,ravencrest,1548,monk,mistweaver,35,17,18
Bluebery,burning-legion,1547,monk,mistweaver,30,17,13
Phébz,archimonde,1547,monk,mistweaver,74,40,34
Prettysus,silvermoon,1546,monk,mistweaver,66,41,25
Wannabejoker,stormscale,1546,monk,mistweaver,72,38,34
Wølfy,argent-dawn,1545,monk,mistweaver,68,36,32
Mordmonkx,draenor,1545,monk,mistweaver,429,226,203
Ønøf,rashgarroth,1545,monk,mistweaver,77,38,39
Painswîft,blackhand,1544,monk,mistweaver,54,34,20
Kirkeý,ravencrest,1544,monk,mistweaver,55,31,24
Barracüs,dun-modr,1544,monk,mistweaver,78,43,35
Lysanmonk,zuljin,1544,monk,mistweaver,123,67,56
Atommyran,frostmane,1544,monk,mistweaver,147,80,67
Aryphus,blackmoore,1544,monk,mistweaver,76,39,37
Brucechi,kargath,1543,monk,mistweaver,111,77,34
Jinhee,nemesis,1543,monk,mistweaver,74,47,27
Kåýðø,archimonde,1543,monk,mistweaver,102,54,48
Njursten,twilights-hammer,1543,monk,mistweaver,296,150,146
Eckø,rashgarroth,1542,monk,mistweaver,88,52,36
Phyromonky,uldum,1541,monk,mistweaver,42,25,17
Evilrui,ravencrest,1541,monk,mistweaver,99,54,45
Mellu,kazzak,1539,monk,mistweaver,44,31,13
Slayâtwo,blackrock,1539,monk,mistweaver,33,23,10
Bambøuéqtz,khaz-modan,1539,monk,mistweaver,60,40,20
Нунтяк,gordunni,1539,monk,mistweaver,364,178,186
Lefferubie,hyjal,1538,monk,mistweaver,72,40,32
Onepunchmon,ragnaros,1538,monk,mistweaver,46,24,22
Dupengchi,blackrock,1538,monk,mistweaver,60,31,29
Anzii,silvermoon,1538,monk,mistweaver,51,25,26
Drylezm,twisting-nether,1537,monk,mistweaver,28,20,8
Mará,burning-legion,1537,monk,mistweaver,54,35,19
Molgar,tarren-mill,1537,monk,mistweaver,86,48,38
Møjíto,stormscale,1537,monk,mistweaver,89,47,42
Kushvendorx,silvermoon,1537,monk,mistweaver,72,38,34
Zaheer,xavius,1537,monk,mistweaver,71,23,48
Лалафест,soulflayer,1536,monk,mistweaver,64,35,29
Диванн,howling-fjord,1535,monk,mistweaver,50,29,21
Эмфул,soulflayer,1535,monk,mistweaver,47,26,21
Guthäxlul,khazgoroth,1535,monk,mistweaver,563,297,266
Sneezao,ravencrest,1534,monk,mistweaver,210,114,96
Dumplings,earthen-ring,1531,monk,mistweaver,78,48,30
Zêstâgôdx,twisting-nether,1531,monk,mistweaver,30,16,14
Mer,outland,1531,monk,mistweaver,91,48,43
Xloxloxloxy,outland,1530,monk,mistweaver,24,16,8
Jcchi,xavius,1530,monk,mistweaver,132,63,69
Ninjasven,bladefist,1530,monk,mistweaver,42,19,23
Mattybfast,tarren-mill,1529,monk,mistweaver,59,44,15
Gronoz,drakthul,1529,monk,mistweaver,150,84,66
Soulxq,blackrock,1529,monk,mistweaver,219,112,107
Noni,gorgonnash,1529,monk,mistweaver,113,57,56
Karatekickyo,ravencrest,1528,monk,mistweaver,40,22,18
Longpeng,ysera,1528,monk,mistweaver,36,18,18
Timboxd,blackmoore,1527,monk,mistweaver,85,49,36
Zinnout,twisting-nether,1527,monk,mistweaver,149,85,64
Aeolôs,hyjal,1527,monk,mistweaver,120,65,55
Urbàs,blackmoore,1526,monk,mistweaver,42,29,13
Applestrûdel,blackrock,1526,monk,mistweaver,93,55,38
Trollandroll,stormscale,1526,monk,mistweaver,193,98,95
Musslee,elune,1526,monk,mistweaver,129,65,64
Endorrphine,ravencrest,1526,monk,mistweaver,158,72,86
Bazalka,blackmoore,1526,monk,mistweaver,64,29,35
Vàlky,outland,1525,monk,mistweaver,24,16,8
Shouling,outland,1525,monk,mistweaver,115,68,47
Нерлимар,howling-fjord,1525,monk,mistweaver,56,33,23
Barbielølz,archimonde,1525,monk,mistweaver,30,17,13
Annaftz,kirin-tor,1525,monk,mistweaver,33,18,15
Casic,tichondrius,1524,monk,mistweaver,36,26,10
Amnis,pozzo-delleternità,1524,monk,mistweaver,77,45,32
Missmstweavr,blackrock,1524,monk,mistweaver,96,56,40
Mwmonkchamp,blackrock,1524,monk,mistweaver,45,21,24
Føxy,sunstrider,1523,monk,mistweaver,78,45,33
Kadoran,argent-dawn,1523,monk,mistweaver,30,17,13
Каземат,booty-bay,1523,monk,mistweaver,149,83,66
Shiesel,draenor,1523,monk,mistweaver,104,56,48
Sámal,draenor,1522,monk,mistweaver,90,55,35
Boomshaq,defias-brotherhood,1522,monk,mistweaver,319,169,150
Кулаквнос,gordunni,1522,monk,mistweaver,216,109,107
Uncleheal,tarren-mill,1521,monk,mistweaver,37,21,16
Zerym,silvermoon,1520,monk,mistweaver,78,38,40
Correforrest,dun-modr,1519,monk,mistweaver,132,81,51
Bóber,kazzak,1519,monk,mistweaver,54,30,24
Whoszeus,archimonde,1519,monk,mistweaver,356,184,172
Sînê,archimonde,1518,monk,mistweaver,174,98,76
Monarko,twisting-nether,1518,monk,mistweaver,143,80,63
Huricän,drakthul,1518,monk,mistweaver,69,35,34
Moohamood,argent-dawn,1518,monk,mistweaver,172,87,85
Baaws,blackrock,1517,monk,mistweaver,53,32,21
Mightnorn,tarren-mill,1517,monk,mistweaver,36,20,16
Absolutezen,tarren-mill,1517,monk,mistweaver,95,48,47
Mecin,ragnaros,1516,monk,mistweaver,78,44,34
Jimbearend,argent-dawn,1516,monk,mistweaver,212,116,96
Carlocolucci,the-maelstrom,1516,monk,mistweaver,61,33,28
Eynodiggity,blackmoore,1516,monk,mistweaver,72,38,34
Ticktak,archimonde,1515,monk,mistweaver,92,55,37
Discoelysia,outland,1515,monk,mistweaver,194,104,90
Misthera,burning-legion,1515,monk,mistweaver,148,70,78
Sobadzlolz,alexstrasza,1515,monk,mistweaver,60,28,32
Joshimitsu,sylvanas,1515,monk,mistweaver,98,45,53
Shàká,stormscale,1514,monk,mistweaver,42,28,14
Drúdkh,tarren-mill,1514,monk,mistweaver,72,41,31
Saliya,draenor,1514,monk,mistweaver,40,20,20
Løsang,blackrock,1513,monk,mistweaver,239,140,99
Kungfox,frostwolf,1513,monk,mistweaver,84,43,41
Dromarch,dun-modr,1513,monk,mistweaver,81,39,42
Twigleaf,kazzak,1513,monk,mistweaver,49,22,27
Hitsumia,archimonde,1513,monk,mistweaver,54,23,31
Xhanc,aegwynn,1512,monk,mistweaver,24,18,6
Jbzzu,outland,1512,monk,mistweaver,48,23,25
Monkiful,haomarush,1512,monk,mistweaver,52,21,31
Ronkingkong,ravencrest,1512,monk,mistweaver,42,16,26
Vajawalker,twisting-nether,1511,monk,mistweaver,132,76,56
Quendi,arthas,1511,monk,mistweaver,320,172,148
Elity,archimonde,1510,monk,mistweaver,82,54,28
Ragenn,zuljin,1510,monk,mistweaver,49,32,17
Eslu,outland,1510,monk,mistweaver,46,28,18
Oogwai,twisting-nether,1510,monk,mistweaver,108,64,44
Shoryugrops,chants-éternels,1509,monk,mistweaver,26,18,8
Siamesedream,outland,1509,monk,mistweaver,260,150,110
Orkiya,archimonde,1509,monk,mistweaver,348,182,166
Légit,argent-dawn,1508,monk,mistweaver,122,80,42
Krysira,blackrock,1508,monk,mistweaver,30,19,11
Reivil,kazzak,1508,monk,mistweaver,30,16,14
Fungxi,archimonde,1508,monk,mistweaver,78,33,45
Plånck,archimonde,1507,monk,mistweaver,24,16,8
Lobnx,kazzak,1507,monk,mistweaver,41,25,16
Mongretod,ravencrest,1507,monk,mistweaver,42,22,20
Romk,darkspear,1506,monk,mistweaver,60,43,17
Wifepuncher,blackhand,1506,monk,mistweaver,36,19,17
Backseatgmr,ravencrest,1506,monk,mistweaver,106,54,52
Smâsh,blackhand,1505,monk,mistweaver,88,51,37
Chípmonk,earthen-ring,1505,monk,mistweaver,213,117,96
Gravityfist,aegwynn,1505,monk,mistweaver,102,48,54
Basthek,blackhand,1505,monk,mistweaver,107,50,57
Вондерофъю,gordunni,1505,monk,mistweaver,54,24,30
Chiroan,twisting-nether,1504,monk,mistweaver,112,64,48
Kungfuppl,kazzak,1504,monk,mistweaver,103,46,57
Мирюзаки,gordunni,1503,monk,mistweaver,84,52,32
Инженерия,howling-fjord,1503,monk,mistweaver,60,36,24
Visk,blackmoore,1503,monk,mistweaver,203,108,95
Bullbøx,chamber-of-aspects,1503,monk,mistweaver,123,55,68
Lökmedsmör,draenor,1502,monk,mistweaver,78,49,29
Gatubarnet,stormscale,1502,monk,mistweaver,95,52,43
Askmeout,ravencrest,1501,monk,mistweaver,85,49,36
Самадайка,howling-fjord,1501,monk,mistweaver,166,86,80
Venturi,aegwynn,1500,monk,mistweaver,131,69,62
Doingmaster,blackrock,1500,monk,mistweaver,60,30,30
Riotplz,draenor,1500,monk,mistweaver,45,22,23
Skusle,defias-brotherhood,1499,monk,mistweaver,36,22,14
Timmyßênz,kaelthas,1499,monk,mistweaver,107,60,47
Амаззонния,soulflayer,1498,monk,mistweaver,380,186,194
Gumar,antonidas,1497,monk,mistweaver,30,18,12
Zeldrís,ragnaros,1497,monk,mistweaver,102,51,51
Jihaaz,nemesis,1496,monk,mistweaver,187,97,90
Bigballs,ysera,1496,monk,mistweaver,66,30,36
Coopers,hyjal,1495,monk,mistweaver,111,63,48
Busfâhrer,antonidas,1495,monk,mistweaver,29,16,13
Fistyboyuk,tarren-mill,1494,monk,mistweaver,29,17,12
Skif,blackhand,1493,monk,mistweaver,42,24,18
Pandimaci,ragnaros,1492,monk,mistweaver,152,87,65
Fistarfrans,sylvanas,1491,monk,mistweaver,44,30,14
Píkachuu,ragnaros,1491,monk,mistweaver,65,41,24
Cbmonk,sylvanas,1490,monk,mistweaver,86,51,35
Onÿz,hyjal,1490,monk,mistweaver,63,36,27
Incapme,outland,1490,monk,mistweaver,180,98,82
Chakuro,ravencrest,1488,monk,mistweaver,30,20,10
Lunarès,antonidas,1488,monk,mistweaver,44,25,19
Quicc,ravencrest,1488,monk,mistweaver,72,36,36
Ароба,blackscar,1488,monk,mistweaver,65,31,34
Teztouza,kazzak,1487,monk,mistweaver,60,35,25
Scare,stormreaver,1487,monk,mistweaver,111,63,48
Tonyjohns,draenor,1486,monk,mistweaver,30,18,12
Kegrøll,doomhammer,1486,monk,mistweaver,54,29,25
Cmk,outland,1486,monk,mistweaver,102,42,60
Moveietss,stormscale,1485,monk,mistweaver,18,16,2
Zýru,ragnaros,1485,monk,mistweaver,163,90,73
Fungku,azjolnerub,1485,monk,mistweaver,357,180,177
Vivir,stormreaver,1483,monk,mistweaver,240,130,110
Nimander,burning-legion,1483,monk,mistweaver,45,22,23
Pikajeww,kazzak,1482,monk,mistweaver,86,58,28
Maiver,stormscale,1482,monk,mistweaver,139,78,61
Mekki,outland,1481,monk,mistweaver,21,17,4
Boozmoo,stormscale,1481,monk,mistweaver,76,55,21
Ajita,blackmoore,1481,monk,mistweaver,66,35,31
Asterii,archimonde,1481,monk,mistweaver,42,20,22
Cäpten,dethecus,1480,monk,mistweaver,28,19,9
Themistius,kazzak,1480,monk,mistweaver,41,26,15
Lilmanfist,stormscale,1480,monk,mistweaver,42,22,20
Fistingfury,burning-blade,1480,monk,mistweaver,168,87,81
Kano,burning-legion,1479,monk,mistweaver,38,23,15
Mistyice,kazzak,1479,monk,mistweaver,30,17,13
Sororicide,stormscale,1479,monk,mistweaver,48,25,23
Aguerxf,alleria,1479,monk,mistweaver,65,30,35
Ракенрол,deathguard,1478,monk,mistweaver,24,17,7
Юансноу,blackscar,1478,monk,mistweaver,108,64,44
Dudulinda,silvermoon,1478,monk,mistweaver,155,82,73
Saáru,argent-dawn,1478,monk,mistweaver,114,57,57
Ytonie,gorgonnash,1477,monk,mistweaver,36,28,8
Kreynich,blackhand,1477,monk,mistweaver,36,25,11
Sanhollo,stormscale,1477,monk,mistweaver,29,17,12
Dìó,tarren-mill,1477,monk,mistweaver,210,117,93
Conguitø,colinas-pardas,1476,monk,mistweaver,176,92,84
Okdontnerf,kazzak,1476,monk,mistweaver,130,64,66
Shiveri,outland,1476,monk,mistweaver,89,42,47
Danîi,dun-morogh,1475,monk,mistweaver,62,38,24
Gucciweaver,tarren-mill,1474,monk,mistweaver,35,22,13
Влажныйтач,soulflayer,1474,monk,mistweaver,42,25,17
Rìnox,blackmoore,1474,monk,mistweaver,144,78,66
Skâte,dun-modr,1473,monk,mistweaver,77,42,35
Angelofchaos,outland,1472,monk,mistweaver,36,28,8
Tòrian,pozzo-delleternità,1472,monk,mistweaver,60,29,31
Affrro,drakthul,1471,monk,mistweaver,89,51,38
Fredder,blackrock,1471,monk,mistweaver,335,183,152
Sheishot,kazzak,1471,monk,mistweaver,61,32,29
Монкиннияя,gordunni,1471,monk,mistweaver,45,21,24
Thuz,kazzak,1470,monk,mistweaver,75,39,36
Анамо,blackscar,1469,monk,mistweaver,78,45,33
Rebeka,dun-modr,1469,monk,mistweaver,36,17,19
Rymz,sanguino,1468,monk,mistweaver,115,68,47
Kanajambe,twisting-nether,1468,monk,mistweaver,114,66,48
Зелёныймонк,soulflayer,1468,monk,mistweaver,114,63,51
Moistweaver,hellfire,1468,monk,mistweaver,84,44,40
Capwouk,tarren-mill,1468,monk,mistweaver,36,16,20
Janpu,outland,1467,monk,mistweaver,42,25,17
Vitnam,auchindoun,1467,monk,mistweaver,287,151,136
Kandislee,ravencrest,1467,monk,mistweaver,78,40,38
Zenfoxy,blackrock,1467,monk,mistweaver,54,23,31
Mystd,hyjal,1466,monk,mistweaver,41,24,17
Jusn,tarren-mill,1466,monk,mistweaver,173,91,82
Trxy,argent-dawn,1466,monk,mistweaver,72,35,37
Vørdèthxd,outland,1465,monk,mistweaver,84,58,26
Hærleyquin,ravencrest,1465,monk,mistweaver,48,23,25
Jyll,malganis,1465,monk,mistweaver,185,80,105
Fisticuffs,tarren-mill,1464,monk,mistweaver,70,37,33
Yararsizz,twisting-nether,1463,monk,mistweaver,61,39,22
Varanthyra,argent-dawn,1463,monk,mistweaver,66,34,32
Германика,soulflayer,1463,monk,mistweaver,395,198,197
Mønía,ysondre,1463,monk,mistweaver,60,25,35
Bigkim,khadgar,1462,monk,mistweaver,36,16,20
Xplosiv,twisting-nether,1461,monk,mistweaver,271,143,128
Farrken,drakthul,1460,monk,mistweaver,55,32,23
Badonna,burning-legion,1460,monk,mistweaver,102,59,43
Россиянин,thermaplugg,1460,monk,mistweaver,78,41,37
Lpm,draenor,1459,monk,mistweaver,56,32,24
Idkfa,sylvanas,1459,monk,mistweaver,79,45,34
Morebuffz,ravencrest,1459,monk,mistweaver,165,88,77
Bîgmø,blades-edge,1459,monk,mistweaver,42,22,20
Salvaje,stormscale,1458,monk,mistweaver,78,46,32
Bendís,twisting-nether,1458,monk,mistweaver,149,77,72
Zaïn,hyjal,1457,monk,mistweaver,85,52,33
Katse,eredar,1457,monk,mistweaver,140,83,57
Atómic,eredar,1457,monk,mistweaver,34,18,16
Muix,draenor,1457,monk,mistweaver,48,23,25
Zenzu,blackmoore,1455,monk,mistweaver,54,34,20
Knäven,defias-brotherhood,1455,monk,mistweaver,48,28,20
Fattysan,argent-dawn,1455,monk,mistweaver,142,76,66
Diabolùs,blackmoore,1454,monk,mistweaver,48,20,28
Marielo,blackmoore,1453,monk,mistweaver,116,63,53
Genjosanso,kazzak,1453,monk,mistweaver,225,122,103
Vicmønk,kazzak,1453,monk,mistweaver,74,40,34
Torqualis,kazzak,1453,monk,mistweaver,358,184,174
Tsifsakari,silvermoon,1453,monk,mistweaver,261,128,133
Monkzdino,destromath,1453,monk,mistweaver,89,43,46
Latsu,silvermoon,1451,monk,mistweaver,42,21,21
Gruslinovica,archimonde,1451,monk,mistweaver,67,31,36
Beerbringer,kazzak,1450,monk,mistweaver,36,24,12
Сестраджосси,gordunni,1450,monk,mistweaver,29,17,12
Zavarius,silvermoon,1450,monk,mistweaver,59,28,31
Wryktas,aegwynn,1449,monk,mistweaver,24,20,4
Toaborsten,tarren-mill,1448,monk,mistweaver,64,54,10
Cocoonkappa,dun-modr,1447,monk,mistweaver,45,27,18
Cmgxbrew,blackrock,1447,monk,mistweaver,41,16,25
Изимонк,gordunni,1446,monk,mistweaver,41,25,16
Ätishâ,archimonde,1446,monk,mistweaver,175,89,86
Zands,ysondre,1445,monk,mistweaver,84,51,33
Madweaver,tarren-mill,1445,monk,mistweaver,52,28,24
Zenified,ragnaros,1444,monk,mistweaver,94,45,49
Chìless,shadowsong,1443,monk,mistweaver,30,21,9
Ônlýféédx,burning-blade,1443,monk,mistweaver,36,16,20
Saïtama,krasus,1442,monk,mistweaver,40,21,19
Брусуко,howling-fjord,1442,monk,mistweaver,40,20,20
Acidflexx,kazzak,1441,monk,mistweaver,69,39,30
Bigbuddha,outland,1441,monk,mistweaver,41,21,20
Caskgut,ravencrest,1440,monk,mistweaver,155,88,67
Furrychan,blackmoore,1440,monk,mistweaver,42,23,19
Mugenzenx,sanguino,1439,monk,mistweaver,24,15,9
Daitaro,ravencrest,1439,monk,mistweaver,92,49,43
Shàllýn,antonidas,1439,monk,mistweaver,48,24,24
Draxed,kazzak,1438,monk,mistweaver,30,20,10
Fuzzypunch,draenor,1438,monk,mistweaver,140,79,61
Moorf,ravencrest,1438,monk,mistweaver,30,15,15
Loganess,sunstrider,1438,monk,mistweaver,36,15,21
Koalazero,kazzak,1437,monk,mistweaver,30,15,15
Futtzi,thrall,1436,monk,mistweaver,59,34,25
Jâdhe,zuljin,1436,monk,mistweaver,48,21,27
Garweaver,frostwolf,1436,monk,mistweaver,36,15,21
Nezuko,kazzak,1435,monk,mistweaver,61,37,24
Icantstopme,argent-dawn,1435,monk,mistweaver,48,29,19
Laggedfist,kazzak,1435,monk,mistweaver,48,28,20
Neverendxx,draenor,1435,monk,mistweaver,68,31,37
Habmit,ravencrest,1434,monk,mistweaver,18,15,3
Musaya,chamber-of-aspects,1434,monk,mistweaver,48,21,27
Bleja,blackhand,1433,monk,mistweaver,262,137,125
Неэверида,deepholm,1433,monk,mistweaver,296,152,144
Neszes,outland,1432,monk,mistweaver,24,15,9
Santanax,ravencrest,1432,monk,mistweaver,30,17,13
Thralg,neptulon,1432,monk,mistweaver,78,44,34
Brêwjob,archimonde,1432,monk,mistweaver,121,67,54
Barks,archimonde,1432,monk,mistweaver,146,79,67
Ryle,forscherliga,1431,monk,mistweaver,54,28,26
Akùmawíns,archimonde,1431,monk,mistweaver,60,30,30
Nievah,argent-dawn,1430,monk,mistweaver,39,24,15
Bréwmáster,silvermoon,1430,monk,mistweaver,56,31,25
Notmelo,dun-modr,1428,monk,mistweaver,30,18,12
Monkgd,sylvanas,1428,monk,mistweaver,152,85,67
Nela,sanguino,1428,monk,mistweaver,72,39,33
Degentz,alakir,1428,monk,mistweaver,86,41,45
Tiashun,argent-dawn,1427,monk,mistweaver,48,28,20
Venac,burning-legion,1427,monk,mistweaver,291,161,130
Скорпин,ashenvale,1426,monk,mistweaver,68,35,33
Tinkerholic,frostmane,1426,monk,mistweaver,332,170,162
Qtonboard,garrosh,1426,monk,mistweaver,165,78,87
Kazutora,archimonde,1425,monk,mistweaver,18,15,3
Mqsxww,stormscale,1425,monk,mistweaver,24,15,9
Achtal,blackmoore,1425,monk,mistweaver,71,38,33
Nrkbob,ysondre,1425,monk,mistweaver,101,54,47
Brewzleè,ravencrest,1425,monk,mistweaver,64,33,31
Letmerollplz,ravencrest,1424,monk,mistweaver,76,47,29
Guanglee,silvermoon,1424,monk,mistweaver,80,49,31
Atenazadonte,sanguino,1424,monk,mistweaver,39,23,16
Néovo,blackmoore,1424,monk,mistweaver,120,65,55
Kungfupandy,blackmoore,1424,monk,mistweaver,298,161,137
Dræk,twisting-nether,1423,monk,mistweaver,91,46,45
Pati,blackrock,1423,monk,mistweaver,189,95,94
Bigchaz,outland,1421,monk,mistweaver,24,15,9
Ikuyaa,ravencrest,1421,monk,mistweaver,29,15,14
Meeralya,ravencrest,1421,monk,mistweaver,42,18,24
Ronocs,turalyon,1420,monk,mistweaver,57,33,24
Peaceweaver,kilrogg,1419,monk,mistweaver,48,30,18
Azouko,onyxia,1419,monk,mistweaver,37,20,17
Imamonk,tarren-mill,1419,monk,mistweaver,30,15,15
Kégman,silvermoon,1418,monk,mistweaver,51,30,21
Woushou,outland,1418,monk,mistweaver,178,98,80
Bukkits,argent-dawn,1418,monk,mistweaver,72,35,37
Pogun,kazzak,1417,monk,mistweaver,24,15,9
Xianxiaa,ravencrest,1417,monk,mistweaver,100,57,43
ßountÿ,kazzak,1416,monk,mistweaver,66,46,20
Xanadoll,outland,1416,monk,mistweaver,30,19,11
Yarie,blackmoore,1416,monk,mistweaver,126,63,63
Flaton,draenor,1415,monk,mistweaver,45,25,20
Luffix,outland,1415,monk,mistweaver,54,29,25
Nexyyfist,kazzak,1415,monk,mistweaver,99,48,51
Drunkenmønk,mannoroth,1414,monk,mistweaver,23,17,6
Moonachi,tarren-mill,1414,monk,mistweaver,72,42,30
Amélith,kirin-tor,1414,monk,mistweaver,60,33,27
Zenvex,tarren-mill,1414,monk,mistweaver,50,27,23
Konïï,dalaran,1414,monk,mistweaver,30,15,15
Fleecymonk,blackmoore,1414,monk,mistweaver,54,23,31
Tacktix,defias-brotherhood,1413,monk,mistweaver,35,22,13
Тефтелъка,soulflayer,1413,monk,mistweaver,52,29,23
Генжуро,blackscar,1413,monk,mistweaver,30,15,15
Ayanaami,pozzo-delleternità,1413,monk,mistweaver,42,17,25
Tílidin,malganis,1412,monk,mistweaver,30,21,9
Lazuros,auchindoun,1412,monk,mistweaver,30,16,14
Newlol,outland,1412,monk,mistweaver,66,34,32
Tily,stormreaver,1411,monk,mistweaver,84,45,39
Suggy,kilrogg,1411,monk,mistweaver,46,24,22
Azkaal,marécage-de-zangar,1410,monk,mistweaver,30,20,10
Drâcømørt,dalaran,1410,monk,mistweaver,57,31,26
Dembe,darksorrow,1410,monk,mistweaver,196,99,97
Eclipsè,dragonmaw,1409,monk,mistweaver,59,34,25
Банзашарик,gordunni,1409,monk,mistweaver,96,54,42
Khakk,elune,1408,monk,mistweaver,36,21,15
Nivi,aegwynn,1408,monk,mistweaver,30,15,15
Piednuques,archimonde,1408,monk,mistweaver,54,22,32
Lucebree,nozdormu,1407,monk,mistweaver,233,129,104
Asmiu,die-aldor,1406,monk,mistweaver,36,23,13
Loth,archimonde,1406,monk,mistweaver,30,17,13
Robertoó,burning-legion,1406,monk,mistweaver,100,56,44
Khapta,ysondre,1406,monk,mistweaver,78,40,38
Nîcko,ravencrest,1405,monk,mistweaver,48,28,20
Spritzbaron,blackmoore,1405,monk,mistweaver,36,16,20
Kazume,pozzo-delleternità,1404,monk,mistweaver,57,35,22
Kroyus,antonidas,1404,monk,mistweaver,164,84,80
Cicera,kazzak,1404,monk,mistweaver,59,25,34
Theichi,draenor,1403,monk,mistweaver,117,65,52
Xfu,auchindoun,1403,monk,mistweaver,142,64,78
Kify,dun-modr,1402,monk,mistweaver,33,19,14
Lunì,nathrezim,1402,monk,mistweaver,42,24,18
Dipdop,blackhand,1401,monk,mistweaver,229,129,100
Tisculaccio,pozzo-delleternità,1401,monk,mistweaver,466,238,228
Hewlz,blackmoore,1401,monk,mistweaver,42,21,21
Шведишпорн,soulflayer,1400,monk,mistweaver,66,40,26
Astolfochan,silvermoon,1400,monk,mistweaver,36,18,18
Неонх,gordunni,1399,monk,mistweaver,24,15,9
Facetimee,ahnqiraj,1399,monk,mistweaver,74,42,32
Mischenka,thrall,1399,monk,mistweaver,90,50,40
Staane,hyjal,1399,monk,mistweaver,48,23,25
Тхэгык,soulflayer,1399,monk,mistweaver,36,15,21
Shakal,outland,1397,monk,mistweaver,72,46,26
Perseverance,illidan,1397,monk,mistweaver,42,26,16
Blackthorens,sylvanas,1396,monk,mistweaver,85,58,27
Lekce,the-maelstrom,1396,monk,mistweaver,28,18,10
Coliusz,bloodhoof,1396,monk,mistweaver,47,19,28
Popcornn,archimonde,1394,monk,mistweaver,66,35,31
Schaulong,blackmoore,1394,monk,mistweaver,108,57,51
Pantyypolice,blackrock,1393,monk,mistweaver,22,16,6
Anadia,blackrock,1393,monk,mistweaver,24,15,9
Folfimo,silvermoon,1393,monk,mistweaver,29,17,12
Nartaran,archimonde,1393,monk,mistweaver,42,16,26
Wontdie,dalaran,1393,monk,mistweaver,90,25,65
Juicyloux,aegwynn,1392,monk,mistweaver,98,64,34
Valdaras,runetotem,1392,monk,mistweaver,36,15,21
Bibidøng,drakthul,1391,monk,mistweaver,36,21,15
Mistsen,kazzak,1391,monk,mistweaver,87,49,38
Hugemuffin,the-maelstrom,1391,monk,mistweaver,372,187,185
Zyphix,twisting-nether,1391,monk,mistweaver,42,19,23
Spittq,ysondre,1390,monk,mistweaver,81,48,33
Baddany,sanguino,1390,monk,mistweaver,102,57,45
Malfius,shadowsong,1390,monk,mistweaver,58,32,26
Rasputín,draenor,1390,monk,mistweaver,124,66,58
Zukatan,tarren-mill,1389,monk,mistweaver,136,77,59
Рекилоллз,gordunni,1389,monk,mistweaver,130,69,61
Kungfubatti,stormscale,1389,monk,mistweaver,219,116,103
Puddinpop,auchindoun,1389,monk,mistweaver,91,42,49
Mistfistmw,outland,1389,monk,mistweaver,98,45,53
Zenmist,kazzak,1388,monk,mistweaver,29,15,14
Gottegrisen,sylvanas,1388,monk,mistweaver,69,34,35
Cypriot,mazrigos,1387,monk,mistweaver,89,57,32
Greenshortea,aegwynn,1387,monk,mistweaver,62,34,28
Монкпех,gordunni,1387,monk,mistweaver,153,78,75
Vuzashiji,argent-dawn,1387,monk,mistweaver,139,69,70
Monkhônk,blackmoore,1386,monk,mistweaver,59,28,31
Cybert,blackmoore,1386,monk,mistweaver,70,28,42
Adamlól,tarren-mill,1386,monk,mistweaver,44,17,27
Nahir,ragnaros,1385,monk,mistweaver,106,52,54
Keksmash,ravencrest,1385,monk,mistweaver,80,38,42
Mythadeya,stormscale,1385,monk,mistweaver,90,39,51
Eniyl,hyjal,1384,monk,mistweaver,84,40,44
Саинтифик,gordunni,1384,monk,mistweaver,42,19,23
Котэлатэ,gordunni,1384,monk,mistweaver,50,22,28
Smmithyy,draenor,1383,monk,mistweaver,40,22,18
Roidcarry,blackrock,1383,monk,mistweaver,41,16,25
Jumper,xavius,1382,monk,mistweaver,48,29,19
Striptina,blackmoore,1382,monk,mistweaver,90,49,41
Oregan,conseil-des-ombres,1382,monk,mistweaver,113,59,54
Fizted,tarren-mill,1382,monk,mistweaver,59,30,29
Pandacus,silvermoon,1381,monk,mistweaver,90,40,50
Haxxo,die-nachtwache,1380,monk,mistweaver,68,40,28
Sandbox,aszune,1380,monk,mistweaver,29,15,14
Bulletproof,bloodscalp,1379,monk,mistweaver,127,71,56
Kruemelkeks,frostwolf,1378,monk,mistweaver,57,33,24
Kobudo,burning-legion,1378,monk,mistweaver,203,93,110
Fatskeleton,stormreaver,1378,monk,mistweaver,457,209,248
Awesomebrah,the-maelstrom,1377,monk,mistweaver,24,15,9
Monqt,sylvanas,1377,monk,mistweaver,66,40,26
Gigilonis,korgall,1377,monk,mistweaver,257,138,119
Rakowo,arthas,1377,monk,mistweaver,30,16,14
Grintilif,malygos,1376,monk,mistweaver,36,23,13
Chàrràth,blackmoore,1376,monk,mistweaver,285,138,147
Сильфиета,gordunni,1375,monk,mistweaver,75,43,32
Xladerzz,kazzak,1374,monk,mistweaver,23,15,8
Ninpou,blackrock,1374,monk,mistweaver,62,35,27
Jarô,silvermoon,1374,monk,mistweaver,130,58,72
Hackyback,outland,1373,monk,mistweaver,75,50,25
Xwtdreamz,hyjal,1373,monk,mistweaver,139,72,67
Portugas,aegwynn,1373,monk,mistweaver,54,22,32
Freebírd,shattered-hand,1372,monk,mistweaver,75,44,31
Rhemm,the-maelstrom,1372,monk,mistweaver,101,52,49
Sshbrew,kazzak,1372,monk,mistweaver,60,28,32
Plasticbag,ravencrest,1371,monk,mistweaver,98,63,35
Swiftmonky,azuremyst,1371,monk,mistweaver,35,15,20
Rollsamdi,tarren-mill,1370,monk,mistweaver,63,37,26
Тиктокмонк,gordunni,1369,monk,mistweaver,55,22,33
Nausìcaa,defias-brotherhood,1368,monk,mistweaver,30,20,10
Kirtachi,dun-modr,1368,monk,mistweaver,23,15,8
Pandalezanda,silvermoon,1368,monk,mistweaver,63,40,23
Jeydi,ravencrest,1368,monk,mistweaver,97,52,45
Trancendent,silvermoon,1368,monk,mistweaver,34,15,19
Faa,archimonde,1367,monk,mistweaver,23,17,6
Fistmeg,grim-batol,1367,monk,mistweaver,47,16,31
Horriblemonk,archimonde,1366,monk,mistweaver,36,21,15
Krylin,antonidas,1366,monk,mistweaver,165,83,82
Beaglemo,blackrock,1366,monk,mistweaver,35,15,20
Coollann,drakthul,1364,monk,mistweaver,64,29,35
Tøngpø,argent-dawn,1363,monk,mistweaver,30,18,12
Carloz,drakthul,1363,monk,mistweaver,110,63,47
Nìkâ,blackmoore,1363,monk,mistweaver,93,52,41
Sadfacetiki,kazzak,1363,monk,mistweaver,81,34,47
Vetocorleone,kazzak,1362,monk,mistweaver,190,99,91
Masumi,sanguino,1362,monk,mistweaver,88,43,45
Gilario,silvermoon,1361,monk,mistweaver,132,66,66
Blaeys,blackmoore,1360,monk,mistweaver,81,48,33
Charlett,the-venture-co,1360,monk,mistweaver,52,28,24
Gråce,nemesis,1360,monk,mistweaver,296,155,141
Kravmaghar,arthas,1359,monk,mistweaver,36,20,16
Monkehst,dun-modr,1359,monk,mistweaver,120,61,59
Wøw,blackrock,1358,monk,mistweaver,24,17,7
Aznreznzfdqs,grim-batol,1356,monk,mistweaver,42,27,15
Nevelbeast,rexxar,1356,monk,mistweaver,69,38,31
Bigdickmonk,blackmoore,1356,monk,mistweaver,81,41,40
Rëliq,wildhammer,1355,monk,mistweaver,30,16,14
Allosthenos,ravencrest,1355,monk,mistweaver,141,72,69
Créo,azjolnerub,1355,monk,mistweaver,54,27,27
Pechu,blackhand,1355,monk,mistweaver,33,15,18
Papasan,aggramar,1354,monk,mistweaver,66,37,29
Medovic,blackmoore,1354,monk,mistweaver,262,137,125
Ðømínus,blackmoore,1354,monk,mistweaver,160,82,78
Thayne,blades-edge,1354,monk,mistweaver,30,15,15
Melikicks,silvermoon,1354,monk,mistweaver,42,19,23
Pusityv,silvermoon,1353,monk,mistweaver,66,35,31
Abrra,burning-legion,1353,monk,mistweaver,36,15,21
Адскиймех,deathweaver,1352,monk,mistweaver,111,58,53
Saolin,emeriss,1352,monk,mistweaver,90,46,44
Eltonj,sylvanas,1351,monk,mistweaver,142,82,60
Muaba,outland,1351,monk,mistweaver,58,27,31
Nasaislying,grim-batol,1350,monk,mistweaver,102,57,45
Rbgmachine,burning-legion,1350,monk,mistweaver,54,28,26
Wwz,hyjal,1350,monk,mistweaver,142,61,81
Gwynelin,argent-dawn,1348,monk,mistweaver,26,17,9
Konexzx,blackmoore,1348,monk,mistweaver,42,24,18
Touchofmonk,draenor,1348,monk,mistweaver,48,26,22
Loreo,burning-legion,1348,monk,mistweaver,213,115,98
Фериго,gordunni,1348,monk,mistweaver,119,62,57
Garfeels,sylvanas,1347,monk,mistweaver,24,16,8
Brewsclues,twisting-nether,1347,monk,mistweaver,30,15,15
Kwacisawhe,die-aldor,1347,monk,mistweaver,56,25,31
Lìtenstrumpa,sylvanas,1346,monk,mistweaver,66,34,32
Bråin,ravenholdt,1346,monk,mistweaver,54,27,27
Jollaz,twisting-nether,1345,monk,mistweaver,29,15,14
Chucknorrís,ragnaros,1344,monk,mistweaver,34,15,19
Meo,emeriss,1344,monk,mistweaver,42,17,25
Lennifer,ragnaros,1343,monk,mistweaver,18,14,4
Chigee,kazzak,1343,monk,mistweaver,30,18,12
Chochinbi,garrosh,1343,monk,mistweaver,42,25,17
Dunkfjås,stormscale,1343,monk,mistweaver,24,14,10
Gemil,argent-dawn,1343,monk,mistweaver,24,14,10
Coalsack,outland,1343,monk,mistweaver,28,15,13
Jamonkal,blackhand,1343,monk,mistweaver,39,18,21
Irønmaxx,die-aldor,1342,monk,mistweaver,24,14,10
Unluckyday,ragnaros,1342,monk,mistweaver,64,37,27
Kryopumper,blackmoore,1342,monk,mistweaver,120,63,57
Firefîst,blackmoore,1341,monk,mistweaver,18,14,4
Vibemonk,outland,1341,monk,mistweaver,18,14,4
Lfmasctop,ravencrest,1341,monk,mistweaver,25,19,6
Boytoyfist,ravencrest,1341,monk,mistweaver,24,14,10
Åshêrs,stormscale,1341,monk,mistweaver,45,25,20
Panzergonk,ravencrest,1340,monk,mistweaver,18,14,4
Mvpßæ,stormscale,1340,monk,mistweaver,90,50,40
Ðoom,sylvanas,1340,monk,mistweaver,123,60,63
Roudious,arathi,1340,monk,mistweaver,30,14,16
Herdom,blackmoore,1339,monk,mistweaver,59,39,20
Urict,hyjal,1339,monk,mistweaver,30,16,14
Tobiboby,burning-legion,1339,monk,mistweaver,82,43,39
Квиор,deathguard,1339,monk,mistweaver,48,24,24
Sideswipes,the-maelstrom,1339,monk,mistweaver,52,25,27
Elasha,archimonde,1338,monk,mistweaver,25,16,9
Ùrìel,dalaran,1338,monk,mistweaver,42,23,19
Tokkz,eredar,1337,monk,mistweaver,20,17,3
Jeññie,stormscale,1337,monk,mistweaver,18,14,4
Yàfa,archimonde,1337,monk,mistweaver,24,14,10
Chillimonk,antonidas,1337,monk,mistweaver,33,17,16
Permajuist,tarren-mill,1336,monk,mistweaver,18,14,4
Sinzy,dentarg,1336,monk,mistweaver,36,21,15
Pämella,alleria,1334,monk,mistweaver,36,26,10
Ráây,blackrock,1334,monk,mistweaver,55,34,21
Toastmonk,outland,1334,monk,mistweaver,24,14,10
Picayune,mazrigos,1334,monk,mistweaver,119,63,56
Onlyfísts,stormscale,1334,monk,mistweaver,54,20,34
Shainingzer,ysondre,1333,monk,mistweaver,28,15,13
Tastyfists,blackmoore,1333,monk,mistweaver,36,19,17
Weavi,kazzak,1333,monk,mistweaver,77,39,38
Maqs,argent-dawn,1331,monk,mistweaver,42,27,15
Choochoo,archimonde,1331,monk,mistweaver,48,22,26
Zøubida,draenor,1330,monk,mistweaver,36,21,15
Dunderfix,tarren-mill,1330,monk,mistweaver,72,41,31
Riip,ysondre,1330,monk,mistweaver,30,17,13
Monkjakt,draenor,1330,monk,mistweaver,42,17,25
Виноипиво,soulflayer,1330,monk,mistweaver,64,25,39
Køshka,archimonde,1329,monk,mistweaver,18,14,4
Draxaxa,hyjal,1329,monk,mistweaver,52,29,23
Pvppenergy,silvermoon,1329,monk,mistweaver,54,28,26
Galaxumi,ragnaros,1329,monk,mistweaver,42,21,21
Anqan,outland,1329,monk,mistweaver,30,14,16
Muleerom,kazzak,1329,monk,mistweaver,30,14,16
Midgetyoda,outland,1329,monk,mistweaver,46,20,26
Sajin,la-croisade-écarlate,1329,monk,mistweaver,36,15,21
Пекинес,gordunni,1329,monk,mistweaver,37,15,22
Sÿldae,dun-modr,1328,monk,mistweaver,30,21,9
Lofe,drakthul,1328,monk,mistweaver,30,14,16
Zondanmw,aegwynn,1327,monk,mistweaver,24,14,10
Beesquared,stormrage,1327,monk,mistweaver,99,55,44
Yâssu,archimonde,1327,monk,mistweaver,33,18,15
Moistyheals,kazzak,1327,monk,mistweaver,86,42,44
Hyggefingerm,ravencrest,1326,monk,mistweaver,24,16,8
Cudworth,silvermoon,1326,monk,mistweaver,90,59,31
Ariluna,tarren-mill,1326,monk,mistweaver,24,14,10
Grenreaper,twisting-nether,1326,monk,mistweaver,30,14,16
Menazera,antonidas,1326,monk,mistweaver,87,39,48
Salix,quelthalas,1325,monk,mistweaver,38,23,15
Monkinamight,turalyon,1325,monk,mistweaver,54,31,23
Meehx,ravencrest,1324,monk,mistweaver,18,14,4
Zozaar,stormscale,1324,monk,mistweaver,18,14,4
Kapauww,twisting-nether,1324,monk,mistweaver,48,26,22
Звиздаатый,blackscar,1323,monk,mistweaver,42,26,16
Eonyzi,kazzak,1323,monk,mistweaver,66,40,26
Lcflay,archimonde,1323,monk,mistweaver,117,64,53
Akalaja,alakir,1323,monk,mistweaver,52,28,24
Saimheal,blackrock,1322,monk,mistweaver,23,15,8
Xevol,burning-legion,1322,monk,mistweaver,37,22,15
Doyoubleed,twisting-nether,1322,monk,mistweaver,30,14,16
Fraideberoa,ravencrest,1321,monk,mistweaver,42,30,12
Moonica,zenedar,1320,monk,mistweaver,38,23,15
Lovange,silvermoon,1320,monk,mistweaver,24,14,10
Moreløs,stormscale,1320,monk,mistweaver,66,37,29
Миамита,eversong,1320,monk,mistweaver,113,58,55
Renegatt,twisting-nether,1320,monk,mistweaver,30,14,16
Mîla,sylvanas,1319,monk,mistweaver,42,26,16
Rhynne,ysondre,1319,monk,mistweaver,42,25,17
Winwalker,archimonde,1319,monk,mistweaver,30,16,14
Badcøwboy,archimonde,1319,monk,mistweaver,131,56,75
Sylicia,alleria,1318,monk,mistweaver,42,23,19
Mécagnóme,dalaran,1318,monk,mistweaver,113,58,55
Homechan,burning-legion,1317,monk,mistweaver,24,15,9
Yahní,eredar,1317,monk,mistweaver,169,88,81
Хромдар,gordunni,1316,monk,mistweaver,38,21,17
Erenaar,nemesis,1315,monk,mistweaver,54,30,24
Thegrudge,dragonblight,1315,monk,mistweaver,42,16,26
Kîârâ,frostwolf,1314,monk,mistweaver,52,30,22
Sêssai,outland,1313,monk,mistweaver,56,36,20
Stolas,spinebreaker,1313,monk,mistweaver,68,41,27
Aykin,ravencrest,1313,monk,mistweaver,30,18,12
Galaxyfist,ragnaros,1313,monk,mistweaver,230,120,110
Brewswíllis,tarren-mill,1312,monk,mistweaver,18,14,4
Pinkstar,kazzak,1312,monk,mistweaver,24,15,9
Tuppence,defias-brotherhood,1312,monk,mistweaver,24,14,10
Bruceflea,blackrock,1312,monk,mistweaver,210,111,99
Szilvia,sylvanas,1312,monk,mistweaver,96,50,46
Lioky,eredar,1312,monk,mistweaver,54,26,28
Tality,outland,1312,monk,mistweaver,42,19,23
Monkani,ravencrest,1311,monk,mistweaver,42,23,19
Mofisto,bladefist,1311,monk,mistweaver,78,42,36
Blinkër,sanguino,1311,monk,mistweaver,36,19,17
Leefang,neptulon,1311,monk,mistweaver,49,24,25
Kassducu,archimonde,1310,monk,mistweaver,45,31,14
Leyira,blackmoore,1310,monk,mistweaver,65,42,23
Shaosshoshin,exodar,1310,monk,mistweaver,54,31,23
Rèddit,kazzak,1310,monk,mistweaver,78,37,41
Ролитта,gordunni,1309,monk,mistweaver,42,25,17
Ragnametal,tarren-mill,1309,monk,mistweaver,46,25,21
Rhuru,argent-dawn,1309,monk,mistweaver,61,32,29
Garmuth,tarren-mill,1307,monk,mistweaver,52,28,24
Токасзавода,soulflayer,1305,monk,mistweaver,52,34,18
Revii,anubarak,1305,monk,mistweaver,30,14,16
Katharína,azuremyst,1305,monk,mistweaver,66,27,39
Nosenz,ravencrest,1304,monk,mistweaver,70,35,35
Mulana,sanguino,1304,monk,mistweaver,30,14,16
Kenzmist,stormrage,1303,monk,mistweaver,34,27,7
Fetchd,blackmoore,1303,monk,mistweaver,38,23,15
Brewm,silvermoon,1302,monk,mistweaver,36,20,16
Lésley,ravencrest,1302,monk,mistweaver,66,35,31
Rorkito,sanguino,1302,monk,mistweaver,58,30,28
Tondi,malygos,1302,monk,mistweaver,34,17,17
Monkyou,hyjal,1301,monk,mistweaver,155,89,66
Murdalum,ravencrest,1301,monk,mistweaver,30,17,13
Snitzla,drakthul,1300,monk,mistweaver,45,35,10
Mareki,nethersturm,1300,monk,mistweaver,111,62,49
Trivi,blackrock,1300,monk,mistweaver,69,37,32
Lïtäø,archimonde,1300,monk,mistweaver,54,26,28
Pandage,darksorrow,1300,monk,mistweaver,63,25,38
Moinalisaa,outland,1299,monk,mistweaver,30,18,12
Poklicka,deathwing,1298,monk,mistweaver,30,24,6
Tossen,ragnaros,1298,monk,mistweaver,30,17,13
Sasedawd,outland,1297,monk,mistweaver,33,17,16
Kaztruman,draenor,1296,monk,mistweaver,76,33,43
Erzull,doomhammer,1295,monk,mistweaver,92,52,40
Stegtflæsk,ravencrest,1295,monk,mistweaver,74,39,35
Hîtmachine,twisting-nether,1294,monk,mistweaver,34,22,12
Joübar,archimonde,1293,monk,mistweaver,30,17,13
Dánný,antonidas,1293,monk,mistweaver,95,51,44
Mku,kazzak,1292,monk,mistweaver,27,15,12
Cocoxo,twisting-nether,1291,monk,mistweaver,15,15,0
Loorda,neptulon,1291,monk,mistweaver,66,36,30
Mórrid,draenor,1291,monk,mistweaver,54,28,26
Bréwsléé,ragnaros,1290,monk,mistweaver,27,16,11
Durand,blackhand,1290,monk,mistweaver,36,18,18
Tnt,antonidas,1290,monk,mistweaver,75,35,40
Nosugars,tarren-mill,1288,monk,mistweaver,18,14,4
Bláckøutx,quelthalas,1288,monk,mistweaver,103,53,50
Shenson,mazrigos,1288,monk,mistweaver,73,35,38
Keímohansio,twisting-nether,1288,monk,mistweaver,30,14,16
Daltailr,silvermoon,1287,monk,mistweaver,66,29,37
Draenan,blackrock,1286,monk,mistweaver,24,15,9
Wangwang,outland,1286,monk,mistweaver,24,14,10
Flexxus,ravencrest,1286,monk,mistweaver,29,14,15
Tekwandn,shattrath,1285,monk,mistweaver,62,35,27
Kswis,outland,1284,monk,mistweaver,98,46,52
Йомо,borean-tundra,1284,monk,mistweaver,72,28,44
Mondrim,burning-legion,1283,monk,mistweaver,265,130,135
Wrathing,tarren-mill,1282,monk,mistweaver,24,18,6
Хэйхати,gordunni,1282,monk,mistweaver,164,82,82
Гиббискус,gordunni,1282,monk,mistweaver,66,28,38
Pml,ravencrest,1282,monk,mistweaver,42,14,28
Fistweavr,antonidas,1281,monk,mistweaver,64,32,32
Saintmoon,drakthul,1279,monk,mistweaver,111,60,51
Heyami,ravencrest,1279,monk,mistweaver,76,26,50
Masimonk,blackrock,1278,monk,mistweaver,35,22,13
Lûxz,ragnaros,1278,monk,mistweaver,66,30,36
Ashulera,archimonde,1278,monk,mistweaver,55,23,32
Numpys,sanguino,1277,monk,mistweaver,29,14,15
Slâpzz,ravencrest,1276,monk,mistweaver,18,15,3
Safíx,hyjal,1276,monk,mistweaver,47,26,21
Декстрометор,greymane,1275,monk,mistweaver,24,14,10
Fhengwei,outland,1274,monk,mistweaver,24,14,10
Brofist,emeriss,1274,monk,mistweaver,103,42,61
Brizs,outland,1273,monk,mistweaver,167,98,69
Nathaanel,argent-dawn,1273,monk,mistweaver,143,81,62
Ksll,silvermoon,1273,monk,mistweaver,72,35,37
Marrave,chogall,1273,monk,mistweaver,130,57,73
Cranecannon,aegwynn,1272,monk,mistweaver,24,14,10
Carnat,blackrock,1272,monk,mistweaver,47,25,22
Anya,boulderfist,1272,monk,mistweaver,42,19,23
Drpajhiwo,burning-legion,1271,monk,mistweaver,58,34,24
Drboombay,kazzak,1271,monk,mistweaver,68,36,32
Profylaxist,arathor,1271,monk,mistweaver,149,73,76
Bloodpanci,ragnaros,1270,monk,mistweaver,57,32,25
Adzk,tarren-mill,1270,monk,mistweaver,60,30,30
Akkri,tarren-mill,1270,monk,mistweaver,36,17,19
Hialdó,sylvanas,1269,monk,mistweaver,48,26,22
Monkstains,the-maelstrom,1268,monk,mistweaver,24,17,7
Sukisukí,ragnaros,1268,monk,mistweaver,88,49,39
Chainster,defias-brotherhood,1268,monk,mistweaver,94,49,45
Mishax,draenor,1268,monk,mistweaver,84,41,43
Moinopoly,archimonde,1267,monk,mistweaver,30,17,13
Hazeroamer,tarren-mill,1267,monk,mistweaver,48,26,22
Pawnzqt,stormscale,1267,monk,mistweaver,36,19,17
Джоский,borean-tundra,1267,monk,mistweaver,136,60,76
Bizzet,jaedenar,1266,monk,mistweaver,57,30,27
Pandathiss,argent-dawn,1265,monk,mistweaver,48,27,21
Sandrafarm,ragnaros,1264,monk,mistweaver,126,78,48
Mickjabber,aegwynn,1263,monk,mistweaver,66,35,31
Bluum,ravencrest,1263,monk,mistweaver,54,23,31
Neylin,stormscale,1262,monk,mistweaver,137,65,72
Трикленд,azuregos,1262,monk,mistweaver,72,34,38
Monkeytoast,ahnqiraj,1261,monk,mistweaver,45,29,16
Karatemonk,stormscale,1261,monk,mistweaver,54,23,31
Bîmbâmboom,blackmoore,1260,monk,mistweaver,67,34,33
Perraviciosa,sanguino,1260,monk,mistweaver,48,24,24
Monkypunch,tarren-mill,1260,monk,mistweaver,87,40,47
Сигакрю,howling-fjord,1259,monk,mistweaver,39,24,15
Bbigttgothgf,doomhammer,1258,monk,mistweaver,24,14,10
Macgyverr,outland,1258,monk,mistweaver,24,14,10
Rotkäppchen,blackmoore,1258,monk,mistweaver,65,33,32
Shyasianmonk,eitrigg,1257,monk,mistweaver,24,14,10
Egwane,argent-dawn,1257,monk,mistweaver,158,77,81
Yèna,pozzo-delleternità,1257,monk,mistweaver,371,179,192
Zyneswalker,blackhand,1257,monk,mistweaver,59,27,32
Chígoku,grim-batol,1257,monk,mistweaver,52,23,29
Jázzhands,draenor,1256,monk,mistweaver,76,40,36
Malkaviano,kazzak,1256,monk,mistweaver,172,85,87
Applemonk,tarren-mill,1256,monk,mistweaver,76,35,41
Мирксимонк,soulflayer,1256,monk,mistweaver,35,16,19
Mestro,argent-dawn,1255,monk,mistweaver,172,94,78
Houzagackel,blackrock,1254,monk,mistweaver,72,32,40
Yorlena,malganis,1253,monk,mistweaver,35,23,12
Томтью,gordunni,1253,monk,mistweaver,321,161,160
Stâhlfaust,antonidas,1253,monk,mistweaver,32,15,17
Amemiya,sanguino,1252,monk,mistweaver,128,65,63
Jabarwackie,kiljaeden,1251,monk,mistweaver,24,19,5
Yokuboo,ysondre,1251,monk,mistweaver,78,41,37
Bigfister,frostwhisper,1251,monk,mistweaver,36,14,22
Gozen,blackmoore,1250,monk,mistweaver,48,29,19
Orctagon,tarren-mill,1250,monk,mistweaver,26,15,11
Snack,mannoroth,1249,monk,mistweaver,52,29,23
Zel,dentarg,1247,monk,mistweaver,36,22,14
Inline,antonidas,1247,monk,mistweaver,24,13,11
Catmønk,drakthul,1247,monk,mistweaver,24,13,11
Div,malygos,1247,monk,mistweaver,30,13,17
Badwithnames,stormscale,1246,monk,mistweaver,18,13,5
Kyramea,aegwynn,1246,monk,mistweaver,18,13,5
Nesthorian,draenor,1246,monk,mistweaver,123,61,62
Мистерхюй,gordunni,1246,monk,mistweaver,144,68,76
Elusen,kazzak,1245,monk,mistweaver,18,13,5
Kakos,eldrethalas,1245,monk,mistweaver,39,27,12
Níki,earthen-ring,1245,monk,mistweaver,30,20,10
Psyhooz,burning-legion,1245,monk,mistweaver,56,35,21
Worf,haomarush,1245,monk,mistweaver,78,43,35
Deore,kazzak,1245,monk,mistweaver,24,13,11
Темарон,gordunni,1245,monk,mistweaver,48,25,23
Tazerfess,culte-de-la-rive-noire,1245,monk,mistweaver,30,13,17
Gedzio,silvermoon,1245,monk,mistweaver,40,15,25
Momomonku,hyjal,1244,monk,mistweaver,18,13,5
Rôckcat,blackrock,1244,monk,mistweaver,54,32,22
Kunolis,kazzak,1244,monk,mistweaver,42,22,20
Karatelady,twisting-nether,1244,monk,mistweaver,27,14,13
Skaadoosh,aggra-português,1244,monk,mistweaver,80,37,43
Snooponk,kazzak,1244,monk,mistweaver,48,17,31
Shêd,sargeras,1243,monk,mistweaver,60,29,31
Orenjis,kazzak,1242,monk,mistweaver,71,30,41
Snackis,blackmoore,1241,monk,mistweaver,30,13,17
Chibuku,burning-legion,1240,monk,mistweaver,24,13,11
Дезмимонк,ashenvale,1240,monk,mistweaver,24,13,11
Smdone,drakthul,1239,monk,mistweaver,18,13,5
Tolk,ravencrest,1239,monk,mistweaver,66,37,29
Freemann,archimonde,1239,monk,mistweaver,411,207,204
Fernasmonk,aggra-português,1238,monk,mistweaver,36,23,13
Fiddle,archimonde,1238,monk,mistweaver,24,13,11
Виброолег,gordunni,1238,monk,mistweaver,24,13,11
Stinkerella,blackhand,1238,monk,mistweaver,42,22,20
Kärmma,sanguino,1238,monk,mistweaver,66,28,38
Такиера,gordunni,1237,monk,mistweaver,24,13,11
Sydras,silvermoon,1237,monk,mistweaver,741,375,366
Dargaron,tarren-mill,1237,monk,mistweaver,48,19,29
Ugras,auchindoun,1237,monk,mistweaver,54,17,37
Spinalot,eredar,1236,monk,mistweaver,18,13,5
Phyin,onyxia,1236,monk,mistweaver,18,13,5
Norualy,tichondrius,1236,monk,mistweaver,65,35,30
Marryonlyfan,twisting-nether,1236,monk,mistweaver,30,14,16
Mcloving,turalyon,1236,monk,mistweaver,41,18,23
Assfist,drakthul,1235,monk,mistweaver,152,82,70
Boredom,wildhammer,1235,monk,mistweaver,133,70,63
Azoka,cthun,1235,monk,mistweaver,52,24,28
Bensó,stormscale,1234,monk,mistweaver,81,51,30
Gozgajr,twisting-nether,1234,monk,mistweaver,103,48,55
Limpópó,bloodfeather,1233,monk,mistweaver,59,38,21
Monksim,outland,1232,monk,mistweaver,66,30,36
Rumiñawi,ravencrest,1232,monk,mistweaver,49,19,30
Rgkekw,dun-modr,1231,monk,mistweaver,117,64,53
Stenhård,azjolnerub,1231,monk,mistweaver,60,27,33
Celph,kazzak,1231,monk,mistweaver,30,13,17
Pepesmacks,kazzak,1230,monk,mistweaver,24,13,11
Yeetkunmeep,outland,1230,monk,mistweaver,90,42,48
Saimonk,malganis,1230,monk,mistweaver,35,14,21
Chingbag,dalaran,1229,monk,mistweaver,18,13,5
Mcronald,blackhand,1229,monk,mistweaver,90,50,40
Fooriyanker,tarren-mill,1229,monk,mistweaver,55,30,25
Shiftchenko,stormscale,1228,monk,mistweaver,92,51,41
Meihuaquan,ravencrest,1228,monk,mistweaver,24,13,11
Toon,eredar,1228,monk,mistweaver,142,69,73
Togahoshy,antonidas,1227,monk,mistweaver,70,34,36
Relaxis,teldrassil,1226,monk,mistweaver,54,29,25
Chitun,malganis,1225,monk,mistweaver,22,14,8
Chiá,tarren-mill,1225,monk,mistweaver,151,80,71
Rayvi,kiljaeden,1224,monk,mistweaver,18,13,5
Vatsmijter,silvermoon,1224,monk,mistweaver,27,14,13
Suigintirno,twisting-nether,1223,monk,mistweaver,24,13,11
Matteliito,silvermoon,1222,monk,mistweaver,73,41,32
Jetchi,twisting-nether,1222,monk,mistweaver,131,71,60
Phrynè,silvermoon,1222,monk,mistweaver,55,29,26
Тэсси,blackscar,1222,monk,mistweaver,44,19,25
Gammelbruno,azshara,1221,monk,mistweaver,76,38,38
Ivi,neptulon,1220,monk,mistweaver,76,40,36
Tripitakâ,dun-modr,1220,monk,mistweaver,65,30,35
Zandoy,draenor,1219,monk,mistweaver,24,13,11
Лелейная,gordunni,1219,monk,mistweaver,26,13,13
Onlybench,ysondre,1219,monk,mistweaver,54,26,28
Radrielinda,veknilash,1218,monk,mistweaver,23,14,9
Creatinin,ragnaros,1217,monk,mistweaver,54,28,26
Evelios,blackmoore,1217,monk,mistweaver,65,33,32
Wûcm,silvermoon,1216,monk,mistweaver,29,13,16
Hæbitz,blackrock,1215,monk,mistweaver,24,13,11
Белыйрасист,gordunni,1215,monk,mistweaver,36,13,23
Jozo,hyjal,1214,monk,mistweaver,48,23,25
Umagon,chogall,1214,monk,mistweaver,143,65,78
Valky,bloodfeather,1213,monk,mistweaver,95,56,39
Glivilalis,drekthar,1213,monk,mistweaver,64,32,32
Trymax,blackmoore,1213,monk,mistweaver,57,23,34
Aíkô,dun-morogh,1212,monk,mistweaver,18,13,5
Bhasundara,turalyon,1212,monk,mistweaver,88,51,37
Lilniccí,blackrock,1210,monk,mistweaver,62,34,28
Nezukoko,archimonde,1209,monk,mistweaver,22,13,9
Siouxxsie,thunderhorn,1208,monk,mistweaver,292,137,155
Nainketx,ravencrest,1208,monk,mistweaver,29,13,16
Pawfong,draenor,1207,monk,mistweaver,84,49,35
Diplicious,ragnaros,1206,monk,mistweaver,24,13,11
Trimperlow,blackmoore,1205,monk,mistweaver,30,14,16
Helixsfist,outland,1204,monk,mistweaver,23,13,10
Vladikus,tarren-mill,1204,monk,mistweaver,233,110,123
Heretogo,draenor,1203,monk,mistweaver,84,47,37
Køudbeap,archimonde,1202,monk,mistweaver,42,22,20
Wtfmonk,twisting-nether,1200,monk,mistweaver,47,28,19
Glavniuhordi,twisting-nether,1200,monk,mistweaver,28,14,14
Blackmonk,chromaggus,1199,monk,mistweaver,27,16,11
Brewsmaster,archimonde,1199,monk,mistweaver,53,24,29
Wôôp,blackrock,1198,monk,mistweaver,48,26,22
Tintatama,aszune,1198,monk,mistweaver,160,75,85
Нимоник,soulflayer,1198,monk,mistweaver,96,44,52
Ogpandapo,stormscale,1198,monk,mistweaver,223,99,124
Lugoxi,the-maelstrom,1196,monk,mistweaver,72,38,34
Алли,lich-king,1196,monk,mistweaver,90,37,53
Mislaw,silvermoon,1195,monk,mistweaver,33,22,11
Ricksancez,nemesis,1194,monk,mistweaver,30,20,10
Bierbestie,eredar,1194,monk,mistweaver,48,26,22
Superuser,tarren-mill,1194,monk,mistweaver,37,19,18
Октай,gordunni,1193,monk,mistweaver,46,31,15
Stow,kazzak,1193,monk,mistweaver,21,13,8
Reòl,blackmoore,1193,monk,mistweaver,24,13,11
Vattghern,blackhand,1192,monk,mistweaver,129,61,68
Lubeï,kirin-tor,1191,monk,mistweaver,94,52,42
Windspirit,darksorrow,1191,monk,mistweaver,72,29,43
Kayen,frostwhisper,1190,monk,mistweaver,208,110,98
Wteg,emerald-dream,1190,monk,mistweaver,93,41,52
Jifun,kazzak,1189,monk,mistweaver,24,13,11
Kaizenthor,runetotem,1189,monk,mistweaver,48,15,33
Ewynamonk,silvermoon,1188,monk,mistweaver,24,14,10
Зрти,gordunni,1188,monk,mistweaver,30,15,15
Faares,tarren-mill,1188,monk,mistweaver,30,15,15
Mitsukiseven,ravencrest,1188,monk,mistweaver,48,21,27
Liveitup,kazzak,1187,monk,mistweaver,18,14,4
Hvnm,ravencrest,1186,monk,mistweaver,266,136,130
Putrezitu,ragnaros,1186,monk,mistweaver,51,26,25
Янезнаюкенни,soulflayer,1186,monk,mistweaver,110,51,59
Skrøn,kult-der-verdammten,1184,monk,mistweaver,21,16,5
Schlaganfall,outland,1184,monk,mistweaver,49,25,24
Nyrkkiseski,outland,1183,monk,mistweaver,17,13,4
Celestine,mugthol,1183,monk,mistweaver,243,126,117
Shiyonô,aegwynn,1183,monk,mistweaver,29,15,14
Yunziwo,nemesis,1183,monk,mistweaver,30,15,15
Hadesboss,ravencrest,1182,monk,mistweaver,43,23,20
Betelgeuse,jaedenar,1181,monk,mistweaver,88,33,55
Brünó,kazzak,1180,monk,mistweaver,116,71,45
Eucalyptuz,draenor,1178,monk,mistweaver,30,14,16
Highmonktain,alakir,1177,monk,mistweaver,41,25,16
Gârdt,blackmoore,1176,monk,mistweaver,108,63,45
Badonkamonk,twilights-hammer,1176,monk,mistweaver,68,36,32
Яутжа,soulflayer,1176,monk,mistweaver,36,19,17
Elainmonk,thrall,1175,monk,mistweaver,17,13,4
Wotaner,eredar,1174,monk,mistweaver,30,14,16
Kelechi,stormreaver,1172,monk,mistweaver,32,13,19
Шотгар,howling-fjord,1171,monk,mistweaver,42,18,24
Mistmama,malganis,1169,monk,mistweaver,18,14,4
Pussochkram,ravencrest,1167,monk,mistweaver,30,18,12
Журлина,eversong,1167,monk,mistweaver,60,34,26
Carcasce,la-croisade-écarlate,1166,monk,mistweaver,86,47,39
Ndj,hyjal,1165,monk,mistweaver,35,21,14
Akiiro,aegwynn,1164,monk,mistweaver,60,30,30
Subsul,sylvanas,1164,monk,mistweaver,94,45,49
Muggen,minahonda,1163,monk,mistweaver,41,18,23
Pandaaäaaäaa,archimonde,1162,monk,mistweaver,21,14,7
Velicko,ravencrest,1162,monk,mistweaver,38,22,16
Arathos,tichondrius,1162,monk,mistweaver,157,83,74
Andrah,blackmoore,1162,monk,mistweaver,46,16,30
Несочетаемая,soulflayer,1161,monk,mistweaver,19,13,6
Sensëi,bronze-dragonflight,1161,monk,mistweaver,73,31,42
Desertctype,burning-legion,1160,monk,mistweaver,55,27,28
Rag,burning-legion,1159,monk,mistweaver,236,109,127
Thrallergik,ysondre,1157,monk,mistweaver,72,41,31
Charminbeard,antonidas,1157,monk,mistweaver,71,29,42
Jinora,theradras,1156,monk,mistweaver,36,14,22
Tamriel,korgall,1155,monk,mistweaver,48,21,27
Naskon,nemesis,1154,monk,mistweaver,48,21,27
Bananamonk,nathrezim,1153,monk,mistweaver,17,13,4
Geckazz,kazzak,1153,monk,mistweaver,27,18,9
Болетка,blackscar,1153,monk,mistweaver,158,76,82
Yuuhai,ravencrest,1152,monk,mistweaver,18,12,6
Олежатоксик,gordunni,1152,monk,mistweaver,18,12,6
Yayaxoxoxo,archimonde,1152,monk,mistweaver,18,12,6
Suhnukka,stormscale,1152,monk,mistweaver,24,12,12
Kôtsvlêkjê,outland,1151,monk,mistweaver,24,12,12
Zesha,zuljin,1151,monk,mistweaver,30,12,18
Gnasseschef,outland,1150,monk,mistweaver,18,12,6
Дилдобойс,gordunni,1150,monk,mistweaver,18,12,6
Sosschi,silvermoon,1150,monk,mistweaver,18,12,6
Verlan,quelthalas,1150,monk,mistweaver,49,25,24
Hittokick,draenor,1150,monk,mistweaver,37,13,24
Ciridely,thrall,1149,monk,mistweaver,18,12,6
Varolul,aegwynn,1149,monk,mistweaver,51,27,24
Orowh,archimonde,1149,monk,mistweaver,24,12,12
Angerymonk,kazzak,1149,monk,mistweaver,30,12,18
Кукунколдыч,gordunni,1149,monk,mistweaver,36,13,23
Kemari,argent-dawn,1148,monk,mistweaver,18,12,6
Ýüñgßèëf,dun-modr,1148,monk,mistweaver,18,12,6
Brewdooms,laughing-skull,1148,monk,mistweaver,42,12,30
Бэккс,howling-fjord,1147,monk,mistweaver,18,12,6
Truelo,eredar,1147,monk,mistweaver,18,12,6
Vejbz,blackmoore,1147,monk,mistweaver,24,12,12
Req,darksorrow,1146,monk,mistweaver,24,12,12
Selirka,archimonde,1145,monk,mistweaver,18,12,6
Оджи,blackscar,1145,monk,mistweaver,18,12,6
Souhei,drakthul,1145,monk,mistweaver,18,12,6
Xyest,frostwolf,1145,monk,mistweaver,30,12,18
Монкмяу,howling-fjord,1145,monk,mistweaver,33,12,21
Антошамв,gordunni,1145,monk,mistweaver,36,12,24
Andelicek,burning-blade,1144,monk,mistweaver,24,12,12
Pandereta,aggra-português,1143,monk,mistweaver,18,12,6
Pô,sanguino,1143,monk,mistweaver,18,12,6
Lennykrvtz,kazzak,1142,monk,mistweaver,18,12,6
Japumonk,kazzak,1142,monk,mistweaver,41,23,18
Fizzlekungfu,tarren-mill,1142,monk,mistweaver,24,12,12
Тильтоний,gordunni,1142,monk,mistweaver,24,12,12
Иклипси,gordunni,1141,monk,mistweaver,12,12,0
Myez,stormscale,1141,monk,mistweaver,18,12,6
Andik,kazzak,1141,monk,mistweaver,24,12,12
Elanahi,antonidas,1141,monk,mistweaver,30,12,18
Cråzymonk,ravencrest,1140,monk,mistweaver,21,13,8
Weshilling,tarren-mill,1139,monk,mistweaver,18,12,6
Imvengeance,stormscale,1139,monk,mistweaver,239,111,128
Irìss,nerzhul,1138,monk,mistweaver,86,47,39
Jagermonk,doomhammer,1138,monk,mistweaver,24,12,12
Lithenyx,bladefist,1137,monk,mistweaver,30,12,18
Алунам,soulflayer,1137,monk,mistweaver,30,12,18
Syyrø,silvermoon,1137,monk,mistweaver,36,12,24
Kesuke,stormreaver,1136,monk,mistweaver,193,97,96
Revna,auchindoun,1136,monk,mistweaver,24,12,12
Slý,archimonde,1135,monk,mistweaver,38,24,14
Валялекарь,gordunni,1135,monk,mistweaver,24,12,12
Nabenja,madmortem,1134,monk,mistweaver,74,35,39
Gantz,blackhand,1134,monk,mistweaver,72,28,44
Pandasia,kargath,1133,monk,mistweaver,76,34,42
Verdi,tarren-mill,1132,monk,mistweaver,18,12,6
Kyuumaa,ravencrest,1132,monk,mistweaver,26,13,13
Моийам,howling-fjord,1130,monk,mistweaver,30,12,18
Claudet,das-konsortium,1127,monk,mistweaver,70,32,38
Vvårdenfell,hyjal,1126,monk,mistweaver,33,13,20
Tipsycookie,nozdormu,1125,monk,mistweaver,24,12,12
Skharrbrew,norgannon,1124,monk,mistweaver,66,30,36
Oddessa,ravenholdt,1122,monk,mistweaver,253,123,130
Stoutz,kazzak,1122,monk,mistweaver,30,13,17
Desyync,silvermoon,1122,monk,mistweaver,50,21,29
Rampagepo,turalyon,1121,monk,mistweaver,48,19,29
Vzan,kazzak,1120,monk,mistweaver,57,29,28
Zuzuljin,chogall,1120,monk,mistweaver,48,16,32
Xarii,aegwynn,1119,monk,mistweaver,16,13,3
Friartucker,bloodhoof,1118,monk,mistweaver,68,40,28
Ryanshazier,eredar,1117,monk,mistweaver,56,33,23
Rayokhen,kazzak,1117,monk,mistweaver,24,13,11
Kappakick,tarren-mill,1117,monk,mistweaver,24,12,12
Mooji,malganis,1117,monk,mistweaver,34,12,22
Tsouli,twilights-hammer,1116,monk,mistweaver,24,12,12
Flawpa,blackmoore,1115,monk,mistweaver,18,12,6
Snakeéyés,kazzak,1115,monk,mistweaver,20,13,7
Alphafist,argent-dawn,1115,monk,mistweaver,36,16,20
Dankiron,darksorrow,1114,monk,mistweaver,42,13,29
Hornissy,antonidas,1113,monk,mistweaver,88,48,40
Twinny,drakthul,1113,monk,mistweaver,26,13,13
Kujanpei,rajaxx,1112,monk,mistweaver,30,14,16
Shenlong,burning-blade,1112,monk,mistweaver,33,14,19
Gaîdemar,blackmoore,1110,monk,mistweaver,34,13,21
Fastblood,kazzak,1107,monk,mistweaver,30,19,11
Jolbucheron,hyjal,1104,monk,mistweaver,24,14,10
Cheriedevile,drakthul,1104,monk,mistweaver,30,12,18
Serilyah,aegwynn,1102,monk,mistweaver,25,14,11
Bohjera,kazzak,1101,monk,mistweaver,47,23,24
Lamne,quelthalas,1100,monk,mistweaver,42,17,25
Ляосинь,deepholm,1099,monk,mistweaver,24,12,12
Chimonk,ravencrest,1099,monk,mistweaver,34,16,18
Nurthi,argent-dawn,1099,monk,mistweaver,30,13,17
Муррчалкин,howling-fjord,1098,monk,mistweaver,17,12,5
Yoruby,kazzak,1098,monk,mistweaver,32,13,19
Qungphu,silvermoon,1098,monk,mistweaver,47,13,34
Sigvar,frostmane,1097,monk,mistweaver,57,20,37
Sqedi,draenor,1096,monk,mistweaver,40,15,25
Затвоейщекой,soulflayer,1095,monk,mistweaver,17,12,5
Baldurr,dalaran,1095,monk,mistweaver,51,20,31
Bwater,grim-batol,1095,monk,mistweaver,52,17,35
Tanyà,hyjal,1094,monk,mistweaver,18,13,5
Vanquishlølz,archimonde,1094,monk,mistweaver,60,25,35
Dèathpunch,doomhammer,1092,monk,mistweaver,409,204,205
Kalet,ragnaros,1092,monk,mistweaver,83,39,44
Добраядушка,gordunni,1091,monk,mistweaver,48,22,26
Tèam,defias-brotherhood,1089,monk,mistweaver,26,13,13
Yesman,quelthalas,1087,monk,mistweaver,73,29,44
Chun,arathor,1086,monk,mistweaver,108,54,54
Ayelas,silvermoon,1085,monk,mistweaver,26,12,14
Samh,twisting-nether,1082,monk,mistweaver,59,37,22
Alurymnk,blackrock,1077,monk,mistweaver,59,27,32
Fabrew,tarren-mill,1077,monk,mistweaver,30,12,18
Heäléna,ragnaros,1075,monk,mistweaver,37,27,10
Domingovivas,dun-modr,1075,monk,mistweaver,42,21,21
Baoton,blackmoore,1075,monk,mistweaver,36,12,24
Ronanze,silvermoon,1074,monk,mistweaver,108,60,48
Enceladion,burning-legion,1074,monk,mistweaver,84,40,44
ßam,ravencrest,1074,monk,mistweaver,47,21,26
Сунджи,eversong,1073,monk,mistweaver,179,81,98
Psychö,zuljin,1072,monk,mistweaver,35,17,18
Senseithai,trollbane,1068,monk,mistweaver,30,14,16
Kungfusler,twisting-nether,1067,monk,mistweaver,30,13,17
Mïsericordie,dalaran,1067,monk,mistweaver,36,15,21
Bobbyknuckls,ravencrest,1064,monk,mistweaver,54,17,37
Äcé,sylvanas,1063,monk,mistweaver,31,12,19
Fardareismai,kazzak,1062,monk,mistweaver,75,34,41
Birdymonk,boulderfist,1061,monk,mistweaver,91,53,38
Quaksalber,amanthul,1060,monk,mistweaver,119,63,56
Nikiz,festung-der-stürme,1060,monk,mistweaver,90,39,51
Punto,onyxia,1059,monk,mistweaver,225,109,116
Павнмонкх,gordunni,1056,monk,mistweaver,18,11,7
Haruuka,thrall,1056,monk,mistweaver,18,11,7
Reidzqt,kazzak,1056,monk,mistweaver,18,11,7
Savonnettejr,culte-de-la-rive-noire,1056,monk,mistweaver,18,11,7
Totemlygodx,alakir,1056,monk,mistweaver,18,11,7
Puñetaso,los-errantes,1056,monk,mistweaver,101,47,54
Darkmonkky,tarren-mill,1056,monk,mistweaver,24,11,13
Ffxivrefugee,argent-dawn,1056,monk,mistweaver,24,11,13
Магхрмонк,soulflayer,1056,monk,mistweaver,30,11,19
Vtx,blackrock,1055,monk,mistweaver,18,11,7
Feedmydreams,executus,1055,monk,mistweaver,18,11,7
Wheeslz,aegwynn,1055,monk,mistweaver,18,11,7
Brutamonk,blackmoore,1055,monk,mistweaver,18,11,7
Kakor,gorgonnash,1055,monk,mistweaver,18,11,7
Sandshark,argent-dawn,1055,monk,mistweaver,247,122,125
Mistmist,sylvanas,1055,monk,mistweaver,24,11,13
Gecli,stormscale,1055,monk,mistweaver,30,11,19
Jakethestake,twilights-hammer,1054,monk,mistweaver,12,11,1
Unjie,outland,1054,monk,mistweaver,12,11,1
Kispiszock,bloodscalp,1054,monk,mistweaver,18,11,7
Kragor,eredar,1054,monk,mistweaver,18,11,7
Savvuzzino,nemesis,1054,monk,mistweaver,18,11,7
Franziskanus,das-syndikat,1054,monk,mistweaver,18,11,7
Ghettomonk,blackmoore,1054,monk,mistweaver,32,15,17
Vrexza,kazzak,1054,monk,mistweaver,24,11,13
Nomim,kazzak,1053,monk,mistweaver,18,11,7
Namitsa,trollbane,1053,monk,mistweaver,144,67,77
Fistii,burning-legion,1053,monk,mistweaver,24,11,13
Loctak,nathrezim,1052,monk,mistweaver,102,62,40
Judopig,blades-edge,1052,monk,mistweaver,22,12,10
Wangho,magtheridon,1052,monk,mistweaver,126,58,68
Lambofmonkz,stormscale,1052,monk,mistweaver,36,11,25
Anoukxbabe,blackmoore,1051,monk,mistweaver,24,11,13
Spinniboi,blackhand,1051,monk,mistweaver,24,11,13
Brewmâster,kazzak,1050,monk,mistweaver,24,11,13
Verd,cthun,1050,monk,mistweaver,77,31,46
Laddo,thunderhorn,1049,monk,mistweaver,24,11,13
Каратекоров,soulflayer,1049,monk,mistweaver,30,11,19
Runakar,draenor,1049,monk,mistweaver,36,11,25
Shmidi,antonidas,1048,monk,mistweaver,117,61,56
Missfist,stormscale,1047,monk,mistweaver,18,11,7
Fellatia,garrosh,1045,monk,mistweaver,63,34,29
Cranekickbot,ravencrest,1045,monk,mistweaver,24,11,13
Orcput,minahonda,1044,monk,mistweaver,18,11,7
Irphan,ravencrest,1042,monk,mistweaver,18,11,7
Khaldin,hyjal,1041,monk,mistweaver,18,11,7
Monkgart,sylvanas,1041,monk,mistweaver,18,11,7
Graffy,eonar,1040,monk,mistweaver,60,32,28
Stayinlosplz,ysondre,1039,monk,mistweaver,17,11,6
Andim,frostwolf,1039,monk,mistweaver,92,49,43
Toweliè,thrall,1039,monk,mistweaver,24,11,13
Ívó,ragnaros,1039,monk,mistweaver,24,11,13
Анпапаяя,galakrond,1039,monk,mistweaver,25,11,14
Tolomèo,nemesis,1037,monk,mistweaver,24,11,13
Waytealz,stormscale,1036,monk,mistweaver,126,50,76
Equabléé,argent-dawn,1035,monk,mistweaver,24,11,13
Havery,sanguino,1034,monk,mistweaver,17,12,5
Kocyme,die-aldor,1034,monk,mistweaver,21,13,8
Leikô,grim-batol,1033,monk,mistweaver,24,11,13
Брэйки,lich-king,1032,monk,mistweaver,30,12,18
Karmasfist,ravencrest,1029,monk,mistweaver,101,48,53
ßarghest,sanguino,1029,monk,mistweaver,60,20,40
Kätelyys,dun-modr,1027,monk,mistweaver,24,11,13
Mjaweaver,stormscale,1027,monk,mistweaver,125,56,69
Eldunári,sanguino,1024,monk,mistweaver,60,22,38
Deii,frostwolf,1023,monk,mistweaver,117,51,66
Zywoo,emerald-dream,1022,monk,mistweaver,29,12,17
Hithxbye,stormscale,1020,monk,mistweaver,96,38,58
Апесиинка,gordunni,1019,monk,mistweaver,68,31,37
Eggroll,archimonde,1018,monk,mistweaver,23,11,12
Alexiarofl,silvermoon,1017,monk,mistweaver,20,12,8
Xanyth,confrérie-du-thorium,1017,monk,mistweaver,22,13,9
Zedruu,tarren-mill,1015,monk,mistweaver,24,12,12
Lascala,eredar,1011,monk,mistweaver,48,18,30
Tarzaki,hyjal,1010,monk,mistweaver,25,12,13
Shontal,ravencrest,1010,monk,mistweaver,24,11,13
Pepegaswipe,ravencrest,1010,monk,mistweaver,30,11,19
Munqqi,stormscale,1009,monk,mistweaver,22,14,8
Tootenchamun,veklor,1007,monk,mistweaver,114,49,65
Ivnatorx,outland,1006,monk,mistweaver,17,11,6
Nephi,kirin-tor,1006,monk,mistweaver,54,22,32
Gaf,tarren-mill,1004,monk,mistweaver,19,12,7
Candypoppe,argent-dawn,1004,monk,mistweaver,58,30,28
Kameltreiba,antonidas,1004,monk,mistweaver,23,11,12
Zenchî,ysondre,1001,monk,mistweaver,22,13,9
Leïsha,ysondre,1000,monk,mistweaver,24,12,12
Liwong,antonidas,999,monk,mistweaver,65,32,33
Iamnudel,blackmoore,995,monk,mistweaver,24,11,13
Matrim,arathor,994,monk,mistweaver,38,12,26
Jayline,kazzak,992,monk,mistweaver,65,26,39
Unpapaya,silvermoon,991,monk,mistweaver,21,11,10
Chukwandi,ravencrest,991,monk,mistweaver,130,67,63
Холанн,greymane,991,monk,mistweaver,150,68,82
Fugmonk,ravencrest,989,monk,mistweaver,17,11,6
Shenyen,silvermoon,987,monk,mistweaver,27,11,16
Xuaolang,sanguino,986,monk,mistweaver,30,12,18
Plsdontdie,sylvanas,983,monk,mistweaver,20,11,9
Yøøps,dalaran,982,monk,mistweaver,45,22,23
Woguo,drakthul,981,monk,mistweaver,36,15,21
Madmonki,ragnaros,980,monk,mistweaver,160,90,70
Brewtalize,defias-brotherhood,977,monk,mistweaver,30,16,14
Goya,sargeras,976,monk,mistweaver,36,21,15
Furynextdoor,hyjal,974,monk,mistweaver,17,11,6
Аверлорд,fordragon,973,monk,mistweaver,34,14,20
Bèfmoka,sargeras,965,monk,mistweaver,233,112,121
Suchergebnis,tarren-mill,964,monk,mistweaver,66,23,43
Catwiø,hyjal,963,monk,mistweaver,32,12,20
Horfus,stormscale,963,monk,mistweaver,36,12,24
Shilvah,azuremyst,962,monk,mistweaver,27,14,13
Culédegallah,archimonde,960,monk,mistweaver,12,10,2
Watschensepp,arthas,960,monk,mistweaver,12,10,2
Hurjat,stormreaver,960,monk,mistweaver,18,10,8
Cannonk,blackhand,960,monk,mistweaver,18,10,8
Klappzz,outland,960,monk,mistweaver,18,10,8
Шадофрейз,gordunni,960,monk,mistweaver,18,10,8
Ilsalumiere,nemesis,960,monk,mistweaver,18,10,8
Nízra,archimonde,959,monk,mistweaver,12,10,2
Citamonk,blackmoore,959,monk,mistweaver,12,10,2
Sioumoo,malganis,959,monk,mistweaver,16,11,5
Dexcore,draenor,959,monk,mistweaver,18,10,8
Zekethegreat,tarren-mill,959,monk,mistweaver,18,10,8
Såvonnette,ysondre,959,monk,mistweaver,18,10,8
Monkfriend,quelthalas,959,monk,mistweaver,18,10,8
Mahøni,malganis,959,monk,mistweaver,18,10,8
Parlez,argent-dawn,959,monk,mistweaver,18,10,8
Mâjô,blackhand,959,monk,mistweaver,18,10,8
Divinechi,kazzak,959,monk,mistweaver,18,10,8
Synkek,tarren-mill,959,monk,mistweaver,18,10,8
Silentpedo,stormscale,959,monk,mistweaver,19,10,9
Хэймичх,gordunni,959,monk,mistweaver,24,10,14
Pikkupotkuri,stormreaver,959,monk,mistweaver,24,10,14
Zappikmonk,silvermoon,958,monk,mistweaver,12,10,2
ßreacherx,argent-dawn,958,monk,mistweaver,12,10,2
Mynokxu,blackmoore,958,monk,mistweaver,12,10,2
Паклюха,howling-fjord,958,monk,mistweaver,18,10,8
Fettakules,eredar,958,monk,mistweaver,18,10,8
Âechlz,malfurion,958,monk,mistweaver,18,10,8
Oiorie,twisting-nether,958,monk,mistweaver,18,10,8
Wkiller,outland,958,monk,mistweaver,24,10,14
Mieau,ysondre,957,monk,mistweaver,26,15,11
Risingsunkek,ravencrest,957,monk,mistweaver,18,10,8
Zentyà,hyjal,957,monk,mistweaver,18,10,8
Rutikuiva,kazzak,957,monk,mistweaver,24,10,14
Lerouxx,archimonde,957,monk,mistweaver,24,10,14
Teoroll,stormscale,956,monk,mistweaver,18,10,8
Nêrfmeta,kazzak,956,monk,mistweaver,18,10,8
Aaenzen,argent-dawn,956,monk,mistweaver,18,10,8
Bbok,silvermoon,956,monk,mistweaver,36,10,26
Agodx,sanguino,955,monk,mistweaver,18,10,8
Dath,outland,955,monk,mistweaver,18,10,8
Ronnchi,twisting-nether,955,monk,mistweaver,24,10,14
Ossifist,blackhand,955,monk,mistweaver,24,10,14
Justbalem,outland,955,monk,mistweaver,30,10,20
Keisy,kazzak,954,monk,mistweaver,24,10,14
Mitchell,sylvanas,953,monk,mistweaver,18,10,8
Kurzgesagt,destromath,953,monk,mistweaver,30,10,20
Wilymonka,dalaran,952,monk,mistweaver,18,10,8
Boloboc,auchindoun,951,monk,mistweaver,12,10,2
Tojokirumi,dalaran,951,monk,mistweaver,12,10,2
Dennó,mannoroth,951,monk,mistweaver,18,10,8
Marteling,silvermoon,951,monk,mistweaver,24,10,14
Garff,aggra-português,951,monk,mistweaver,26,10,16
Monkyd,stormscale,950,monk,mistweaver,18,10,8
Vulsong,burning-legion,949,monk,mistweaver,18,10,8
Derok,twisting-nether,949,monk,mistweaver,24,10,14
Griffens,argent-dawn,943,monk,mistweaver,17,10,7
Монахий,gordunni,943,monk,mistweaver,24,10,14
Фистермонк,gordunni,942,monk,mistweaver,66,30,36
Serylliah,aegwynn,942,monk,mistweaver,24,10,14
Jaggsi,hellfire,942,monk,mistweaver,114,40,74
Escopetin,los-errantes,942,monk,mistweaver,30,10,20
Røär,khaz-modan,934,monk,mistweaver,12,10,2
Ariä,marécage-de-zangar,930,monk,mistweaver,24,13,11
Liathina,sylvanas,928,monk,mistweaver,25,10,15
Jusex,stormreaver,927,monk,mistweaver,22,11,11
Kieteltje,sylvanas,926,monk,mistweaver,18,10,8
Jokkmonkk,sunstrider,925,monk,mistweaver,20,11,9
Fréýáá,blackrock,925,monk,mistweaver,60,31,29
Shoshin,stormscale,925,monk,mistweaver,81,41,40
Buggaa,dalaran,924,monk,mistweaver,63,35,28
Shenexo,kazzak,924,monk,mistweaver,20,11,9
Nosrewolwer,burning-legion,921,monk,mistweaver,24,11,13
Шадялинь,howling-fjord,920,monk,mistweaver,23,10,13
Wallmonker,blackrock,915,monk,mistweaver,24,10,14
Blackeyé,malganis,914,monk,mistweaver,47,25,22
Dinxfar,draenor,913,monk,mistweaver,21,11,10
Ràsetsu,nagrand,912,monk,mistweaver,41,20,21
Zolpi,arathi,911,monk,mistweaver,41,26,15
Dícxi,ravencrest,910,monk,mistweaver,17,10,7
Neifaust,silvermoon,908,monk,mistweaver,120,46,74
Чвка,booty-bay,907,monk,mistweaver,30,14,16
Kamîî,sanguino,907,monk,mistweaver,27,12,15
Xialongbao,khaz-modan,907,monk,mistweaver,45,11,34
Lilithrevan,frostmourne,905,monk,mistweaver,15,11,4
Brúcélee,silvermoon,904,monk,mistweaver,22,11,11
Malroj,aggramar,902,monk,mistweaver,21,11,10
Hireo,blades-edge,901,monk,mistweaver,89,38,51
Bottomoré,silvermoon,901,monk,mistweaver,95,34,61
Châkra,dun-modr,900,monk,mistweaver,34,11,23
Jamaìca,outland,898,monk,mistweaver,24,12,12
Leafsoup,argent-dawn,895,monk,mistweaver,211,101,110
Мишапяточка,howling-fjord,890,monk,mistweaver,12,11,1
Foothay,tarren-mill,884,monk,mistweaver,42,11,31
Mistyheals,nagrand,883,monk,mistweaver,36,19,17
Cheytana,archimonde,879,monk,mistweaver,11,10,1
Leípe,ravencrest,879,monk,mistweaver,40,11,29
Katx,marécage-de-zangar,878,monk,mistweaver,56,18,38
Schellentano,defias-brotherhood,876,monk,mistweaver,48,22,26
Olivegreen,emerald-dream,870,monk,mistweaver,48,24,24
Greez,tarren-mill,869,monk,mistweaver,22,10,12
Mélonie,dalaran,869,monk,mistweaver,26,11,15
Turbobär,blackrock,864,monk,mistweaver,12,9,3
Lifecoco,blackrock,864,monk,mistweaver,12,9,3
Pashtrak,argent-dawn,864,monk,mistweaver,12,9,3
Jokkopapoo,archimonde,864,monk,mistweaver,12,9,3
Kookmin,doomhammer,864,monk,mistweaver,12,9,3
Profesàur,pozzo-delleternità,864,monk,mistweaver,12,9,3
Miists,kazzak,864,monk,mistweaver,18,9,9
Mzdm,dalaran,864,monk,mistweaver,18,9,9
Åmba,blackrock,864,monk,mistweaver,18,9,9
Rätx,blackhand,864,monk,mistweaver,24,9,15
Balia,blackrock,864,monk,mistweaver,24,9,15
Linusqt,argent-dawn,863,monk,mistweaver,12,9,3
Arlot,blackmoore,863,monk,mistweaver,12,9,3
Pelegrini,ravencrest,863,monk,mistweaver,12,9,3
Atfu,argent-dawn,863,monk,mistweaver,12,9,3
Shabaz,draenor,863,monk,mistweaver,12,9,3
Зарычал,soulflayer,863,monk,mistweaver,18,9,9
Torinia,madmortem,863,monk,mistweaver,18,9,9
Dababy,twisting-nether,863,monk,mistweaver,18,9,9
Fènja,kult-der-verdammten,863,monk,mistweaver,18,9,9
Shéesh,tarren-mill,863,monk,mistweaver,18,9,9
Nowhaazzer,dun-modr,863,monk,mistweaver,18,9,9
Kyleestrutt,stormscale,863,monk,mistweaver,18,9,9
Daybaobao,the-maelstrom,863,monk,mistweaver,156,64,92
Rminto,twisting-nether,863,monk,mistweaver,24,9,15
Rhodin,krasus,863,monk,mistweaver,30,9,21
Ribbeh,draenor,862,monk,mistweaver,12,9,3
Niborc,doomhammer,862,monk,mistweaver,12,9,3
Deepfistehr,outland,862,monk,mistweaver,12,9,3
Колбасина,gordunni,862,monk,mistweaver,12,9,3
Missislee,aegwynn,862,monk,mistweaver,12,9,3
Requizen,ravencrest,862,monk,mistweaver,18,9,9
Nöwmack,archimonde,862,monk,mistweaver,18,9,9
Ricegodx,kazzak,862,monk,mistweaver,144,71,73
Twopoint,blackmoore,861,monk,mistweaver,12,9,3
Mwsama,stormscale,861,monk,mistweaver,12,9,3
Puñolou,sanguino,861,monk,mistweaver,12,9,3
Koldar,grim-batol,861,monk,mistweaver,17,12,5
Misstickle,stormscale,861,monk,mistweaver,18,9,9
Rustó,ravencrest,861,monk,mistweaver,18,9,9
Changzu,sanguino,861,monk,mistweaver,87,42,45
Ugotcraned,tarren-mill,861,monk,mistweaver,130,50,80
Mistya,ragnaros,859,monk,mistweaver,18,9,9
Samie,ravencrest,859,monk,mistweaver,18,9,9
Iwtkms,magtheridon,859,monk,mistweaver,24,9,15
Nortý,drakthul,858,monk,mistweaver,12,9,3
Mistréss,silvermoon,858,monk,mistweaver,18,9,9
Yza,dun-modr,858,monk,mistweaver,18,9,9
Karmaclit,malganis,857,monk,mistweaver,18,9,9
Bingching,silvermoon,857,monk,mistweaver,113,44,69
Arukoru,kazzak,857,monk,mistweaver,36,10,26
Thymesurge,ravencrest,856,monk,mistweaver,18,9,9
Chozen,blackmoore,854,monk,mistweaver,18,9,9
Healmeup,anetheron,854,monk,mistweaver,18,9,9
Wêntô,aegwynn,854,monk,mistweaver,24,9,15
Drumonk,kelthuzad,854,monk,mistweaver,36,9,27
Mirøc,blackmoore,853,monk,mistweaver,18,9,9
Bakersdozen,tarren-mill,852,monk,mistweaver,24,9,15
Мастерхилфу,ashenvale,849,monk,mistweaver,22,13,9
Jugogodx,blackrock,845,monk,mistweaver,17,9,8
Keeba,kirin-tor,840,monk,mistweaver,277,129,148
Geeberz,twisting-nether,838,monk,mistweaver,18,9,9
Samuelka,burning-blade,838,monk,mistweaver,47,14,33
Zuntze,guldan,834,monk,mistweaver,18,9,9
Drakzyr,argent-dawn,831,monk,mistweaver,16,9,7
Cmonbruh,ravencrest,831,monk,mistweaver,17,9,8
Drugarix,uldaman,831,monk,mistweaver,18,9,9
Muuck,blackrock,830,monk,mistweaver,20,10,10
Pikafume,hellfire,827,monk,mistweaver,14,10,4
Pepefocho,sanguino,827,monk,mistweaver,30,11,19
Køzuky,archimonde,825,monk,mistweaver,23,11,12
Thiccbaby,kazzak,816,monk,mistweaver,15,9,6
Mynaira,tarren-mill,811,monk,mistweaver,50,11,39
Zóma,ragnaros,810,monk,mistweaver,28,10,18
Киото,ashenvale,808,monk,mistweaver,137,57,80
Alfiemonk,ravencrest,804,monk,mistweaver,48,13,35
Xalyà,archimonde,803,monk,mistweaver,18,12,6
Colita,kazzak,803,monk,mistweaver,22,11,11
Умцаца,soulflayer,803,monk,mistweaver,255,103,152
Extaszeh,turalyon,802,monk,mistweaver,17,11,6
Тайви,deepholm,799,monk,mistweaver,17,9,8
Whytoosxy,silvermoon,799,monk,mistweaver,23,9,14
Zerochi,kazzak,796,monk,mistweaver,19,10,9
Почтисдох,soulflayer,781,monk,mistweaver,16,9,7
Гуппер,howling-fjord,768,monk,mistweaver,12,8,4
Kradder,nordrassil,768,monk,mistweaver,12,8,4
Гошатехник,soulflayer,768,monk,mistweaver,12,8,4
Egh,der-rat-von-dalaran,768,monk,mistweaver,12,8,4
Stvilde,tarren-mill,768,monk,mistweaver,12,8,4
Colin,aegwynn,768,monk,mistweaver,12,8,4
Adrianchase,ravencrest,768,monk,mistweaver,12,8,4
Miamalkøva,nemesis,768,monk,mistweaver,12,8,4
Jlo,stormscale,768,monk,mistweaver,12,8,4
Berlym,tarren-mill,768,monk,mistweaver,12,8,4
Wisebeb,les-clairvoyants,768,monk,mistweaver,12,8,4
Myndry,varimathras,768,monk,mistweaver,12,8,4
Mialena,thrall,768,monk,mistweaver,12,8,4
Daisymerolli,nemesis,768,monk,mistweaver,12,8,4
Mvm,outland,768,monk,mistweaver,12,8,4
Monfmonk,archimonde,768,monk,mistweaver,12,8,4
Guarnounet,hyjal,768,monk,mistweaver,12,8,4
Kashino,frostwhisper,768,monk,mistweaver,12,8,4
Cattleyah,ysondre,768,monk,mistweaver,12,8,4
Starboyy,twisting-nether,768,monk,mistweaver,12,8,4
Senzz,eredar,768,monk,mistweaver,14,8,6
Ravity,blackmoore,768,monk,mistweaver,18,8,10
Kûngfu,tarren-mill,768,monk,mistweaver,18,8,10
Dêsmî,ravencrest,768,monk,mistweaver,18,8,10
Tino,sylvanas,768,monk,mistweaver,18,8,10
Orki,ragnaros,768,monk,mistweaver,18,8,10
Fistgodx,blackrock,768,monk,mistweaver,18,8,10
Eldaras,tarren-mill,768,monk,mistweaver,18,8,10
Twåålf,kazzak,768,monk,mistweaver,18,8,10
Mädravën,ragnaros,768,monk,mistweaver,24,8,16
Sozzemonk,kazzak,767,monk,mistweaver,12,8,4
Maigraith,malganis,767,monk,mistweaver,12,8,4
Мистхоррор,gordunni,767,monk,mistweaver,12,8,4
Hvdo,silvermoon,767,monk,mistweaver,12,8,4
Fiststowin,blackrock,767,monk,mistweaver,12,8,4
Lin,nathrezim,767,monk,mistweaver,12,8,4
Xerzulo,silvermoon,767,monk,mistweaver,12,8,4
Nxyytko,aegwynn,767,monk,mistweaver,16,9,7
Suií,blackmoore,767,monk,mistweaver,18,8,10
Shishalord,blackhand,767,monk,mistweaver,18,8,10
Bolana,ravencrest,767,monk,mistweaver,18,8,10
Faki,eredar,767,monk,mistweaver,18,8,10
Tottle,archimonde,767,monk,mistweaver,18,8,10
Skelmir,dragonblight,767,monk,mistweaver,18,8,10
Gízmö,tarren-mill,767,monk,mistweaver,18,8,10
Блябери,howling-fjord,767,monk,mistweaver,18,8,10
Skiqzy,ravencrest,767,monk,mistweaver,18,8,10
Tomporius,blackmoore,767,monk,mistweaver,18,8,10
Apöllo,ragnaros,767,monk,mistweaver,18,8,10
Qúázu,silvermoon,767,monk,mistweaver,24,8,16
Monkfist,the-maelstrom,767,monk,mistweaver,24,8,16
Qî,ravencrest,767,monk,mistweaver,30,8,22
Mediumzin,twisting-nether,767,monk,mistweaver,30,8,22
Twoßastard,kazzak,766,monk,mistweaver,12,8,4
Nulojeu,archimonde,766,monk,mistweaver,12,8,4
Ledunjames,dragonblight,766,monk,mistweaver,12,8,4
Bûbota,dun-modr,766,monk,mistweaver,12,8,4
Votix,tarren-mill,766,monk,mistweaver,19,10,9
Gakunie,blackhand,766,monk,mistweaver,18,8,10
Bashboosh,stormscale,766,monk,mistweaver,18,8,10
Хере,soulflayer,766,monk,mistweaver,18,8,10
Kegbrew,kazzak,765,monk,mistweaver,12,8,4
Hersmonk,drakthul,765,monk,mistweaver,12,8,4
Lorkas,darkmoon-faire,765,monk,mistweaver,12,8,4
Ebonymilfy,archimonde,765,monk,mistweaver,12,8,4
Dukhi,kazzak,765,monk,mistweaver,12,8,4
Pô,nemesis,765,monk,mistweaver,18,8,10
Jemijedno,drakthul,764,monk,mistweaver,12,8,4
Babaganoush,frostwolf,764,monk,mistweaver,18,8,10
Dazll,twisting-nether,764,monk,mistweaver,24,8,16
Breykhar,aegwynn,762,monk,mistweaver,18,8,10
Pekinn,sanguino,761,monk,mistweaver,18,8,10
Nemevas,dun-modr,761,monk,mistweaver,30,8,22
Xèrá,antonidas,759,monk,mistweaver,30,8,22
Speki,sylvanas,758,monk,mistweaver,12,8,4
Сукавкимоно,soulflayer,758,monk,mistweaver,18,8,10
Jetsweep,kazzak,753,monk,mistweaver,24,8,16
Шаолий,gordunni,748,monk,mistweaver,48,15,33
Irorii,silvermoon,747,monk,mistweaver,23,8,15
Gokentu,silvermoon,738,monk,mistweaver,43,15,28
Issan,archimonde,736,monk,mistweaver,23,9,14
Iluvfistinjk,sylvanas,734,monk,mistweaver,15,9,6
Metaphysic,tarren-mill,734,monk,mistweaver,23,8,15
Ndaula,drakthul,733,monk,mistweaver,25,9,16
Spëarôu,hyjal,732,monk,mistweaver,18,10,8
Popao,silvermoon,719,monk,mistweaver,15,9,6
Коумана,gordunni,719,monk,mistweaver,18,10,8
Дядямаготика,deathguard,719,monk,mistweaver,27,9,18
Thanzul,blackmoore,715,monk,mistweaver,9,9,0
Trueks,uldum,714,monk,mistweaver,16,9,7
Zhanshì,blackmoore,714,monk,mistweaver,21,9,12
Mozzi,frostmane,712,monk,mistweaver,25,9,16
Порвуседло,soulflayer,703,monk,mistweaver,28,10,18
ßæutiful,silvermoon,702,monk,mistweaver,59,22,37
Ørishi,antonidas,701,monk,mistweaver,17,8,9
Годъяр,gordunni,698,monk,mistweaver,20,8,12
Nrb,outland,695,monk,mistweaver,14,8,6
Melaz,ravencrest,688,monk,mistweaver,13,8,5
Tingly,kazzak,687,monk,mistweaver,15,8,7
Biggesttaf,stormscale,672,monk,mistweaver,10,8,2
Osírìs,ravencrest,672,monk,mistweaver,12,7,5
Sindfist,ysondre,672,monk,mistweaver,12,7,5
Monkamonk,blutkessel,672,monk,mistweaver,12,7,5
Kyliansètuit,ysondre,672,monk,mistweaver,12,7,5
Павнмонк,gordunni,672,monk,mistweaver,12,7,5
Ráñdømxyû,silvermoon,672,monk,mistweaver,12,7,5
Caramellate,ragnaros,672,monk,mistweaver,12,7,5
Níkxz,ragnaros,672,monk,mistweaver,12,7,5
Yulon,blackrock,672,monk,mistweaver,12,7,5
Shaolinjutsu,ravencrest,672,monk,mistweaver,12,7,5
Mjoo,blackrock,672,monk,mistweaver,12,7,5
Wafää,kazzak,672,monk,mistweaver,12,7,5
Ryutoo,silvermoon,672,monk,mistweaver,12,7,5
Flexify,outland,672,monk,mistweaver,12,7,5
Mw,magtheridon,672,monk,mistweaver,12,7,5
ßreacher,argent-dawn,672,monk,mistweaver,12,7,5
Monkel,frostwolf,672,monk,mistweaver,12,7,5
Merçury,dun-morogh,672,monk,mistweaver,12,7,5
Soulcháos,ravencrest,672,monk,mistweaver,12,7,5
Alutzharn,argent-dawn,672,monk,mistweaver,12,7,5
Vitessewagon,ysondre,672,monk,mistweaver,12,7,5
Neptulion,ravencrest,672,monk,mistweaver,12,7,5
Prismaticx,ravencrest,672,monk,mistweaver,12,7,5
Vazpy,sylvanas,672,monk,mistweaver,12,7,5
Hessuzen,stormreaver,672,monk,mistweaver,12,7,5
Frajer,auchindoun,672,monk,mistweaver,12,7,5
Astarrserran,drakthul,672,monk,mistweaver,12,7,5
Buddhweiser,malfurion,672,monk,mistweaver,12,7,5
Whatthemonk,arathor,672,monk,mistweaver,12,7,5
Zontovolo,draenor,672,monk,mistweaver,12,7,5
Møñk,draenor,672,monk,mistweaver,12,7,5
Вхукьютиикс,howling-fjord,672,monk,mistweaver,13,7,6
Fántâ,outland,672,monk,mistweaver,18,7,11
Päätöksiä,defias-brotherhood,672,monk,mistweaver,18,7,11
Olîvê,ravencrest,672,monk,mistweaver,18,7,11
Fullcocoon,stormscale,672,monk,mistweaver,18,7,11
Alwaysme,grim-batol,672,monk,mistweaver,18,7,11
Brakmar,twisting-nether,672,monk,mistweaver,18,7,11
Scz,draenor,672,monk,mistweaver,18,7,11
Fistweavingg,tarren-mill,672,monk,mistweaver,18,7,11
Bâsarä,archimonde,672,monk,mistweaver,18,7,11
Кулаквтебе,borean-tundra,672,monk,mistweaver,18,7,11
Boîndíl,malfurion,672,monk,mistweaver,18,7,11
Hurricrane,kazzak,672,monk,mistweaver,24,7,17
Funkystach,archimonde,671,monk,mistweaver,12,7,5
Hitmon,kazzak,671,monk,mistweaver,12,7,5
Æternia,stormscale,671,monk,mistweaver,12,7,5
Afkmonk,archimonde,671,monk,mistweaver,12,7,5
Fonk,blades-edge,671,monk,mistweaver,12,7,5
Matsimonk,sylvanas,671,monk,mistweaver,12,7,5
Yumrukatam,twisting-nether,671,monk,mistweaver,12,7,5
Lenalé,sanguino,671,monk,mistweaver,12,7,5
Nuclearmilk,stormscale,671,monk,mistweaver,12,7,5
Firisz,silvermoon,671,monk,mistweaver,12,7,5
Кисеч,soulflayer,671,monk,mistweaver,12,7,5
Wudao,anubarak,671,monk,mistweaver,12,7,5
Ony,agamaggan,671,monk,mistweaver,12,7,5
Whinestein,the-venture-co,671,monk,mistweaver,18,7,11
Tiddor,burning-legion,671,monk,mistweaver,18,7,11
Zendyy,argent-dawn,670,monk,mistweaver,12,7,5
Onepunchgril,arathor,670,monk,mistweaver,12,7,5
Tayruni,nazjatar,670,monk,mistweaver,18,7,11
Shîïna,ysondre,669,monk,mistweaver,24,7,17
Mayako,nemesis,667,monk,mistweaver,12,7,5
Chenpô,gorgonnash,667,monk,mistweaver,12,7,5
Buddhamilch,nathrezim,667,monk,mistweaver,18,7,11
Dotheas,argent-dawn,667,monk,mistweaver,18,7,11
Iife,frostwolf,665,monk,mistweaver,12,7,5
Wuchanglan,blackmoore,665,monk,mistweaver,30,7,23
Zoolloonn,norgannon,664,monk,mistweaver,18,7,11
Pandadoum,ysondre,663,monk,mistweaver,12,7,5
Kapona,kazzak,661,monk,mistweaver,30,7,23
Qdwdwqerdads,ravencrest,640,monk,mistweaver,16,8,8
Lylaei,argent-dawn,639,monk,mistweaver,17,7,10
Shapumvilla,alonsus,637,monk,mistweaver,8,8,0
Jsuispasheal,dalaran,625,monk,mistweaver,129,52,77
Randomxbrew,draenor,624,monk,mistweaver,9,8,1
Ютуми,soulflayer,624,monk,mistweaver,15,8,7
Yøda,malganis,621,monk,mistweaver,15,7,8
Jàckiechàn,nemesis,617,monk,mistweaver,12,8,4
Ravsar,kazzak,615,monk,mistweaver,17,9,8
Cringefemboy,moonglade,607,monk,mistweaver,11,7,4
Chakarma,twisting-nether,606,monk,mistweaver,34,7,27
Møñkgødx,silvermoon,592,monk,mistweaver,7,7,0
Xanaxmaster,archimonde,576,monk,mistweaver,6,6,0
Circlekick,twisting-nether,576,monk,mistweaver,6,6,0
Batschmaia,shattrath,576,monk,mistweaver,6,6,0
Redundänt,kazzak,576,monk,mistweaver,6,6,0
Mowì,stormscale,576,monk,mistweaver,6,6,0
Nigirisake,blackrock,576,monk,mistweaver,6,6,0
Daddynasty,blackhand,576,monk,mistweaver,6,6,0
Althéia,dalaran,576,monk,mistweaver,6,6,0
Ushuriel,ragnaros,576,monk,mistweaver,9,7,2
Juicepøpe,tarren-mill,576,monk,mistweaver,10,7,3
Ankelstrumpa,tarren-mill,576,monk,mistweaver,12,6,6
Fluxqt,ravencrest,576,monk,mistweaver,12,6,6
Traumerei,ravencrest,576,monk,mistweaver,12,6,6
Gosphhell,archimonde,576,monk,mistweaver,12,6,6
Arenajunkie,pozzo-delleternità,576,monk,mistweaver,12,6,6
Testicolino,nemesis,576,monk,mistweaver,12,6,6
Mamysuze,elune,576,monk,mistweaver,12,6,6
Deepênd,antonidas,576,monk,mistweaver,12,6,6
Icecoldbrew,outland,576,monk,mistweaver,12,6,6
Bfagameplay,stormscale,576,monk,mistweaver,12,6,6
Freemmrx,kazzak,576,monk,mistweaver,12,6,6
Yez,azjolnerub,576,monk,mistweaver,12,6,6
Кончеглаз,soulflayer,576,monk,mistweaver,12,6,6
Pivomamrad,drakthul,576,monk,mistweaver,12,6,6
Ryac,defias-brotherhood,576,monk,mistweaver,12,6,6
Миражмонк,howling-fjord,576,monk,mistweaver,12,6,6
Xaw,sanguino,576,monk,mistweaver,12,6,6
Monsh,burning-legion,576,monk,mistweaver,12,6,6
Garfunkel,emeriss,576,monk,mistweaver,12,6,6
Rudiculous,malganis,576,monk,mistweaver,12,6,6
Monjonagger,tyrande,576,monk,mistweaver,12,6,6
Mørbradgryde,silvermoon,576,monk,mistweaver,12,6,6
Rashtamonk,blackmoore,576,monk,mistweaver,12,6,6
Fistandfury,outland,576,monk,mistweaver,12,6,6
Leashed,blackmoore,576,monk,mistweaver,12,6,6
Sucemonkok,blackrock,576,monk,mistweaver,12,6,6
Vedak,stormreaver,576,monk,mistweaver,12,6,6
Sinensi,conseil-des-ombres,576,monk,mistweaver,12,6,6
Incapfull,archimonde,576,monk,mistweaver,18,6,12
Торен,soulflayer,576,monk,mistweaver,18,6,12
Девачки,soulflayer,576,monk,mistweaver,18,6,12
Siiderivalas,kazzak,576,monk,mistweaver,18,6,12
Itsthemonkky,tarren-mill,576,monk,mistweaver,24,6,18
Calîmero,outland,575,monk,mistweaver,6,6,0
Pôo,medivh,575,monk,mistweaver,12,6,6
Ricepudding,the-maelstrom,575,monk,mistweaver,12,6,6
Kushinaa,teldrassil,575,monk,mistweaver,12,6,6
Skonk,frostmane,575,monk,mistweaver,12,6,6
Incapp,ysondre,575,monk,mistweaver,12,6,6
Bümbüjke,ragnaros,575,monk,mistweaver,12,6,6
Crommul,burning-legion,575,monk,mistweaver,12,6,6
Drír,archimonde,575,monk,mistweaver,12,6,6
Biogasanlage,tarren-mill,575,monk,mistweaver,12,6,6
Drlyn,blackmoore,575,monk,mistweaver,12,6,6
Vexzen,tarren-mill,575,monk,mistweaver,12,6,6
Mistbeever,ragnaros,575,monk,mistweaver,12,6,6
Loutremoine,archimonde,575,monk,mistweaver,12,6,6
Yogi,defias-brotherhood,575,monk,mistweaver,12,6,6
Latify,todeswache,575,monk,mistweaver,18,6,12
Mockmé,defias-brotherhood,575,monk,mistweaver,18,6,12
Monkiky,hyjal,575,monk,mistweaver,18,6,12
Jamesxdeen,stormreaver,575,monk,mistweaver,18,6,12
Chuckmorris,draenor,574,monk,mistweaver,12,6,6
Othalain,silvermoon,574,monk,mistweaver,12,6,6
Granniz,archimonde,574,monk,mistweaver,12,6,6
Irishdëmon,ravencrest,574,monk,mistweaver,16,6,10
Jackamonk,kazzak,574,monk,mistweaver,18,6,12
Xentimus,kazzak,573,monk,mistweaver,18,6,12
Tajusia,sporeggar,573,monk,mistweaver,18,6,12
Mascrax,earthen-ring,573,monk,mistweaver,18,6,12
Cheechong,grim-batol,573,monk,mistweaver,28,8,20
Bearknuckles,darkmoon-faire,572,monk,mistweaver,12,6,6
Tenaris,nefarian,571,monk,mistweaver,12,6,6
Edenbllow,twisting-nether,571,monk,mistweaver,18,6,12
Shuzao,steamwheedle-cartel,569,monk,mistweaver,24,6,18
Flancho,shendralar,567,monk,mistweaver,12,6,6
Christien,ungoro,558,monk,mistweaver,29,6,23
Chasiu,antonidas,543,monk,mistweaver,14,7,7
Dinkei,sylvanas,543,monk,mistweaver,14,7,7
Sadeq,argent-dawn,542,monk,mistweaver,10,7,3
Sixhottie,defias-brotherhood,528,monk,mistweaver,9,7,2
Yesaya,sylvanas,528,monk,mistweaver,9,6,3
Lidalol,silvermoon,527,monk,mistweaver,9,7,2
Noctaeth,destromath,527,monk,mistweaver,11,6,5
Depletomonk,blackrock,527,monk,mistweaver,17,6,11
Insomniyah,tarren-mill,527,monk,mistweaver,17,6,11
Jackwondo,blackmoore,522,monk,mistweaver,16,8,8
Justinweaver,silvermoon,522,monk,mistweaver,19,9,10
Permagone,argent-dawn,522,monk,mistweaver,16,7,9
Dråf,ysondre,522,monk,mistweaver,18,7,11
Bêlebend,frostwolf,512,monk,mistweaver,10,6,4
Xzuena,blackmoore,511,monk,mistweaver,8,6,2
Przx,kazzak,510,monk,mistweaver,16,6,10
Fardulka,stormscale,508,monk,mistweaver,22,6,16
Schlitzohr,onyxia,493,monk,mistweaver,27,6,21
Подорожнник,gordunni,480,monk,mistweaver,6,5,1
Cintiq,silvermoon,480,monk,mistweaver,6,5,1
Peao,blackmoore,480,monk,mistweaver,6,5,1
Chiibah,malygos,480,monk,mistweaver,6,5,1
Lyganos,dalaran,480,monk,mistweaver,6,5,1
Ilovesrya,archimonde,480,monk,mistweaver,6,5,1
Xkäz,archimonde,480,monk,mistweaver,6,5,1
Monkoni,silvermoon,480,monk,mistweaver,6,5,1
Khabibs,hyjal,480,monk,mistweaver,6,5,1
Saikwondo,silvermoon,480,monk,mistweaver,6,5,1
Veladana,chamber-of-aspects,480,monk,mistweaver,6,5,1
Awy,drakthul,480,monk,mistweaver,6,5,1
Hyhu,burning-legion,480,monk,mistweaver,6,5,1
Ørcqt,tarren-mill,480,monk,mistweaver,6,5,1
Saenxz,blackrock,480,monk,mistweaver,6,5,1
Lanina,silvermoon,480,monk,mistweaver,6,5,1
Kaowar,nerzhul,480,monk,mistweaver,6,5,1
Stromon,silvermoon,480,monk,mistweaver,6,5,1
Notoriousx,thrall,480,monk,mistweaver,6,5,1
Ninagi,khaz-modan,480,monk,mistweaver,6,5,1
Khazanthir,terenas,480,monk,mistweaver,6,5,1
Supersane,antonidas,480,monk,mistweaver,6,5,1
Sloopkogel,tarren-mill,480,monk,mistweaver,6,5,1
Niima,archimonde,480,monk,mistweaver,6,5,1
Nobrainfist,stormscale,480,monk,mistweaver,6,5,1
Укусдракона,soulflayer,480,monk,mistweaver,6,5,1
Notgherit,nemesis,480,monk,mistweaver,6,5,1
Redminote,blackmoore,480,monk,mistweaver,6,5,1
Fwretwar,archimonde,480,monk,mistweaver,6,5,1
Anthufufu,ysondre,480,monk,mistweaver,6,5,1
Wannabeloa,silvermoon,480,monk,mistweaver,6,5,1
Sio,dentarg,480,monk,mistweaver,6,5,1
Lycerá,antonidas,480,monk,mistweaver,9,5,4
Siezlebabo,blackrock,480,monk,mistweaver,12,5,7
Kmorhin,antonidas,480,monk,mistweaver,12,5,7
Mikefist,blackrock,480,monk,mistweaver,12,5,7
Bountyño,dun-modr,480,monk,mistweaver,12,5,7
Gaspacio,silvermoon,480,monk,mistweaver,12,5,7
Smahammonk,sylvanas,480,monk,mistweaver,12,5,7
Clenda,hyjal,480,monk,mistweaver,12,5,7
Похмелись,blackscar,480,monk,mistweaver,12,5,7
Minervaez,grim-batol,480,monk,mistweaver,12,5,7
Miquella,scarshield-legion,480,monk,mistweaver,12,5,7
Sonixx,anubarak,480,monk,mistweaver,12,5,7
Relentlessly,blackrock,480,monk,mistweaver,12,5,7
Aurelìá,aegwynn,480,monk,mistweaver,12,5,7
Kaichi,defias-brotherhood,480,monk,mistweaver,12,5,7
Loveít,blackrock,480,monk,mistweaver,12,5,7
Atrikaww,kazzak,480,monk,mistweaver,12,5,7
Jodeen,shadowsong,480,monk,mistweaver,12,5,7
Erandja,silvermoon,480,monk,mistweaver,12,5,7
Ðrçleañ,stormreaver,480,monk,mistweaver,12,5,7
Чебурекстень,blackscar,480,monk,mistweaver,12,5,7
Hon,sanguino,480,monk,mistweaver,12,5,7
Selambebis,twisting-nether,480,monk,mistweaver,12,5,7
Rollarøund,outland,480,monk,mistweaver,12,5,7
Rockié,blackmoore,480,monk,mistweaver,12,5,7
Karmonk,outland,480,monk,mistweaver,12,5,7
Sashun,blackmoore,480,monk,mistweaver,12,5,7
Kâfkas,twisting-nether,480,monk,mistweaver,12,5,7
Domedagsdamp,draenor,480,monk,mistweaver,12,5,7
Potato,aggramar,480,monk,mistweaver,12,5,7
Bistweaver,kazzak,480,monk,mistweaver,12,5,7
Cøntfarmer,ravencrest,480,monk,mistweaver,12,5,7
Tchitã,hyjal,480,monk,mistweaver,12,5,7
Momonkymo,blackmoore,480,monk,mistweaver,12,5,7
Аэрди,howling-fjord,480,monk,mistweaver,12,5,7
Yinsho,stormscale,480,monk,mistweaver,12,5,7
Дэдлитрюк,soulflayer,480,monk,mistweaver,12,5,7
Elmun,draenor,480,monk,mistweaver,12,5,7
Grïmgødx,ravencrest,480,monk,mistweaver,12,5,7
Mønkî,blackrock,480,monk,mistweaver,12,5,7
Mailyne,blackmoore,480,monk,mistweaver,13,5,8
Moistweaver,drakthul,480,monk,mistweaver,18,5,13
Копытька,gordunni,480,monk,mistweaver,18,5,13
Jackíechen,draenor,480,monk,mistweaver,41,9,32
Risomonk,blackrock,480,monk,mistweaver,24,5,19
Kidpoo,ragnaros,479,monk,mistweaver,6,5,1
Proxxona,eredar,479,monk,mistweaver,6,5,1
Bubas,burning-legion,479,monk,mistweaver,9,5,4
Neyîth,scarshield-legion,479,monk,mistweaver,12,5,7
Dopenudel,antonidas,479,monk,mistweaver,12,5,7
Bovinebuddha,stormscale,479,monk,mistweaver,12,5,7
Luigimonk,dun-modr,479,monk,mistweaver,12,5,7
Yûkang,eldrethalas,479,monk,mistweaver,12,5,7
Дарума,grom,479,monk,mistweaver,12,5,7
Bigbrutus,draenor,479,monk,mistweaver,12,5,7
Âsmoran,blackmoore,479,monk,mistweaver,12,5,7
Raivoaívo,twisting-nether,479,monk,mistweaver,12,5,7
Mîsts,aszune,479,monk,mistweaver,12,5,7
Sotqyy,stormscale,479,monk,mistweaver,12,5,7
Unagui,bronzebeard,479,monk,mistweaver,18,5,13
Chîca,ysondre,479,monk,mistweaver,18,5,13
Bajabanger,stormscale,479,monk,mistweaver,18,5,13
Knotze,eredar,479,monk,mistweaver,18,5,13
Løkî,culte-de-la-rive-noire,479,monk,mistweaver,24,5,19
Бебралом,soulflayer,478,monk,mistweaver,6,5,1
Wînk,amanthul,478,monk,mistweaver,12,5,7
Backbone,auchindoun,478,monk,mistweaver,12,5,7
Golouf,ysondre,478,monk,mistweaver,12,5,7
Holowk,archimonde,477,monk,mistweaver,23,5,18
Leffe,thunderhorn,476,monk,mistweaver,12,5,7
Honîgbär,blackhand,470,monk,mistweaver,18,5,13
Rafa,burning-blade,470,monk,mistweaver,18,5,13
Filomenata,rexxar,469,monk,mistweaver,19,5,14
Nxmonk,sylvanas,468,monk,mistweaver,19,9,10
Frodrin,kazzak,467,monk,mistweaver,21,6,15
Ilgidius,defias-brotherhood,447,monk,mistweaver,10,5,5
Ñø,twisting-nether,447,monk,mistweaver,11,5,6
Zinzyo,aegwynn,447,monk,mistweaver,11,5,6
Doctòrmónk,tarren-mill,447,monk,mistweaver,14,6,8
Chinochuke,dun-modr,432,monk,mistweaver,9,6,3
Kawaì,frostwolf,431,monk,mistweaver,17,5,12
Mæáv,tarren-mill,426,monk,mistweaver,9,7,2
Ygêrne,archimonde,426,monk,mistweaver,15,6,9
Lévanà,antonidas,415,monk,mistweaver,8,5,3
Dibbz,bladefist,415,monk,mistweaver,10,5,5
Sudoku,thrall,415,monk,mistweaver,14,5,9
Kazéshini,doomhammer,384,monk,mistweaver,6,4,2
Bhrag,die-aldor,384,monk,mistweaver,6,4,2
Claww,blackrock,384,monk,mistweaver,6,4,2
Ved,shattered-hand,384,monk,mistweaver,6,4,2
Meldii,ravencrest,384,monk,mistweaver,6,4,2
Antipedyfile,kazzak,384,monk,mistweaver,6,4,2
Pagadi,destromath,384,monk,mistweaver,6,4,2
Monkersquad,doomhammer,384,monk,mistweaver,6,4,2
Rokonbigfan,blackrock,384,monk,mistweaver,6,4,2
Mïstfister,ravencrest,384,monk,mistweaver,6,4,2
Fakestrxx,aegwynn,384,monk,mistweaver,6,4,2
Highline,draenor,384,monk,mistweaver,6,4,2
Chunkymonkee,magtheridon,384,monk,mistweaver,6,4,2
Senshí,stormscale,384,monk,mistweaver,6,4,2
Zbamonk,burning-legion,384,monk,mistweaver,6,4,2
Trácybéákérx,kazzak,384,monk,mistweaver,6,4,2
Meineaugen,blackhand,384,monk,mistweaver,6,4,2
Pikahelp,ravencrest,384,monk,mistweaver,6,4,2
Cojoncito,tarren-mill,384,monk,mistweaver,6,4,2
Леобтв,soulflayer,384,monk,mistweaver,6,4,2
Vîsdom,kazzak,384,monk,mistweaver,6,4,2
Tedicated,tarren-mill,384,monk,mistweaver,6,4,2
Mistydex,eredar,384,monk,mistweaver,6,4,2
Shanzein,dragonmaw,384,monk,mistweaver,6,4,2
Bigflex,conseil-des-ombres,384,monk,mistweaver,6,4,2
Senretsu,kazzak,384,monk,mistweaver,6,4,2
Bratana,dun-morogh,384,monk,mistweaver,6,4,2
Monguru,silvermoon,384,monk,mistweaver,6,4,2
Immadbrew,blackmoore,384,monk,mistweaver,6,4,2
Tuulijäbä,stormreaver,384,monk,mistweaver,6,4,2
Kbsanityproc,kul-tiras,384,monk,mistweaver,6,4,2
Lilædi,draenor,384,monk,mistweaver,6,4,2
Gyógyítóütés,ragnaros,384,monk,mistweaver,6,4,2
Peaceweaver,ravencrest,384,monk,mistweaver,6,4,2
Tüüdüülüü,blackrock,384,monk,mistweaver,6,4,2
Boreuz,kazzak,384,monk,mistweaver,6,4,2
Camlen,draenor,384,monk,mistweaver,6,4,2
Zugzuwg,ahnqiraj,384,monk,mistweaver,6,4,2
Харуказэ,howling-fjord,384,monk,mistweaver,6,4,2
Oxway,silvermoon,384,monk,mistweaver,6,4,2
Sendayam,blackhand,384,monk,mistweaver,6,4,2
Slokwerk,dentarg,384,monk,mistweaver,6,4,2
Trâffix,kazzak,384,monk,mistweaver,6,4,2
Seorsum,twisting-nether,384,monk,mistweaver,6,4,2
Ennamoly,blackmoore,384,monk,mistweaver,6,4,2
Thérin,silvermoon,384,monk,mistweaver,6,4,2
Zenvurv,kazzak,384,monk,mistweaver,6,4,2
Данваго,deathguard,384,monk,mistweaver,6,4,2
Chiodora,ravencrest,384,monk,mistweaver,6,4,2
Naìsh,arygos,384,monk,mistweaver,6,4,2
Cravmonk,the-venture-co,384,monk,mistweaver,6,4,2
Гарримонк,deathguard,384,monk,mistweaver,6,4,2
Gangichi,blackhand,384,monk,mistweaver,9,5,4
Dúlgor,blackmoore,384,monk,mistweaver,11,6,5
Häppÿ,kazzak,384,monk,mistweaver,8,4,4
Bûl,blackmoore,384,monk,mistweaver,12,4,8
Nebelwandler,blackhand,384,monk,mistweaver,12,4,8
Карманедаун,howling-fjord,384,monk,mistweaver,12,4,8
Obeliskbrew,kazzak,384,monk,mistweaver,12,4,8
Subzxftw,archimonde,384,monk,mistweaver,12,4,8
Pompeflûte,archimonde,384,monk,mistweaver,12,4,8
Pandamums,frostwhisper,384,monk,mistweaver,12,4,8
Cactuzjuize,ragnaros,384,monk,mistweaver,12,4,8
Chimail,blackrock,384,monk,mistweaver,12,4,8
Nessä,kazzak,384,monk,mistweaver,12,4,8
Kokaingimli,outland,384,monk,mistweaver,12,4,8
Mistywaves,stormscale,384,monk,mistweaver,12,4,8
Тониромано,thermaplugg,384,monk,mistweaver,12,4,8
Woofi,tarren-mill,384,monk,mistweaver,12,4,8
Rustyzuki,hyjal,384,monk,mistweaver,12,4,8
Altairan,ragnaros,384,monk,mistweaver,12,4,8
Eurocod,draenor,384,monk,mistweaver,12,4,8
Pepperboer,magtheridon,384,monk,mistweaver,12,4,8
Smøkÿý,eredar,384,monk,mistweaver,12,4,8
Eth,nagrand,384,monk,mistweaver,12,4,8
Monkmonkesen,stormscale,384,monk,mistweaver,12,4,8
Audaz,dun-modr,384,monk,mistweaver,12,4,8
Invsionrush,crushridge,384,monk,mistweaver,12,4,8
Divljivepar,stormscale,384,monk,mistweaver,12,4,8
Bruceli,darkmoon-faire,384,monk,mistweaver,12,4,8
Jchi,ravencrest,384,monk,mistweaver,12,4,8
Mîyüki,dalaran,384,monk,mistweaver,18,4,14
Supwithat,kazzak,383,monk,mistweaver,6,4,2
Goldenquinn,sylvanas,383,monk,mistweaver,6,4,2
Шалфевна,grom,383,monk,mistweaver,16,7,9
Ornithorynke,hyjal,383,monk,mistweaver,12,4,8
Doneithné,stormscale,383,monk,mistweaver,12,4,8
Tarly,archimonde,383,monk,mistweaver,12,4,8
Gnomebrew,ravencrest,383,monk,mistweaver,12,4,8
Aêsir,thrall,383,monk,mistweaver,12,4,8
Korrok,sanguino,383,monk,mistweaver,12,4,8
Zaalleh,draenor,382,monk,mistweaver,7,6,1
Jackiechann,kazzak,382,monk,mistweaver,6,4,2
Zigzak,kul-tiras,382,monk,mistweaver,12,4,8
Fkflying,defias-brotherhood,381,monk,mistweaver,12,4,8
Fairhand,emerald-dream,367,monk,mistweaver,11,4,7
Plií,frostwolf,362,monk,mistweaver,19,6,13
Qizz,antonidas,352,monk,mistweaver,10,5,5
Buckersxo,kazzak,330,monk,mistweaver,11,6,5
Aennie,zuljin,330,monk,mistweaver,11,5,6
Chimý,tarren-mill,330,monk,mistweaver,15,5,10
Shrimpcawk,alonsus,320,monk,mistweaver,10,4,6
Craneisback,archimonde,319,monk,mistweaver,5,4,1
Sayumì,antonidas,319,monk,mistweaver,5,4,1
Perikencito,dun-modr,288,monk,mistweaver,6,3,3
Watzabi,defias-brotherhood,288,monk,mistweaver,6,3,3
Wando,defias-brotherhood,288,monk,mistweaver,6,3,3
Linçhi,dun-modr,288,monk,mistweaver,6,3,3
Лён,ashenvale,288,monk,mistweaver,6,3,3
Chiheal,outland,288,monk,mistweaver,6,3,3
Kaskinhas,archimonde,288,monk,mistweaver,6,3,3
Senpuu,defias-brotherhood,288,monk,mistweaver,6,3,3
Thiccolas,argent-dawn,288,monk,mistweaver,6,3,3
Mivansemmi,ragnaros,288,monk,mistweaver,6,3,3
Маруты,soulflayer,288,monk,mistweaver,6,3,3
Oslyabya,twisting-nether,288,monk,mistweaver,6,3,3
Lívscoachen,tarren-mill,288,monk,mistweaver,6,3,3
Lassador,onyxia,288,monk,mistweaver,6,3,3
Shoskio,chamber-of-aspects,288,monk,mistweaver,6,3,3
Koba,frostwolf,288,monk,mistweaver,6,3,3
Louiemon,outland,288,monk,mistweaver,6,3,3
Erì,malfurion,288,monk,mistweaver,6,3,3
Bútkus,argent-dawn,288,monk,mistweaver,6,3,3
Sennín,blackhand,288,monk,mistweaver,6,3,3
Kakukkosora,ragnaros,288,monk,mistweaver,6,3,3
Родо,blackscar,288,monk,mistweaver,6,3,3
Yutahon,azjolnerub,288,monk,mistweaver,6,3,3
Jadeterror,argent-dawn,288,monk,mistweaver,6,3,3
Lovewreck,twisting-nether,288,monk,mistweaver,6,3,3
Trubushatal,ravencrest,288,monk,mistweaver,6,3,3
Jackíechun,twisting-nether,288,monk,mistweaver,6,3,3
Chaisun,blackrock,288,monk,mistweaver,6,3,3
Thånkky,kazzak,288,monk,mistweaver,6,3,3
Helacoon,archimonde,288,monk,mistweaver,6,3,3
Муртузикх,blackscar,288,monk,mistweaver,6,3,3
Uggs,hyjal,288,monk,mistweaver,6,3,3
Akinhd,twisting-nether,288,monk,mistweaver,6,3,3
Mistless,ragnaros,288,monk,mistweaver,6,3,3
Gojò,outland,288,monk,mistweaver,6,3,3
Rotakapa,arathor,288,monk,mistweaver,6,3,3
Rípple,alakir,288,monk,mistweaver,6,3,3
Catley,archimonde,288,monk,mistweaver,6,3,3
Leifjuster,stormscale,288,monk,mistweaver,6,3,3
Ipès,archimonde,288,monk,mistweaver,6,3,3
Sàfcony,eredar,288,monk,mistweaver,6,3,3
Andrèa,draenor,288,monk,mistweaver,6,3,3
Baisi,blackhand,288,monk,mistweaver,6,3,3
Shàolïn,dalaran,288,monk,mistweaver,6,3,3
Friidam,lightbringer,288,monk,mistweaver,6,3,3
Киликххл,deathguard,288,monk,mistweaver,6,3,3
Коррелир,howling-fjord,288,monk,mistweaver,6,3,3
Auraceleste,nemesis,288,monk,mistweaver,6,3,3
Sulhàn,blackrock,288,monk,mistweaver,6,3,3
Хаолей,gordunni,288,monk,mistweaver,6,3,3
Místerfister,ravencrest,288,monk,mistweaver,6,3,3
Norbii,twisting-nether,288,monk,mistweaver,6,3,3
Sotariana,archimonde,288,monk,mistweaver,6,3,3
Napari,tichondrius,288,monk,mistweaver,6,3,3
Litenværen,tarren-mill,288,monk,mistweaver,6,3,3
Bronda,shadowsong,288,monk,mistweaver,6,3,3
Shnohh,blackmoore,288,monk,mistweaver,6,3,3
Enfargo,ravencrest,288,monk,mistweaver,6,3,3
Xarain,tyrande,288,monk,mistweaver,6,3,3
Turbofinger,doomhammer,288,monk,mistweaver,6,3,3
Màlydôr,outland,288,monk,mistweaver,6,3,3
Fistwave,malganis,288,monk,mistweaver,6,3,3
Klarez,hellfire,288,monk,mistweaver,6,3,3
Рнбклаб,gordunni,288,monk,mistweaver,6,3,3
Zkrmonk,kazzak,288,monk,mistweaver,6,3,3
Mønkek,kazzak,288,monk,mistweaver,6,3,3
Hilton,thrall,288,monk,mistweaver,6,3,3
Kenaïï,archimonde,288,monk,mistweaver,6,3,3
Shiìnx,hyjal,288,monk,mistweaver,6,3,3
Radisha,uldum,288,monk,mistweaver,6,3,3
Kjeyro,ravencrest,288,monk,mistweaver,6,3,3
Greatfupanda,bronze-dragonflight,288,monk,mistweaver,6,3,3
Loempia,outland,288,monk,mistweaver,6,3,3
Napqi,malganis,288,monk,mistweaver,6,3,3
Culiacàn,blackmoore,288,monk,mistweaver,6,3,3
Seeyousoon,nemesis,288,monk,mistweaver,6,3,3
Tetmo,blackhand,288,monk,mistweaver,6,3,3
Píco,gorgonnash,288,monk,mistweaver,6,3,3
Píxels,ravencrest,288,monk,mistweaver,6,3,3
Zyrosmonk,blackmoore,288,monk,mistweaver,6,3,3
Såsha,sanguino,288,monk,mistweaver,6,3,3
Sadgé,kazzak,288,monk,mistweaver,8,3,5
Justfistyoux,archimonde,288,monk,mistweaver,12,3,9
Monkenya,kazzak,288,monk,mistweaver,12,3,9
Zalupina,silvermoon,288,monk,mistweaver,12,3,9
Lottelita,tarren-mill,288,monk,mistweaver,12,3,9
Danèè,defias-brotherhood,288,monk,mistweaver,12,3,9
Koreanbullet,archimonde,288,monk,mistweaver,12,3,9
Leøni,malfurion,288,monk,mistweaver,12,3,9
Albertã,doomhammer,288,monk,mistweaver,12,3,9
Lïv,kirin-tor,288,monk,mistweaver,12,3,9
Farkasmw,arathor,288,monk,mistweaver,12,3,9
Xvll,kaelthas,288,monk,mistweaver,12,3,9
Nikosonkush,archimonde,288,monk,mistweaver,12,3,9
Älys,outland,288,monk,mistweaver,12,3,9
Shaokz,sylvanas,288,monk,mistweaver,12,3,9
Drunklee,aegwynn,288,monk,mistweaver,12,3,9
Deezspin,twisting-nether,288,monk,mistweaver,12,3,9
Gaehitmonlee,ravencrest,288,monk,mistweaver,12,3,9
Sedk,kazzak,288,monk,mistweaver,12,3,9
Alilith,drakthul,288,monk,mistweaver,12,3,9
Bigbuddha,agamaggan,288,monk,mistweaver,17,3,14
Phínez,thunderhorn,288,monk,mistweaver,18,3,15
Crayz,blackmoore,288,monk,mistweaver,18,3,15
Velita,dun-modr,288,monk,mistweaver,18,3,15
Upbringer,ragnaros,288,monk,mistweaver,18,3,15
Xilasa,blackrock,288,monk,mistweaver,18,3,15
Munkeguden,ravencrest,288,monk,mistweaver,22,3,19
Bo,malorne,287,monk,mistweaver,6,3,3
Playboicarti,frostwolf,287,monk,mistweaver,6,3,3
Torpedoorc,blackrock,287,monk,mistweaver,6,3,3
Hanumahn,kilrogg,287,monk,mistweaver,12,3,9
Weedtastic,ravencrest,287,monk,mistweaver,24,3,21
Shorebreak,argent-dawn,286,monk,mistweaver,6,3,3
Hamonja,sanguino,285,monk,mistweaver,36,3,33
Holishet,twisting-nether,271,monk,mistweaver,11,3,8
Spinosa,zirkel-des-cenarius,271,monk,mistweaver,12,3,9
Maharaj,terenas,255,monk,mistweaver,11,3,8
Lupîn,veklor,253,monk,mistweaver,10,3,7
Writeofl,silvermoon,240,monk,mistweaver,15,4,11
Mð,blackmoore,239,monk,mistweaver,5,3,2
Tidox,burning-legion,239,monk,mistweaver,5,3,2
Gujja,doomhammer,239,monk,mistweaver,5,3,2
Xkôra,cthun,239,monk,mistweaver,5,3,2
Monkelise,stormscale,234,monk,mistweaver,8,5,3
Jeuxfacil,archimonde,234,monk,mistweaver,9,4,5
Nypö,hyjal,234,monk,mistweaver,10,4,6
Mouhous,hellscream,234,monk,mistweaver,13,4,9
Cerativ,kult-der-verdammten,234,monk,mistweaver,17,4,13
Арнольдовна,blackscar,234,monk,mistweaver,17,4,13
Merqurychi,ravencrest,228,monk,mistweaver,14,7,7
Злюкшо,howling-fjord,192,monk,mistweaver,10,4,6
Auaaua,ravencrest,192,monk,mistweaver,6,2,4
Зараз,gordunni,192,monk,mistweaver,6,2,4
Kolsyran,draenor,192,monk,mistweaver,6,2,4
Ninano,ravencrest,192,monk,mistweaver,6,2,4
Shinyin,outland,192,monk,mistweaver,6,2,4
Shanokee,blackrock,192,monk,mistweaver,6,2,4
Troudbamone,dalaran,192,monk,mistweaver,6,2,4
Telofisto,nemesis,192,monk,mistweaver,6,2,4
Brewzin,frostwhisper,192,monk,mistweaver,6,2,4
Denau,aegwynn,192,monk,mistweaver,6,2,4
Dennismansix,sylvanas,192,monk,mistweaver,6,2,4
Faustíne,blackmoore,192,monk,mistweaver,6,2,4
Votegus,outland,192,monk,mistweaver,6,2,4
Izzana,onyxia,192,monk,mistweaver,6,2,4
Monkrat,blackrock,192,monk,mistweaver,6,2,4
Toxicvxpe,archimonde,192,monk,mistweaver,6,2,4
Brogenhagen,silvermoon,192,monk,mistweaver,6,2,4
Gabbah,blackrock,192,monk,mistweaver,6,2,4
Ariyamonkk,sylvanas,192,monk,mistweaver,6,2,4
Fistyxoxo,blackrock,192,monk,mistweaver,6,2,4
Sînge,archimonde,192,monk,mistweaver,6,2,4
Sørps,ravencrest,192,monk,mistweaver,6,2,4
Shynlee,frostwhisper,192,monk,mistweaver,6,2,4
Wifeeagro,doomhammer,192,monk,mistweaver,6,2,4
Nashli,kazzak,192,monk,mistweaver,6,2,4
Overcute,twisting-nether,192,monk,mistweaver,6,2,4
Ódién,der-rat-von-dalaran,192,monk,mistweaver,6,2,4
Moshka,blackhand,192,monk,mistweaver,6,2,4
Влегкуюрву,gordunni,192,monk,mistweaver,6,2,4
Wizzad,blackmoore,192,monk,mistweaver,6,2,4
Trippyv,ragnaros,192,monk,mistweaver,6,2,4
Mäismz,stormscale,192,monk,mistweaver,6,2,4
Dalaipyjama,quelthalas,192,monk,mistweaver,6,2,4
Люсилью,howling-fjord,192,monk,mistweaver,6,2,4
Karatemooves,kazzak,192,monk,mistweaver,6,2,4
Laesh,archimonde,192,monk,mistweaver,6,2,4
Acbcz,draenor,192,monk,mistweaver,6,2,4
Flyingraven,magtheridon,192,monk,mistweaver,6,2,4
Chegweaver,ravencrest,192,monk,mistweaver,6,2,4
Bartûs,blackmoore,192,monk,mistweaver,6,2,4
Laagun,blackmoore,192,monk,mistweaver,6,2,4
Халиосфа,gordunni,192,monk,mistweaver,6,2,4
Morty,balnazzar,192,monk,mistweaver,6,2,4
Xùen,blackrock,192,monk,mistweaver,6,2,4
Starwalkin,silvermoon,192,monk,mistweaver,6,2,4
Fettucini,anubarak,192,monk,mistweaver,6,2,4
Armanimads,kazzak,192,monk,mistweaver,6,2,4
Torpedopetra,baelgun,192,monk,mistweaver,6,2,4
Brüshïë,kazzak,192,monk,mistweaver,6,2,4
Шиншири,gordunni,192,monk,mistweaver,6,2,4
Aliozman,azshara,192,monk,mistweaver,6,2,4
Леронтас,gordunni,192,monk,mistweaver,6,2,4
Nezrusltwo,dun-modr,192,monk,mistweaver,6,2,4
Jadefain,argent-dawn,192,monk,mistweaver,6,2,4
Ahaa,kazzak,192,monk,mistweaver,6,2,4
Kyz,darkspear,192,monk,mistweaver,6,2,4
Merlyñ,blackmoore,192,monk,mistweaver,6,2,4
Espectrå,dun-modr,192,monk,mistweaver,6,2,4
Jtepm,ravencrest,192,monk,mistweaver,6,2,4
Kanaja,emerald-dream,192,monk,mistweaver,6,2,4
Kurono,senjin,192,monk,mistweaver,6,2,4
Axan,drekthar,192,monk,mistweaver,6,2,4
Watermelon,laughing-skull,192,monk,mistweaver,6,2,4
Nihx,dun-modr,192,monk,mistweaver,6,2,4
Khrajsyy,kazzak,192,monk,mistweaver,6,2,4
Scorpìon,blackrock,192,monk,mistweaver,6,2,4
Ïnaho,hyjal,192,monk,mistweaver,6,2,4
Amoose,blackmoore,192,monk,mistweaver,6,2,4
Denfeiteqken,ragnaros,192,monk,mistweaver,6,2,4
Thrìllseeker,blackmoore,192,monk,mistweaver,6,2,4
Mutai,tarren-mill,192,monk,mistweaver,6,2,4
Spághettôni,eredar,192,monk,mistweaver,6,2,4
Bankmw,nordrassil,192,monk,mistweaver,6,2,4
Jolifine,alleria,192,monk,mistweaver,6,2,4
Fisterxd,blackrock,192,monk,mistweaver,6,2,4
Mystize,shattered-hand,192,monk,mistweaver,6,2,4
Baiyana,hyjal,192,monk,mistweaver,6,2,4
Liluzi,aszune,192,monk,mistweaver,6,2,4
Jinmi,blackmoore,192,monk,mistweaver,10,3,7
Beriberi,tichondrius,192,monk,mistweaver,7,2,5
Karun,ravencrest,192,monk,mistweaver,7,2,5
Thomasruin,the-venture-co,192,monk,mistweaver,7,2,5
Jacksbäro,zirkel-des-cenarius,192,monk,mistweaver,12,2,10
Annamonk,tarren-mill,192,monk,mistweaver,12,2,10
Johnsôn,blackmoore,192,monk,mistweaver,12,2,10
Zárl,shadowsong,192,monk,mistweaver,12,2,10
Alexandrovic,hyjal,192,monk,mistweaver,12,2,10
Monkolben,blackmoore,192,monk,mistweaver,12,2,10
Bierdame,blackhand,192,monk,mistweaver,12,2,10
Kinoshíta,draenor,192,monk,mistweaver,12,2,10
Anifurry,tarren-mill,192,monk,mistweaver,12,2,10
Ascrem,ragnaros,192,monk,mistweaver,12,2,10
Sillbis,bronzebeard,192,monk,mistweaver,12,2,10
Doabarrelrol,blackmoore,192,monk,mistweaver,12,2,10
Clonaz,silvermoon,192,monk,mistweaver,12,2,10
Dòrâ,archimonde,192,monk,mistweaver,12,2,10
Brixelol,kazzak,192,monk,mistweaver,12,2,10
Djkaratemunk,tarren-mill,192,monk,mistweaver,24,2,22
Ceeyu,antonidas,191,monk,mistweaver,6,2,4
Sargnorak,dalaran,191,monk,mistweaver,6,2,4
Hisagi,khaz-modan,191,monk,mistweaver,6,2,4
Jackywayne,blackmoore,180,monk,mistweaver,18,5,13
Uluwatu,sanguino,160,monk,mistweaver,10,2,8
Megatazz,hyjal,159,monk,mistweaver,5,2,3
Øsys,dun-modr,159,monk,mistweaver,5,2,3
Mistyjack,kazzak,159,monk,mistweaver,5,2,3
Hectør,terrordar,159,monk,mistweaver,5,2,3
Scpanda,aggra-português,159,monk,mistweaver,8,3,5
Fisttweaver,twisting-nether,159,monk,mistweaver,8,3,5
Zausmo,kazzak,144,monk,mistweaver,9,2,7
Wololomonk,silvermoon,138,monk,mistweaver,8,3,5
Mankzie,argent-dawn,138,monk,mistweaver,9,3,6
Ostarikyttä,stormscale,138,monk,mistweaver,10,3,7
Monkigobrr,draenor,138,monk,mistweaver,11,3,8
Kunleu,draenor,137,monk,mistweaver,10,4,6
Спартаннка,gordunni,137,monk,mistweaver,8,3,5
Athëlyn,hyjal,137,monk,mistweaver,11,3,8
Naisha,arygos,128,monk,mistweaver,4,2,2
Wraq,tarren-mill,128,monk,mistweaver,4,2,2
Mossadjr,blackmoore,106,monk,mistweaver,9,4,5
Tóffée,silvermoon,96,monk,mistweaver,6,1,5
Kanade,kul-tiras,96,monk,mistweaver,6,1,5
Tetukss,zuljin,96,monk,mistweaver,6,1,5
Yonahä,kazzak,96,monk,mistweaver,6,1,5
Mezz,ahnqiraj,96,monk,mistweaver,6,1,5
Metakids,kazzak,96,monk,mistweaver,6,1,5
Stölltommy,draenor,96,monk,mistweaver,6,1,5
Ytjin,draenor,96,monk,mistweaver,6,1,5
Wolfynk,kazzak,96,monk,mistweaver,6,1,5
Katmunk,silvermoon,96,monk,mistweaver,6,1,5
Rullandezutt,kazzak,96,monk,mistweaver,6,1,5
Mandràmw,hyjal,96,monk,mistweaver,6,1,5
Pream,blackrock,96,monk,mistweaver,6,1,5
Bellamnk,darksorrow,96,monk,mistweaver,6,1,5
Worldfamous,stormscale,96,monk,mistweaver,6,1,5
Aang,blackrock,96,monk,mistweaver,6,1,5
Fapmaster,aegwynn,96,monk,mistweaver,6,1,5
Munkina,tarren-mill,96,monk,mistweaver,6,1,5
Jessiemonk,blackhand,96,monk,mistweaver,6,1,5
Toté,kazzak,96,monk,mistweaver,6,1,5
Claptone,blackrock,96,monk,mistweaver,6,1,5
Butrinto,hellfire,96,monk,mistweaver,6,1,5
Aequïtas,nemesis,96,monk,mistweaver,6,1,5
Rostick,drakthul,96,monk,mistweaver,6,1,5
Krisstopherr,draenor,96,monk,mistweaver,6,1,5
Guldendrak,draenor,96,monk,mistweaver,6,1,5
Chîvex,stormscale,96,monk,mistweaver,6,1,5
Gargalondeze,twisting-nether,96,monk,mistweaver,6,1,5
Cai,blackrock,96,monk,mistweaver,6,1,5
Рискасм,soulflayer,96,monk,mistweaver,6,1,5
Vaelis,arthas,96,monk,mistweaver,6,1,5
Botsmw,kazzak,96,monk,mistweaver,6,1,5
Bruslie,cthun,96,monk,mistweaver,6,1,5
Brewbunnyqt,thrall,96,monk,mistweaver,6,1,5
Jvousnike,chants-éternels,96,monk,mistweaver,6,1,5
Кукуныч,deathguard,96,monk,mistweaver,6,1,5
Missblack,zuljin,96,monk,mistweaver,6,1,5
Bumbiere,outland,96,monk,mistweaver,6,1,5
Ffacé,stormscale,96,monk,mistweaver,6,1,5
Juicylips,frostwolf,96,monk,mistweaver,6,1,5
Psyblådès,silvermoon,96,monk,mistweaver,6,1,5
Smlpp,kazzak,96,monk,mistweaver,6,1,5
Àómìñêdâìkí,lightnings-blade,96,monk,mistweaver,6,1,5
Ponchers,aegwynn,96,monk,mistweaver,6,1,5
Fantazero,ravencrest,96,monk,mistweaver,6,1,5
Fisten,xavius,96,monk,mistweaver,6,1,5
Lìlíy,taerar,96,monk,mistweaver,6,1,5
Prezze,outland,96,monk,mistweaver,6,1,5
Duvelmonk,dragonblight,96,monk,mistweaver,6,1,5
Itxelita,zuljin,96,monk,mistweaver,6,1,5
Crymôreplz,blackmoore,96,monk,mistweaver,6,1,5
Skadchi,blackhand,96,monk,mistweaver,6,1,5
Starplatinüm,dun-modr,96,monk,mistweaver,6,1,5
Эйнея,soulflayer,96,monk,mistweaver,6,1,5
Brandy,kazzak,96,monk,mistweaver,6,1,5
Legpunch,the-maelstrom,96,monk,mistweaver,6,1,5
Monkgoatx,aegwynn,96,monk,mistweaver,6,1,5
Havefunguys,alakir,96,monk,mistweaver,6,1,5
Yeanwoo,burning-legion,96,monk,mistweaver,6,1,5
Ceffoine,chogall,96,monk,mistweaver,6,1,5
Nimonk,blackhand,96,monk,mistweaver,6,1,5
Flekweaver,tarren-mill,96,monk,mistweaver,6,1,5
Kamui,naxxramas,96,monk,mistweaver,6,1,5
Cbamonk,tarren-mill,96,monk,mistweaver,6,1,5
Monkinator,stormreaver,96,monk,mistweaver,6,1,5
Sooyung,kazzak,96,monk,mistweaver,6,1,5
Capos,wrathbringer,96,monk,mistweaver,11,1,10
Alexì,taerar,96,monk,mistweaver,12,1,11
Hotfist,outland,96,monk,mistweaver,12,1,11
Тевимонк,gordunni,96,monk,mistweaver,12,1,11
Tmhamm,ravencrest,96,monk,mistweaver,12,1,11
Sigournémist,silvermoon,96,monk,mistweaver,12,1,11
Dmndog,antonidas,96,monk,mistweaver,12,1,11
Marrów,chamber-of-aspects,96,monk,mistweaver,14,1,13
Potnaro,burning-legion,95,monk,mistweaver,12,1,11
Eijin,arathor,95,monk,mistweaver,12,1,11
Trlmøna,gorgonnash,90,monk,mistweaver,11,4,7
Lílliv,wrathbringer,79,monk,mistweaver,5,1,4
Moondu,argent-dawn,64,monk,mistweaver,4,1,3
Barendhoff,sylvanas,64,monk,mistweaver,4,1,3
Бязь,gordunni,63,monk,mistweaver,2,2,0
Fae,kirin-tor,63,monk,mistweaver,14,2,12
Johnnybgood,tarren-mill,42,monk,mistweaver,10,3,7
Axilane,outland,42,monk,mistweaver,7,2,5
Drosky,archimonde,42,monk,mistweaver,7,2,5
Ceedxyz,antonidas,42,monk,mistweaver,9,2,7
Teemouz,hyjal,42,monk,mistweaver,9,2,7
Флокэ,soulflayer,42,monk,mistweaver,9,2,7
Tonh,stormscale,42,monk,mistweaver,11,2,9
Monkeykung,defias-brotherhood,40,monk,mistweaver,16,3,13
Nïkaa,dun-modr,18,monk,mistweaver,21,10,11
Pandaaäaaäaa,archimonde,1391,monk,brewmaster,34,18,16
Jademyst,outland,1263,monk,brewmaster,40,14,26
Sinpho,ahnqiraj,1192,monk,brewmaster,48,19,29
Winchun,ravencrest,820,monk,brewmaster,32,14,18
Padawang,twisting-nether,767,monk,brewmaster,24,8,16
Комбатпро,borean-tundra,711,monk,brewmaster,138,62,76
Shirôhige,zirkel-des-cenarius,480,monk,brewmaster,12,5,7
Merqurychi,ravencrest,480,monk,brewmaster,12,5,7
Ehrenkranich,blackrock,288,monk,brewmaster,6,3,3
Johnnykegs,draenor,288,monk,brewmaster,6,3,3
Tauroné,draenor,288,monk,brewmaster,12,3,9
Fullzi,dalaran,192,monk,brewmaster,6,2,4
Zerendir,magtheridon,192,monk,brewmaster,6,2,4
Shurak,uldaman,192,monk,brewmaster,6,2,4
Tayoo,aegwynn,192,monk,brewmaster,6,2,4
Youkaii,alexstrasza,192,monk,brewmaster,12,2,10
Yeanwoo,burning-legion,96,monk,brewmaster,6,1,5
Simbabsu,thrall,96,monk,brewmaster,6,1,5
Badcøwboy,archimonde,96,monk,brewmaster,6,1,5
Piedliés,ravencrest,96,monk,brewmaster,6,1,5
Tylee,tarren-mill,96,monk,brewmaster,6,1,5
Mezz,ahnqiraj,96,monk,brewmaster,6,1,5
Winarchek,tarren-mill,96,monk,brewmaster,6,1,5
Lubeï,kirin-tor,96,monk,brewmaster,6,1,5
Lòthbar,confrérie-du-thorium,63,monk,brewmaster,2,2,0
Rmtexter,ravencrest,2404,monk,windwalker,167,94,73
Lîlilîlîlîlí,stormscale,2388,monk,windwalker,84,53,31
Sîxmonths,stormscale,2347,monk,windwalker,90,60,30
Queteapie,stormscale,2337,monk,windwalker,106,63,43
Fistyw,stormscale,2313,monk,windwalker,104,60,44
Ewynamonk,silvermoon,2310,monk,windwalker,150,81,69
Edenmonk,dun-morogh,2273,monk,windwalker,90,50,40
Tianzu,twisting-nether,2251,monk,windwalker,246,134,112
Faxax,draenor,2239,monk,windwalker,168,87,81
Ilovehim,antonidas,2237,monk,windwalker,102,58,44
Locotommy,blackrock,2228,monk,windwalker,92,51,41
Balia,blackrock,2196,monk,windwalker,181,97,84
Kokushibo,cthun,2193,monk,windwalker,102,56,46
Keeferslover,dun-morogh,2187,monk,windwalker,66,39,27
Brñ,twisting-nether,2186,monk,windwalker,84,44,40
Hitsuwalker,archimonde,2180,monk,windwalker,252,138,114
Teressah,argent-dawn,2169,monk,windwalker,84,48,36
Monkmeta,frostwolf,2167,monk,windwalker,120,72,48
Senretsu,shattered-halls,2165,monk,windwalker,120,62,58
Fistenjoyer,outland,2159,monk,windwalker,155,84,71
Stÿvww,archimonde,2152,monk,windwalker,85,48,37
Lilcatlife,tyrande,2152,monk,windwalker,72,38,34
Plaww,dalaran,2148,monk,windwalker,138,83,55
Дезмимонк,ashenvale,2136,monk,windwalker,73,41,32
Snusochnocco,the-maelstrom,2136,monk,windwalker,126,64,62
Onlypressw,tarren-mill,2126,monk,windwalker,66,34,32
Tabetai,tarren-mill,2125,monk,windwalker,90,46,44
Redundänt,kazzak,2122,monk,windwalker,84,46,38
Daosh,nemesis,2109,monk,windwalker,121,60,61
Минимонахх,blackscar,2108,monk,windwalker,201,101,100
Melyda,ravencrest,2105,monk,windwalker,341,183,158
Shrimpcawk,alonsus,2100,monk,windwalker,271,152,119
Dêsmî,ravencrest,2098,monk,windwalker,58,36,22
Deretrox,twisting-nether,2097,monk,windwalker,101,54,47
Edenwalker,dun-morogh,2096,monk,windwalker,114,54,60
Muix,draenor,2091,monk,windwalker,60,34,26
Leppix,outland,2090,monk,windwalker,137,66,71
Váinz,ravencrest,2084,monk,windwalker,102,50,52
Elinalia,burning-legion,2067,monk,windwalker,150,75,75
Rivaz,archimonde,2061,monk,windwalker,108,55,53
Rivazsunkick,archimonde,2052,monk,windwalker,322,158,164
Аррани,thermaplugg,2045,monk,windwalker,82,46,36
Pichouhuahua,elune,2045,monk,windwalker,234,117,117
Unpruneable,stormscale,2042,monk,windwalker,333,162,171
Gyto,archimonde,2038,monk,windwalker,83,45,38
Anteric,sylvanas,2037,monk,windwalker,83,46,37
Padawang,twisting-nether,2034,monk,windwalker,82,44,38
Stepsyzz,stormscale,2029,monk,windwalker,178,86,92
Hefners,grim-batol,2028,monk,windwalker,71,36,35
Hôllowx,archimonde,2023,monk,windwalker,75,43,32
Hôllowx,throkferoth,2023,monk,windwalker,72,37,35
Dänÿww,elune,2020,monk,windwalker,92,50,42
Милыйколян,soulflayer,2020,monk,windwalker,78,40,38
Мистмастер,soulflayer,2014,monk,windwalker,54,32,22
Deuxmonk,outland,2014,monk,windwalker,134,64,70
Щищ,gordunni,2010,monk,windwalker,294,157,137
Blizò,tarren-mill,2010,monk,windwalker,78,41,37
Erazhen,blackrock,2009,monk,windwalker,66,33,33
Vyneth,draenor,2008,monk,windwalker,95,47,48
Theoww,dragonblight,2008,monk,windwalker,179,87,92
Spectré,outland,2007,monk,windwalker,101,46,55
Juujika,ravencrest,2006,monk,windwalker,65,35,30
Venuki,blackrock,2005,monk,windwalker,108,65,43
Ilovealicia,ragnaros,2005,monk,windwalker,89,47,42
Troopmonk,ravencrest,2005,monk,windwalker,265,135,130
Нелегитимный,howling-fjord,2001,monk,windwalker,444,225,219
Fistyfast,hyjal,1998,monk,windwalker,54,33,21
Vulkoo,lightbringer,1995,monk,windwalker,69,36,33
Vixia,outland,1994,monk,windwalker,41,23,18
Soulja,bloodfeather,1993,monk,windwalker,655,335,320
Форгетх,soulflayer,1990,monk,windwalker,84,46,38
Vexíllum,sylvanas,1986,monk,windwalker,120,67,53
Eth,nagrand,1975,monk,windwalker,84,42,42
Deathmøøn,tyrande,1975,monk,windwalker,93,41,52
Däemon,twisting-nether,1970,monk,windwalker,138,71,67
Атммо,soulflayer,1967,monk,windwalker,95,51,44
Bulluh,blackmoore,1964,monk,windwalker,59,31,28
Wolmachégodx,archimonde,1960,monk,windwalker,60,33,27
Pandamoniun,aggra-português,1957,monk,windwalker,236,119,117
Wonkeed,hyjal,1956,monk,windwalker,185,97,88
Gorguts,stormscale,1955,monk,windwalker,90,52,38
Ililgeg,thrall,1954,monk,windwalker,143,81,62
Имортарион,howling-fjord,1954,monk,windwalker,211,105,106
Rismonk,twisting-nether,1950,monk,windwalker,166,84,82
Fabrina,blackrock,1949,monk,windwalker,114,58,56
Senniñ,ravencrest,1943,monk,windwalker,54,30,24
Arlohan,argent-dawn,1938,monk,windwalker,48,31,17
Dévíllíá,ragnaros,1936,monk,windwalker,72,35,37
Bannedww,ravencrest,1935,monk,windwalker,54,36,18
Devilmønk,thrall,1934,monk,windwalker,162,85,77
Diagmonk,arathi,1934,monk,windwalker,142,74,68
Wheelchairqt,stormscale,1928,monk,windwalker,42,28,14
Fistinguhuhu,outland,1928,monk,windwalker,254,121,133
Enerchi,ravencrest,1926,monk,windwalker,96,51,45
Jájsemshadow,drakthul,1922,monk,windwalker,72,37,35
Orkamonka,burning-legion,1921,monk,windwalker,66,35,31
Sobadzlolz,alexstrasza,1911,monk,windwalker,184,104,80
Ellipirelli,doomhammer,1911,monk,windwalker,156,74,82
Swas,outland,1909,monk,windwalker,114,57,57
Shpunk,ravencrest,1909,monk,windwalker,268,133,135
Цеска,howling-fjord,1909,monk,windwalker,171,84,87
Zukatan,tarren-mill,1907,monk,windwalker,232,116,116
Джэкичача,soulflayer,1907,monk,windwalker,110,55,55
Jonnyboxer,ravencrest,1907,monk,windwalker,90,45,45
Kåýðø,archimonde,1906,monk,windwalker,74,42,32
Gararasu,eredar,1906,monk,windwalker,59,30,29
Riskcapcap,dentarg,1905,monk,windwalker,72,37,35
Ladderfiend,stormscale,1905,monk,windwalker,203,93,110
Gorèdusthoof,blackhand,1903,monk,windwalker,156,77,79
Fln,blackrock,1902,monk,windwalker,82,45,37
Pitball,ravencrest,1898,monk,windwalker,72,36,36
Bogey,ragnaros,1898,monk,windwalker,50,24,26
Slyonex,ravencrest,1897,monk,windwalker,202,113,89
Ksâin,ravencrest,1896,monk,windwalker,66,34,32
Nicesky,ravencrest,1896,monk,windwalker,174,86,88
Edgys,silvermoon,1894,monk,windwalker,60,46,14
Oberháupt,blackrock,1893,monk,windwalker,84,46,38
Сугробикк,soulflayer,1893,monk,windwalker,178,82,96
Seyley,tarren-mill,1889,monk,windwalker,114,69,45
Këftêmé,kazzak,1889,monk,windwalker,78,47,31
Копытька,gordunni,1889,monk,windwalker,63,35,28
Monksea,ravencrest,1888,monk,windwalker,48,24,24
Shaolinthug,stormscale,1886,monk,windwalker,89,40,49
Маруты,soulflayer,1886,monk,windwalker,100,42,58
Cander,stormscale,1885,monk,windwalker,78,42,36
Mikedcrybaby,tarren-mill,1885,monk,windwalker,189,101,88
Mosch,blackrock,1884,monk,windwalker,82,44,38
Pêterpump,blackrock,1884,monk,windwalker,215,115,100
Санварион,eversong,1884,monk,windwalker,144,72,72
Yukfou,tarren-mill,1884,monk,windwalker,70,33,37
Sørann,drekthar,1883,monk,windwalker,106,56,50
Муррчалкин,howling-fjord,1881,monk,windwalker,54,30,24
Rorkito,sanguino,1881,monk,windwalker,98,52,46
Яагрессивный,howling-fjord,1880,monk,windwalker,86,43,43
Niamix,archimonde,1879,monk,windwalker,423,211,212
Fapmaster,aegwynn,1877,monk,windwalker,60,31,29
Fotmwalker,ragnaros,1877,monk,windwalker,547,276,271
Hàtéppl,ravencrest,1877,monk,windwalker,54,26,28
Dianly,ravencrest,1875,monk,windwalker,134,62,72
Megatazz,hyjal,1873,monk,windwalker,129,74,55
Omnibar,kazzak,1872,monk,windwalker,48,28,20
Ztl,twisting-nether,1871,monk,windwalker,191,104,87
Heran,ravencrest,1870,monk,windwalker,253,125,128
Mónkâs,tarren-mill,1870,monk,windwalker,120,58,62
Mäismz,stormscale,1869,monk,windwalker,30,20,10
Тихийпук,deathguard,1869,monk,windwalker,176,99,77
Denjasftw,culte-de-la-rive-noire,1868,monk,windwalker,48,30,18
Beernie,tarren-mill,1867,monk,windwalker,72,44,28
Ellevance,draenor,1865,monk,windwalker,77,43,34
Krothus,tarren-mill,1864,monk,windwalker,157,90,67
Reelaxyyz,outland,1864,monk,windwalker,125,68,57
Ãmaterasû,kazzak,1864,monk,windwalker,61,30,31
Peaceweaver,ravencrest,1863,monk,windwalker,124,69,55
Doktormonk,blackrock,1863,monk,windwalker,232,128,104
Brüshïë,kazzak,1863,monk,windwalker,65,33,32
Ratslayerz,dun-modr,1861,monk,windwalker,132,70,62
Zéroneufsix,silvermoon,1861,monk,windwalker,74,34,40
Häshbulla,ragnaros,1860,monk,windwalker,57,31,26
Nightingalê,silvermoon,1858,monk,windwalker,95,54,41
Helloimfrank,tarren-mill,1857,monk,windwalker,54,28,26
Bwayn,blackhand,1857,monk,windwalker,374,184,190
Yipmaan,kazzak,1856,monk,windwalker,85,52,33
Диванн,howling-fjord,1855,monk,windwalker,59,30,29
Sayozz,hyjal,1855,monk,windwalker,663,335,328
Adrianchase,ravencrest,1854,monk,windwalker,60,35,25
Чеченборцуха,howling-fjord,1852,monk,windwalker,126,70,56
Coollann,drakthul,1852,monk,windwalker,66,34,32
Owalker,ravencrest,1851,monk,windwalker,54,34,20
Kitcheneer,twisting-nether,1851,monk,windwalker,69,40,29
Bobblasfists,tarren-mill,1851,monk,windwalker,61,30,31
Vanoarabidze,ravencrest,1849,monk,windwalker,47,27,20
Lullerull,silvermoon,1849,monk,windwalker,69,39,30
Ackken,twisting-nether,1849,monk,windwalker,99,52,47
Domiqx,blackhand,1849,monk,windwalker,72,37,35
Gresmar,defias-brotherhood,1848,monk,windwalker,254,132,122
Moistpocket,stormscale,1848,monk,windwalker,72,33,39
Trendyroxy,blackrock,1846,monk,windwalker,133,64,69
Zéroneufsizz,silvermoon,1845,monk,windwalker,54,29,25
Bossdog,mugthol,1844,monk,windwalker,57,33,24
Rêshi,draenor,1844,monk,windwalker,364,196,168
Rayneo,argent-dawn,1844,monk,windwalker,78,40,38
Boostarevine,stormscale,1842,monk,windwalker,59,38,21
Uwuhehe,ravencrest,1841,monk,windwalker,82,46,36
Hitsu,archimonde,1839,monk,windwalker,42,27,15
Mebrin,ragnaros,1837,monk,windwalker,107,56,51
Ревенджж,howling-fjord,1837,monk,windwalker,278,137,141
Sàitama,hyjal,1837,monk,windwalker,82,40,42
Шейдла,soulflayer,1836,monk,windwalker,148,82,66
Эльморо,goldrinn,1835,monk,windwalker,60,32,28
Santanax,ravencrest,1834,monk,windwalker,42,27,15
Kungfuhkyou,tarren-mill,1833,monk,windwalker,36,23,13
Astriz,outland,1833,monk,windwalker,36,23,13
Mystx,stormrage,1833,monk,windwalker,159,87,72
Linuxx,ravencrest,1832,monk,windwalker,90,45,45
Chucknorrîs,doomhammer,1831,monk,windwalker,79,47,32
Toyless,ravencrest,1831,monk,windwalker,54,27,27
Akuuji,silvermoon,1830,monk,windwalker,66,35,31
Iløvealicia,ravencrest,1830,monk,windwalker,58,28,30
Hurricrane,kazzak,1829,monk,windwalker,286,140,146
Ninadobrév,stormscale,1828,monk,windwalker,222,120,102
Shinjiu,kiljaeden,1827,monk,windwalker,54,34,20
Инрэйджинкап,soulflayer,1826,monk,windwalker,252,123,129
Monk,shattered-hand,1824,monk,windwalker,65,30,35
Nicomonk,ravencrest,1823,monk,windwalker,75,45,30
Monkini,kazzak,1823,monk,windwalker,54,27,27
Divinechi,kazzak,1821,monk,windwalker,60,39,21
Akhlÿs,ysondre,1821,monk,windwalker,48,27,21
Tinjihn,magtheridon,1821,monk,windwalker,228,112,116
Idiot,outland,1819,monk,windwalker,112,62,50
Carbozø,archimonde,1819,monk,windwalker,179,99,80
Domww,outland,1819,monk,windwalker,174,90,84
Вагонюлеера,howling-fjord,1819,monk,windwalker,46,22,24
Bläckijackï,hyjal,1818,monk,windwalker,50,28,22
Ютуми,soulflayer,1817,monk,windwalker,60,29,31
Saadx,ravencrest,1816,monk,windwalker,205,111,94
Salvaje,stormscale,1816,monk,windwalker,362,193,169
Vandamme,archimonde,1816,monk,windwalker,92,46,46
Moai,nemesis,1816,monk,windwalker,48,24,24
Sultanofrizz,draenor,1815,monk,windwalker,48,26,22
Monkees,twisting-nether,1815,monk,windwalker,65,33,32
Notmelo,dun-modr,1815,monk,windwalker,54,27,27
Dansaam,tarren-mill,1813,monk,windwalker,42,25,17
Sinted,blackmoore,1813,monk,windwalker,61,30,31
Khrylx,twisting-nether,1812,monk,windwalker,58,32,26
Gankplank,nemesis,1811,monk,windwalker,42,22,20
Sororicide,stormscale,1811,monk,windwalker,275,138,137
Ampm,ravencrest,1810,monk,windwalker,80,39,41
Рэйвх,howling-fjord,1808,monk,windwalker,36,19,17
Sushiroll,stormrage,1808,monk,windwalker,111,55,56
Arsonists,argent-dawn,1807,monk,windwalker,52,28,24
Venrea,archimonde,1807,monk,windwalker,81,41,40
Baltimore,stormscale,1806,monk,windwalker,36,25,11
Åbyssgòd,kazzak,1805,monk,windwalker,60,24,36
Elfisto,eredar,1804,monk,windwalker,54,31,23
Möîne,arathi,1804,monk,windwalker,90,47,43
Unangebracht,silvermoon,1803,monk,windwalker,227,121,106
Драконзмей,soulflayer,1802,monk,windwalker,142,72,70
Windwanker,eredar,1800,monk,windwalker,36,22,14
Blïss,kazzak,1800,monk,windwalker,90,49,41
Mcflaïe,ysondre,1800,monk,windwalker,120,62,58
Jinpachi,ravencrest,1800,monk,windwalker,77,36,41
Flunkefar,defias-brotherhood,1800,monk,windwalker,120,55,65
Aimbotkid,tarren-mill,1798,monk,windwalker,84,43,41
Калестонз,howling-fjord,1797,monk,windwalker,60,33,27
Xinxanxonxin,zuljin,1797,monk,windwalker,131,61,70
Gonkun,outland,1796,monk,windwalker,199,106,93
Yacum,blackrock,1795,monk,windwalker,77,35,42
Barbalekos,ragnaros,1793,monk,windwalker,182,98,84
Karmaisabich,ragnaros,1792,monk,windwalker,30,19,11
Жъёь,howling-fjord,1792,monk,windwalker,77,39,38
Stealthsøul,outland,1789,monk,windwalker,30,21,9
Runefists,twisting-nether,1787,monk,windwalker,42,23,19
Pàrádìsé,ravencrest,1787,monk,windwalker,119,60,59
Diagmonk,kazzak,1787,monk,windwalker,60,28,32
Skailzkrt,hyjal,1786,monk,windwalker,51,23,28
Madelnheaven,burning-legion,1784,monk,windwalker,97,50,47
Shînøbi,dalaran,1784,monk,windwalker,205,98,107
Mollytov,tarren-mill,1784,monk,windwalker,101,44,57
Ravelbaby,blackrock,1783,monk,windwalker,61,31,30
Pelou,culte-de-la-rive-noire,1782,monk,windwalker,269,142,127
Циорех,gordunni,1781,monk,windwalker,99,59,40
Tuulijäbä,stormreaver,1781,monk,windwalker,48,26,22
Pandafuki,ravencrest,1781,monk,windwalker,86,42,44
Эвэйжион,gordunni,1780,monk,windwalker,102,62,40
Dwdw,aerie-peak,1780,monk,windwalker,83,41,42
Тэсти,blackscar,1779,monk,windwalker,75,38,37
Heyami,ravencrest,1777,monk,windwalker,72,34,38
Mynokxu,blackmoore,1775,monk,windwalker,98,56,42
Anhox,ragnaros,1774,monk,windwalker,102,57,45
Дуэльныйчел,howling-fjord,1774,monk,windwalker,217,110,107
Fistofrage,ravencrest,1773,monk,windwalker,111,63,48
Джобишоп,howling-fjord,1769,monk,windwalker,45,27,18
Sponkas,tarren-mill,1768,monk,windwalker,42,20,22
Тхэгык,soulflayer,1767,monk,windwalker,66,27,39
Lørðbrøñkø,blackrock,1766,monk,windwalker,112,64,48
Klumpenx,draenor,1766,monk,windwalker,94,48,46
Ароба,blackscar,1766,monk,windwalker,90,42,48
Twinny,drakthul,1765,monk,windwalker,96,54,42
Kaijam,argent-dawn,1764,monk,windwalker,96,41,55
Минагороси,galakrond,1763,monk,windwalker,112,64,48
Kjeyro,ravencrest,1762,monk,windwalker,35,20,15
Korié,ravencrest,1762,monk,windwalker,103,55,48
Donvishas,aegwynn,1761,monk,windwalker,131,69,62
Iminzww,ravencrest,1759,monk,windwalker,96,46,50
Moultsou,hyjal,1758,monk,windwalker,66,33,33
Fistu,silvermoon,1757,monk,windwalker,85,48,37
Saodiseng,outland,1757,monk,windwalker,137,75,62
Zandoy,draenor,1756,monk,windwalker,82,46,36
Yassøux,archimonde,1756,monk,windwalker,329,162,167
Rismonk,frostmane,1756,monk,windwalker,138,63,75
Pili,aegwynn,1753,monk,windwalker,66,38,28
Catchmee,agamaggan,1752,monk,windwalker,41,25,16
Freehelper,stormscale,1751,monk,windwalker,96,40,56
Arachmk,drakthul,1750,monk,windwalker,114,52,62
Broner,dunemaul,1747,monk,windwalker,104,50,54
Monkenio,stormscale,1745,monk,windwalker,60,30,30
Lonechi,sylvanas,1743,monk,windwalker,65,34,31
Фодз,soulflayer,1743,monk,windwalker,81,33,48
Desmî,ravencrest,1741,monk,windwalker,42,19,23
Saltotriks,tarren-mill,1739,monk,windwalker,127,57,70
Гладастар,soulflayer,1736,monk,windwalker,228,117,111
Рокебайбейби,howling-fjord,1734,monk,windwalker,282,147,135
Shoenk,blackhand,1732,monk,windwalker,48,26,22
Béarly,outland,1731,monk,windwalker,78,34,44
Greenshortea,aegwynn,1728,monk,windwalker,42,21,21
Shagzy,ravencrest,1727,monk,windwalker,41,25,16
Projectasura,draenor,1727,monk,windwalker,285,143,142
Ninjagaiden,archimonde,1727,monk,windwalker,102,47,55
Mîsts,aszune,1726,monk,windwalker,74,40,34
Stillwater,thrall,1726,monk,windwalker,289,146,143
Такиера,gordunni,1726,monk,windwalker,66,31,35
Виндволкерша,gordunni,1725,monk,windwalker,54,31,23
Agren,argent-dawn,1725,monk,windwalker,41,19,22
Capedbaldy,blackhand,1724,monk,windwalker,41,23,18
Rerowine,magtheridon,1723,monk,windwalker,180,86,94
Ugabugash,silvermoon,1722,monk,windwalker,72,39,33
Draina,archimonde,1721,monk,windwalker,52,24,28
Waaks,archimonde,1720,monk,windwalker,114,63,51
Roidcarry,blackrock,1720,monk,windwalker,83,45,38
Mefîsto,blackrock,1719,monk,windwalker,81,47,34
Reõ,argent-dawn,1719,monk,windwalker,141,77,64
Varis,stormreaver,1718,monk,windwalker,39,19,20
Трэйци,blackscar,1716,monk,windwalker,39,23,16
Whoszeus,archimonde,1716,monk,windwalker,97,53,44
Niyka,silvermoon,1716,monk,windwalker,150,76,74
Гкдшка,blackscar,1715,monk,windwalker,63,27,36
Narstie,kazzak,1714,monk,windwalker,71,36,35
Drýton,blackrock,1713,monk,windwalker,42,22,20
Виноипиво,soulflayer,1713,monk,windwalker,60,30,30
Iceym,stormscale,1713,monk,windwalker,105,49,56
Jjslag,stormscale,1712,monk,windwalker,102,48,54
Димакарма,howling-fjord,1712,monk,windwalker,101,45,56
Мионелолл,goldrinn,1708,monk,windwalker,106,60,46
Citamo,ravencrest,1707,monk,windwalker,48,25,23
Saduh,thrall,1707,monk,windwalker,50,24,26
Inkegomonk,draenor,1707,monk,windwalker,120,57,63
Healbotzweik,frostwolf,1706,monk,windwalker,102,44,58
Такюн,howling-fjord,1705,monk,windwalker,699,351,348
Лагвай,gordunni,1705,monk,windwalker,42,21,21
Лазанья,grom,1705,monk,windwalker,128,60,68
Wørldwâlker,kazzak,1704,monk,windwalker,36,25,11
Yeratel,argent-dawn,1704,monk,windwalker,201,97,104
Muaba,outland,1704,monk,windwalker,60,26,34
Wwisalright,burning-legion,1703,monk,windwalker,68,40,28
Mikz,ravencrest,1703,monk,windwalker,122,70,52
Ñø,twisting-nether,1702,monk,windwalker,42,18,24
Shaokïng,exodar,1700,monk,windwalker,294,151,143
Bugrika,tarren-mill,1700,monk,windwalker,48,24,24
Chiscake,blackrock,1699,monk,windwalker,40,22,18
Senguro,frostwolf,1699,monk,windwalker,72,39,33
Tommypistol,runetotem,1698,monk,windwalker,226,109,117
Bunnyfighter,nemesis,1698,monk,windwalker,94,42,52
Bonepalm,kazzak,1697,monk,windwalker,29,21,8
Meineaugen,blackhand,1696,monk,windwalker,35,22,13
Jizoh,eredar,1696,monk,windwalker,92,44,48
Shoura,blackmoore,1696,monk,windwalker,90,41,49
Testmonial,hyjal,1694,monk,windwalker,54,21,33
Меняубило,howling-fjord,1693,monk,windwalker,142,70,72
Ashânti,eredar,1691,monk,windwalker,62,30,32
Сандерстрайк,howling-fjord,1690,monk,windwalker,121,67,54
Bnî,blackmoore,1689,monk,windwalker,99,59,40
Хекмуги,borean-tundra,1689,monk,windwalker,174,91,83
Cranekickbot,ravencrest,1689,monk,windwalker,83,36,47
Gujja,doomhammer,1689,monk,windwalker,68,28,40
Джийви,goldrinn,1687,monk,windwalker,42,22,20
Lesauceboss,kazzak,1685,monk,windwalker,48,25,23
Jafandmeja,tarren-mill,1683,monk,windwalker,106,65,41
Ktrina,ravencrest,1682,monk,windwalker,226,118,108
Mezz,ahnqiraj,1681,monk,windwalker,48,24,24
Tisaki,blackhand,1680,monk,windwalker,41,25,16
Denji,kargath,1680,monk,windwalker,42,22,20
Gozslzly,drakthul,1680,monk,windwalker,90,47,43
Мандаирины,gordunni,1680,monk,windwalker,137,71,66
Hilzaxsub,archimonde,1679,monk,windwalker,47,29,18
Yobo,archimonde,1679,monk,windwalker,89,44,45
Pazü,ysondre,1679,monk,windwalker,119,57,62
Xiâomèi,dun-modr,1679,monk,windwalker,168,79,89
Yungdrippy,eredar,1678,monk,windwalker,88,43,45
Xullon,dragonblight,1677,monk,windwalker,160,82,78
Wwfastsoloq,zenedar,1675,monk,windwalker,54,28,26
Annamonk,tarren-mill,1675,monk,windwalker,66,29,37
Mädic,outland,1673,monk,windwalker,42,22,20
Jam,aerie-peak,1673,monk,windwalker,36,18,18
Zenothar,ravencrest,1672,monk,windwalker,42,28,14
Kebabvevaren,twisting-nether,1672,monk,windwalker,33,21,12
Leadgen,tarren-mill,1670,monk,windwalker,122,63,59
Pawsgodx,ragnaros,1669,monk,windwalker,78,40,38
Lemmeportbk,ravencrest,1669,monk,windwalker,68,32,36
Wuux,tarren-mill,1668,monk,windwalker,125,67,58
Fistingbull,grim-batol,1668,monk,windwalker,132,69,63
Dankiron,darksorrow,1668,monk,windwalker,68,32,36
Sesi,drakthul,1668,monk,windwalker,94,41,53
Antomamonk,ravencrest,1666,monk,windwalker,87,43,44
Hoøo,hyjal,1664,monk,windwalker,59,24,35
Blwh,stormscale,1663,monk,windwalker,54,25,29
Vtx,blackrock,1662,monk,windwalker,30,18,12
Gojò,outland,1662,monk,windwalker,48,28,20
Karateboy,dun-modr,1661,monk,windwalker,75,39,36
Ilovefreddy,stormscale,1660,monk,windwalker,54,23,31
Hazzat,nordrassil,1659,monk,windwalker,60,35,25
Geeér,outland,1658,monk,windwalker,42,24,18
Белено,deathguard,1657,monk,windwalker,66,36,30
Qwizqwak,twisting-nether,1657,monk,windwalker,90,44,46
Holmwalker,twisting-nether,1657,monk,windwalker,148,70,78
Doobly,kazzak,1656,monk,windwalker,278,148,130
Базилмнк,howling-fjord,1655,monk,windwalker,35,22,13
Shardonay,ravencrest,1655,monk,windwalker,42,26,16
Tenshinhann,outland,1652,monk,windwalker,84,39,45
Zledriasa,ravencrest,1651,monk,windwalker,56,23,33
Jiya,blackmoore,1650,monk,windwalker,178,83,95
Tubørg,ravencrest,1650,monk,windwalker,57,26,31
Shirkán,ragnaros,1649,monk,windwalker,36,21,15
Междунамиад,gordunni,1648,monk,windwalker,30,18,12
Thérez,les-sentinelles,1648,monk,windwalker,42,22,20
Бадхидхаарма,booty-bay,1647,monk,windwalker,138,62,76
Кишмякмонк,howling-fjord,1646,monk,windwalker,60,31,29
Гуппер,howling-fjord,1646,monk,windwalker,54,23,31
Атакцуки,gordunni,1645,monk,windwalker,75,42,33
Хосэ,gordunni,1645,monk,windwalker,41,19,22
Faustux,blackmoore,1644,monk,windwalker,60,28,32
Эльторо,goldrinn,1644,monk,windwalker,184,84,100
Permagone,argent-dawn,1642,monk,windwalker,84,48,36
Nhola,sanguino,1642,monk,windwalker,148,83,65
Enju,tarren-mill,1642,monk,windwalker,43,22,21
Флурсон,gordunni,1642,monk,windwalker,58,25,33
Bubjuu,ravencrest,1642,monk,windwalker,54,22,32
Hampocket,ravencrest,1641,monk,windwalker,56,29,27
Karmachi,ravencrest,1641,monk,windwalker,105,48,57
Alkanphel,kazzak,1640,monk,windwalker,54,32,22
Таайлиньх,gordunni,1640,monk,windwalker,46,18,28
Selfmademan,drakthul,1638,monk,windwalker,30,22,8
Ànklar,blackrock,1638,monk,windwalker,90,48,42
Breezzmonka,twisting-nether,1638,monk,windwalker,48,24,24
Трайтубайтми,gordunni,1638,monk,windwalker,129,64,65
Kármo,thrall,1638,monk,windwalker,41,20,21
Schøcker,blackmoore,1638,monk,windwalker,96,45,51
Phesxm,sylvanas,1637,monk,windwalker,41,23,18
Chigre,hyjal,1636,monk,windwalker,106,54,52
Shanokee,blackrock,1635,monk,windwalker,36,21,15
Potsymist,twisting-nether,1635,monk,windwalker,67,33,34
Futtefut,ravencrest,1635,monk,windwalker,60,25,35
Дыня,gordunni,1634,monk,windwalker,54,33,21
Ybnobama,outland,1634,monk,windwalker,54,24,30
Hævihænning,argent-dawn,1633,monk,windwalker,60,35,25
Weizi,madmortem,1632,monk,windwalker,53,29,24
Акумах,blackscar,1632,monk,windwalker,111,55,56
Pwaff,kazzak,1632,monk,windwalker,108,51,57
Nastyvibes,dun-modr,1629,monk,windwalker,30,20,10
Yiannischan,draenor,1629,monk,windwalker,127,64,63
Osalot,ravencrest,1629,monk,windwalker,116,56,60
Chaospilot,sylvanas,1629,monk,windwalker,218,103,115
Homelanderxx,tarren-mill,1627,monk,windwalker,42,22,20
Ijji,argent-dawn,1627,monk,windwalker,89,37,52
Samantonah,nemesis,1626,monk,windwalker,63,40,23
Пекинес,gordunni,1626,monk,windwalker,42,22,20
Diefist,ravencrest,1625,monk,windwalker,46,21,25
Cheethfu,ragnaros,1624,monk,windwalker,88,48,40
Glorïagaynor,archimonde,1624,monk,windwalker,48,19,29
Vark,bloodscalp,1623,monk,windwalker,42,22,20
Bigfistah,tarren-mill,1623,monk,windwalker,58,26,32
Básíl,frostwolf,1622,monk,windwalker,83,40,43
Монкигодхх,howling-fjord,1621,monk,windwalker,31,21,10
Lycké,silvermoon,1621,monk,windwalker,108,62,46
Turßo,ravencrest,1620,monk,windwalker,77,50,27
Hybridtheory,doomhammer,1620,monk,windwalker,159,81,78
Iastyn,kazzak,1620,monk,windwalker,99,50,49
Elizry,alakir,1619,monk,windwalker,94,52,42
Goldenww,sanguino,1618,monk,windwalker,123,72,51
Sérrè,tarren-mill,1618,monk,windwalker,48,25,23
Thungara,emerald-dream,1618,monk,windwalker,52,27,25
Ñinjakick,outland,1618,monk,windwalker,90,42,48
Mabkww,ravencrest,1617,monk,windwalker,36,19,17
Shalysa,ravencrest,1616,monk,windwalker,47,27,20
Gdkz,tarren-mill,1616,monk,windwalker,113,53,60
Кианасоломид,gordunni,1615,monk,windwalker,296,146,150
Erenaar,nemesis,1614,monk,windwalker,60,43,17
Karpanderi,stormreaver,1614,monk,windwalker,29,17,12
Fijiwater,draenor,1613,monk,windwalker,24,17,7
Тринх,ashenvale,1613,monk,windwalker,54,31,23
Saisha,defias-brotherhood,1613,monk,windwalker,36,20,16
Orkuru,kazzak,1613,monk,windwalker,35,17,18
Skalmirbadut,tarren-mill,1612,monk,windwalker,36,22,14
Tauti,dun-morogh,1610,monk,windwalker,36,21,15
Fiddyy,outland,1610,monk,windwalker,36,20,16
Qoopu,frostwhisper,1610,monk,windwalker,59,29,30
Humpenpower,blackhand,1609,monk,windwalker,53,32,21
Miløøx,silvermoon,1609,monk,windwalker,82,42,40
Fokdem,tarren-mill,1608,monk,windwalker,72,41,31
Zaethh,drakthul,1608,monk,windwalker,53,28,25
Ocëane,sanguino,1608,monk,windwalker,228,114,114
Steros,die-aldor,1608,monk,windwalker,42,21,21
Piedliés,ravencrest,1608,monk,windwalker,48,22,26
Quoc,blackmoore,1608,monk,windwalker,47,20,27
Hunkfur,ravencrest,1607,monk,windwalker,86,44,42
Mionoor,aegwynn,1607,monk,windwalker,322,156,166
Walie,twisting-nether,1607,monk,windwalker,66,21,45
Тайммуайтай,howling-fjord,1606,monk,windwalker,90,50,40
Ryle,forscherliga,1606,monk,windwalker,102,54,48
Xanlee,twisting-nether,1605,monk,windwalker,30,18,12
Vayarah,antonidas,1605,monk,windwalker,54,28,26
Meltfistqt,ravencrest,1604,monk,windwalker,117,60,57
Valduri,stormscale,1604,monk,windwalker,60,27,33
Нэдэлин,greymane,1603,monk,windwalker,48,29,19
Ìnconnu,dalaran,1603,monk,windwalker,172,92,80
Фортрен,deepholm,1603,monk,windwalker,105,49,56
Faustix,blackmoore,1602,monk,windwalker,78,42,36
Barneyzan,tarren-mill,1602,monk,windwalker,41,20,21
Thyf,drakthul,1602,monk,windwalker,72,30,42
Nigu,dun-modr,1601,monk,windwalker,85,47,38
Астрал,soulflayer,1601,monk,windwalker,48,22,26
Муаннуар,soulflayer,1599,monk,windwalker,30,17,13
Вэилэй,gordunni,1599,monk,windwalker,36,18,18
Stormymonk,blackrock,1599,monk,windwalker,53,21,32
Зестус,galakrond,1598,monk,windwalker,42,19,23
Шотгар,howling-fjord,1597,monk,windwalker,72,31,41
Djinÿ,ysondre,1596,monk,windwalker,269,142,127
Jeppehmonk,stormscale,1596,monk,windwalker,36,19,17
Djbuttholex,tarren-mill,1595,monk,windwalker,47,25,22
Naschitüte,blackrock,1594,monk,windwalker,387,195,192
Sori,mazrigos,1594,monk,windwalker,43,20,23
Картезо,gordunni,1592,monk,windwalker,48,24,24
Vuzashiji,argent-dawn,1591,monk,windwalker,96,51,45
Nexyyfist,kazzak,1590,monk,windwalker,65,38,27
Ròux,blackmoore,1589,monk,windwalker,53,27,26
Kalsdee,argent-dawn,1586,monk,windwalker,85,48,37
Sylicia,alleria,1584,monk,windwalker,134,64,70
Apprentice,ravencrest,1582,monk,windwalker,29,17,12
Lucaspires,sylvanas,1582,monk,windwalker,179,86,93
Charlett,the-venture-co,1581,monk,windwalker,125,66,59
Bluumorc,ravencrest,1580,monk,windwalker,30,20,10
Skiplegsweeb,stormscale,1579,monk,windwalker,30,21,9
Leasyww,antonidas,1579,monk,windwalker,29,18,11
Хзт,howling-fjord,1579,monk,windwalker,147,69,78
Fistedx,twisting-nether,1578,monk,windwalker,136,62,74
Hosh,ysondre,1577,monk,windwalker,91,44,47
Bloodfist,zuljin,1576,monk,windwalker,118,59,59
Zenified,ragnaros,1574,monk,windwalker,72,33,39
Miamausebär,blackmoore,1573,monk,windwalker,59,24,35
Denau,aegwynn,1572,monk,windwalker,36,21,15
Янакаблуках,howling-fjord,1572,monk,windwalker,384,203,181
Fullzi,dalaran,1572,monk,windwalker,42,20,22
Вайлаут,gordunni,1571,monk,windwalker,29,17,12
Чифую,lich-king,1570,monk,windwalker,71,32,39
Løllapalooza,ragnaros,1569,monk,windwalker,63,30,33
Heffertonne,eredar,1568,monk,windwalker,72,40,32
Rayokhen,kazzak,1568,monk,windwalker,48,24,24
Lurklee,blackhand,1566,monk,windwalker,52,30,22
Saikø,silvermoon,1566,monk,windwalker,35,19,16
Secretmonk,ravencrest,1565,monk,windwalker,41,17,24
Монашкасюэ,howling-fjord,1564,monk,windwalker,42,27,15
Notsmol,quelthalas,1563,monk,windwalker,72,33,39
Crewladal,arakarahm,1562,monk,windwalker,86,36,50
Sugura,dethecus,1561,monk,windwalker,149,75,74
Fantazero,burning-legion,1561,monk,windwalker,71,31,40
Gaehitmonlee,ravencrest,1559,monk,windwalker,277,145,132
Aslêyia,antonidas,1559,monk,windwalker,60,28,32
Blackdwarf,tarren-mill,1553,monk,windwalker,67,38,29
Deme,sylvanas,1553,monk,windwalker,137,74,63
Монквкроксах,howling-fjord,1553,monk,windwalker,44,22,22
Schmidti,kazzak,1553,monk,windwalker,48,17,31
Sòftx,stormscale,1549,monk,windwalker,34,22,12
Morslee,burning-legion,1549,monk,windwalker,151,69,82
Shorisensei,aszune,1547,monk,windwalker,56,24,32
Fungamelol,blackhand,1546,monk,windwalker,54,34,20
Kirkeý,ravencrest,1546,monk,windwalker,85,42,43
Chulli,stormscale,1546,monk,windwalker,61,30,31
Djshady,sylvanas,1544,monk,windwalker,72,36,36
Soxx,arthas,1543,monk,windwalker,171,90,81
Blickx,draenor,1542,monk,windwalker,40,21,19
Монголгодх,howling-fjord,1540,monk,windwalker,216,119,97
Powz,nordrassil,1539,monk,windwalker,36,20,16
Psyhooz,burning-legion,1539,monk,windwalker,68,36,32
Jogiemonk,ravencrest,1538,monk,windwalker,30,17,13
Plsnerfmemor,hyjal,1537,monk,windwalker,70,37,33
Tea,arathor,1537,monk,windwalker,162,82,80
Howkong,archimonde,1535,monk,windwalker,30,16,14
Babyfax,draenor,1534,monk,windwalker,30,16,14
Emå,nemesis,1533,monk,windwalker,52,25,27
Wajoba,blackhand,1533,monk,windwalker,36,16,20
Zahj,ysondre,1532,monk,windwalker,31,19,12
Rationis,blackmoore,1531,monk,windwalker,42,22,20
Orkuuddiu,pozzo-delleternità,1531,monk,windwalker,221,113,108
Embodimonk,twisting-nether,1531,monk,windwalker,344,175,169
Fablemayfly,tarren-mill,1530,monk,windwalker,225,112,113
Defrinol,grim-batol,1529,monk,windwalker,42,21,21
Тшейши,howling-fjord,1526,monk,windwalker,54,28,26
Scribzw,twisting-nether,1524,monk,windwalker,24,16,8
Brutec,blackmoore,1522,monk,windwalker,60,27,33
Волкейн,soulflayer,1522,monk,windwalker,36,16,20
Luckyjones,tarren-mill,1521,monk,windwalker,30,16,14
Eonyzi,kazzak,1521,monk,windwalker,54,27,27
Немонахх,howling-fjord,1521,monk,windwalker,66,28,38
Ролитта,gordunni,1517,monk,windwalker,78,45,33
Swanp,dun-modr,1516,monk,windwalker,36,17,19
Litenværen,tarren-mill,1515,monk,windwalker,24,16,8
Wodniuch,defias-brotherhood,1515,monk,windwalker,57,28,29
Feyzmonk,ysondre,1513,monk,windwalker,30,16,14
Rãkan,kazzak,1512,monk,windwalker,90,52,38
Gorskie,silvermoon,1512,monk,windwalker,93,48,45
Belobe,stormscale,1511,monk,windwalker,69,33,36
Fattony,bronzebeard,1510,monk,windwalker,46,30,16
Yunà,twisting-nether,1510,monk,windwalker,57,23,34
Jolbucheron,hyjal,1509,monk,windwalker,120,62,58
Blyatfist,draenor,1509,monk,windwalker,38,18,20
Kanõ,outland,1508,monk,windwalker,171,92,79
Miyagisensei,ravencrest,1508,monk,windwalker,100,50,50
Agitoyamissj,burning-legion,1508,monk,windwalker,196,97,99
Траблы,howling-fjord,1507,monk,windwalker,30,16,14
Дивипи,blackscar,1506,monk,windwalker,54,24,30
Анпапаяя,galakrond,1505,monk,windwalker,59,32,27
Gatyz,archimonde,1505,monk,windwalker,87,42,45
Nggz,archimonde,1503,monk,windwalker,163,95,68
Mink,uldum,1503,monk,windwalker,66,32,34
Hästgodx,the-maelstrom,1503,monk,windwalker,36,16,20
Chireapz,blackrock,1502,monk,windwalker,66,33,33
Artharox,anachronos,1501,monk,windwalker,36,22,14
Qtk,arthas,1501,monk,windwalker,42,16,26
Merilwyn,argent-dawn,1500,monk,windwalker,46,27,19
Niyatî,draenor,1499,monk,windwalker,64,30,34
Lassith,ravencrest,1497,monk,windwalker,30,16,14
Okilexsan,sanguino,1495,monk,windwalker,41,30,11
Kukazamura,silvermoon,1495,monk,windwalker,83,41,42
Nèlvár,blackhand,1490,monk,windwalker,86,47,39
Ноупэйн,soulflayer,1490,monk,windwalker,72,32,40
Sweeneyboo,outland,1489,monk,windwalker,144,69,75
ßibip,hyjal,1488,monk,windwalker,67,40,27
Bèrïth,kazzak,1488,monk,windwalker,114,55,59
Weetaxx,tarren-mill,1488,monk,windwalker,36,16,20
Boutarzi,hyjal,1487,monk,windwalker,96,51,45
Дайкиаомине,gordunni,1487,monk,windwalker,100,50,50
Traxxus,sanguino,1483,monk,windwalker,90,49,41
Lellaccio,pozzo-delleternità,1481,monk,windwalker,54,24,30
Goldengem,silvermoon,1480,monk,windwalker,60,24,36
Malutkie,defias-brotherhood,1479,monk,windwalker,186,97,89
Awesomebrah,the-maelstrom,1478,monk,windwalker,36,19,17
Блябери,howling-fjord,1478,monk,windwalker,43,21,22
Investing,silvermoon,1478,monk,windwalker,48,23,25
Norualy,tichondrius,1477,monk,windwalker,42,24,18
Qdwdwqerdads,ravencrest,1477,monk,windwalker,48,22,26
Mynaira,tarren-mill,1476,monk,windwalker,57,25,32
Tenszangetsu,ragnaros,1473,monk,windwalker,47,25,22
Mönkgodx,outland,1473,monk,windwalker,84,40,44
Пампич,borean-tundra,1471,monk,windwalker,108,53,55
Kunjo,earthen-ring,1470,monk,windwalker,78,38,40
Cowboy,veknilash,1470,monk,windwalker,42,20,22
Bastos,blackrock,1469,monk,windwalker,393,197,196
Fatchi,alakir,1467,monk,windwalker,29,17,12
Galaxyfists,blackhand,1467,monk,windwalker,132,68,64
Xuuan,argent-dawn,1466,monk,windwalker,143,78,65
Gotmonkon,tarren-mill,1466,monk,windwalker,42,19,23
Andyww,doomhammer,1466,monk,windwalker,78,27,51
Yinsho,stormscale,1464,monk,windwalker,42,23,19
Ívó,ragnaros,1463,monk,windwalker,102,49,53
Franziskanus,das-syndikat,1462,monk,windwalker,60,31,29
Bîmbâmboom,blackmoore,1462,monk,windwalker,66,27,39
Kaztruman,draenor,1461,monk,windwalker,106,51,55
Cac,argent-dawn,1461,monk,windwalker,205,98,107
Купейчик,gordunni,1460,monk,windwalker,123,56,67
Symaro,aegwynn,1459,monk,windwalker,87,40,47
Des,bronzebeard,1458,monk,windwalker,32,20,12
Styxmk,blackhand,1458,monk,windwalker,29,16,13
Salderlol,stormscale,1458,monk,windwalker,118,57,61
Sagewhisper,ravencrest,1458,monk,windwalker,57,27,30
Dòrâ,archimonde,1458,monk,windwalker,93,43,50
Smørc,the-maelstrom,1458,monk,windwalker,38,17,21
Fratznkicker,blackhand,1456,monk,windwalker,147,79,68
Yanmonk,silvermoon,1455,monk,windwalker,32,18,14
Bobbyknuckls,ravencrest,1455,monk,windwalker,455,228,227
Qtv,arthas,1455,monk,windwalker,33,16,17
Shypanda,blackhand,1454,monk,windwalker,125,68,57
Crockzy,twisting-nether,1452,monk,windwalker,60,31,29
Boxpunchkick,kazzak,1452,monk,windwalker,62,30,32
Nikchi,destromath,1450,monk,windwalker,121,57,64
Vibé,blackmoore,1449,monk,windwalker,59,33,26
Йетисан,gordunni,1449,monk,windwalker,246,120,126
Yuffîe,sanguino,1448,monk,windwalker,61,30,31
Toúch,blackmoore,1448,monk,windwalker,100,42,58
Kamui,naxxramas,1446,monk,windwalker,57,32,25
Луэнн,gordunni,1445,monk,windwalker,240,120,120
Mcsmack,argent-dawn,1444,monk,windwalker,54,33,21
Лаодзы,deathguard,1443,monk,windwalker,59,27,32
Dumbbell,magtheridon,1442,monk,windwalker,60,30,30
Thekaj,kazzak,1441,monk,windwalker,72,43,29
Âdonis,twisting-nether,1441,monk,windwalker,66,33,33
Реброперо,gordunni,1441,monk,windwalker,105,46,59
Hazmad,archimonde,1440,monk,windwalker,106,58,48
Street,nethersturm,1439,monk,windwalker,95,53,42
Sanshiro,defias-brotherhood,1439,monk,windwalker,64,32,32
Ketakarlsson,tarren-mill,1437,monk,windwalker,461,243,218
Blutáar,khazgoroth,1437,monk,windwalker,179,87,92
Pepperboer,magtheridon,1437,monk,windwalker,60,29,31
Артемиоксх,blackscar,1437,monk,windwalker,37,15,22
Kàrmà,aegwynn,1437,monk,windwalker,48,19,29
Кунфумастер,gordunni,1437,monk,windwalker,41,16,25
Pabu,emeriss,1436,monk,windwalker,30,15,15
Ðâvàizskÿ,ysondre,1436,monk,windwalker,30,15,15
Såliten,tarren-mill,1435,monk,windwalker,30,15,15
Kneecapper,ravencrest,1434,monk,windwalker,255,127,128
Laewyn,burning-blade,1434,monk,windwalker,36,16,20
Hymek,defias-brotherhood,1433,monk,windwalker,25,16,9
Yìng,tarren-mill,1433,monk,windwalker,90,43,47
Flowér,auchindoun,1433,monk,windwalker,36,15,21
Простогаля,howling-fjord,1432,monk,windwalker,142,76,66
Чистыйбаер,soulflayer,1432,monk,windwalker,36,15,21
Elpuncho,dentarg,1431,monk,windwalker,96,48,48
Домудароги,gordunni,1431,monk,windwalker,60,29,31
Кунгфурер,lich-king,1431,monk,windwalker,36,16,20
Tayoo,aegwynn,1430,monk,windwalker,42,23,19
Senshí,stormscale,1430,monk,windwalker,50,23,27
Jackywayne,blackmoore,1429,monk,windwalker,71,35,36
Messyaction,kazzak,1426,monk,windwalker,71,32,39
Wonkà,archimonde,1426,monk,windwalker,36,15,21
Jukei,blackmoore,1425,monk,windwalker,30,15,15
Risomonk,blackrock,1425,monk,windwalker,127,62,65
Bakash,ysondre,1424,monk,windwalker,370,181,189
Melaz,ravencrest,1423,monk,windwalker,24,15,9
Earendil,culte-de-la-rive-noire,1423,monk,windwalker,89,45,44
Räudiger,nazjatar,1423,monk,windwalker,356,178,178
Twinkletoe,twisting-nether,1423,monk,windwalker,30,15,15
Minalu,frostwolf,1423,monk,windwalker,48,22,26
Monzziess,draenor,1422,monk,windwalker,78,36,42
Greytail,argent-dawn,1422,monk,windwalker,48,22,26
Jeydi,ravencrest,1421,monk,windwalker,111,65,46
Wakmo,bladefist,1421,monk,windwalker,140,73,67
Løwping,blackmoore,1421,monk,windwalker,95,41,54
Wazari,nemesis,1420,monk,windwalker,115,58,57
Thighdiver,emeriss,1416,monk,windwalker,108,60,48
Fífrelin,archimonde,1416,monk,windwalker,66,34,32
Darré,sylvanas,1416,monk,windwalker,285,138,147
Бичмэн,deathguard,1415,monk,windwalker,78,36,42
Klapptoast,blackmoore,1413,monk,windwalker,82,45,37
Matlahon,kazzak,1413,monk,windwalker,143,71,72
Pandarok,argent-dawn,1412,monk,windwalker,73,33,40
Votbo,kazzak,1412,monk,windwalker,60,25,35
Dræk,twisting-nether,1410,monk,windwalker,116,60,56
Chilleê,blackmoore,1409,monk,windwalker,29,16,13
Odanobunaga,ravencrest,1408,monk,windwalker,77,39,38
Гномкия,gordunni,1408,monk,windwalker,30,15,15
Shapzxd,archimonde,1408,monk,windwalker,53,20,33
Lòthbar,confrérie-du-thorium,1407,monk,windwalker,150,84,66
Kylerøne,hyjal,1404,monk,windwalker,182,95,87
Roptoglad,hyjal,1404,monk,windwalker,77,34,43
Alandriai,blackmoore,1403,monk,windwalker,42,21,21
Soleriasbrew,blackhand,1403,monk,windwalker,222,109,113
Добраядушка,gordunni,1400,monk,windwalker,36,19,17
Fistberul,ravencrest,1400,monk,windwalker,108,56,52
Fymvy,ravencrest,1400,monk,windwalker,30,15,15
Томтью,gordunni,1400,monk,windwalker,137,68,69
Брэгандерт,gordunni,1400,monk,windwalker,60,26,34
Akÿo,archimonde,1399,monk,windwalker,35,15,20
Chígoku,grim-batol,1398,monk,windwalker,188,92,96
Badcøwboy,archimonde,1396,monk,windwalker,30,15,15
Azato,hyjal,1394,monk,windwalker,60,29,31
Icecoldish,tarren-mill,1393,monk,windwalker,131,70,61
Mistbeever,ragnaros,1393,monk,windwalker,36,18,18
Kyraxs,silvermoon,1392,monk,windwalker,53,26,27
Yléria,kirin-tor,1392,monk,windwalker,43,21,22
Mobbært,antonidas,1392,monk,windwalker,48,20,28
Qtchi,eredar,1391,monk,windwalker,43,16,27
Тейваан,soulflayer,1390,monk,windwalker,120,66,54
Laggedfist,kazzak,1388,monk,windwalker,33,15,18
Spinntowin,blackmoore,1386,monk,windwalker,161,79,82
Kîngjungeîle,dalaran,1384,monk,windwalker,30,17,13
Undefinedid,ravencrest,1384,monk,windwalker,164,86,78
Fisty,lightbringer,1384,monk,windwalker,36,15,21
Флейминго,soulflayer,1381,monk,windwalker,84,41,43
Nodzomi,shadowsong,1380,monk,windwalker,111,57,54
Кюзичка,gordunni,1379,monk,windwalker,83,38,45
Монахнехилит,howling-fjord,1379,monk,windwalker,102,45,57
Nolo,outland,1379,monk,windwalker,99,43,56
Муайтайец,howling-fjord,1379,monk,windwalker,119,51,68
Ðoom,sylvanas,1379,monk,windwalker,42,15,27
Yesman,quelthalas,1378,monk,windwalker,205,106,99
Bigdickmonk,blackmoore,1377,monk,windwalker,54,23,31
Swiftmonky,azuremyst,1376,monk,windwalker,48,27,21
Turbofinger,doomhammer,1376,monk,windwalker,85,38,47
Байтли,gordunni,1375,monk,windwalker,114,53,61
Recklusa,stormscale,1374,monk,windwalker,69,39,30
Kata,saurfang,1374,monk,windwalker,54,24,30
Misutò,tarren-mill,1372,monk,windwalker,54,30,24
Odelagga,draenor,1371,monk,windwalker,36,19,17
Крутотимс,howling-fjord,1371,monk,windwalker,83,33,50
Îrønfist,blackmoore,1368,monk,windwalker,41,23,18
Frictional,ravencrest,1366,monk,windwalker,129,59,70
Анике,howling-fjord,1365,monk,windwalker,57,24,33
Cleør,blackmoore,1363,monk,windwalker,46,23,23
Cptfist,argent-dawn,1363,monk,windwalker,58,27,31
Exikûsh,frostwolf,1362,monk,windwalker,75,38,37
Galadriel,kazzak,1361,monk,windwalker,36,15,21
Ketrie,argent-dawn,1360,monk,windwalker,116,57,59
Tempestu,twisting-nether,1358,monk,windwalker,108,50,58
Shushux,ysondre,1358,monk,windwalker,36,15,21
Xamaan,sanguino,1355,monk,windwalker,60,32,28
Behemothm,kazzak,1350,monk,windwalker,84,41,43
Nerd,argent-dawn,1350,monk,windwalker,41,20,21
Vivvy,argent-dawn,1350,monk,windwalker,53,25,28
Вамптолкер,howling-fjord,1348,monk,windwalker,42,21,21
Bandiya,archimonde,1348,monk,windwalker,127,61,66
Turbofistsqt,kazzak,1346,monk,windwalker,28,15,13
Monwig,tarren-mill,1346,monk,windwalker,64,33,31
Lokregar,blackmoore,1345,monk,windwalker,42,21,21
Intensivee,silvermoon,1345,monk,windwalker,77,36,41
Fantasiløs,twisting-nether,1344,monk,windwalker,77,38,39
Atrikaww,kazzak,1343,monk,windwalker,24,14,10
Joachi,outland,1343,monk,windwalker,30,14,16
Thänkky,kazzak,1340,monk,windwalker,24,14,10
Keberathom,stormscale,1340,monk,windwalker,235,112,123
Bg,blackhand,1339,monk,windwalker,24,14,10
Urgoll,silvermoon,1339,monk,windwalker,59,28,31
Драгслер,howling-fjord,1339,monk,windwalker,66,31,35
Tecisharmony,ravencrest,1338,monk,windwalker,24,14,10
Manlyfistx,stormscale,1337,monk,windwalker,31,14,17
Fiststowin,blackrock,1337,monk,windwalker,36,14,22
Бладмонки,soulflayer,1336,monk,windwalker,54,22,32
Kyz,darkspear,1336,monk,windwalker,53,21,32
Iluvatareru,twisting-nether,1333,monk,windwalker,60,31,29
Djînns,blackmoore,1333,monk,windwalker,60,30,30
Euronymesis,silvermoon,1332,monk,windwalker,76,35,41
Melikicks,silvermoon,1331,monk,windwalker,54,25,29
Migg,burning-legion,1330,monk,windwalker,46,18,28
Takapotku,silvermoon,1328,monk,windwalker,28,15,13
Tetetete,silvermoon,1327,monk,windwalker,66,36,30
Prototypx,blackmoore,1325,monk,windwalker,84,42,42
Øbamakush,archimonde,1323,monk,windwalker,36,17,19
Monklonk,kazzak,1323,monk,windwalker,42,19,23
Емопацан,gordunni,1321,monk,windwalker,42,27,15
Kryzu,ragnaros,1321,monk,windwalker,30,14,16
Monkariuz,antonidas,1321,monk,windwalker,40,18,22
Девятиусатый,gordunni,1321,monk,windwalker,52,22,30
Монкфейс,howling-fjord,1320,monk,windwalker,72,31,41
Shurak,uldaman,1319,monk,windwalker,36,16,20
Rhift,draenor,1317,monk,windwalker,64,35,29
Bcaa,outland,1317,monk,windwalker,30,16,14
Pipatvs,drakthul,1315,monk,windwalker,55,30,25
Resinn,ravencrest,1313,monk,windwalker,41,17,24
Брысьли,howling-fjord,1312,monk,windwalker,86,42,44
Popox,stormreaver,1312,monk,windwalker,30,14,16
Digô,malganis,1310,monk,windwalker,36,23,13
Czvibuh,drakthul,1309,monk,windwalker,66,32,34
Trizeth,grim-batol,1308,monk,windwalker,24,14,10
Monkgol,stormscale,1308,monk,windwalker,58,29,29
Verfa,twisting-nether,1308,monk,windwalker,78,38,40
Kungfumite,twisting-nether,1307,monk,windwalker,161,83,78
Fatlazypanda,argent-dawn,1306,monk,windwalker,62,37,25
Threevthree,kazzak,1305,monk,windwalker,33,18,15
Sarmal,nemesis,1305,monk,windwalker,62,29,33
Blumonk,argent-dawn,1301,monk,windwalker,512,256,256
Fûràxx,hyjal,1300,monk,windwalker,120,61,59
Убивашечка,blackscar,1300,monk,windwalker,69,31,38
Кримсон,blackscar,1299,monk,windwalker,95,51,44
Клепер,soulflayer,1298,monk,windwalker,79,45,34
Loocoos,ragnaros,1295,monk,windwalker,76,42,34
Lolipokicake,ravencrest,1294,monk,windwalker,41,16,25
Kyujushigu,silvermoon,1293,monk,windwalker,138,69,69
Xialongbao,khaz-modan,1291,monk,windwalker,47,19,28
Gordienko,silvermoon,1291,monk,windwalker,36,14,22
Коркирас,howling-fjord,1290,monk,windwalker,96,52,44
Miyaghï,dun-modr,1289,monk,windwalker,137,69,68
Räws,kirin-tor,1289,monk,windwalker,30,14,16
Phyllochinon,blackrock,1288,monk,windwalker,52,32,20
Óó,los-errantes,1287,monk,windwalker,57,28,29
Jutso,argent-dawn,1284,monk,windwalker,27,15,12
Maino,dalaran,1282,monk,windwalker,55,32,23
Gødxq,hyjal,1280,monk,windwalker,82,35,47
Tharaën,archimonde,1280,monk,windwalker,42,14,28
Sajin,la-croisade-écarlate,1279,monk,windwalker,29,14,15
Døwe,archimonde,1279,monk,windwalker,29,14,15
Umagon,chogall,1279,monk,windwalker,126,60,66
Mirôku,onyxia,1279,monk,windwalker,60,28,32
Elmonkx,onyxia,1279,monk,windwalker,48,17,31
Нежненький,gordunni,1278,monk,windwalker,30,14,16
Ekincheng,twisting-nether,1277,monk,windwalker,168,95,73
Scedadle,outland,1277,monk,windwalker,27,14,13
Gokuson,azjolnerub,1276,monk,windwalker,48,21,27
Betelgeuse,jaedenar,1273,monk,windwalker,33,15,18
Vulvie,ysondre,1271,monk,windwalker,138,70,68
Kaipo,ragnaros,1270,monk,windwalker,58,24,34
Mønkeydluffy,blackmoore,1269,monk,windwalker,66,33,33
Dummars,ragnaros,1266,monk,windwalker,30,15,15
Jerrykhãn,archimonde,1266,monk,windwalker,54,24,30
Critique,stormscale,1264,monk,windwalker,78,37,41
Arshy,silvermoon,1263,monk,windwalker,29,14,15
Ahlu,argent-dawn,1261,monk,windwalker,45,17,28
Likethat,hyjal,1260,monk,windwalker,125,60,65
Яшкациган,howling-fjord,1259,monk,windwalker,139,65,74
Nilssön,silvermoon,1258,monk,windwalker,26,14,12
Weedonyz,hyjal,1257,monk,windwalker,18,15,3
Ayyee,blackmoore,1257,monk,windwalker,96,40,56
Gorfax,sanguino,1254,monk,windwalker,58,31,27
Mycki,dalaran,1254,monk,windwalker,131,61,70
ßenito,burning-legion,1254,monk,windwalker,42,18,24
Vajawalkerx,twisting-nether,1247,monk,windwalker,18,13,5
Bal,tyrande,1247,monk,windwalker,45,27,18
Djpunchable,blackrock,1247,monk,windwalker,24,13,11
Askarg,hyjal,1247,monk,windwalker,42,20,22
Rainymonday,ravencrest,1246,monk,windwalker,24,13,11
Moonkeeye,stormscale,1246,monk,windwalker,114,59,55
Melombus,dun-modr,1246,monk,windwalker,30,13,17
Mcscrub,ragnaros,1245,monk,windwalker,24,13,11
Wêntô,aegwynn,1245,monk,windwalker,36,16,20
Mikelangelo,frostmane,1243,monk,windwalker,35,14,21
Brandy,kazzak,1242,monk,windwalker,30,13,17
Pacimaru,silvermoon,1242,monk,windwalker,30,13,17
Одиниз,gordunni,1241,monk,windwalker,102,64,38
Monkeystar,archimonde,1240,monk,windwalker,18,13,5
Mwoinesamdi,hyjal,1240,monk,windwalker,30,14,16
Rhâzalgûl,khaz-modan,1238,monk,windwalker,24,13,11
Pandermann,antonidas,1238,monk,windwalker,30,16,14
Jesmander,kazzak,1237,monk,windwalker,36,19,17
Patadademijo,tarren-mill,1237,monk,windwalker,36,16,20
Zoyrac,malygos,1236,monk,windwalker,30,16,14
Zymonks,silvermoon,1236,monk,windwalker,36,13,23
Кирокко,gordunni,1235,monk,windwalker,30,20,10
Kouradoskylo,twisting-nether,1234,monk,windwalker,29,16,13
Криповая,deathguard,1234,monk,windwalker,40,16,24
Blyatfast,draenor,1233,monk,windwalker,24,13,11
Кунфуцый,gordunni,1233,monk,windwalker,24,13,11
Чвка,booty-bay,1233,monk,windwalker,204,102,102
Monktoon,doomhammer,1233,monk,windwalker,40,20,20
Lumpero,stormreaver,1232,monk,windwalker,24,16,8
Macgregorc,tarren-mill,1232,monk,windwalker,27,14,13
Янасру,gordunni,1232,monk,windwalker,273,136,137
Огненныйкит,blackscar,1232,monk,windwalker,72,34,38
Kegrøll,doomhammer,1231,monk,windwalker,42,21,21
Ðøgai,frostwolf,1231,monk,windwalker,36,16,20
Calyonn,archimonde,1230,monk,windwalker,131,58,73
Samh,twisting-nether,1227,monk,windwalker,52,28,24
Néroburnsred,eredar,1227,monk,windwalker,86,39,47
Деоен,eversong,1224,monk,windwalker,76,34,42
Hôók,blackhand,1221,monk,windwalker,24,13,11
Нэкстимонк,howling-fjord,1221,monk,windwalker,30,16,14
Grandoreille,archimonde,1221,monk,windwalker,47,16,31
Sinziana,silvermoon,1217,monk,windwalker,20,14,6
Халиосфа,gordunni,1217,monk,windwalker,36,14,22
Bruzuh,outland,1215,monk,windwalker,31,15,16
Vushao,blackmoore,1215,monk,windwalker,174,81,93
Xem,azjolnerub,1215,monk,windwalker,30,13,17
Rollah,ravencrest,1214,monk,windwalker,34,16,18
Krâr,onyxia,1213,monk,windwalker,60,28,32
Joshxao,blackmoore,1211,monk,windwalker,36,13,23
Keskonriz,ysondre,1209,monk,windwalker,108,46,62
Gúerrilla,tarren-mill,1206,monk,windwalker,111,60,51
Imvengeance,stormscale,1205,monk,windwalker,58,28,30
Joaquuin,sylvanas,1204,monk,windwalker,54,27,27
Pingxiaopo,khaz-modan,1204,monk,windwalker,52,20,32
Билльбо,fordragon,1203,monk,windwalker,132,65,67
Kaengy,hyjal,1203,monk,windwalker,36,14,22
Xen,uldum,1201,monk,windwalker,30,18,12
Valky,bloodfeather,1201,monk,windwalker,42,22,20
Jïrén,archimonde,1201,monk,windwalker,122,53,69
Sîstâhfîstâh,kazzak,1199,monk,windwalker,21,13,8
Meowmelade,stormscale,1198,monk,windwalker,30,18,12
Senkaihero,nemesis,1197,monk,windwalker,36,19,17
Kusid,ragnaros,1196,monk,windwalker,31,18,13
Trunks,turalyon,1194,monk,windwalker,54,27,27
Yøøps,dalaran,1191,monk,windwalker,71,33,38
Шмальзахар,howling-fjord,1190,monk,windwalker,53,24,29
Snakozer,elune,1187,monk,windwalker,29,13,16
Bâmbêlvî,tyrande,1186,monk,windwalker,27,15,12
Sillbis,bronzebeard,1185,monk,windwalker,267,122,145
Qsê,ysondre,1183,monk,windwalker,24,13,11
Hackerman,archimonde,1183,monk,windwalker,59,26,33
Ricksancez,nemesis,1182,monk,windwalker,58,30,28
Grìzzly,stormreaver,1182,monk,windwalker,86,35,51
Stronkman,frostwhisper,1180,monk,windwalker,36,24,12
Jlamonja,dun-modr,1180,monk,windwalker,25,13,12
Gozgoya,doomhammer,1176,monk,windwalker,124,60,64
Рочч,gordunni,1172,monk,windwalker,30,17,13
Forpandariaa,kazzak,1171,monk,windwalker,42,15,27
Kalyxx,agamaggan,1167,monk,windwalker,48,19,29
Пивондэполо,gordunni,1162,monk,windwalker,64,27,37
Pyto,sanguino,1156,monk,windwalker,61,33,28
Deathwishes,zenedar,1156,monk,windwalker,36,13,23
Djstepmom,ravencrest,1152,monk,windwalker,12,12,0
Bellarika,nemesis,1152,monk,windwalker,12,12,0
Ðìør,kazzak,1152,monk,windwalker,18,12,6
Buffwwx,silvermoon,1152,monk,windwalker,24,12,12
Galexuz,blackrock,1152,monk,windwalker,30,12,18
Gøøgodx,tarren-mill,1151,monk,windwalker,18,12,6
Tðptier,drakthul,1151,monk,windwalker,18,12,6
Çhina,twisting-nether,1151,monk,windwalker,24,12,12
Sander,twilights-hammer,1151,monk,windwalker,27,13,14
Daybaobao,the-maelstrom,1150,monk,windwalker,28,14,14
Martur,bronzebeard,1150,monk,windwalker,30,12,18
Zerødamage,malorne,1149,monk,windwalker,18,12,6
Stormsong,arthas,1149,monk,windwalker,18,12,6
Hypern,twisting-nether,1149,monk,windwalker,22,13,9
Elfisto,baelgun,1149,monk,windwalker,26,13,13
Azorantay,dentarg,1149,monk,windwalker,24,12,12
Monk,dun-modr,1148,monk,windwalker,24,12,12
Brorsantuck,frostmane,1147,monk,windwalker,18,12,6
Faìthlessqt,azshara,1146,monk,windwalker,24,12,12
Silvrt,tarren-mill,1145,monk,windwalker,24,12,12
Kagëra,ysondre,1145,monk,windwalker,24,12,12
Ameri,burning-steppes,1145,monk,windwalker,24,12,12
Fedrra,twisting-nether,1144,monk,windwalker,24,12,12
Sigath,emeriss,1144,monk,windwalker,42,12,30
Lottelita,tarren-mill,1143,monk,windwalker,26,12,14
Мяуки,soulflayer,1141,monk,windwalker,24,12,12
Chonkard,drakthul,1136,monk,windwalker,92,36,56
Mönchdog,blackmoore,1135,monk,windwalker,36,19,17
Lílliv,wrathbringer,1135,monk,windwalker,30,12,18
Thichquang,sylvanas,1134,monk,windwalker,18,12,6
Ехерех,blackscar,1133,monk,windwalker,50,29,21
Groundnpound,silvermoon,1133,monk,windwalker,24,12,12
Gramary,silvermoon,1132,monk,windwalker,30,17,13
Martial,arthas,1131,monk,windwalker,107,52,55
Sixqtn,blackrock,1131,monk,windwalker,30,12,18
Somonks,twisting-nether,1124,monk,windwalker,42,19,23
Kirara,talnivarr,1121,monk,windwalker,18,12,6
Changsun,confrérie-du-thorium,1117,monk,windwalker,30,12,18
Непорядочная,gordunni,1114,monk,windwalker,69,31,38
Mongole,hellscream,1112,monk,windwalker,30,12,18
Bayak,antonidas,1111,monk,windwalker,82,40,42
Югэн,azuregos,1110,monk,windwalker,36,17,19
Moreløs,stormscale,1109,monk,windwalker,71,29,42
Panzeerotto,nemesis,1106,monk,windwalker,106,44,62
Omoi,twisting-nether,1101,monk,windwalker,119,47,72
Noodlesauce,silvermoon,1100,monk,windwalker,15,12,3
Spêcky,blackmoore,1100,monk,windwalker,70,33,37
Yamo,blackrock,1096,monk,windwalker,23,12,11
Koreangirlx,archimonde,1086,monk,windwalker,14,12,2
Iamzra,kazzak,1078,monk,windwalker,35,12,23
Spiritclaw,kul-tiras,1072,monk,windwalker,78,41,37
Yeddek,archimonde,1071,monk,windwalker,56,32,24
Monkiki,hyjal,1070,monk,windwalker,31,12,19
Malarie,magtheridon,1069,monk,windwalker,173,91,82
Jayline,kazzak,1069,monk,windwalker,54,21,33
Nades,the-maelstrom,1067,monk,windwalker,17,12,5
Концептуалик,gordunni,1060,monk,windwalker,27,16,11
Wrizz,area-52,1056,monk,windwalker,18,11,7
Гидрах,soulflayer,1055,monk,windwalker,18,11,7
Merokiin,kazzak,1055,monk,windwalker,18,11,7
Weezé,outland,1055,monk,windwalker,18,11,7
Cirixx,outland,1055,monk,windwalker,18,11,7
Thiccboi,dragonblight,1055,monk,windwalker,24,11,13
Ogelele,twisting-nether,1055,monk,windwalker,24,11,13
Denwont,twisting-nether,1054,monk,windwalker,18,11,7
Garlä,archimonde,1054,monk,windwalker,18,11,7
Leolilu,ravencrest,1054,monk,windwalker,18,11,7
Mahom,twisting-nether,1054,monk,windwalker,18,11,7
Chlamydious,silvermoon,1054,monk,windwalker,302,143,159
Daltailr,silvermoon,1054,monk,windwalker,27,11,16
Tiaqa,aegwynn,1053,monk,windwalker,12,11,1
Karatemonk,stormscale,1053,monk,windwalker,24,11,13
Silcet,stormscale,1052,monk,windwalker,18,11,7
Fistingfury,burning-blade,1052,monk,windwalker,24,11,13
Degentz,alakir,1051,monk,windwalker,21,12,9
Bottomoré,silvermoon,1051,monk,windwalker,30,12,18
Realiaze,tichondrius,1051,monk,windwalker,30,11,19
Psychovirgîn,archimonde,1050,monk,windwalker,18,11,7
Bananaboat,tarren-mill,1050,monk,windwalker,18,11,7
Gléipnir,ravencrest,1050,monk,windwalker,24,11,13
Monkacek,drakthul,1049,monk,windwalker,18,11,7
Sêssai,outland,1049,monk,windwalker,18,11,7
Dopi,frostmane,1049,monk,windwalker,22,12,10
Monkyou,hyjal,1046,monk,windwalker,18,11,7
Dokuziq,twisting-nether,1046,monk,windwalker,28,12,16
Sholean,die-aldor,1045,monk,windwalker,18,11,7
Jgma,auchindoun,1045,monk,windwalker,339,161,178
Fastpawssk,outland,1044,monk,windwalker,40,16,24
Ørlandéa,archimonde,1043,monk,windwalker,95,50,45
Youngstorm,kazzak,1040,monk,windwalker,24,13,11
Dofunk,eonar,1030,monk,windwalker,23,13,10
Tysonwonka,thrall,1030,monk,windwalker,44,20,24
Marcianorock,archimonde,1028,monk,windwalker,36,17,19
Brevduwan,ragnaros,1024,monk,windwalker,24,11,13
Napqi,malganis,1023,monk,windwalker,17,11,6
Monkiatsu,turalyon,1023,monk,windwalker,56,28,28
Шоты,soulflayer,1019,monk,windwalker,18,11,7
Runny,sanguino,1008,monk,windwalker,42,12,30
Armutschkerl,blackhand,997,monk,windwalker,41,13,28
Buggaa,dalaran,996,monk,windwalker,23,11,12
Undgrund,burning-legion,992,monk,windwalker,36,16,20
Rektless,nordrassil,989,monk,windwalker,20,11,9
Myiio,khaz-modan,987,monk,windwalker,42,12,30
Dokodesuka,ysondre,985,monk,windwalker,58,29,29
Agress,sanguino,984,monk,windwalker,72,33,39
Обликонт,soulflayer,983,monk,windwalker,24,12,12
Yuchiiro,hyjal,973,monk,windwalker,30,13,17
Votix,tarren-mill,960,monk,windwalker,12,10,2
Pïpöu,archimonde,960,monk,windwalker,12,10,2
Matexww,frostwhisper,960,monk,windwalker,18,10,8
Ðävàizskó,ysondre,960,monk,windwalker,18,10,8
Plånck,archimonde,960,monk,windwalker,18,10,8
Sqoobie,tarren-mill,960,monk,windwalker,18,10,8
Wreckpuss,tarren-mill,960,monk,windwalker,18,10,8
Rìnox,blackmoore,960,monk,windwalker,18,10,8
Kåtsumi,sanguino,960,monk,windwalker,24,10,14
Balance,laughing-skull,960,monk,windwalker,24,10,14
Sebikm,ravencrest,959,monk,windwalker,12,10,2
Uglyfister,kazzak,959,monk,windwalker,18,10,8
Белыйрасист,gordunni,959,monk,windwalker,18,10,8
Bígwrékt,twisting-nether,959,monk,windwalker,18,10,8
Wowweaver,outland,959,monk,windwalker,18,10,8
Eggroll,archimonde,959,monk,windwalker,18,10,8
Nycea,blackrock,959,monk,windwalker,18,10,8
Sàlêxz,ysondre,959,monk,windwalker,18,10,8
Pilpoo,magtheridon,959,monk,windwalker,30,13,17
Winifspin,twisting-nether,959,monk,windwalker,24,10,14
Pando,hyjal,959,monk,windwalker,24,10,14
Såsha,sanguino,959,monk,windwalker,24,10,14
Вамдампощам,blackscar,959,monk,windwalker,24,10,14
Miridius,silvermoon,959,monk,windwalker,24,10,14
Rulliya,kazzak,959,monk,windwalker,24,10,14
Shialemonk,twisting-nether,957,monk,windwalker,18,10,8
Михот,eversong,957,monk,windwalker,30,15,15
Pimahz,aggra-português,956,monk,windwalker,18,10,8
Doreese,moonglade,955,monk,windwalker,18,10,8
Пенетраторд,gordunni,955,monk,windwalker,24,10,14
Duches,tarren-mill,955,monk,windwalker,24,10,14
Màrlux,kazzak,954,monk,windwalker,24,10,14
Orcword,ragnaros,953,monk,windwalker,18,10,8
Glenlaw,draenor,950,monk,windwalker,30,10,20
Chæli,tarren-mill,944,monk,windwalker,29,12,17
Rhaekhan,kirin-tor,943,monk,windwalker,24,10,14
Zonavya,stormreaver,941,monk,windwalker,27,11,16
Jawofiron,quelthalas,941,monk,windwalker,29,10,19
Dionee,twisting-nether,939,monk,windwalker,69,30,39
Linocence,draenor,938,monk,windwalker,173,89,84
Grîmjaw,nordrassil,933,monk,windwalker,30,11,19
Trolleurz,archimonde,932,monk,windwalker,32,12,20
Vandersnátch,garrosh,929,monk,windwalker,16,11,5
Sebbii,twisting-nether,927,monk,windwalker,23,10,13
Touchgodx,blackrock,927,monk,windwalker,26,11,15
Brucilli,dalaran,926,monk,windwalker,60,26,34
Khazàd,archimonde,924,monk,windwalker,17,10,7
Goltigald,archimonde,923,monk,windwalker,29,10,19
Astmönk,archimonde,910,monk,windwalker,24,11,13
Vercya,dun-morogh,910,monk,windwalker,76,29,47
Elahn,outland,909,monk,windwalker,27,10,17
Broussly,voljin,907,monk,windwalker,65,31,34
Gidmonk,darkspear,904,monk,windwalker,42,22,20
Farlopeti,dun-modr,900,monk,windwalker,66,20,46
Celimbrimbor,eredar,892,monk,windwalker,20,10,10
Scorpìon,blackrock,888,monk,windwalker,20,11,9
Flyingraven,magtheridon,880,monk,windwalker,28,10,18
Апесиинка,gordunni,874,monk,windwalker,23,11,12
Loordcraft,silvermoon,864,monk,windwalker,12,9,3
Pattafixcrin,blackrock,864,monk,windwalker,12,9,3
Eternalmoose,grim-batol,864,monk,windwalker,12,9,3
Syzztwo,stormscale,864,monk,windwalker,12,9,3
Freemmrx,kazzak,864,monk,windwalker,12,9,3
Yõungõld,stormscale,864,monk,windwalker,12,9,3
Athem,frostwolf,864,monk,windwalker,12,9,3
Larsowns,ragnaros,864,monk,windwalker,12,9,3
Zmile,ragnaros,864,monk,windwalker,18,9,9
Lrizz,argent-dawn,864,monk,windwalker,18,9,9
Jessie,bloodscalp,864,monk,windwalker,18,9,9
Weaverman,ragnaros,864,monk,windwalker,18,9,9
Varea,blackrock,864,monk,windwalker,18,9,9
Tonikor,kazzak,864,monk,windwalker,18,9,9
Notadrâgon,sylvanas,864,monk,windwalker,18,9,9
Skriptzy,blackmoore,864,monk,windwalker,18,9,9
Nesedondondn,stormscale,864,monk,windwalker,18,9,9
Hilfe,stormscale,864,monk,windwalker,18,9,9
Luxii,blackmoore,864,monk,windwalker,18,9,9
Øåæøæøåæ,ravencrest,864,monk,windwalker,18,9,9
Brols,dalaran,864,monk,windwalker,18,9,9
Gîø,blackmoore,864,monk,windwalker,18,9,9
Rileyweed,hellscream,864,monk,windwalker,18,9,9
Snookzlol,aegwynn,864,monk,windwalker,18,9,9
Chryan,marécage-de-zangar,864,monk,windwalker,18,9,9
Archnun,stormscale,864,monk,windwalker,24,9,15
Dorks,sanguino,864,monk,windwalker,24,9,15
Shaokz,sylvanas,863,monk,windwalker,12,9,3
Yeol,ravencrest,863,monk,windwalker,18,9,9
Wâgwân,hyjal,863,monk,windwalker,18,9,9
Otp,hyjal,863,monk,windwalker,18,9,9
Dmeenmonk,kazzak,863,monk,windwalker,18,9,9
Miýági,blackmoore,863,monk,windwalker,18,9,9
Jakkeez,twisting-nether,863,monk,windwalker,18,9,9
Alphalus,khaz-modan,863,monk,windwalker,18,9,9
Cranecannon,aegwynn,863,monk,windwalker,19,9,10
Dearm,burning-legion,863,monk,windwalker,24,9,15
Gálaxyfist,blackhand,863,monk,windwalker,24,9,15
Thawy,sargeras,863,monk,windwalker,24,9,15
Nouraxo,kazzak,862,monk,windwalker,18,9,9
Serizawã,hyjal,862,monk,windwalker,18,9,9
Krtinse,ravencrest,862,monk,windwalker,18,9,9
Sûûn,hyjal,862,monk,windwalker,18,9,9
Bonkboi,tarren-mill,862,monk,windwalker,24,9,15
Асшез,gordunni,862,monk,windwalker,24,9,15
Пропесочило,gordunni,862,monk,windwalker,28,10,18
Tylavie,silvermoon,861,monk,windwalker,18,9,9
Teztouza,kazzak,861,monk,windwalker,18,9,9
Sooyung,kazzak,861,monk,windwalker,18,9,9
Lin,nathrezim,861,monk,windwalker,18,9,9
Авентусс,howling-fjord,861,monk,windwalker,24,9,15
Nandromonk,dalaran,861,monk,windwalker,24,9,15
Дасний,gordunni,859,monk,windwalker,12,9,3
Velita,dun-modr,858,monk,windwalker,27,9,18
Meff,hyjal,855,monk,windwalker,16,10,6
Jujujitsu,archimonde,854,monk,windwalker,47,23,24
Mozzaks,doomhammer,852,monk,windwalker,12,9,3
Zanizu,blackhand,831,monk,windwalker,14,10,4
Prycch,twisting-nether,831,monk,windwalker,16,9,7
Chanzey,silvermoon,831,monk,windwalker,17,9,8
Gáchisláyer,kazzak,831,monk,windwalker,23,9,14
Yamqt,thrall,816,monk,windwalker,27,9,18
Fusetonww,tarren-mill,815,monk,windwalker,17,9,8
Nichonne,khaz-modan,815,monk,windwalker,30,9,21
Të,ysondre,814,monk,windwalker,21,9,12
Elayja,twisting-nether,809,monk,windwalker,20,10,10
Монкуем,gordunni,802,monk,windwalker,18,9,9
Dushimonk,runetotem,797,monk,windwalker,22,9,13
Karatiy,doomhammer,795,monk,windwalker,99,33,66
Mórrid,draenor,791,monk,windwalker,27,9,18
Shàllýn,antonidas,784,monk,windwalker,19,9,10
Rezuz,draenor,768,monk,windwalker,12,8,4
Arisua,blackhand,768,monk,windwalker,12,8,4
Funnymonk,magtheridon,768,monk,windwalker,12,8,4
Wladqz,stormscale,768,monk,windwalker,12,8,4
Carmismonk,tarren-mill,768,monk,windwalker,12,8,4
Nyaruko,blackrock,768,monk,windwalker,12,8,4
Rma,twisting-nether,768,monk,windwalker,12,8,4
Karels,archimonde,768,monk,windwalker,12,8,4
Dirtymonki,stormscale,768,monk,windwalker,12,8,4
Slayh,archimonde,768,monk,windwalker,12,8,4
Cuteshygirl,shattrath,768,monk,windwalker,18,8,10
Skymonkey,kul-tiras,768,monk,windwalker,18,8,10
Jamiedhism,ravencrest,768,monk,windwalker,18,8,10
Cptschneider,blackmoore,768,monk,windwalker,18,8,10
Qaanimn,ravencrest,768,monk,windwalker,18,8,10
Meduseqt,ravencrest,768,monk,windwalker,24,8,16
Sungødx,blackrock,768,monk,windwalker,24,8,16
Nízra,archimonde,767,monk,windwalker,12,8,4
Monkaluth,draenor,767,monk,windwalker,12,8,4
Marksanuwu,kilrogg,767,monk,windwalker,12,8,4
Yungbaren,frostwolf,767,monk,windwalker,12,8,4
Пашаскороход,gordunni,767,monk,windwalker,12,8,4
Daizz,magtheridon,767,monk,windwalker,12,8,4
Maifu,thrall,767,monk,windwalker,18,8,10
Olgachocolat,blackmoore,767,monk,windwalker,18,8,10
Pinkcell,sanguino,767,monk,windwalker,18,8,10
Johnsôn,blackmoore,767,monk,windwalker,18,8,10
Alurymnk,blackrock,767,monk,windwalker,18,8,10
Валерабицепс,gordunni,767,monk,windwalker,18,8,10
Nokitz,kazzak,767,monk,windwalker,18,8,10
Монквв,eversong,767,monk,windwalker,18,8,10
Bansheerrz,hyjal,767,monk,windwalker,18,8,10
Wutan,burning-legion,767,monk,windwalker,18,8,10
Válkyrìe,ravencrest,767,monk,windwalker,24,8,16
Plsnerfrogue,tarren-mill,766,monk,windwalker,12,8,4
Wilywolxx,silvermoon,766,monk,windwalker,12,8,4
Pocaa,arakarahm,766,monk,windwalker,18,8,10
Tuwongfu,argent-dawn,766,monk,windwalker,18,8,10
Naynayrb,draenor,766,monk,windwalker,18,8,10
Милиса,grom,764,monk,windwalker,15,9,6
Chiroidz,kazzak,764,monk,windwalker,18,8,10
Nirvanabange,sylvanas,764,monk,windwalker,24,8,16
Ørgasm,magtheridon,763,monk,windwalker,24,8,16
Moutabesh,silvermoon,762,monk,windwalker,18,8,10
Rangomind,silvermoon,761,monk,windwalker,12,8,4
Sayonarami,frostmane,753,monk,windwalker,18,8,10
Wallky,burning-blade,743,monk,windwalker,30,8,22
Kûma,echsenkessel,735,monk,windwalker,16,8,8
Merjis,stormscale,719,monk,windwalker,17,8,9
Darîus,archimonde,718,monk,windwalker,21,8,13
Portugas,aegwynn,711,monk,windwalker,28,9,19
Shyriu,kazzak,702,monk,windwalker,16,8,8
Fredder,blackrock,701,monk,windwalker,23,8,15
Månkey,ahnqiraj,672,monk,windwalker,12,7,5
Vetocorleone,kazzak,672,monk,windwalker,12,7,5
Doash,nemesis,672,monk,windwalker,12,7,5
Мягкийпо,howling-fjord,672,monk,windwalker,12,7,5
Sizok,blackmoore,672,monk,windwalker,12,7,5
Pawsy,twisting-nether,672,monk,windwalker,12,7,5
Assÿría,ravencrest,672,monk,windwalker,12,7,5
Arthanaar,drakthul,672,monk,windwalker,12,7,5
Vionixe,kazzak,672,monk,windwalker,12,7,5
Zerosixtyone,kazzak,672,monk,windwalker,12,7,5
Sugondese,grim-batol,672,monk,windwalker,12,7,5
Thailun,kazzak,672,monk,windwalker,12,7,5
Tortasauro,sanguino,672,monk,windwalker,12,7,5
Despéradø,archimonde,672,monk,windwalker,12,7,5
Vixiatwo,outland,672,monk,windwalker,12,7,5
Fambi,ragnaros,672,monk,windwalker,12,7,5
Lilßaby,archimonde,672,monk,windwalker,12,7,5
Gargalondeze,twisting-nether,672,monk,windwalker,12,7,5
Bananabatman,ragnaros,672,monk,windwalker,12,7,5
Jekkar,uldum,672,monk,windwalker,12,7,5
Тэюкимма,gordunni,672,monk,windwalker,12,7,5
Balanceqt,ravencrest,672,monk,windwalker,12,7,5
Njursten,twilights-hammer,672,monk,windwalker,12,7,5
Shoelaren,ragnaros,672,monk,windwalker,12,7,5
Dennismansix,sylvanas,672,monk,windwalker,12,7,5
Bryggarn,draenor,672,monk,windwalker,12,7,5
Saburo,archimonde,672,monk,windwalker,12,7,5
Мишадуротар,borean-tundra,672,monk,windwalker,19,9,10
Risingspud,frostmane,672,monk,windwalker,18,7,11
Quï,hyjal,672,monk,windwalker,18,7,11
Márliene,twisting-nether,672,monk,windwalker,18,7,11
Ráây,blackrock,672,monk,windwalker,18,7,11
Çùçé,dalaran,672,monk,windwalker,18,7,11
Jkmonkyo,blackrock,672,monk,windwalker,18,7,11
Nevertouch,blackrock,672,monk,windwalker,18,7,11
Elababe,ravencrest,672,monk,windwalker,18,7,11
Zarkan,draenor,672,monk,windwalker,18,7,11
Борзыйпес,soulflayer,672,monk,windwalker,18,7,11
Mayliene,stormscale,672,monk,windwalker,18,7,11
Xkôra,cthun,672,monk,windwalker,18,7,11
Bloodsports,anubarak,672,monk,windwalker,18,7,11
Бесчувствие,blackscar,672,monk,windwalker,18,7,11
Bbcmonkinc,aegwynn,672,monk,windwalker,22,8,14
Kajï,frostmane,672,monk,windwalker,24,7,17
Keisy,kazzak,672,monk,windwalker,24,7,17
Quendiz,frostwolf,672,monk,windwalker,24,7,17
Mystikmonk,blackrock,671,monk,windwalker,12,7,5
Bierdame,blackhand,671,monk,windwalker,12,7,5
Sonofelrond,twisting-nether,671,monk,windwalker,12,7,5
Boxarnsgrabb,shattered-hand,671,monk,windwalker,12,7,5
Dubhira,blackmoore,671,monk,windwalker,12,7,5
Azouko,onyxia,671,monk,windwalker,12,7,5
Эзархадон,lich-king,671,monk,windwalker,12,7,5
Maelea,ysondre,671,monk,windwalker,12,7,5
Iluvfistinjk,sylvanas,671,monk,windwalker,12,7,5
Windsamdi,hyjal,671,monk,windwalker,18,7,11
Kawaiitsuki,sanguino,671,monk,windwalker,18,7,11
Discosean,frostmane,671,monk,windwalker,18,7,11
Vipergaming,aggra-português,671,monk,windwalker,18,7,11
Erwva,draenor,671,monk,windwalker,24,7,17
Zhiothe,argent-dawn,670,monk,windwalker,12,7,5
Kharnael,hyjal,670,monk,windwalker,12,7,5
Shaol,stormreaver,669,monk,windwalker,12,7,5
Raychi,draenor,669,monk,windwalker,18,7,11
Мистерхюй,gordunni,669,monk,windwalker,30,7,23
Lewimoäne,khaz-modan,667,monk,windwalker,12,7,5
Socialxty,dun-modr,618,monk,windwalker,16,8,8
Mistysausage,silvermoon,616,monk,windwalker,33,8,25
Pïpöu,kirin-tor,607,monk,windwalker,11,7,4
Манамба,blackscar,605,monk,windwalker,26,7,19
Fistlimc,eredar,576,monk,windwalker,6,6,0
Mùtsúræv,ravencrest,576,monk,windwalker,6,6,0
Котэлатэ,gordunni,576,monk,windwalker,6,6,0
Ilovecravmag,draenor,576,monk,windwalker,12,6,6
Imsoslow,twisting-nether,576,monk,windwalker,12,6,6
Monkeez,onyxia,576,monk,windwalker,12,6,6
Kiial,blackmoore,576,monk,windwalker,12,6,6
Zenfoxy,blackrock,576,monk,windwalker,12,6,6
Plani,ragnaros,576,monk,windwalker,12,6,6
Vjelan,forscherliga,576,monk,windwalker,12,6,6
Geochi,tarren-mill,576,monk,windwalker,12,6,6
Спортикус,galakrond,576,monk,windwalker,12,6,6
Trample,stormscale,576,monk,windwalker,12,6,6
Fistweavs,ravencrest,576,monk,windwalker,12,6,6
Jollyzug,blackrock,576,monk,windwalker,12,6,6
Ilcooljay,ravencrest,576,monk,windwalker,12,6,6
Ferree,tarren-mill,576,monk,windwalker,12,6,6
Gramkin,ravencrest,576,monk,windwalker,12,6,6
Mcgregors,aszune,576,monk,windwalker,12,6,6
Níko,korgall,576,monk,windwalker,12,6,6
Willempie,stormreaver,576,monk,windwalker,12,6,6
Cealestes,blackmoore,576,monk,windwalker,12,6,6
Doyoubleed,twisting-nether,576,monk,windwalker,12,6,6
Nyrkkikylpy,ravencrest,576,monk,windwalker,12,6,6
Tossen,ragnaros,576,monk,windwalker,12,6,6
Pâtâpouf,hyjal,576,monk,windwalker,12,6,6
Xàrslòulolz,kazzak,576,monk,windwalker,12,6,6
Rigbone,kazzak,576,monk,windwalker,12,6,6
Worasemonk,hyjal,576,monk,windwalker,12,6,6
Svakkanww,kazzak,576,monk,windwalker,12,6,6
Geezer,the-maelstrom,576,monk,windwalker,12,6,6
Хмелеварня,goldrinn,576,monk,windwalker,12,6,6
Gamerboydude,silvermoon,576,monk,windwalker,12,6,6
Мэрджик,soulflayer,576,monk,windwalker,12,6,6
Sæ,kazzak,576,monk,windwalker,12,6,6
Amsdpoe,kazzak,576,monk,windwalker,12,6,6
Аморальнохх,blackscar,576,monk,windwalker,12,6,6
Karradine,khaz-modan,576,monk,windwalker,18,6,12
Synthesize,aerie-peak,576,monk,windwalker,18,6,12
Xoconut,ravencrest,576,monk,windwalker,18,6,12
Faxxax,draenor,576,monk,windwalker,18,6,12
Xwalk,kazzak,576,monk,windwalker,18,6,12
Fimis,alonsus,576,monk,windwalker,18,6,12
Norgamx,alakir,576,monk,windwalker,18,6,12
Ввмонкпбогх,gordunni,576,monk,windwalker,18,6,12
Wingzzy,outland,575,monk,windwalker,6,6,0
Teetoor,argent-dawn,575,monk,windwalker,12,6,6
Woalter,silvermoon,575,monk,windwalker,12,6,6
Woknroll,draenor,575,monk,windwalker,12,6,6
Akkri,tarren-mill,575,monk,windwalker,12,6,6
Magharald,das-syndikat,575,monk,windwalker,12,6,6
Tofast,darksorrow,575,monk,windwalker,12,6,6
Beerpowér,outland,575,monk,windwalker,12,6,6
Kykymbappe,archimonde,575,monk,windwalker,12,6,6
Okpm,marécage-de-zangar,575,monk,windwalker,12,6,6
Boojj,kazzak,575,monk,windwalker,12,6,6
Sorya,aegwynn,575,monk,windwalker,12,6,6
Smallmonk,hyjal,575,monk,windwalker,12,6,6
Фистермонк,gordunni,575,monk,windwalker,12,6,6
Klotsobunidi,kazzak,575,monk,windwalker,15,7,8
Крэйзимедвед,howling-fjord,575,monk,windwalker,18,6,12
Jaylée,thrall,574,monk,windwalker,12,6,6
Bogopo,kazzak,574,monk,windwalker,14,6,8
Panda,das-syndikat,574,monk,windwalker,24,6,18
Veila,the-maelstrom,573,monk,windwalker,12,6,6
Izabell,bronzebeard,573,monk,windwalker,18,6,12
Mullan,eonar,573,monk,windwalker,24,6,18
What,marécage-de-zangar,572,monk,windwalker,12,6,6
Kungfubaby,hyjal,571,monk,windwalker,12,6,6
Энвишь,soulflayer,559,monk,windwalker,11,6,5
Жарптыца,gordunni,559,monk,windwalker,17,6,11
Lemaru,kazzak,559,monk,windwalker,17,6,11
Jhiqqui,archimonde,542,monk,windwalker,11,6,5
Hochiminh,eldrethalas,526,monk,windwalker,11,6,5
Kungfupandy,blackmoore,512,monk,windwalker,22,6,16
Dasjinso,blackhand,511,monk,windwalker,14,6,8
Everydayrain,ravencrest,511,monk,windwalker,14,6,8
Kassducu,archimonde,511,monk,windwalker,20,6,14
Eaghor,draenor,510,monk,windwalker,10,6,4
Жекадобряк,howling-fjord,503,monk,windwalker,15,7,8
Päjcsi,ragnaros,480,monk,windwalker,6,5,1
Quasarmonk,ravencrest,480,monk,windwalker,6,5,1
Killabees,stormscale,480,monk,windwalker,6,5,1
Kretoz,stormreaver,480,monk,windwalker,6,5,1
Kapud,twisting-nether,480,monk,windwalker,6,5,1
Smøkÿý,eredar,480,monk,windwalker,6,5,1
Монкигодх,howling-fjord,480,monk,windwalker,6,5,1
Карателькасл,gordunni,480,monk,windwalker,6,5,1
Nekov,frostmane,480,monk,windwalker,6,5,1
Holyrop,aegwynn,480,monk,windwalker,6,5,1
Fistyamommy,blackmoore,480,monk,windwalker,6,5,1
Emptyeyés,kazzak,480,monk,windwalker,6,5,1
Kaelwind,burning-legion,480,monk,windwalker,12,5,7
Yeanwoo,burning-legion,480,monk,windwalker,12,5,7
Ghettomonk,blackmoore,480,monk,windwalker,12,5,7
Krazylegs,sanguino,480,monk,windwalker,12,5,7
Aljabbar,ravencrest,480,monk,windwalker,12,5,7
Onepunchgal,silvermoon,480,monk,windwalker,12,5,7
Hilmisan,ravencrest,480,monk,windwalker,12,5,7
Mickjabber,aegwynn,480,monk,windwalker,12,5,7
Беглыйлаваш,gordunni,480,monk,windwalker,12,5,7
Salesforce,cthun,480,monk,windwalker,12,5,7
Pîna,onyxia,480,monk,windwalker,12,5,7
Señorzayo,ravencrest,480,monk,windwalker,12,5,7
Drfistalot,blackrock,480,monk,windwalker,12,5,7
Dertekk,archimonde,480,monk,windwalker,12,5,7
Нагиботар,thermaplugg,480,monk,windwalker,12,5,7
Lerouxx,archimonde,480,monk,windwalker,12,5,7
Buddhaissara,ravencrest,480,monk,windwalker,12,5,7
Enrookiejr,aegwynn,480,monk,windwalker,12,5,7
Grintilif,malygos,480,monk,windwalker,12,5,7
Käsefäuste,azshara,480,monk,windwalker,12,5,7
Pandaria,bronze-dragonflight,480,monk,windwalker,12,5,7
Расселкроу,galakrond,480,monk,windwalker,12,5,7
Killthemonk,rajaxx,480,monk,windwalker,12,5,7
Yakalba,ravencrest,480,monk,windwalker,12,5,7
Ödenn,hyjal,480,monk,windwalker,12,5,7
Udon,argent-dawn,480,monk,windwalker,12,5,7
Bimberta,argent-dawn,480,monk,windwalker,12,5,7
Fistus,dentarg,480,monk,windwalker,12,5,7
Øåæøæøåæ,kazzak,480,monk,windwalker,12,5,7
Szoney,blackhand,480,monk,windwalker,12,5,7
Renegatt,twisting-nether,480,monk,windwalker,12,5,7
Amislish,draenor,480,monk,windwalker,12,5,7
Plsdontdie,sylvanas,480,monk,windwalker,12,5,7
Emejzy,draenor,480,monk,windwalker,12,5,7
Npkwalker,outland,480,monk,windwalker,12,5,7
Kenjibsen,blackhand,480,monk,windwalker,12,5,7
Sermuonelis,kazzak,480,monk,windwalker,12,5,7
Áutumnfalls,stormscale,480,monk,windwalker,12,5,7
Plingpong,sylvanas,480,monk,windwalker,12,5,7
Sneptichitz,draenor,480,monk,windwalker,12,5,7
Крилни,soulflayer,480,monk,windwalker,12,5,7
Nicetrybuddy,draenor,480,monk,windwalker,18,5,13
Telarîa,blackhand,480,monk,windwalker,18,5,13
Draxaxa,hyjal,480,monk,windwalker,18,5,13
Medovic,blackmoore,480,monk,windwalker,18,5,13
Microsaft,blackrock,480,monk,windwalker,18,5,13
Wartexsenior,khaz-modan,479,monk,windwalker,6,5,1
Zaalleh,draenor,479,monk,windwalker,6,5,1
Latify,todeswache,479,monk,windwalker,12,5,7
Zoldicfamily,outland,479,monk,windwalker,12,5,7
Диксэш,ashenvale,479,monk,windwalker,12,5,7
Sdk,silvermoon,479,monk,windwalker,12,5,7
Alopécida,voljin,479,monk,windwalker,15,6,9
Холанн,greymane,479,monk,windwalker,18,5,13
Øñ,cthun,479,monk,windwalker,18,5,13
Mïsted,sylvanas,479,monk,windwalker,18,5,13
Effeots,blackrock,479,monk,windwalker,18,5,13
Tjukkas,bloodhoof,479,monk,windwalker,24,5,19
Fastblood,kazzak,478,monk,windwalker,18,5,13
Blackdu,drakthul,477,monk,windwalker,16,6,10
Sadwhi,turalyon,472,monk,windwalker,12,5,7
Lqp,outland,447,monk,windwalker,11,5,6
Chifù,silvermoon,432,monk,windwalker,19,6,13
Crokmoche,archimonde,428,monk,windwalker,12,7,5
Marqinio,archimonde,426,monk,windwalker,15,7,8
Twdabuser,tarren-mill,415,monk,windwalker,8,5,3
Камагами,howling-fjord,400,monk,windwalker,7,5,2
Theoalt,dragonblight,399,monk,windwalker,5,5,0
Лордволкер,gordunni,393,monk,windwalker,16,7,9
Karya,chogall,384,monk,windwalker,6,4,2
Asceticism,twisting-nether,384,monk,windwalker,6,4,2
Monkflexi,draenor,384,monk,windwalker,6,4,2
Sepi,hellfire,384,monk,windwalker,6,4,2
Palarîns,dalaran,384,monk,windwalker,6,4,2
Onn,outland,384,monk,windwalker,6,4,2
Wingwalker,twisting-nether,384,monk,windwalker,6,4,2
Màlydôr,outland,384,monk,windwalker,6,4,2
Larrý,sylvanas,384,monk,windwalker,6,4,2
Windstormcro,ragnaros,384,monk,windwalker,6,4,2
Hertel,boulderfist,384,monk,windwalker,6,4,2
Hotfist,outland,384,monk,windwalker,6,4,2
Rhèa,todeswache,384,monk,windwalker,6,4,2
Alâkhai,nerzhul,384,monk,windwalker,6,4,2
Soulspar,ragnaros,384,monk,windwalker,6,4,2
Rugys,ravenholdt,384,monk,windwalker,6,4,2
Tacktix,defias-brotherhood,384,monk,windwalker,6,4,2
Sprizzfuaz,blackmoore,384,monk,windwalker,6,4,2
Riggedwind,ragnaros,384,monk,windwalker,6,4,2
Shadezz,blackmoore,384,monk,windwalker,6,4,2
Mystd,hyjal,384,monk,windwalker,6,4,2
Venersere,eitrigg,384,monk,windwalker,6,4,2
Râgnør,blackrock,384,monk,windwalker,6,4,2
Ровк,howling-fjord,384,monk,windwalker,6,4,2
Saysin,blackrock,384,monk,windwalker,6,4,2
Tàlo,anachronos,384,monk,windwalker,6,4,2
Justwannaówn,blackrock,384,monk,windwalker,6,4,2
Piednuques,archimonde,384,monk,windwalker,6,4,2
Møønkëy,archimonde,384,monk,windwalker,6,4,2
Àyoörts,archimonde,384,monk,windwalker,6,4,2
Sesh,runetotem,384,monk,windwalker,6,4,2
Blazeuu,drakthul,384,monk,windwalker,6,4,2
Wushin,antonidas,384,monk,windwalker,6,4,2
Faithww,tarren-mill,384,monk,windwalker,6,4,2
Tottle,archimonde,384,monk,windwalker,6,4,2
Orenichi,antonidas,384,monk,windwalker,6,4,2
Jériícho,khaz-modan,384,monk,windwalker,6,4,2
Baisi,blackhand,384,monk,windwalker,6,4,2
Zuny,ravencrest,384,monk,windwalker,6,4,2
Shailene,kazzak,384,monk,windwalker,6,4,2
Stambro,blackhand,384,monk,windwalker,6,4,2
Нниндзя,fordragon,384,monk,windwalker,6,4,2
Милосердие,eversong,384,monk,windwalker,6,4,2
Orênda,silvermoon,384,monk,windwalker,6,4,2
Dadrael,argent-dawn,384,monk,windwalker,6,4,2
Laéna,argent-dawn,384,monk,windwalker,6,4,2
Hitslikegøku,ravencrest,384,monk,windwalker,6,4,2
Karrin,ghostlands,384,monk,windwalker,6,4,2
Rayids,kazzak,384,monk,windwalker,6,4,2
Jetcee,kazzak,384,monk,windwalker,6,4,2
Ubap,emeriss,384,monk,windwalker,6,4,2
Bumm,ravencrest,384,monk,windwalker,6,4,2
Clìtfister,silvermoon,384,monk,windwalker,6,4,2
Ciuco,stormscale,384,monk,windwalker,6,4,2
Kurtfu,ravencrest,384,monk,windwalker,6,4,2
Catchm,tarren-mill,384,monk,windwalker,6,4,2
Кокпанчер,soulflayer,384,monk,windwalker,6,4,2
Windvibes,antonidas,384,monk,windwalker,6,4,2
Disciprín,tarren-mill,384,monk,windwalker,6,4,2
Garmore,blackmoore,384,monk,windwalker,9,5,4
Випик,gordunni,384,monk,windwalker,15,5,10
Goremancey,draenor,384,monk,windwalker,12,4,8
Billyebbasta,nemesis,384,monk,windwalker,12,4,8
Dëvilliä,ragnaros,384,monk,windwalker,12,4,8
Knupi,dalaran,384,monk,windwalker,12,4,8
Møñkgødx,silvermoon,384,monk,windwalker,12,4,8
Аоепуп,soulflayer,384,monk,windwalker,12,4,8
Räyh,outland,384,monk,windwalker,12,4,8
Bluum,ravencrest,384,monk,windwalker,12,4,8
Blyadislav,ravencrest,384,monk,windwalker,12,4,8
Bigkim,khadgar,384,monk,windwalker,12,4,8
Ожиганов,soulflayer,384,monk,windwalker,12,4,8
Chucknorrys,blackmoore,384,monk,windwalker,12,4,8
Azia,bronzebeard,384,monk,windwalker,12,4,8
Kushvendorx,silvermoon,384,monk,windwalker,12,4,8
Ledoz,ravencrest,384,monk,windwalker,12,4,8
Scribzz,twisting-nether,384,monk,windwalker,12,4,8
Loorda,neptulon,384,monk,windwalker,12,4,8
Tyrastel,dalaran,384,monk,windwalker,12,4,8
Vaélin,area-52,384,monk,windwalker,12,4,8
Bytheway,kazzak,384,monk,windwalker,12,4,8
Кириешек,deathguard,384,monk,windwalker,12,4,8
Ragobd,argent-dawn,384,monk,windwalker,12,4,8
Løkî,culte-de-la-rive-noire,384,monk,windwalker,12,4,8
Гарчи,azuregos,384,monk,windwalker,12,4,8
Fishweaver,ravencrest,384,monk,windwalker,12,4,8
Axan,drekthar,384,monk,windwalker,12,4,8
Showmeskillz,blackmoore,384,monk,windwalker,12,4,8
Hitmônchan,ravencrest,384,monk,windwalker,12,4,8
Fueradeserie,dun-modr,384,monk,windwalker,12,4,8
Дзинкс,howling-fjord,384,monk,windwalker,16,4,12
Bombanato,kazzak,384,monk,windwalker,17,4,13
Monkkr,argent-dawn,384,monk,windwalker,18,4,14
Softjab,twisting-nether,384,monk,windwalker,18,4,14
Aesthetìc,draenor,384,monk,windwalker,18,4,14
Dunkfjås,stormscale,384,monk,windwalker,18,4,14
Huion,die-aldor,383,monk,windwalker,6,4,2
Bbinzu,lothar,383,monk,windwalker,6,4,2
Erzull,doomhammer,383,monk,windwalker,11,4,7
Desertctype,burning-legion,367,monk,windwalker,11,4,7
Slight,ragnaros,352,monk,windwalker,10,4,6
Arkhaan,dun-modr,351,monk,windwalker,11,4,7
Youngmonk,tarren-mill,351,monk,windwalker,23,4,19
Benkkei,ysondre,336,monk,windwalker,15,4,11
Shamarinator,kazzak,330,monk,windwalker,15,5,10
Mutso,turalyon,328,monk,windwalker,21,7,14
Лайтсих,soulflayer,320,monk,windwalker,10,4,6
Choje,blackmoore,319,monk,windwalker,5,4,1
Alë,argent-dawn,319,monk,windwalker,8,4,4
Банхелоу,ashenvale,319,monk,windwalker,8,4,4
Velduin,dun-modr,288,monk,windwalker,6,3,3
Veline,dun-modr,288,monk,windwalker,6,3,3
Jâycrane,ravencrest,288,monk,windwalker,6,3,3
Merqurychi,ravencrest,288,monk,windwalker,6,3,3
Kärmma,sanguino,288,monk,windwalker,6,3,3
Suplift,magtheridon,288,monk,windwalker,6,3,3
Parkroy,ravencrest,288,monk,windwalker,6,3,3
Øutlawsnipxx,sanguino,288,monk,windwalker,6,3,3
Soraora,twisting-nether,288,monk,windwalker,6,3,3
Vayyn,kazzak,288,monk,windwalker,6,3,3
Rogeri,kazzak,288,monk,windwalker,6,3,3
Monkelibonk,ravencrest,288,monk,windwalker,6,3,3
Kungf,twisting-nether,288,monk,windwalker,6,3,3
Zelraqt,burning-steppes,288,monk,windwalker,6,3,3
Chakkal,twisting-nether,288,monk,windwalker,6,3,3
Ratfacè,outland,288,monk,windwalker,6,3,3
Exòar,ravencrest,288,monk,windwalker,6,3,3
Tshajek,hyjal,288,monk,windwalker,6,3,3
Scrv,blackhand,288,monk,windwalker,6,3,3
Cribling,stormscale,288,monk,windwalker,6,3,3
Tjmnk,ravencrest,288,monk,windwalker,6,3,3
Vøltha,dalaran,288,monk,windwalker,6,3,3
Twoßastard,kazzak,288,monk,windwalker,6,3,3
Adewelee,dalaran,288,monk,windwalker,6,3,3
Kirosan,ragnaros,288,monk,windwalker,6,3,3
Guybrúsh,twisting-nether,288,monk,windwalker,6,3,3
Koot,ragnaros,288,monk,windwalker,6,3,3
Grippen,ragnaros,288,monk,windwalker,6,3,3
Deadlytouch,pozzo-delleternità,288,monk,windwalker,6,3,3
Rickymonktwo,ragnaros,288,monk,windwalker,6,3,3
Woushou,outland,288,monk,windwalker,6,3,3
Marcjess,kazzak,288,monk,windwalker,6,3,3
Jakfuki,ragnaros,288,monk,windwalker,6,3,3
Testibuul,archimonde,288,monk,windwalker,6,3,3
Stonkss,ragnaros,288,monk,windwalker,6,3,3
Бреэйн,howling-fjord,288,monk,windwalker,6,3,3
Rpzlefisc,archimonde,288,monk,windwalker,6,3,3
Старательный,howling-fjord,288,monk,windwalker,6,3,3
Xpobak,ravencrest,288,monk,windwalker,6,3,3
Vultzm,draenor,288,monk,windwalker,6,3,3
Десмаут,blackscar,288,monk,windwalker,6,3,3
Sensei,rajaxx,288,monk,windwalker,6,3,3
Пингкин,deathweaver,288,monk,windwalker,6,3,3
Рендикаое,soulflayer,288,monk,windwalker,6,3,3
Dabaws,draenor,288,monk,windwalker,6,3,3
Realfighter,arathor,288,monk,windwalker,6,3,3
Патаомальчик,blackscar,288,monk,windwalker,6,3,3
Sharofi,ravencrest,288,monk,windwalker,6,3,3
Droozy,silvermoon,288,monk,windwalker,6,3,3
Zéná,gilneas,288,monk,windwalker,6,3,3
Gangzone,eredar,288,monk,windwalker,6,3,3
Halümeth,ysondre,288,monk,windwalker,6,3,3
Aaronm,tarren-mill,288,monk,windwalker,6,3,3
Zìnko,eredar,288,monk,windwalker,6,3,3
Møngøwéávé,argent-dawn,288,monk,windwalker,6,3,3
Mushush,draenor,288,monk,windwalker,6,3,3
Heavensåway,ysondre,288,monk,windwalker,6,3,3
Fìstmedaddy,tarren-mill,288,monk,windwalker,6,3,3
Heijus,tarren-mill,288,monk,windwalker,6,3,3
Jalari,turalyon,288,monk,windwalker,6,3,3
Лавтян,gordunni,288,monk,windwalker,6,3,3
Nüffelbüffel,blackrock,288,monk,windwalker,6,3,3
Pandathiss,argent-dawn,288,monk,windwalker,6,3,3
Ctrlqx,garona,288,monk,windwalker,6,3,3
Zunixxww,terrordar,288,monk,windwalker,6,3,3
Nibbly,argent-dawn,288,monk,windwalker,6,3,3
Ariesani,blackmoore,288,monk,windwalker,6,3,3
Шаоснов,eversong,288,monk,windwalker,6,3,3
Patîence,silvermoon,288,monk,windwalker,6,3,3
Balkanbeastt,draenor,288,monk,windwalker,10,4,6
Hellanmonk,stormscale,288,monk,windwalker,8,3,5
Chówmin,silvermoon,288,monk,windwalker,11,4,7
Bambøuéqtz,khaz-modan,288,monk,windwalker,9,3,6
Koreanswap,nordrassil,288,monk,windwalker,9,3,6
Xingji,antonidas,288,monk,windwalker,12,3,9
Rag,burning-legion,288,monk,windwalker,12,3,9
Cøbrakaï,archimonde,288,monk,windwalker,12,3,9
Adis,nerathor,288,monk,windwalker,12,3,9
Roxmonk,ravencrest,288,monk,windwalker,12,3,9
Venac,burning-legion,288,monk,windwalker,12,3,9
Yvètte,ravencrest,288,monk,windwalker,12,3,9
Shandarr,twisting-nether,288,monk,windwalker,12,3,9
Xiæo,moonglade,288,monk,windwalker,12,3,9
Nerrwhind,sylvanas,288,monk,windwalker,12,3,9
Yunxi,stormreaver,288,monk,windwalker,12,3,9
Spoiry,tarren-mill,288,monk,windwalker,12,3,9
Orenjis,kazzak,288,monk,windwalker,12,3,9
Kukulelee,ragnaros,288,monk,windwalker,12,3,9
Barylen,outland,288,monk,windwalker,12,3,9
Geliôs,kazzak,288,monk,windwalker,12,3,9
Mönchfatih,blackhand,288,monk,windwalker,12,3,9
Clamps,darkspear,288,monk,windwalker,12,3,9
Sustanoon,draenor,288,monk,windwalker,12,3,9
Ikasama,culte-de-la-rive-noire,288,monk,windwalker,12,3,9
Jihaaz,nemesis,288,monk,windwalker,13,3,10
Amatara,blackrock,288,monk,windwalker,18,3,15
Monkwins,turalyon,287,monk,windwalker,6,3,3
Ceeyu,antonidas,287,monk,windwalker,6,3,3
Baazoka,blackmoore,287,monk,windwalker,6,3,3
Syaóran,exodar,286,monk,windwalker,12,3,9
Соловьюх,gordunni,286,monk,windwalker,12,3,9
Madagazsgar,kazzak,256,monk,windwalker,10,3,7
Ходячиймонк,gordunni,256,monk,windwalker,10,3,7
Landiiguru,ragnaros,256,monk,windwalker,10,3,7
Пкмлкм,gordunni,255,monk,windwalker,11,3,8
Dolkenm,tarren-mill,240,monk,windwalker,9,4,5
Zerno,archimonde,239,monk,windwalker,5,3,2
Fancyfists,ravencrest,239,monk,windwalker,5,3,2
Foxroll,kazzak,239,monk,windwalker,5,3,2
Tbagman,argent-dawn,234,monk,windwalker,9,4,5
Andrah,blackmoore,234,monk,windwalker,14,4,10
Ayanaami,pozzo-delleternità,224,monk,windwalker,16,3,13
Idointcare,ravencrest,192,monk,windwalker,4,3,1
Bignessb,draenor,192,monk,windwalker,4,3,1
Wickly,stormscale,192,monk,windwalker,10,4,6
Фистингкоуч,gordunni,192,monk,windwalker,9,3,6
Kano,burning-legion,192,monk,windwalker,9,3,6
Khirazim,ysondre,192,monk,windwalker,6,2,4
Akazuki,frostwolf,192,monk,windwalker,6,2,4
Nql,kazzak,192,monk,windwalker,6,2,4
Bamboosnack,kazzak,192,monk,windwalker,6,2,4
Bensil,ravencrest,192,monk,windwalker,6,2,4
Icaena,ravencrest,192,monk,windwalker,6,2,4
Jintae,deathwing,192,monk,windwalker,6,2,4
Paykø,antonidas,192,monk,windwalker,6,2,4
Brewroll,ravencrest,192,monk,windwalker,6,2,4
Loriodas,tarren-mill,192,monk,windwalker,6,2,4
Ранки,lich-king,192,monk,windwalker,6,2,4
Fulddask,ravencrest,192,monk,windwalker,6,2,4
Deathpùlse,ravencrest,192,monk,windwalker,6,2,4
Minfilla,argent-dawn,192,monk,windwalker,6,2,4
Montybrew,tarren-mill,192,monk,windwalker,6,2,4
Entropî,tarren-mill,192,monk,windwalker,6,2,4
ßájkà,ravencrest,192,monk,windwalker,6,2,4
Mtmonk,tarren-mill,192,monk,windwalker,6,2,4
Panicfist,stormscale,192,monk,windwalker,6,2,4
Lxq,blackhand,192,monk,windwalker,6,2,4
Laxnacke,the-maelstrom,192,monk,windwalker,6,2,4
Lildaddymonk,ravencrest,192,monk,windwalker,6,2,4
Jakamstar,ravencrest,192,monk,windwalker,6,2,4
Jackonk,eredar,192,monk,windwalker,6,2,4
Îreful,tarren-mill,192,monk,windwalker,6,2,4
Mezeko,stormscale,192,monk,windwalker,6,2,4
Грагдораш,soulflayer,192,monk,windwalker,6,2,4
Mychigun,ravencrest,192,monk,windwalker,6,2,4
Bensó,stormscale,192,monk,windwalker,6,2,4
Lollonko,kazzak,192,monk,windwalker,6,2,4
Мификкласс,deathguard,192,monk,windwalker,6,2,4
Дедизшишки,soulflayer,192,monk,windwalker,6,2,4
Påiñ,silvermoon,192,monk,windwalker,6,2,4
Musclorww,ysondre,192,monk,windwalker,6,2,4
Амекиса,deathguard,192,monk,windwalker,6,2,4
Nebelpanda,ravencrest,192,monk,windwalker,6,2,4
Akkadianx,ravencrest,192,monk,windwalker,6,2,4
Jojitsu,ravencrest,192,monk,windwalker,6,2,4
Cobox,die-arguswacht,192,monk,windwalker,6,2,4
Walterwayne,blackrock,192,monk,windwalker,6,2,4
Bludclart,outland,192,monk,windwalker,6,2,4
Manniche,kazzak,192,monk,windwalker,6,2,4
Gabbah,blackrock,192,monk,windwalker,6,2,4
Бладби,howling-fjord,192,monk,windwalker,6,2,4
Майамибитч,howling-fjord,192,monk,windwalker,6,2,4
Слабодян,gordunni,192,monk,windwalker,6,2,4
Канибальный,gordunni,192,monk,windwalker,6,2,4
Savecdfornxt,blackmoore,192,monk,windwalker,6,2,4
Yaevinn,burning-legion,192,monk,windwalker,6,2,4
Panzerfall,hyjal,192,monk,windwalker,6,2,4
Halat,kazzak,192,monk,windwalker,6,2,4
Пинкомтебя,gordunni,192,monk,windwalker,6,2,4
Псилоцибин,gordunni,192,monk,windwalker,6,2,4
Sqedi,draenor,192,monk,windwalker,6,2,4
Пекник,gordunni,192,monk,windwalker,6,2,4
Brùcelee,blackmoore,192,monk,windwalker,6,2,4
Priosia,ragnaros,192,monk,windwalker,6,2,4
Zýru,ragnaros,192,monk,windwalker,6,2,4
Nehjo,blackrock,192,monk,windwalker,6,2,4
Føxy,sunstrider,192,monk,windwalker,6,2,4
Charlês,outland,192,monk,windwalker,6,2,4
Wahrye,hyjal,192,monk,windwalker,6,2,4
Kazemja,ragnaros,192,monk,windwalker,6,2,4
Eynodiggity,blackmoore,192,monk,windwalker,6,2,4
Freebîrd,shattered-hand,192,monk,windwalker,6,2,4
Асцент,blackscar,192,monk,windwalker,6,2,4
Bloodychi,ravencrest,192,monk,windwalker,6,2,4
Baoton,blackmoore,192,monk,windwalker,6,2,4
Popurita,sanguino,192,monk,windwalker,6,2,4
Chaosmonk,zuljin,192,monk,windwalker,6,2,4
Fístfillet,twisting-nether,192,monk,windwalker,6,2,4
Monkdönk,draenor,192,monk,windwalker,6,2,4
Apöllo,ragnaros,192,monk,windwalker,6,2,4
Shadopam,zuljin,192,monk,windwalker,6,2,4
Subsul,sylvanas,192,monk,windwalker,6,2,4
Frajer,auchindoun,192,monk,windwalker,6,2,4
Pathik,onyxia,192,monk,windwalker,6,2,4
Youruba,dun-modr,192,monk,windwalker,6,2,4
Twinfists,blackmoore,192,monk,windwalker,6,2,4
Madinsane,thrall,192,monk,windwalker,6,2,4
Niborc,doomhammer,192,monk,windwalker,6,2,4
Monktadito,sanguino,192,monk,windwalker,6,2,4
Stillflow,draenor,192,monk,windwalker,6,2,4
Bobthewild,draenor,192,monk,windwalker,6,2,4
Gwaundes,outland,192,monk,windwalker,6,2,4
Codimonk,elune,192,monk,windwalker,6,2,4
Zynex,twisting-nether,192,monk,windwalker,6,2,4
Deniise,kult-der-verdammten,192,monk,windwalker,6,2,4
Stenhård,azjolnerub,192,monk,windwalker,6,2,4
Friidam,lightbringer,192,monk,windwalker,6,2,4
Wteg,emerald-dream,192,monk,windwalker,6,2,4
Kràk,sargeras,192,monk,windwalker,6,2,4
Shïma,sargeras,192,monk,windwalker,6,2,4
Noctaeth,destromath,192,monk,windwalker,6,2,4
Dodoglad,hyjal,192,monk,windwalker,6,2,4
Píkachuu,ragnaros,192,monk,windwalker,9,2,7
Mysticpaws,kazzak,192,monk,windwalker,16,3,13
Rhatid,twisting-nether,192,monk,windwalker,12,2,10
Lilotus,ragnaros,192,monk,windwalker,12,2,10
Jolsey,sunstrider,192,monk,windwalker,12,2,10
Rolegsweep,arathor,192,monk,windwalker,12,2,10
Tongat,ravencrest,192,monk,windwalker,12,2,10
Schneewase,blackrock,192,monk,windwalker,12,2,10
Ronkingkong,ravencrest,192,monk,windwalker,12,2,10
Pawpipe,ravencrest,192,monk,windwalker,12,2,10
Гнидожор,booty-bay,192,monk,windwalker,12,2,10
Shaow,hyjal,192,monk,windwalker,12,2,10
Bo,malorne,192,monk,windwalker,17,2,15
Mashalar,ravencrest,191,monk,windwalker,6,2,4
Yianjih,blackmoore,191,monk,windwalker,6,2,4
Brêwjob,archimonde,180,monk,windwalker,14,6,8
Bruhgdar,silvermoon,175,monk,windwalker,11,2,9
Bambucz,burning-legion,160,monk,windwalker,10,2,8
Монкпех,gordunni,159,monk,windwalker,5,2,3
Nefy,antonidas,159,monk,windwalker,5,2,3
Idkfa,sylvanas,159,monk,windwalker,11,2,9
Atrøciøus,ravencrest,138,monk,windwalker,7,3,4
Jweise,tarren-mill,138,monk,windwalker,7,3,4
Räpeltäjä,stormreaver,138,monk,windwalker,11,4,7
Leolani,blackmoore,128,monk,windwalker,10,2,8
Makïi,archimonde,127,monk,windwalker,8,2,6
Uftis,thrall,127,monk,windwalker,8,2,6
Varanthyra,argent-dawn,96,monk,windwalker,6,1,5
Lazyfellôw,drakthul,96,monk,windwalker,6,1,5
Dreamworkx,draenor,96,monk,windwalker,6,1,5
Kinføu,hyjal,96,monk,windwalker,6,1,5
Yuanshi,sporeggar,96,monk,windwalker,6,1,5
Lîlpumpx,outland,96,monk,windwalker,6,1,5
Nightninja,drakthul,96,monk,windwalker,6,1,5
Mìcrøb,blackmoore,96,monk,windwalker,6,1,5
Absølutvødka,outland,96,monk,windwalker,6,1,5
Smâsh,blackhand,96,monk,windwalker,6,1,5
Jakaron,kazzak,96,monk,windwalker,6,1,5
Lgndkw,kazzak,96,monk,windwalker,6,1,5
Jongoatjones,outland,96,monk,windwalker,6,1,5
Родиер,gordunni,96,monk,windwalker,6,1,5
Warkyra,sanguino,96,monk,windwalker,6,1,5
Sheikheric,draenor,96,monk,windwalker,6,1,5
Мяяумяу,gordunni,96,monk,windwalker,6,1,5
Frêakz,blackmoore,96,monk,windwalker,6,1,5
Kazéshini,doomhammer,96,monk,windwalker,6,1,5
Butrinto,hellfire,96,monk,windwalker,6,1,5
Dìó,tarren-mill,96,monk,windwalker,6,1,5
Entenburch,blackmoore,96,monk,windwalker,6,1,5
Móz,sylvanas,96,monk,windwalker,6,1,5
Schanabi,dun-morogh,96,monk,windwalker,6,1,5
Kaizenthor,runetotem,96,monk,windwalker,6,1,5
Sinzipin,turalyon,96,monk,windwalker,6,1,5
Fersokä,dun-modr,96,monk,windwalker,6,1,5
Umbrâsyl,ravencrest,96,monk,windwalker,6,1,5
Tooweezé,outland,96,monk,windwalker,6,1,5
Sendayam,blackhand,96,monk,windwalker,6,1,5
Zenzí,ravencrest,96,monk,windwalker,6,1,5
Cabbagés,outland,96,monk,windwalker,6,1,5
Синнэрли,soulflayer,96,monk,windwalker,6,1,5
Chucknørris,blackhand,96,monk,windwalker,6,1,5
Doneithné,stormscale,96,monk,windwalker,6,1,5
Drlightorc,tarren-mill,96,monk,windwalker,6,1,5
Мефодийкун,howling-fjord,96,monk,windwalker,6,1,5
Castrø,argent-dawn,96,monk,windwalker,6,1,5
Zugzuwg,ahnqiraj,96,monk,windwalker,6,1,5
Leonww,kazzak,96,monk,windwalker,6,1,5
Munkyjah,eredar,96,monk,windwalker,6,1,5
Мэдсол,soulflayer,96,monk,windwalker,6,1,5
Kickboxer,burning-legion,96,monk,windwalker,6,1,5
Febris,silvermoon,96,monk,windwalker,6,1,5
Тиронфлакс,soulflayer,96,monk,windwalker,6,1,5
Radashin,burning-legion,96,monk,windwalker,6,1,5
Dudulinda,silvermoon,96,monk,windwalker,6,1,5
Fistyouslow,kazzak,96,monk,windwalker,6,1,5
Harislkwamk,aegwynn,96,monk,windwalker,6,1,5
Konnîchîwa,kazzak,96,monk,windwalker,6,1,5
Gøsù,antonidas,96,monk,windwalker,6,1,5
Ônlýféédx,burning-blade,96,monk,windwalker,6,1,5
Cumspiller,ravencrest,96,monk,windwalker,6,1,5
Monkenya,kazzak,96,monk,windwalker,6,1,5
Mjaweaver,stormscale,96,monk,windwalker,6,1,5
Dark,argent-dawn,96,monk,windwalker,6,1,5
Mikoyoo,marécage-de-zangar,96,monk,windwalker,6,1,5
Shreedmonk,blackmoore,96,monk,windwalker,6,1,5
Gilario,silvermoon,96,monk,windwalker,6,1,5
Popen,chamber-of-aspects,96,monk,windwalker,6,1,5
Faulpelz,onyxia,96,monk,windwalker,6,1,5
Chucknøørys,archimonde,96,monk,windwalker,6,1,5
Chimail,blackrock,96,monk,windwalker,6,1,5
Nsq,ravencrest,96,monk,windwalker,6,1,5
Greytalla,silvermoon,96,monk,windwalker,6,1,5
Бумчака,blackscar,96,monk,windwalker,6,1,5
Musaya,chamber-of-aspects,96,monk,windwalker,6,1,5
Sînge,archimonde,96,monk,windwalker,6,1,5
Elerith,grim-batol,96,monk,windwalker,6,1,5
Bâsarä,archimonde,96,monk,windwalker,6,1,5
Masbrew,ravencrest,96,monk,windwalker,6,1,5
Olympeá,silvermoon,96,monk,windwalker,6,1,5
Dadeldo,blackrock,96,monk,windwalker,12,1,11
Mindfreaks,stormscale,96,monk,windwalker,12,1,11
Monkacphp,drakthul,96,monk,windwalker,12,1,11
Tmhamm,ravencrest,96,monk,windwalker,12,1,11
Araey,argent-dawn,89,monk,windwalker,9,3,6
Aennie,zuljin,84,monk,windwalker,13,4,9
Unotm,kazzak,79,monk,windwalker,5,1,4
Xtcc,kazzak,79,monk,windwalker,5,1,4
Tenzen,dun-modr,79,monk,windwalker,11,1,10
Skailzkrtwo,hyjal,48,monk,windwalker,3,1,2
Xámell,ravencrest,48,monk,windwalker,3,1,2
Cazgur,twisting-nether,42,monk,windwalker,11,3,8
Monkinko,tarren-mill,42,monk,windwalker,10,2,8
Pjetro,draenor,31,monk,windwalker,2,1,1
Gallinaso,dun-modr,16,monk,windwalker,1,1,0
Zaxxz,bladefist,15,monk,windwalker,1,1,0
Wiriday,draenor,2204,paladin,holy,672,345,327
Pointguard,blackrock,2180,paladin,holy,84,48,36
Åbx,argent-dawn,2147,paladin,holy,131,66,65
Ránchìek,ravencrest,2124,paladin,holy,102,51,51
Crewxdlolz,frostmane,2123,paladin,holy,211,118,93
Jìmjim,ysondre,2122,paladin,holy,251,131,120
Likkik,ravencrest,2121,paladin,holy,86,42,44
Royki,the-maelstrom,2111,paladin,holy,70,38,32
Odrareg,kazzak,2105,paladin,holy,502,251,251
Алексендлер,howling-fjord,2082,paladin,holy,362,198,164
Vaîjin,aegwynn,2042,paladin,holy,487,255,232
Ranchiek,ravencrest,2019,paladin,holy,60,31,29
Bighugg,draenor,2007,paladin,holy,114,64,50
Lickssi,outland,2001,paladin,holy,94,56,38
Galaxys,blackhand,1990,paladin,holy,205,107,98
Pêacerainer,stormscale,1989,paladin,holy,357,171,186
Pátish,terenas,1978,paladin,holy,97,45,52
Eldorín,blackmoore,1978,paladin,holy,94,41,53
Strûgglebûs,outland,1968,paladin,holy,95,53,42
Nstea,zuljin,1968,paladin,holy,72,37,35
Gloonî,blackmoore,1964,paladin,holy,77,37,40
Goyimslayer,ravencrest,1960,paladin,holy,300,153,147
Trusttp,ravencrest,1951,paladin,holy,100,59,41
Wontbubblejk,tarren-mill,1944,paladin,holy,84,38,46
Nemebotddos,dun-modr,1940,paladin,holy,101,51,50
Wokyo,tarren-mill,1934,paladin,holy,321,184,137
Seabrook,stormscale,1933,paladin,holy,129,59,70
Zabrok,outland,1928,paladin,holy,100,56,44
Reckx,argent-dawn,1927,paladin,holy,113,50,63
Wheelybin,argent-dawn,1924,paladin,holy,105,46,59
Nemesisbot,dun-modr,1923,paladin,holy,120,66,54
Insanez,stormscale,1919,paladin,holy,98,49,49
Richiks,outland,1916,paladin,holy,96,50,46
Asfhjagwa,stormscale,1907,paladin,holy,59,35,24
Áftershøck,ravencrest,1898,paladin,holy,102,51,51
Peacerainer,stormscale,1890,paladin,holy,138,63,75
Dbblou,draenor,1879,paladin,holy,90,44,46
Aww,anachronos,1869,paladin,holy,180,91,89
Rickstone,kazzak,1866,paladin,holy,72,35,37
Goodpeace,kazzak,1865,paladin,holy,103,49,54
Strugglebusx,outland,1860,paladin,holy,68,36,32
Макстипчик,howling-fjord,1859,paladin,holy,81,40,41
Tipmax,ravencrest,1856,paladin,holy,61,37,24
Dyslexineef,defias-brotherhood,1856,paladin,holy,106,53,53
Jeø,stormscale,1854,paladin,holy,60,30,30
Niwariel,silvermoon,1852,paladin,holy,60,37,23
Типмакс,howling-fjord,1851,paladin,holy,42,25,17
Fáshiön,ravencrest,1849,paladin,holy,78,32,46
Dompèrignon,stormscale,1845,paladin,holy,42,22,20
Hetsuki,tarren-mill,1843,paladin,holy,60,27,33
Wernøw,archimonde,1842,paladin,holy,51,28,23
Shufflenjoyr,argent-dawn,1837,paladin,holy,131,67,64
Pigpiss,ravencrest,1835,paladin,holy,88,41,47
Рустиктоп,gordunni,1830,paladin,holy,72,34,38
Chopdawop,blackmoore,1830,paladin,holy,62,25,37
Ajani,la-croisade-écarlate,1828,paladin,holy,60,27,33
Fashiôn,sylvanas,1823,paladin,holy,63,27,36
Andûrîl,tarren-mill,1819,paladin,holy,197,106,91
Majör,ysondre,1819,paladin,holy,114,58,56
Kianpal,silvermoon,1818,paladin,holy,158,89,69
Neverlostx,ravencrest,1816,paladin,holy,48,31,17
Popecrusade,archimonde,1813,paladin,holy,107,66,41
Callístó,amanthul,1811,paladin,holy,408,209,199
Isøri,antonidas,1807,paladin,holy,168,92,76
Insonia,frostwolf,1804,paladin,holy,177,101,76
Powertilt,ravencrest,1801,paladin,holy,207,98,109
Narkal,archimonde,1800,paladin,holy,135,74,61
Wøllymølly,draenor,1799,paladin,holy,102,53,49
Гола,gordunni,1791,paladin,holy,121,57,64
Welivewewin,defias-brotherhood,1789,paladin,holy,316,161,155
Holysac,kazzak,1783,paladin,holy,54,28,26
Danipaladin,tarren-mill,1776,paladin,holy,100,57,43
Holysacx,aegwynn,1772,paladin,holy,84,48,36
Máttés,antonidas,1770,paladin,holy,83,36,47
Lexó,ravencrest,1768,paladin,holy,66,30,36
Arysur,defias-brotherhood,1767,paladin,holy,590,300,290
Tyrsa,defias-brotherhood,1767,paladin,holy,71,31,40
Heilbuch,durotan,1765,paladin,holy,272,147,125
Verlinya,archimonde,1765,paladin,holy,54,29,25
Holylightxz,runetotem,1765,paladin,holy,93,46,47
Shamoo,archimonde,1763,paladin,holy,48,28,20
Valia,argent-dawn,1761,paladin,holy,105,57,48
Лайхтни,gordunni,1761,paladin,holy,70,36,34
Lrnz,tarren-mill,1761,paladin,holy,108,48,60
Everflame,blackmoore,1758,paladin,holy,102,60,42
Whothisguy,ravencrest,1757,paladin,holy,72,35,37
Måvé,tarren-mill,1754,paladin,holy,163,90,73
Optîmuslîme,veklor,1748,paladin,holy,71,39,32
Rettyfield,blackrock,1744,paladin,holy,42,23,19
Tibelious,ravencrest,1737,paladin,holy,352,174,178
Svyata,twisting-nether,1737,paladin,holy,174,82,92
Jüther,pozzo-delleternità,1736,paladin,holy,35,19,16
Небулариум,howling-fjord,1735,paladin,holy,83,35,48
Phalphlingo,stormscale,1734,paladin,holy,132,60,72
Флэшкапро,soulflayer,1731,paladin,holy,322,171,151
Swâpxy,proudmoore,1728,paladin,holy,72,46,26
Kyoma,burning-legion,1723,paladin,holy,203,90,113
Dàrckness,ravencrest,1722,paladin,holy,479,254,225
Diffay,tarren-mill,1721,paladin,holy,84,45,39
Tyralia,archimonde,1720,paladin,holy,100,61,39
Флэшкапро,blackscar,1719,paladin,holy,58,31,27
Plaeschrmaex,aegwynn,1718,paladin,holy,72,31,41
Derpe,hellscream,1717,paladin,holy,36,21,15
Dewastor,veklor,1715,paladin,holy,64,37,27
Хегия,gordunni,1713,paladin,holy,168,92,76
Kwinn,aggra-português,1713,paladin,holy,36,18,18
Hearten,outland,1712,paladin,holy,28,19,9
Voklane,tarren-mill,1712,paladin,holy,68,34,34
Monkeyclass,blackmoore,1709,paladin,holy,60,30,30
Акунделар,gordunni,1706,paladin,holy,125,63,62
Аришалисичка,blackscar,1704,paladin,holy,82,41,41
Beefcrusher,outland,1704,paladin,holy,42,18,24
Мускатер,gordunni,1702,paladin,holy,124,62,62
Djspresty,ravencrest,1700,paladin,holy,70,40,30
Rezvaya,tarren-mill,1700,paladin,holy,54,22,32
Thaderyl,auchindoun,1699,paladin,holy,308,154,154
Tibælius,ravencrest,1699,paladin,holy,149,74,75
Jerryhârvey,kazzak,1695,paladin,holy,36,18,18
Гигашмяк,howling-fjord,1694,paladin,holy,304,155,149
Vindîcator,defias-brotherhood,1694,paladin,holy,227,107,120
Padisonmeth,blackmoore,1694,paladin,holy,53,19,34
Фьюжндрайв,gordunni,1693,paladin,holy,36,18,18
Chowo,argent-dawn,1693,paladin,holy,113,54,59
Holysac,aegwynn,1692,paladin,holy,72,39,33
Faíren,mugthol,1692,paladin,holy,96,51,45
Gexx,draenor,1692,paladin,holy,119,57,62
Runtheshôw,tarren-mill,1692,paladin,holy,249,116,133
Pignonn,dalaran,1689,paladin,holy,309,154,155
Lofé,drakthul,1688,paladin,holy,98,48,50
Jûliâ,archimonde,1686,paladin,holy,112,57,55
Moeixu,kazzak,1686,paladin,holy,99,41,58
Rejst,drakthul,1686,paladin,holy,71,29,42
Babyboink,kazzak,1685,paladin,holy,65,27,38
Haylø,archimonde,1684,paladin,holy,75,35,40
Skånérost,twisting-nether,1683,paladin,holy,42,25,17
Palagød,blackmoore,1683,paladin,holy,43,23,20
Flouzz,blackmoore,1682,paladin,holy,126,57,69
Drohim,aegwynn,1680,paladin,holy,58,28,30
Lycerax,antonidas,1677,paladin,holy,42,24,18
Thaderÿl,auchindoun,1676,paladin,holy,185,95,90
Necrocursed,blackrock,1676,paladin,holy,48,23,25
Powarpufgirl,blackrock,1668,paladin,holy,65,34,31
Yimnotprot,ravencrest,1668,paladin,holy,72,29,43
Mðnsterz,archimonde,1666,paladin,holy,126,62,64
Holylightxz,archimonde,1666,paladin,holy,48,23,25
Лайтпалочка,soulflayer,1663,paladin,holy,370,185,185
Бирко,blackscar,1661,paladin,holy,99,51,48
Дарксайгн,gordunni,1659,paladin,holy,72,28,44
Мылонеуроних,deathguard,1655,paladin,holy,95,47,48
Lexolex,ravencrest,1655,paladin,holy,42,19,23
Fjorhvor,draenor,1647,paladin,holy,819,422,397
Lopme,ravencrest,1646,paladin,holy,30,18,12
Stidi,frostmane,1646,paladin,holy,202,102,100
Kreutzfeld,argent-dawn,1645,paladin,holy,36,18,18
Kakii,gorgonnash,1645,paladin,holy,59,24,35
Sheroo,rexxar,1642,paladin,holy,36,20,16
Myssa,uldum,1642,paladin,holy,78,42,36
Spinne,tarren-mill,1642,paladin,holy,142,71,71
Alphaøne,stormscale,1642,paladin,holy,42,20,22
Minalinsky,colinas-pardas,1641,paladin,holy,165,94,71
Bécasszelium,varimathras,1640,paladin,holy,352,186,166
Nezâ,blackhand,1640,paladin,holy,82,39,43
Profundus,zuluhed,1640,paladin,holy,102,46,56
Jinyssa,silvermoon,1639,paladin,holy,53,32,21
Celébriel,twisting-nether,1638,paladin,holy,131,74,57
Crucifiction,balnazzar,1637,paladin,holy,78,38,40
Алукартик,deathguard,1631,paladin,holy,101,54,47
Stratarxis,kazzak,1631,paladin,holy,106,52,54
Святстраж,gordunni,1631,paladin,holy,50,23,27
Baazil,ragnaros,1631,paladin,holy,84,38,46
Shabbyy,bronzebeard,1630,paladin,holy,120,66,54
Insanevegan,ravencrest,1628,paladin,holy,66,33,33
Marcope,kazzak,1628,paladin,holy,36,17,19
Umirinbruv,zenedar,1628,paladin,holy,86,37,49
Skailzpal,hyjal,1627,paladin,holy,376,205,171
Smightypal,silvermoon,1626,paladin,holy,147,75,72
Jeromesavile,tarren-mill,1625,paladin,holy,143,68,75
Banglakesh,draenor,1624,paladin,holy,36,20,16
Döug,archimonde,1622,paladin,holy,84,46,38
Jambbo,twisting-nether,1622,paladin,holy,148,81,67
Hardagain,doomhammer,1620,paladin,holy,48,31,17
Chosenlight,darkspear,1620,paladin,holy,316,153,163
Витёнокь,howling-fjord,1619,paladin,holy,259,146,113
Emloses,outland,1618,paladin,holy,378,192,186
Nano,veknilash,1617,paladin,holy,189,98,91
Yzzy,ravencrest,1617,paladin,holy,293,146,147
Athenewins,tarren-mill,1616,paladin,holy,400,210,190
Crankaess,tarren-mill,1616,paladin,holy,73,37,36
Misarosh,drakthul,1616,paladin,holy,60,28,32
Papasito,tarren-mill,1616,paladin,holy,48,17,31
Рэймондх,gordunni,1613,paladin,holy,84,41,43
Percocetx,tarren-mill,1613,paladin,holy,54,24,30
Øøbîatch,archimonde,1612,paladin,holy,84,44,40
Dömötörp,ragnaros,1612,paladin,holy,225,114,111
Astollfo,hyjal,1610,paladin,holy,54,33,21
Jeyyl,aegwynn,1610,paladin,holy,39,21,18
Rekieuna,archimonde,1610,paladin,holy,943,469,474
Astarox,kazzak,1610,paladin,holy,283,133,150
ßestsacjk,kazzak,1610,paladin,holy,54,22,32
Zondãn,blackrock,1608,paladin,holy,101,54,47
Edelarøs,ysondre,1608,paladin,holy,219,104,115
Holeck,aegwynn,1608,paladin,holy,78,31,47
Ironmikë,outland,1607,paladin,holy,60,38,22
Kaputs,twisting-nether,1606,paladin,holy,31,18,13
Klappzi,outland,1606,paladin,holy,41,20,21
Skyf,outland,1606,paladin,holy,299,141,158
Дэнриэль,howling-fjord,1606,paladin,holy,54,25,29
Vxqt,blackrock,1605,paladin,holy,65,30,35
Expander,draenor,1605,paladin,holy,48,20,28
Buntqt,kazzak,1604,paladin,holy,116,61,55
Джонниджага,blackscar,1604,paladin,holy,58,28,30
Spèédyßoi,eldrethalas,1603,paladin,holy,60,34,26
Kfcmanager,archimonde,1603,paladin,holy,60,30,30
Zendæ,archimonde,1602,paladin,holy,45,25,20
Lovemomx,argent-dawn,1602,paladin,holy,52,26,26
Braînbug,blackmoore,1602,paladin,holy,36,18,18
Stepsislana,tarren-mill,1601,paladin,holy,30,17,13
Xelqt,draenor,1601,paladin,holy,134,67,67
Emlight,kazzak,1600,paladin,holy,95,49,46
Judgejuryexe,kazzak,1600,paladin,holy,92,44,48
Xray,ahnqiraj,1597,paladin,holy,104,53,51
Bossedin,aszune,1593,paladin,holy,30,17,13
Thaliasword,sylvanas,1593,paladin,holy,72,34,38
Enemylosers,stormscale,1592,paladin,holy,234,127,107
Ðelusion,sanguino,1592,paladin,holy,70,33,37
Tuoppi,steamwheedle-cartel,1591,paladin,holy,138,71,67
Xaérulus,draenor,1590,paladin,holy,95,46,49
Аронасхе,blackscar,1589,paladin,holy,149,69,80
Askmy,stormscale,1588,paladin,holy,75,42,33
Soád,stormscale,1587,paladin,holy,42,19,23
Сэлфхил,gordunni,1587,paladin,holy,119,53,66
Delicztwo,der-rat-von-dalaran,1586,paladin,holy,54,28,26
Holychît,sanguino,1586,paladin,holy,117,54,63
Kristelle,argent-dawn,1584,paladin,holy,283,145,138
Hawki,blackmoore,1582,paladin,holy,67,40,27
Xenyaa,arygos,1581,paladin,holy,103,53,50
Fannypoo,sylvanas,1581,paladin,holy,251,122,129
Пчелодин,howling-fjord,1581,paladin,holy,36,17,19
Rookbeef,eredar,1580,paladin,holy,72,41,31
Babaluga,blackrock,1580,paladin,holy,30,17,13
Byoß,ravencrest,1580,paladin,holy,38,17,21
Blazerlolz,kazzak,1578,paladin,holy,107,56,51
Ddomi,dun-modr,1578,paladin,holy,54,24,30
Ринэи,howling-fjord,1577,paladin,holy,33,18,15
Holydeals,silvermoon,1577,paladin,holy,84,40,44
Bigdübel,blackhand,1577,paladin,holy,45,18,27
Потокденег,howling-fjord,1576,paladin,holy,409,201,208
Острит,gordunni,1575,paladin,holy,119,64,55
Waynex,twisting-nether,1574,paladin,holy,70,38,32
Deodas,kazzak,1574,paladin,holy,912,455,457
Foxywild,aszune,1574,paladin,holy,129,64,65
Pooncy,ragnaros,1574,paladin,holy,84,41,43
Faíren,blackrock,1572,paladin,holy,66,29,37
Sorfalik,silvermoon,1570,paladin,holy,75,43,32
Sorfalinka,silvermoon,1569,paladin,holy,69,42,27
Wíw,kazzak,1567,paladin,holy,184,90,94
Zaphiri,pozzo-delleternità,1567,paladin,holy,61,28,33
Defnotsikaan,blackhand,1565,paladin,holy,90,43,47
Ашкаил,fordragon,1565,paladin,holy,78,33,45
Ulumoo,tarren-mill,1564,paladin,holy,36,18,18
Gigaheals,ravencrest,1562,paladin,holy,60,39,21
Luxxorr,outland,1561,paladin,holy,106,62,44
Nîkå,ravencrest,1561,paladin,holy,109,62,47
Femaleelf,eredar,1561,paladin,holy,48,20,28
Dylodin,silvermoon,1560,paladin,holy,49,24,25
Cptlighter,draenor,1559,paladin,holy,53,19,34
Artherius,silvermoon,1558,paladin,holy,103,64,39
Voodyy,ravencrest,1557,paladin,holy,36,21,15
Pullheavy,silvermoon,1557,paladin,holy,346,176,170
Arenalena,sylvanas,1555,paladin,holy,217,111,106
Erao,the-maelstrom,1554,paladin,holy,48,24,24
Padrak,eredar,1554,paladin,holy,39,17,22
Aerwyna,draenor,1552,paladin,holy,40,26,14
Skurly,ragnaros,1551,paladin,holy,42,19,23
Факофф,gordunni,1549,paladin,holy,114,62,52
Obviously,echsenkessel,1549,paladin,holy,75,35,40
Pablok,minahonda,1548,paladin,holy,48,17,31
Mistsx,kazzak,1546,paladin,holy,60,27,33
Stinkepieet,blackmoore,1545,paladin,holy,269,139,130
Andronar,blackmoore,1545,paladin,holy,114,54,60
Nåmï,culte-de-la-rive-noire,1543,paladin,holy,72,41,31
Срувтапкизз,blackscar,1543,paladin,holy,89,32,57
Chryme,thrall,1541,paladin,holy,96,48,48
Зинарэмпейдж,gordunni,1539,paladin,holy,102,51,51
Тошанич,soulflayer,1539,paladin,holy,54,24,30
Ìschtarsdad,blackrock,1538,paladin,holy,228,112,116
Эсерпи,gordunni,1536,paladin,holy,485,249,236
Мифариан,blackscar,1536,paladin,holy,297,151,146
Nimeron,ravencrest,1536,paladin,holy,120,60,60
Neverbuble,archimonde,1536,paladin,holy,193,95,98
Юмэйнару,deepholm,1533,paladin,holy,72,37,35
Devinèqt,tarren-mill,1531,paladin,holy,133,73,60
Lóde,silvermoon,1530,paladin,holy,148,77,71
Døgstømper,outland,1529,paladin,holy,83,40,43
Jcbubs,xavius,1528,paladin,holy,234,114,120
Itsjulie,sylvanas,1528,paladin,holy,154,71,83
Леонящер,gordunni,1527,paladin,holy,323,177,146
Injection,khaz-modan,1527,paladin,holy,181,89,92
Irefutabila,stormscale,1527,paladin,holy,112,51,61
Brutalmate,burning-blade,1527,paladin,holy,141,63,78
Бадбх,howling-fjord,1527,paladin,holy,90,39,51
Eastranspal,ravencrest,1527,paladin,holy,93,36,57
Stepsisbro,twisting-nether,1526,paladin,holy,54,30,24
Солфф,gordunni,1526,paladin,holy,146,71,75
Böllerbarbie,silvermoon,1525,paladin,holy,94,56,38
Fløcki,blackhand,1525,paladin,holy,232,119,113
Marygueguete,archimonde,1525,paladin,holy,132,66,66
Ekzykes,ravencrest,1524,paladin,holy,97,48,49
Sweestance,minahonda,1523,paladin,holy,400,205,195
Easypala,blackrock,1521,paladin,holy,180,80,100
Sorfalix,silvermoon,1520,paladin,holy,66,31,35
Fúrion,burning-blade,1520,paladin,holy,60,26,34
Elsewhere,archimonde,1519,paladin,holy,119,54,65
Crystal,thrall,1517,paladin,holy,54,33,21
Скайлайтх,soulflayer,1515,paladin,holy,48,25,23
Cerinae,tarren-mill,1515,paladin,holy,168,87,81
Surian,kazzak,1514,paladin,holy,123,58,65
Cahirs,ravencrest,1514,paladin,holy,66,24,42
Sweetjane,deathwing,1513,paladin,holy,53,28,25
Gasilol,frostwolf,1512,paladin,holy,129,63,66
Nefarius,malganis,1512,paladin,holy,71,34,37
Wingcomandêr,aegwynn,1510,paladin,holy,60,27,33
Skinstructor,silvermoon,1509,paladin,holy,114,61,53
Sncx,ravencrest,1508,paladin,holy,95,48,47
Hairybabe,outland,1507,paladin,holy,102,58,44
Holycoomer,silvermoon,1507,paladin,holy,44,22,22
Эндемичный,soulflayer,1506,paladin,holy,90,50,40
Asenae,draenor,1504,paladin,holy,102,43,59
Fatmidget,kazzak,1503,paladin,holy,66,43,23
Spårvagn,draenor,1502,paladin,holy,84,41,43
Polixeni,draenor,1502,paladin,holy,54,16,38
Catpoopnacho,blackmoore,1500,paladin,holy,90,52,38
Pokébowl,outland,1500,paladin,holy,243,132,111
Dathróhán,silvermoon,1499,paladin,holy,451,227,224
Aese,dun-modr,1499,paladin,holy,102,51,51
Вивай,howling-fjord,1499,paladin,holy,47,21,26
Drident,die-nachtwache,1499,paladin,holy,54,24,30
Крусейдор,soulflayer,1498,paladin,holy,210,101,109
Knoxblue,tarren-mill,1497,paladin,holy,162,84,78
Sübôvîñ,ravencrest,1497,paladin,holy,135,69,66
Pamee,blackrock,1497,paladin,holy,42,20,22
Delmothounet,ysondre,1496,paladin,holy,46,28,18
Konane,drekthar,1495,paladin,holy,49,24,25
Sonil,les-sentinelles,1495,paladin,holy,108,51,57
Imapala,tarren-mill,1494,paladin,holy,42,23,19
Cozm,silvermoon,1494,paladin,holy,174,86,88
Curtfizzle,kazzak,1493,paladin,holy,155,74,81
Холлихэйт,howling-fjord,1492,paladin,holy,279,138,141
Búbblicioús,ravencrest,1491,paladin,holy,108,60,48
Drdeus,kazzak,1490,paladin,holy,201,100,101
Louiepal,outland,1489,paladin,holy,59,30,29
Vadomar,emerald-dream,1488,paladin,holy,136,67,69
Hirolde,zenedar,1487,paladin,holy,128,61,67
Shaevira,ravencrest,1487,paladin,holy,66,30,36
Pisr,draenor,1486,paladin,holy,90,37,53
Merkury,sanguino,1485,paladin,holy,36,19,17
Холиэвил,gordunni,1485,paladin,holy,96,50,46
Palasaadka,dun-modr,1484,paladin,holy,46,20,26
Всехилящий,gordunni,1482,paladin,holy,138,64,74
Divinetollen,ravencrest,1482,paladin,holy,80,35,45
Drzärc,sanguino,1481,paladin,holy,66,31,35
Aachenbrand,blackhand,1480,paladin,holy,221,105,116
Preyy,eredar,1479,paladin,holy,104,58,46
Снупарь,blackscar,1479,paladin,holy,198,100,98
Holydawnx,kazzak,1476,paladin,holy,151,78,73
Nemesi,archimonde,1476,paladin,holy,81,40,41
Ayuwings,ravencrest,1476,paladin,holy,48,22,26
Ауди,howling-fjord,1475,paladin,holy,66,24,42
Эллиарэй,gordunni,1474,paladin,holy,146,71,75
Кизарыч,galakrond,1474,paladin,holy,81,32,49
Дифицит,blackscar,1473,paladin,holy,171,94,77
Ирестли,azuregos,1473,paladin,holy,126,62,64
Screws,dun-modr,1473,paladin,holy,50,18,32
Alessaqas,ravencrest,1471,paladin,holy,107,52,55
Hýpærpøp,ravencrest,1471,paladin,holy,60,25,35
Penth,doomhammer,1471,paladin,holy,44,18,26
Анофарин,gordunni,1470,paladin,holy,90,53,37
Chocòbon,archimonde,1469,paladin,holy,218,117,101
Koksinatorx,stormscale,1469,paladin,holy,89,45,44
Alphä,auchindoun,1468,paladin,holy,36,19,17
Arlette,moonglade,1467,paladin,holy,112,58,54
Selphii,twisting-nether,1467,paladin,holy,46,23,23
Думгохан,howling-fjord,1467,paladin,holy,171,73,98
Wyllian,grim-batol,1466,paladin,holy,161,90,71
Sofishoida,blackmoore,1466,paladin,holy,120,66,54
Бэнкли,soulflayer,1466,paladin,holy,230,125,105
Séphiran,hyjal,1464,paladin,holy,65,35,30
Rinfal,kirin-tor,1464,paladin,holy,120,58,62
Iwillbeing,ragnaros,1464,paladin,holy,84,40,44
Hpal,aegwynn,1464,paladin,holy,135,62,73
Zerafic,sylvanas,1464,paladin,holy,110,41,69
Snigglz,blackhand,1463,paladin,holy,30,16,14
Hezerothys,draenor,1461,paladin,holy,170,89,81
Джонигодх,gordunni,1461,paladin,holy,66,26,40
Jajmentx,kazzak,1460,paladin,holy,93,48,45
Shaleq,cthun,1455,paladin,holy,53,26,27
Xsÿde,archimonde,1455,paladin,holy,160,72,88
Салфеточник,thermaplugg,1453,paladin,holy,124,59,65
Pb,twilights-hammer,1452,paladin,holy,32,22,10
Realpalla,ravenholdt,1452,paladin,holy,126,62,64
Archaegis,silvermoon,1452,paladin,holy,48,19,29
Pureballer,twisting-nether,1451,paladin,holy,41,21,20
Holydano,stormscale,1451,paladin,holy,53,27,26
Raeven,arygos,1451,paladin,holy,558,272,286
Judgealdo,sylvanas,1448,paladin,holy,74,44,30
Powerpufgirl,blackrock,1445,paladin,holy,88,41,47
Flâwless,tarren-mill,1445,paladin,holy,54,24,30
Jaesa,lordaeron,1445,paladin,holy,97,43,54
Curufin,grim-batol,1444,paladin,holy,205,108,97
Nudzolini,tarren-mill,1443,paladin,holy,55,36,19
Trez,blackmoore,1442,paladin,holy,31,18,13
Даниэль,howling-fjord,1442,paladin,holy,211,116,95
Ðenlox,destromath,1442,paladin,holy,157,81,76
Madlightsxd,dun-modr,1442,paladin,holy,60,25,35
Ðantey,blackmoore,1441,paladin,holy,43,24,19
Présidential,grim-batol,1441,paladin,holy,71,34,37
Aebî,dalaran,1440,paladin,holy,84,48,36
Herzel,argent-dawn,1440,paladin,holy,192,98,94
Коварное,borean-tundra,1440,paladin,holy,52,25,27
Pênnywisee,blackhand,1439,paladin,holy,53,28,25
Maitrelampe,argent-dawn,1439,paladin,holy,96,49,47
Móeixü,silvermoon,1438,paladin,holy,36,16,20
Уретроград,soulflayer,1436,paladin,holy,72,36,36
Lucá,silvermoon,1435,paladin,holy,59,31,28
Lastaid,azshara,1435,paladin,holy,313,157,156
Эвердрим,soulflayer,1435,paladin,holy,70,29,41
Этосальвабро,lich-king,1435,paladin,holy,98,38,60
Antragon,nathrezim,1434,paladin,holy,66,30,36
Ilj,archimonde,1433,paladin,holy,89,53,36
Cameron,taerar,1433,paladin,holy,36,17,19
Louiepalmoo,outland,1433,paladin,holy,52,23,29
Mercedes,arthas,1431,paladin,holy,82,43,39
Elvandara,blackmoore,1431,paladin,holy,149,68,81
Thoarin,blackmoore,1430,paladin,holy,75,36,39
Nusbie,argent-dawn,1430,paladin,holy,59,24,35
Drdax,wildhammer,1430,paladin,holy,66,25,41
Locofatguy,drakthul,1429,paladin,holy,184,89,95
Tiffanyqt,frostwolf,1428,paladin,holy,24,16,8
Toohotty,archimonde,1428,paladin,holy,53,22,31
Antivírus,eredar,1427,paladin,holy,60,37,23
Sacbøt,stormscale,1427,paladin,holy,259,132,127
Mefistôfeles,dun-modr,1427,paladin,holy,45,16,29
Beecq,tarren-mill,1426,paladin,holy,94,51,43
Goodbit,dentarg,1425,paladin,holy,98,58,40
Kwenu,tarren-mill,1425,paladin,holy,214,110,104
Волнысвета,howling-fjord,1424,paladin,holy,122,64,58
Superalt,archimonde,1423,paladin,holy,54,26,28
Taiso,alonsus,1422,paladin,holy,132,64,68
Talimañ,kazzak,1421,paladin,holy,90,51,39
Линвэль,gordunni,1421,paladin,holy,85,40,45
Norandel,turalyon,1421,paladin,holy,100,40,60
Брилз,soulflayer,1420,paladin,holy,202,100,102
Rullstolen,the-maelstrom,1418,paladin,holy,72,42,30
Aiyäna,argent-dawn,1418,paladin,holy,125,56,69
Freý,ravencrest,1418,paladin,holy,42,17,25
Cykond,eredar,1417,paladin,holy,34,24,10
Mamporro,dun-modr,1417,paladin,holy,54,28,26
Naylaeh,draenor,1417,paladin,holy,36,18,18
Erathoor,grim-batol,1417,paladin,holy,90,37,53
Phalex,outland,1416,paladin,holy,36,23,13
Глиндес,gordunni,1416,paladin,holy,186,88,98
Demytxx,silvermoon,1416,paladin,holy,49,18,31
Îiî,archimonde,1415,paladin,holy,54,27,27
Парквей,deathweaver,1415,paladin,holy,62,30,32
Cykadin,dun-modr,1415,paladin,holy,96,43,53
Bhlessings,ravencrest,1415,paladin,holy,92,36,56
Zilu,kazzak,1413,paladin,holy,47,24,23
Wepalapvpbop,ravencrest,1413,paladin,holy,30,15,15
Shivxpal,sanguino,1412,paladin,holy,77,45,32
Wellmet,stormreaver,1412,paladin,holy,48,25,23
Uzuriel,chogall,1412,paladin,holy,590,285,305
Juicycheeks,frostwolf,1411,paladin,holy,98,40,58
Coopz,defias-brotherhood,1409,paladin,holy,60,32,28
Åsaruki,emerald-dream,1409,paladin,holy,90,46,44
Wolfage,aegwynn,1409,paladin,holy,30,15,15
Эверейс,howling-fjord,1408,paladin,holy,59,29,30
Mchustler,outland,1408,paladin,holy,72,30,42
Rerollin,the-maelstrom,1407,paladin,holy,62,28,34
Gzerloth,ragnaros,1407,paladin,holy,36,15,21
Онлипалс,thermaplugg,1406,paladin,holy,33,18,15
Blessedpapi,draenor,1406,paladin,holy,72,32,40
Ванябублгам,soulflayer,1405,paladin,holy,74,35,39
Thiccmixy,stormscale,1405,paladin,holy,41,16,25
Diamir,rajaxx,1404,paladin,holy,75,55,20
Dlfî,hyjal,1404,paladin,holy,114,64,50
Shívah,auchindoun,1404,paladin,holy,78,29,49
Lightbrîng,hyjal,1403,paladin,holy,71,38,33
Омнилайт,soulflayer,1402,paladin,holy,61,25,36
Liendry,antonidas,1401,paladin,holy,132,61,71
Honeygodx,antonidas,1399,paladin,holy,57,31,26
Scholzpala,twisting-nether,1398,paladin,holy,72,42,30
Твойвайб,gordunni,1398,paladin,holy,74,36,38
Nerdpallyx,tarren-mill,1398,paladin,holy,157,75,82
Aíe,draenor,1397,paladin,holy,157,79,78
Deathsfate,defias-brotherhood,1397,paladin,holy,39,18,21
Eky,stormreaver,1397,paladin,holy,54,16,38
Emilíá,kazzak,1395,paladin,holy,36,21,15
Arand,blackrock,1395,paladin,holy,163,93,70
Gimch,magtheridon,1395,paladin,holy,72,40,32
Fourshaw,ravencrest,1395,paladin,holy,216,109,107
Solazola,blackmoore,1395,paladin,holy,36,17,19
Alithanari,twisting-nether,1394,paladin,holy,89,47,42
Holyini,twisting-nether,1394,paladin,holy,270,142,128
Zycqo,silvermoon,1394,paladin,holy,203,100,103
Delilahftw,burning-legion,1394,paladin,holy,44,18,26
Eline,zenedar,1393,paladin,holy,90,42,48
Pegason,twisting-nether,1391,paladin,holy,89,52,37
Maxôr,norgannon,1391,paladin,holy,142,77,65
Thaifo,silvermoon,1391,paladin,holy,39,21,18
Сашафистинг,gordunni,1390,paladin,holy,339,170,169
Palablaze,sylvanas,1389,paladin,holy,130,66,64
Lofotof,silvermoon,1389,paladin,holy,42,21,21
Грор,galakrond,1387,paladin,holy,109,50,59
Nemirof,la-croisade-écarlate,1386,paladin,holy,36,20,16
Fenye,twisting-nether,1386,paladin,holy,68,32,36
Grimbold,hellfire,1385,paladin,holy,72,42,30
Эскейпми,howling-fjord,1385,paladin,holy,35,18,17
Цитология,borean-tundra,1385,paladin,holy,146,74,72
Kiingslayeer,kilrogg,1385,paladin,holy,149,74,75
Enyol,stormscale,1384,paladin,holy,98,53,45
Xenaké,kazzak,1384,paladin,holy,355,166,189
Lightaldo,bladefist,1383,paladin,holy,66,43,23
Noliferx,ravencrest,1383,paladin,holy,82,49,33
Wizqy,ravencrest,1382,paladin,holy,130,57,73
Ðuïvel,grim-batol,1382,paladin,holy,52,22,30
Dimdon,silvermoon,1378,paladin,holy,36,20,16
Kapigodx,suramar,1378,paladin,holy,241,129,112
Danepala,defias-brotherhood,1378,paladin,holy,59,29,30
Ретриксвета,eversong,1377,paladin,holy,64,37,27
Abroxis,alleria,1377,paladin,holy,69,37,32
Gabriev,twisting-nether,1376,paladin,holy,49,25,24
Rëtnuhka,drakthul,1376,paladin,holy,108,52,56
Expot,blackmoore,1375,paladin,holy,88,48,40
Mønargøras,blackrock,1375,paladin,holy,96,40,56
Mestgone,dalaran,1374,paladin,holy,105,50,55
Scrimple,stormscale,1374,paladin,holy,97,44,53
Badckes,sylvanas,1373,paladin,holy,140,66,74
Lithera,outland,1372,paladin,holy,48,22,26
Kantfyrste,ravencrest,1372,paladin,holy,145,61,84
Сатангодх,gordunni,1372,paladin,holy,144,58,86
Mikemyers,blackhand,1370,paladin,holy,48,24,24
Eoox,outland,1370,paladin,holy,48,23,25
Relativy,xavius,1370,paladin,holy,144,63,81
Лимфома,goldrinn,1370,paladin,holy,91,39,52
Alard,sanguino,1369,paladin,holy,192,93,99
Bezvakost,thunderhorn,1368,paladin,holy,72,35,37
Vivalabeef,stormscale,1367,paladin,holy,60,26,34
Dimetrix,stormscale,1367,paladin,holy,65,26,39
Jackieb,dun-modr,1367,paladin,holy,63,24,39
Listina,twisting-nether,1366,paladin,holy,42,21,21
Claudîax,kazzak,1366,paladin,holy,117,51,66
Клэйсонгодхх,gordunni,1366,paladin,holy,49,21,28
Висперок,soulflayer,1365,paladin,holy,24,16,8
Valzyffs,twisting-nether,1365,paladin,holy,119,64,55
Mecah,hyjal,1365,paladin,holy,42,21,21
Shakalol,dun-modr,1365,paladin,holy,108,48,60
Kîsyhrâ,aegwynn,1365,paladin,holy,42,16,26
Pappipala,tarren-mill,1361,paladin,holy,84,42,42
Heilgaharald,blackrock,1361,paladin,holy,176,86,90
Ztiina,tarren-mill,1361,paladin,holy,114,54,60
Демига,ashenvale,1361,paladin,holy,66,29,37
Nsk,sylvanas,1360,paladin,holy,148,66,82
Ramos,aggra-português,1360,paladin,holy,60,22,38
Ассантийка,deathguard,1358,paladin,holy,45,21,24
Steggeh,argent-dawn,1358,paladin,holy,150,64,86
Ostardo,blackhand,1357,paladin,holy,24,15,9
Taengoo,frostwhisper,1357,paladin,holy,60,33,27
Wàtchmedánce,blackhand,1356,paladin,holy,42,28,14
Реколори,gordunni,1356,paladin,holy,217,115,102
Рэймета,soulflayer,1356,paladin,holy,48,21,27
Tsukaima,uldaman,1356,paladin,holy,35,15,20
Keltinne,ysondre,1354,paladin,holy,87,51,36
Starfula,archimonde,1353,paladin,holy,114,65,49
Skolisse,kazzak,1353,paladin,holy,268,143,125
Кольт,borean-tundra,1352,paladin,holy,177,91,86
Bubblig,silvermoon,1352,paladin,holy,54,24,30
Палуф,deathguard,1351,paladin,holy,53,31,22
Инблумхх,blackscar,1350,paladin,holy,48,24,24
Wize,steamwheedle-cartel,1350,paladin,holy,121,55,66
Veléxis,outland,1349,paladin,holy,176,85,91
Minpaladin,aegwynn,1349,paladin,holy,46,16,30
Rookzter,sylvanas,1348,paladin,holy,132,69,63
Reeley,drakthul,1348,paladin,holy,268,139,129
Demecir,twisting-nether,1348,paladin,holy,299,151,148
Pennyxx,outland,1346,paladin,holy,23,15,8
Demonskiller,alakir,1346,paladin,holy,89,47,42
Dogmatic,blackmoore,1346,paladin,holy,36,18,18
Chewwaka,bloodhoof,1346,paladin,holy,57,27,30
Plasmádieter,blackrock,1345,paladin,holy,74,33,41
Superpiniouf,archimonde,1345,paladin,holy,49,20,29
Keele,stormscale,1343,paladin,holy,102,49,53
Gefix,archimonde,1342,paladin,holy,48,18,30
Yonì,thrall,1341,paladin,holy,30,21,9
Tyktyk,draenor,1341,paladin,holy,66,38,28
Холишоок,gordunni,1341,paladin,holy,36,14,22
Flavitwink,hyjal,1340,paladin,holy,66,35,31
Zunis,jaedenar,1340,paladin,holy,52,19,33
Itsgossiplol,twisting-nether,1338,paladin,holy,205,104,101
Freaak,dethecus,1337,paladin,holy,60,24,36
Omhz,ravencrest,1336,paladin,holy,38,21,17
Slezz,tarren-mill,1336,paladin,holy,437,221,216
Алекхей,gordunni,1335,paladin,holy,78,36,42
Lightmachine,kirin-tor,1334,paladin,holy,84,56,28
Holiguy,twisting-nether,1333,paladin,holy,221,123,98
Kocovic,tarren-mill,1333,paladin,holy,54,29,25
Seinz,talnivarr,1333,paladin,holy,184,94,90
Anythíng,kazzak,1333,paladin,holy,121,61,60
Fleshgraft,silvermoon,1332,paladin,holy,85,40,45
Reakan,tarren-mill,1331,paladin,holy,24,14,10
Mitsaklas,grim-batol,1331,paladin,holy,227,104,123
Кардеро,gordunni,1329,paladin,holy,171,91,80
Snajajin,dethecus,1329,paladin,holy,86,38,48
Polydeukis,stormscale,1328,paladin,holy,127,56,71
Lazyknight,silvermoon,1328,paladin,holy,84,37,47
Hamish,boulderfist,1327,paladin,holy,36,19,17
Бэдмэн,deathguard,1327,paladin,holy,53,16,37
Axpala,ragnaros,1326,paladin,holy,46,24,22
Sixtynien,outland,1326,paladin,holy,88,45,43
Leon,veknilash,1325,paladin,holy,350,169,181
Thraìn,ravencrest,1325,paladin,holy,113,48,65
Shiøn,zuljin,1325,paladin,holy,64,27,37
Paiadinho,malganis,1324,paladin,holy,131,57,74
Watras,drakthul,1324,paladin,holy,72,26,46
Mefistofe,sanguino,1323,paladin,holy,48,23,25
Lezin,thrall,1323,paladin,holy,36,16,20
Satipal,sargeras,1323,paladin,holy,153,67,86
Ecormcpx,eredar,1322,paladin,holy,62,25,37
Suoivbo,echsenkessel,1321,paladin,holy,18,14,4
Aytu,blackmoore,1321,paladin,holy,39,19,20
Savalibarx,outland,1320,paladin,holy,42,24,18
Nde,silvermoon,1320,paladin,holy,47,20,27
Holynstuff,auchindoun,1319,paladin,holy,49,32,17
Rivanii,kazzak,1319,paladin,holy,225,116,109
Gucix,sylvanas,1319,paladin,holy,95,42,53
Minouminou,archimonde,1318,paladin,holy,42,26,16
Hîfi,blackmoore,1318,paladin,holy,243,131,112
Дезоиль,gordunni,1317,paladin,holy,36,14,22
Heimdalen,moonglade,1316,paladin,holy,54,26,28
Zodshock,stormscale,1316,paladin,holy,90,43,47
Vonat,outland,1316,paladin,holy,70,29,41
Crusherpala,laughing-skull,1316,paladin,holy,83,33,50
Holyfrick,kazzak,1315,paladin,holy,60,28,32
Sangriul,outland,1315,paladin,holy,135,57,78
Ðeswynd,hyjal,1315,paladin,holy,101,42,59
Rorschy,twisting-nether,1314,paladin,holy,24,14,10
Toxicmo,kazzak,1313,paladin,holy,31,21,10
Calmyoself,stormscale,1313,paladin,holy,36,14,22
Xila,blackrock,1312,paladin,holy,44,22,22
Hëüss,suramar,1312,paladin,holy,41,19,22
Lugnals,hyjal,1311,paladin,holy,367,179,188
Borndark,stormscale,1311,paladin,holy,144,63,81
Hÿrrøkk,ysondre,1310,paladin,holy,202,114,88
Agadin,ysondre,1310,paladin,holy,35,19,16
Tohki,darkmoon-faire,1310,paladin,holy,42,17,25
Европпа,soulflayer,1310,paladin,holy,155,61,94
Noskillze,ravencrest,1309,paladin,holy,48,25,23
Alciera,silvermoon,1309,paladin,holy,102,45,57
Gegge,kazzak,1308,paladin,holy,62,26,36
Rookx,stormscale,1308,paladin,holy,66,23,43
Mythsion,blackmoore,1307,paladin,holy,36,16,20
Daizen,blackrock,1306,paladin,holy,67,45,22
Malodos,archimonde,1306,paladin,holy,86,44,42
Skengdaddy,ragnaros,1306,paladin,holy,84,39,45
Holypapa,argent-dawn,1305,paladin,holy,125,60,65
Ondx,silvermoon,1305,paladin,holy,96,39,57
Hellphrodite,aegwynn,1304,paladin,holy,102,53,49
Ginbeam,aegwynn,1304,paladin,holy,190,93,97
Àmset,blackmoore,1304,paladin,holy,41,20,21
Raleknrnr,hyjal,1304,paladin,holy,30,14,16
Lapew,eredar,1303,paladin,holy,63,31,32
Подлыйдим,fordragon,1303,paladin,holy,84,34,50
Иммунитетх,gordunni,1303,paladin,holy,72,29,43
Ashebriinger,silvermoon,1302,paladin,holy,100,58,42
Meldi,dalaran,1302,paladin,holy,39,14,25
Croaton,burning-legion,1301,paladin,holy,24,14,10
Ugolf,kazzak,1301,paladin,holy,168,86,82
Evo,drakthul,1301,paladin,holy,55,25,30
Shaggybeard,frostmane,1301,paladin,holy,36,15,21
Truko,frostwolf,1300,paladin,holy,36,16,20
Vuup,silvermoon,1299,paladin,holy,217,112,105
Greckoe,blackhand,1299,paladin,holy,60,26,34
Bladê,kazzak,1299,paladin,holy,66,26,40
Æmiø,blackmoore,1298,paladin,holy,59,27,32
Vaeyla,archimonde,1298,paladin,holy,33,15,18
Rotana,eredar,1297,paladin,holy,45,25,20
Soreser,skullcrusher,1297,paladin,holy,42,22,20
Holyazzwhup,aegwynn,1297,paladin,holy,30,15,15
Zulpharik,ragnaros,1295,paladin,holy,36,15,21
Pussdocta,ravencrest,1294,paladin,holy,101,52,49
Rekolon,antonidas,1294,paladin,holy,400,205,195
Сномалк,gordunni,1294,paladin,holy,54,24,30
Ardentlight,quelthalas,1292,paladin,holy,42,23,19
Pârabellum,the-maelstrom,1292,paladin,holy,60,28,32
Dovadin,sylvanas,1291,paladin,holy,67,31,36
Mcßluz,les-clairvoyants,1290,paladin,holy,47,27,20
Paladins,archimonde,1290,paladin,holy,63,35,28
Bloodsoldier,twisting-nether,1290,paladin,holy,135,70,65
Archîmondê,marécage-de-zangar,1290,paladin,holy,48,14,34
Mvppaladin,thrall,1289,paladin,holy,30,18,12
Opopoï,dalaran,1289,paladin,holy,42,24,18
Valkhana,draenor,1289,paladin,holy,70,37,33
Slâyerous,draenor,1289,paladin,holy,77,32,45
Зондарк,booty-bay,1289,paladin,holy,77,31,46
Tíep,blackmoore,1288,paladin,holy,103,53,50
Neilimeh,marécage-de-zangar,1286,paladin,holy,63,34,29
Ниссида,blackscar,1286,paladin,holy,77,37,40
Feîxo,ravencrest,1286,paladin,holy,30,14,16
Holydrop,kazzak,1284,paladin,holy,30,18,12
Beatríx,minahonda,1284,paladin,holy,253,135,118
Dedy,frostwhisper,1284,paladin,holy,96,50,46
Exteron,blackmoore,1284,paladin,holy,32,15,17
Elians,outland,1284,paladin,holy,84,35,49
Cowvid,grim-batol,1284,paladin,holy,60,24,36
Wrathlol,ravencrest,1282,paladin,holy,304,151,153
Paellysuir,blackmoore,1280,paladin,holy,38,19,19
Alldo,drakthul,1280,paladin,holy,130,59,71
Necrozi,stormscale,1279,paladin,holy,70,40,30
Ксайлэти,gordunni,1279,paladin,holy,35,15,20
Perfero,kazzak,1279,paladin,holy,66,28,38
Fearleß,malganis,1278,paladin,holy,30,16,14
Ggiwastheret,kazzak,1277,paladin,holy,23,14,9
Manole,ravencrest,1277,paladin,holy,59,34,25
Veo,sylvanas,1277,paladin,holy,57,31,26
Bigfailure,blackmoore,1277,paladin,holy,71,23,48
Talies,ravencrest,1276,paladin,holy,66,37,29
Vorsip,tarren-mill,1276,paladin,holy,48,17,31
Swungling,outland,1275,paladin,holy,96,48,48
Holyppower,frostmane,1275,paladin,holy,35,14,21
Kapigentil,suramar,1274,paladin,holy,83,42,41
Böbble,twisting-nether,1274,paladin,holy,35,17,18
Neithi,twisting-nether,1272,paladin,holy,72,36,36
Taligon,arathor,1272,paladin,holy,42,21,21
Bovinequeef,twisting-nether,1272,paladin,holy,60,29,31
Albertina,silvermoon,1271,paladin,holy,38,19,19
Ballantine,thunderhorn,1271,paladin,holy,95,47,48
Bagull,zuljin,1271,paladin,holy,118,55,63
Кузнейц,borean-tundra,1271,paladin,holy,118,52,66
Mifuttoasort,draenor,1270,paladin,holy,104,51,53
Omegajin,tarren-mill,1269,paladin,holy,45,29,16
Marik,argent-dawn,1269,paladin,holy,65,30,35
Haros,xavius,1268,paladin,holy,89,46,43
Бронеаптечка,soulflayer,1268,paladin,holy,66,33,33
Toradin,thunderhorn,1268,paladin,holy,49,22,27
Allendria,blackmoore,1268,paladin,holy,41,16,25
Делатор,gordunni,1267,paladin,holy,48,22,26
Kiyam,kelthuzad,1265,paladin,holy,42,26,16
Niechepala,grim-batol,1264,paladin,holy,59,27,32
Aahabse,tarren-mill,1263,paladin,holy,95,38,57
Eaw,outland,1262,paladin,holy,24,16,8
Tepowze,twisting-nether,1262,paladin,holy,47,27,20
Гниленький,razuvious,1262,paladin,holy,48,18,30
Adnachiel,blackhand,1261,paladin,holy,80,40,40
Pajtash,doomhammer,1261,paladin,holy,59,29,30
Matagladis,dun-modr,1261,paladin,holy,125,61,64
Arkkipiispa,outland,1260,paladin,holy,78,40,38
Bimylover,archimonde,1260,paladin,holy,36,16,20
Ragequitter,frostmane,1259,paladin,holy,44,26,18
Ambrosía,alleria,1259,paladin,holy,90,41,49
Alesiah,blackhand,1258,paladin,holy,67,30,37
Keladen,burning-legion,1257,paladin,holy,95,50,45
Divinelightz,kazzak,1256,paladin,holy,41,23,18
Paliat,silvermoon,1255,paladin,holy,49,25,24
Nurleen,twisting-nether,1255,paladin,holy,327,154,173
Kaitlyne,tarren-mill,1254,paladin,holy,97,49,48
Regis,dragonblight,1253,paladin,holy,80,44,36
Trîlux,theradras,1252,paladin,holy,51,27,24
Анбели,gordunni,1252,paladin,holy,60,24,36
Zuen,nemesis,1251,paladin,holy,48,19,29
Tyrallan,ragnaros,1251,paladin,holy,36,14,22
Moobykin,stormscale,1250,paladin,holy,68,33,35
Нинтендо,grom,1250,paladin,holy,403,191,212
Spankmeproof,kazzak,1250,paladin,holy,54,24,30
Hogma,hyjal,1250,paladin,holy,36,14,22
Ellisdee,kazzak,1249,paladin,holy,36,20,16
Luraa,drakthul,1249,paladin,holy,42,21,21
Hotub,twisting-nether,1248,paladin,holy,153,73,80
Mercuria,dun-modr,1247,paladin,holy,48,25,23
Slistrash,outland,1247,paladin,holy,221,113,108
Tímby,ravencrest,1246,paladin,holy,30,13,17
Batallarbb,exodar,1245,paladin,holy,54,26,28
Engerau,drakthul,1244,paladin,holy,36,13,23
Mjabubble,stormscale,1243,paladin,holy,141,78,63
Paakz,stormscale,1243,paladin,holy,281,143,138
Neyd,hyjal,1243,paladin,holy,138,57,81
Cmelacek,wildhammer,1241,paladin,holy,42,25,17
Кельдерик,howling-fjord,1241,paladin,holy,133,66,67
Tommoffwarrs,archimonde,1241,paladin,holy,73,35,38
Thranduïl,tarren-mill,1240,paladin,holy,107,58,49
Trisunonvaki,khazgoroth,1240,paladin,holy,150,80,70
Aldran,les-clairvoyants,1240,paladin,holy,56,19,37
Teebxu,outland,1239,paladin,holy,23,14,9
Sanaha,drakthul,1238,paladin,holy,91,49,42
Bloednicht,dentarg,1238,paladin,holy,42,18,24
Aelly,hyjal,1237,paladin,holy,112,56,56
Runtheshow,deathwing,1237,paladin,holy,28,14,14
Blazeberg,tirion,1236,paladin,holy,41,21,20
Sagaruki,emerald-dream,1236,paladin,holy,83,36,47
Naliax,ravencrest,1235,paladin,holy,53,25,28
Babybeater,outland,1234,paladin,holy,101,49,52
Skarn,pozzo-delleternità,1234,paladin,holy,49,22,27
Kerven,doomhammer,1234,paladin,holy,107,47,60
Cumprovider,sylvanas,1233,paladin,holy,48,25,23
Jaezlin,tarren-mill,1232,paladin,holy,130,70,60
Equablex,argent-dawn,1232,paladin,holy,83,44,39
Fiönä,archimonde,1232,paladin,holy,30,13,17
Faildin,arathor,1231,paladin,holy,131,64,67
Reudi,argent-dawn,1230,paladin,holy,54,28,26
Skrrtsteak,draenor,1230,paladin,holy,43,17,26
Bulten,twilights-hammer,1230,paladin,holy,112,44,68
Ivailo,outland,1229,paladin,holy,24,13,11
Weserwehr,laughing-skull,1228,paladin,holy,90,46,44
Heldarim,ysondre,1228,paladin,holy,54,13,41
Billkop,silvermoon,1227,paladin,holy,88,52,36
Padraic,scarshield-legion,1227,paladin,holy,24,13,11
Ashbrìnger,aegwynn,1227,paladin,holy,24,13,11
Josefu,blackmoore,1227,paladin,holy,42,21,21
Aéther,quelthalas,1225,paladin,holy,45,25,20
Segertåget,tarren-mill,1225,paladin,holy,233,118,115
Naenel,dun-modr,1225,paladin,holy,37,16,21
Bobilous,twisting-nether,1225,paladin,holy,36,14,22
Держинский,gordunni,1225,paladin,holy,72,24,48
Паладинас,lich-king,1224,paladin,holy,112,36,76
Baixinho,aggra-português,1223,paladin,holy,117,63,54
Nobodycanxit,twisting-nether,1223,paladin,holy,72,35,37
Beavatott,ragnaros,1223,paladin,holy,60,27,33
Leedspala,tarren-mill,1221,paladin,holy,24,14,10
Schrikii,archimonde,1221,paladin,holy,66,27,39
Crüedriver,nefarian,1221,paladin,holy,76,28,48
Holylight,arathi,1220,paladin,holy,24,13,11
Yoshreddi,malganis,1218,paladin,holy,52,25,27
Lianndrin,blackhand,1218,paladin,holy,58,25,33
Даняхгод,gordunni,1217,paladin,holy,54,26,28
Focùsheal,archimonde,1217,paladin,holy,42,20,22
Калекомобиль,gordunni,1216,paladin,holy,25,13,12
Dubstép,blackrock,1216,paladin,holy,48,20,28
Minui,onyxia,1216,paladin,holy,50,20,30
Alastrr,hyjal,1215,paladin,holy,93,52,41
Fleny,thrall,1215,paladin,holy,24,13,11
Dawnforged,stormscale,1215,paladin,holy,118,56,62
Verianer,shadowsong,1213,paladin,holy,112,65,47
Môdhân,archimonde,1213,paladin,holy,66,31,35
Ромерл,gordunni,1213,paladin,holy,241,112,129
Fredfuriouss,twisting-nether,1212,paladin,holy,37,22,15
Sepha,eonar,1211,paladin,holy,100,55,45
Kilogosa,frostmane,1211,paladin,holy,24,13,11
Pupsihasi,kelthuzad,1211,paladin,holy,61,31,30
Lightmamba,draenor,1211,paladin,holy,72,28,44
Новирка,deathguard,1210,paladin,holy,108,56,52
Crispydixx,draenor,1210,paladin,holy,102,52,50
Paidi,die-todeskrallen,1210,paladin,holy,121,60,61
Nikcsy,ragnaros,1210,paladin,holy,78,29,49
Johnnydeeps,blackrock,1210,paladin,holy,35,13,22
Ithealy,twisting-nether,1209,paladin,holy,140,73,67
Johnnÿsins,hyjal,1209,paladin,holy,63,28,35
Med,malganis,1208,paladin,holy,106,49,57
Baubble,silvermoon,1207,paladin,holy,85,45,40
Xe,kaelthas,1207,paladin,holy,100,48,52
Zeratris,defias-brotherhood,1207,paladin,holy,97,42,55
Holysznajt,burning-legion,1207,paladin,holy,72,30,42
Rébél,argent-dawn,1206,paladin,holy,42,17,25
Lovefox,burning-legion,1205,paladin,holy,42,19,23
Ramels,hyjal,1205,paladin,holy,66,28,38
Нуш,greymane,1203,paladin,holy,36,18,18
Kambood,twisting-nether,1203,paladin,holy,219,103,116
Battosaix,aegwynn,1203,paladin,holy,35,15,20
Ауё,blackscar,1202,paladin,holy,108,53,55
Hùrikan,hyjal,1202,paladin,holy,66,28,38
Holymax,gorgonnash,1201,paladin,holy,51,29,22
Xastur,rexxar,1201,paladin,holy,33,17,16
Skwáru,burning-legion,1200,paladin,holy,112,48,64
Kimmpala,tarren-mill,1200,paladin,holy,42,14,28
Golldy,burning-legion,1199,paladin,holy,71,36,35
Amelyé,kazzak,1199,paladin,holy,43,18,25
Kirilux,dun-modr,1198,paladin,holy,66,37,29
Longa,kazzak,1198,paladin,holy,56,27,29
Кейлол,soulflayer,1198,paladin,holy,101,47,54
Зерегушка,gordunni,1198,paladin,holy,42,15,27
Trastos,wildhammer,1197,paladin,holy,78,40,38
Tucibi,hyjal,1196,paladin,holy,42,24,18
Shenzoo,rajaxx,1196,paladin,holy,65,28,37
Ubiquitous,kazzak,1196,paladin,holy,53,21,32
Edgï,confrérie-du-thorium,1195,paladin,holy,24,14,10
Cowlories,outland,1195,paladin,holy,48,27,21
Brøadway,eredar,1195,paladin,holy,53,24,29
Bjaï,hyjal,1195,paladin,holy,96,36,60
Reeceboss,ravencrest,1194,paladin,holy,35,15,20
Warkyria,sanguino,1193,paladin,holy,37,15,22
Farata,ravencrest,1192,paladin,holy,214,104,110
Shoby,silvermoon,1192,paladin,holy,36,17,19
Chunie,ravencrest,1192,paladin,holy,71,25,46
Майдмен,gordunni,1191,paladin,holy,125,67,58
Ikbenmani,tarren-mill,1190,paladin,holy,72,38,34
Hazø,silvermoon,1190,paladin,holy,69,34,35
Luminix,ragnaros,1189,paladin,holy,36,17,19
Holdmybible,the-maelstrom,1188,paladin,holy,66,26,40
Psycholas,ysondre,1187,paladin,holy,43,24,19
Вертуосгодх,soulflayer,1187,paladin,holy,104,51,53
Taraniah,argent-dawn,1186,paladin,holy,93,48,45
Ninko,sylvanas,1185,paladin,holy,60,31,29
Rhulana,blackrock,1184,paladin,holy,97,57,40
Boric,bloodhoof,1184,paladin,holy,29,16,13
Tsomoo,antonidas,1183,paladin,holy,36,21,15
Vegnar,confrérie-du-thorium,1183,paladin,holy,30,14,16
Akako,outland,1182,paladin,holy,69,31,38
Zypala,silvermoon,1182,paladin,holy,36,16,20
Encod,magtheridon,1182,paladin,holy,65,24,41
Thickets,argent-dawn,1181,paladin,holy,56,30,26
Dreamwatcher,outland,1181,paladin,holy,42,20,22
Свээги,gordunni,1181,paladin,holy,98,46,52
Громобоика,gordunni,1180,paladin,holy,19,13,6
Unpal,ravencrest,1179,paladin,holy,50,20,30
Kayndornek,ravencrest,1178,paladin,holy,78,35,43
Bloodbrook,burning-legion,1177,paladin,holy,35,15,20
Furywithin,veknilash,1176,paladin,holy,23,13,10
Фэрплэйн,gordunni,1175,paladin,holy,92,46,46
Shiidori,aegwynn,1175,paladin,holy,57,23,34
Ланиакеа,deathguard,1174,paladin,holy,63,36,27
Palaadschin,festung-der-stürme,1173,paladin,holy,189,97,92
Неиспоримый,soulflayer,1172,paladin,holy,30,13,17
Опгоп,gordunni,1170,paladin,holy,27,16,11
Merliphel,burning-legion,1169,paladin,holy,39,22,17
Strudell,terrordar,1169,paladin,holy,90,42,48
Mcscrigs,stormrage,1169,paladin,holy,63,28,35
Degods,ravencrest,1169,paladin,holy,54,24,30
Demytx,burning-legion,1169,paladin,holy,54,17,37
Iovä,twisting-nether,1167,paladin,holy,308,137,171
Alextrazite,kazzak,1166,paladin,holy,30,13,17
Кукусяшка,gordunni,1166,paladin,holy,83,34,49
Badasshades,sylvanas,1166,paladin,holy,48,19,29
Guidone,sylvanas,1164,paladin,holy,54,24,30
Puiçanpal,archimonde,1163,paladin,holy,30,15,15
Mozzie,archimonde,1163,paladin,holy,351,166,185
Elohim,echsenkessel,1163,paladin,holy,154,71,83
Hörse,outland,1162,paladin,holy,41,25,16
Angioh,twisting-nether,1162,paladin,holy,48,21,27
Stuzzyy,ravencrest,1162,paladin,holy,48,20,28
Nitrous,zuljin,1161,paladin,holy,72,37,35
Tôra,hyjal,1160,paladin,holy,30,17,13
Pisdez,malganis,1160,paladin,holy,102,46,56
Ýâðæßêæßðæðð,ragnaros,1159,paladin,holy,34,15,19
Ырбис,soulflayer,1159,paladin,holy,34,13,21
Ärinváyá,defias-brotherhood,1157,paladin,holy,121,61,60
Aranael,nemesis,1157,paladin,holy,90,38,52
Brolyadin,dun-modr,1157,paladin,holy,59,22,37
Firelline,outland,1156,paladin,holy,96,44,52
Ioras,sunstrider,1156,paladin,holy,40,13,27
Kherathan,argent-dawn,1155,paladin,holy,199,103,96
Ugurpala,sylvanas,1155,paladin,holy,48,24,24
Ðãwën,uldaman,1154,paladin,holy,27,14,13
Nezrus,dun-modr,1154,paladin,holy,48,19,29
Arcanïk,archimonde,1153,paladin,holy,43,16,27
Likkik,tarren-mill,1152,paladin,holy,18,12,6
Kaki,gorgonnash,1151,paladin,holy,18,12,6
Лавъю,gordunni,1151,paladin,holy,26,15,11
Karnwield,kirin-tor,1151,paladin,holy,221,117,104
Wedervärdig,twilights-hammer,1151,paladin,holy,54,23,31
Flowerbud,tarren-mill,1151,paladin,holy,80,30,50
Алексендлерх,soulflayer,1149,paladin,holy,18,12,6
Galaxxumi,ragnaros,1148,paladin,holy,92,40,52
Beatricse,ravencrest,1148,paladin,holy,49,19,30
Strykar,aggra-português,1147,paladin,holy,60,30,30
Халлейя,gordunni,1147,paladin,holy,24,12,12
Аяпал,blackscar,1147,paladin,holy,105,50,55
Certiorari,draenor,1147,paladin,holy,46,18,28
Flanderspal,ravencrest,1146,paladin,holy,24,12,12
Tukang,kazzak,1146,paladin,holy,73,31,42
Daneyholy,ravencrest,1146,paladin,holy,63,21,42
Merigniüs,ysondre,1145,paladin,holy,60,33,27
Mjølnîr,eredar,1145,paladin,holy,132,62,70
Ymô,archimonde,1145,paladin,holy,40,17,23
Kraajp,stormscale,1144,paladin,holy,87,38,49
Herrius,ravencrest,1144,paladin,holy,30,12,18
Évo,drakthul,1144,paladin,holy,30,12,18
Potatô,twisting-nether,1143,paladin,holy,42,21,21
Eskorbuto,dun-modr,1143,paladin,holy,57,27,30
Ventrue,hyjal,1143,paladin,holy,36,17,19
Yenkodin,blackmoore,1143,paladin,holy,36,16,20
Testrone,twisting-nether,1141,paladin,holy,93,49,44
Keryann,argent-dawn,1141,paladin,holy,114,54,60
Cadila,silvermoon,1140,paladin,holy,84,40,44
Debts,aggramar,1140,paladin,holy,82,32,50
Trolladincho,twisting-nether,1137,paladin,holy,129,63,66
Gromezrael,elune,1137,paladin,holy,60,28,32
Мэйр,howling-fjord,1137,paladin,holy,42,17,25
Lezoom,draenor,1136,paladin,holy,79,40,39
Даурия,soulflayer,1135,paladin,holy,46,21,25
Reven,aszune,1135,paladin,holy,29,13,16
Dopadown,blackrock,1135,paladin,holy,30,13,17
Masuroc,antonidas,1134,paladin,holy,80,38,42
Kompa,sanguino,1132,paladin,holy,24,12,12
Jasiv,draenor,1132,paladin,holy,36,14,22
Palix,dalaran,1132,paladin,holy,36,12,24
Høpé,malganis,1131,paladin,holy,132,70,62
Arraw,archimonde,1131,paladin,holy,36,12,24
Trudi,arthas,1130,paladin,holy,81,37,44
Míxu,stormreaver,1130,paladin,holy,116,51,65
Hellwave,stormscale,1129,paladin,holy,24,13,11
Paliester,stormscale,1128,paladin,holy,42,26,16
Rektalinfekt,malganis,1128,paladin,holy,24,12,12
Paxiffs,eredar,1128,paladin,holy,36,12,24
Ретроо,soulflayer,1127,paladin,holy,71,35,36
Telarii,die-nachtwache,1126,paladin,holy,30,13,17
Grimsz,ysondre,1124,paladin,holy,62,19,43
Johnaggro,outland,1123,paladin,holy,76,34,42
Affiicous,silvermoon,1123,paladin,holy,66,20,46
Zuryy,archimonde,1122,paladin,holy,41,21,20
Barundarr,arthas,1122,paladin,holy,39,18,21
Yaj,magtheridon,1122,paladin,holy,59,27,32
Pristín,blackhand,1122,paladin,holy,30,13,17
Buddy,conseil-des-ombres,1121,paladin,holy,110,60,50
Zebramann,silvermoon,1121,paladin,holy,48,20,28
Unithral,durotan,1120,paladin,holy,36,17,19
Санэрдин,soulflayer,1120,paladin,holy,28,13,15
Ретроградий,howling-fjord,1120,paladin,holy,56,17,39
Echooes,ravencrest,1119,paladin,holy,273,120,153
Zerfleddern,aegwynn,1118,paladin,holy,149,73,76
Альфапушка,soulflayer,1117,paladin,holy,24,12,12
Trístesse,tarren-mill,1117,paladin,holy,231,115,116
Striike,drakthul,1117,paladin,holy,29,12,17
Milesteris,medivh,1116,paladin,holy,72,38,34
Gaskohle,blackmoore,1115,paladin,holy,23,12,11
Tärkan,chogall,1114,paladin,holy,42,18,24
Rôlfzukowzky,guldan,1114,paladin,holy,48,20,28
Riziel,sanguino,1114,paladin,holy,30,12,18
Kanina,outland,1114,paladin,holy,58,23,35
Browario,burning-legion,1113,paladin,holy,23,12,11
Bàldur,dalaran,1111,paladin,holy,48,27,21
Perpon,exodar,1111,paladin,holy,77,37,40
Runeington,silvermoon,1111,paladin,holy,36,15,21
Yokurolel,sanguino,1109,paladin,holy,72,42,30
Syfaria,eldrethalas,1109,paladin,holy,59,26,33
Пауэрлайт,blackscar,1109,paladin,holy,64,27,37
Palanolmal,dun-modr,1107,paladin,holy,52,28,24
Tadjmahal,ravencrest,1106,paladin,holy,29,12,17
Kaktuszfüge,ragnaros,1105,paladin,holy,64,40,24
Doomheart,drakthul,1104,paladin,holy,118,57,61
Collinnawin,aegwynn,1104,paladin,holy,36,12,24
Hehesh,silvermoon,1103,paladin,holy,44,19,25
Flashyplays,silvermoon,1102,paladin,holy,53,36,17
Avengers,sylvanas,1102,paladin,holy,36,18,18
Smirk,aggra-português,1101,paladin,holy,18,12,6
Ауренни,gordunni,1101,paladin,holy,30,12,18
Pallyypower,draenor,1100,paladin,holy,205,110,95
Atkm,aggramar,1100,paladin,holy,42,14,28
Meive,sanguino,1099,paladin,holy,41,14,27
Truthbearer,darksorrow,1098,paladin,holy,182,85,97
Catsnek,darksorrow,1098,paladin,holy,37,15,22
Dryntee,blackmoore,1095,paladin,holy,21,13,8
Darkironpala,argent-dawn,1095,paladin,holy,65,31,34
Митреса,howling-fjord,1094,paladin,holy,30,14,16
Superpopa,twisting-nether,1094,paladin,holy,98,42,56
Darvius,auchindoun,1093,paladin,holy,153,75,78
Галлионн,gordunni,1092,paladin,holy,29,19,10
Feldrøider,nemesis,1092,paladin,holy,100,53,47
Cmen,silvermoon,1090,paladin,holy,251,127,124
Luckies,drakthul,1090,paladin,holy,36,16,20
Kuhs,eredar,1089,paladin,holy,95,46,49
Galadørn,elune,1089,paladin,holy,42,13,29
Ampoula,ravencrest,1088,paladin,holy,28,12,16
Öbedö,malganis,1088,paladin,holy,139,59,80
Healslol,aegwynn,1088,paladin,holy,55,20,35
Stonebeard,ahnqiraj,1087,paladin,holy,129,72,57
Nosn,ravencrest,1087,paladin,holy,66,34,32
Tentacruel,dalaran,1087,paladin,holy,24,12,12
Bígpumprz,archimonde,1085,paladin,holy,35,17,18
Skydor,silvermoon,1084,paladin,holy,187,91,96
Serim,dun-modr,1084,paladin,holy,165,77,88
Фломастер,gordunni,1084,paladin,holy,78,36,42
Varianwrinn,bloodhoof,1083,paladin,holy,30,17,13
Ragua,tarren-mill,1082,paladin,holy,66,23,43
Paladzor,twisting-nether,1082,paladin,holy,38,13,25
Alphárius,argent-dawn,1081,paladin,holy,69,32,37
Luzcian,zuljin,1081,paladin,holy,115,48,67
Nyryon,ysondre,1081,paladin,holy,84,32,52
Uzrael,hyjal,1080,paladin,holy,53,21,32
Poundcake,stormscale,1079,paladin,holy,120,61,59
Ritiv,stormreaver,1079,paladin,holy,146,61,85
Joakìim,stormscale,1079,paladin,holy,39,12,27
Присвет,blackscar,1078,paladin,holy,44,13,31
Ashmaden,tarren-mill,1077,paladin,holy,87,49,38
Thorosus,nathrezim,1076,paladin,holy,36,15,21
Herrmannelig,arthas,1072,paladin,holy,36,15,21
Rákea,blackrock,1072,paladin,holy,78,31,47
Æe,blackmoore,1071,paladin,holy,42,19,23
Jessìca,ravenholdt,1070,paladin,holy,60,31,29
Elisiell,turalyon,1070,paladin,holy,36,15,21
Rya,drakthul,1069,paladin,holy,24,13,11
Videogame,twilights-hammer,1065,paladin,holy,24,12,12
Palidi,tarren-mill,1064,paladin,holy,42,16,26
Молотуля,howling-fjord,1063,paladin,holy,29,12,17
Псимедик,gordunni,1062,paladin,holy,68,34,34
Elp,ysondre,1061,paladin,holy,38,14,24
Phiana,blackmoore,1060,paladin,holy,30,18,12
Droseros,sylvanas,1060,paladin,holy,59,25,34
Rondra,gorgonnash,1059,paladin,holy,36,19,17
Aldas,los-errantes,1059,paladin,holy,30,13,17
Tscheba,kazzak,1058,paladin,holy,118,58,60
Holyfriend,kazzak,1058,paladin,holy,30,14,16
Avalus,trollbane,1058,paladin,holy,66,25,41
Mowik,archimonde,1056,paladin,holy,78,36,42
Mscrabtree,aggramar,1056,paladin,holy,36,14,22
Gayestpala,ravencrest,1056,paladin,holy,30,11,19
Djaléxx,kazzak,1056,paladin,holy,36,11,25
Casmira,blackrock,1055,paladin,holy,18,11,7
Kanketo,korgall,1055,paladin,holy,24,11,13
Безбабла,soulflayer,1055,paladin,holy,36,15,21
Breez,die-aldor,1055,paladin,holy,42,11,31
Holybom,silvermoon,1054,paladin,holy,44,21,23
Dabstar,antonidas,1054,paladin,holy,100,45,55
Tiltslayer,archimonde,1053,paladin,holy,18,11,7
Ozzuum,twisting-nether,1053,paladin,holy,21,12,9
Ларенси,gordunni,1053,paladin,holy,47,20,27
Zephale,sunstrider,1053,paladin,holy,31,11,20
Juicemachine,silvermoon,1052,paladin,holy,18,13,5
Mbp,blackmoore,1052,paladin,holy,30,16,14
Burkaal,antonidas,1052,paladin,holy,89,40,49
Csalóka,bloodscalp,1052,paladin,holy,41,14,27
Whatisapalla,ragnaros,1051,paladin,holy,30,11,19
Impro,archimonde,1051,paladin,holy,30,11,19
Narojj,kazzak,1051,paladin,holy,30,11,19
Lunaary,antonidas,1049,paladin,holy,24,11,13
Pâmê,kazzak,1049,paladin,holy,30,12,18
Missfez,the-maelstrom,1049,paladin,holy,30,11,19
Pinx,kazzak,1047,paladin,holy,24,15,9
Hèmera,archimonde,1047,paladin,holy,18,11,7
Ylandefaran,frostmane,1047,paladin,holy,146,69,77
Geesus,eredar,1047,paladin,holy,24,11,13
Rdypaladin,ravencrest,1047,paladin,holy,24,11,13
Inuyashiki,blackmoore,1047,paladin,holy,30,11,19
Thorhum,moonglade,1046,paladin,holy,60,27,33
Wârlørd,sylvanas,1046,paladin,holy,39,12,27
Payforpvp,draenor,1046,paladin,holy,42,11,31
Psikatchuu,hyjal,1045,paladin,holy,24,11,13
Dimeric,outland,1044,paladin,holy,24,11,13
Edomedo,blackrock,1044,paladin,holy,132,47,85
Паландис,howling-fjord,1042,paladin,holy,54,23,31
Fract,aggramar,1041,paladin,holy,63,32,31
Duschwein,aegwynn,1041,paladin,holy,37,18,19
Lènnja,baelgun,1041,paladin,holy,24,11,13
Churrucuca,minahonda,1040,paladin,holy,57,28,29
Dunka,twisting-nether,1040,paladin,holy,160,78,82
Дантепаладос,soulflayer,1040,paladin,holy,67,20,47
Healìna,hyjal,1038,paladin,holy,24,11,13
Fifisztos,burning-legion,1036,paladin,holy,45,27,18
Holÿbeard,ravencrest,1036,paladin,holy,31,12,19
Гуэргос,gordunni,1034,paladin,holy,24,11,13
Sheldon,sylvanas,1034,paladin,holy,35,14,21
Fiuk,frostwhisper,1033,paladin,holy,28,14,14
Laniñaa,temple-noir,1033,paladin,holy,24,11,13
Himmelsfuror,proudmoore,1033,paladin,holy,107,44,63
Edwín,tichondrius,1033,paladin,holy,36,13,23
Monaatamis,kazzak,1032,paladin,holy,36,11,25
Zetla,khaz-modan,1031,paladin,holy,341,168,173
Krayzier,nordrassil,1031,paladin,holy,33,13,20
Kastiël,hyjal,1031,paladin,holy,70,24,46
Загадзуга,howling-fjord,1030,paladin,holy,36,22,14
Satip,archimonde,1030,paladin,holy,72,42,30
Holyknîght,khaz-modan,1028,paladin,holy,36,23,13
Nicewar,silvermoon,1028,paladin,holy,81,40,41
Лебоввски,blackscar,1028,paladin,holy,37,14,23
Dragonwingz,kazzak,1027,paladin,holy,24,11,13
Leônidas,kazzak,1027,paladin,holy,63,27,36
Crusadelight,alakir,1026,paladin,holy,134,65,69
Purificatoru,draenor,1024,paladin,holy,54,26,28
Synoh,silvermoon,1024,paladin,holy,36,12,24
Ударник,soulflayer,1021,paladin,holy,102,56,46
Mirabol,hyjal,1021,paladin,holy,83,33,50
Antisin,kazzak,1019,paladin,holy,154,64,90
Vilcochon,kaelthas,1018,paladin,holy,18,11,7
Düster,frostwolf,1017,paladin,holy,30,13,17
Çrúsader,frostmane,1016,paladin,holy,48,23,25
Syco,thrall,1015,paladin,holy,35,12,23
Yasmira,frostmourne,1014,paladin,holy,72,41,31
Oscardrei,norgannon,1013,paladin,holy,72,39,33
Øsirix,archimonde,1012,paladin,holy,113,52,61
Darhuun,antonidas,1012,paladin,holy,60,23,37
Syrenia,die-silberne-hand,1012,paladin,holy,87,31,56
Kvea,blackmoore,1011,paladin,holy,90,49,41
Rombi,draenor,1011,paladin,holy,100,41,59
Palir,ysondre,1010,paladin,holy,24,11,13
Santtox,dun-modr,1010,paladin,holy,40,13,27
Stelara,ravencrest,1007,paladin,holy,54,23,31
Radhya,sargeras,1006,paladin,holy,36,15,21
Сашокс,gordunni,1006,paladin,holy,123,51,72
Kone,drakthul,1005,paladin,holy,21,12,9
Saró,ravencrest,1005,paladin,holy,84,22,62
Sanctifiedz,silvermoon,1004,paladin,holy,55,25,30
Pférd,blackrock,1002,paladin,holy,30,13,17
Necropolis,twisting-nether,1001,paladin,holy,54,32,22
Enbye,argent-dawn,1001,paladin,holy,42,18,24
Eledhwen,mannoroth,1000,paladin,holy,72,37,35
Флаила,ashenvale,999,paladin,holy,36,18,18
Battalgazi,azjolnerub,997,paladin,holy,35,14,21
Пегая,soulflayer,994,paladin,holy,24,13,11
Kpunkpam,dun-modr,993,paladin,holy,74,41,33
Aassaass,kazzak,993,paladin,holy,78,22,56
Palagrom,kazzak,991,paladin,holy,34,11,23
Májór,area-52,990,paladin,holy,78,19,59
Avengilo,silvermoon,989,paladin,holy,36,17,19
Gigantiq,draenor,988,paladin,holy,36,11,25
Peacekeep,stormscale,987,paladin,holy,102,43,59
Mêyra,blackhand,986,paladin,holy,22,11,11
Haavoc,arathor,986,paladin,holy,30,13,17
Ryuzu,khazgoroth,985,paladin,holy,41,20,21
Áfx,blackmoore,985,paladin,holy,44,17,27
Quelthemar,stormscale,982,paladin,holy,111,42,69
Cerseï,frostmane,979,paladin,holy,41,13,28
Kaleto,ragnaros,978,paladin,holy,145,71,74
Ralo,shattrath,978,paladin,holy,54,18,36
Tömmÿ,draenor,976,paladin,holy,80,41,39
Edyk,silvermoon,975,paladin,holy,32,12,20
Pölark,archimonde,974,paladin,holy,125,59,66
Ирэуль,gordunni,972,paladin,holy,36,13,23
Fleshoflight,arathor,972,paladin,holy,74,26,48
Shakziva,draenor,968,paladin,holy,78,40,38
Odensson,sylvanas,967,paladin,holy,42,15,27
Selenaluna,turalyon,967,paladin,holy,48,17,31
Оберинмартел,blackscar,965,paladin,holy,102,52,50
Autyzmterror,silvermoon,965,paladin,holy,98,40,58
Swordlupn,argent-dawn,965,paladin,holy,101,39,62
Rafox,malygos,964,paladin,holy,42,17,25
Zinnia,draenor,963,paladin,holy,23,11,12
Severok,darkspear,962,paladin,holy,29,16,13
Koreanpistol,aegwynn,962,paladin,holy,97,39,58
Rapidforce,kazzak,961,paladin,holy,132,66,66
Ayepal,grim-batol,960,paladin,holy,18,10,8
Bapêe,thrall,960,paladin,holy,18,10,8
Rawshatter,kiljaeden,959,paladin,holy,18,10,8
Albakauz,stormscale,959,paladin,holy,24,10,14
Elracktwo,blackhand,958,paladin,holy,18,10,8
Lisma,bloodfeather,958,paladin,holy,18,10,8
Синрайчик,gordunni,958,paladin,holy,42,20,22
Herayo,aegwynn,958,paladin,holy,24,10,14
Astridx,kazzak,958,paladin,holy,24,10,14
Kapsloch,twisting-nether,958,paladin,holy,36,10,26
Whórainzóne,eredar,958,paladin,holy,36,10,26
Unhittable,draenor,957,paladin,holy,18,10,8
Fluv,ravencrest,957,paladin,holy,24,10,14
Kcore,blackrock,957,paladin,holy,36,13,23
Ingenuous,draenor,957,paladin,holy,30,10,20
Smeh,outland,957,paladin,holy,36,10,26
Farquaad,darksorrow,956,paladin,holy,17,11,6
Crashband,bronzebeard,956,paladin,holy,18,10,8
Бадъб,howling-fjord,956,paladin,holy,27,10,17
Sneackerz,archimonde,956,paladin,holy,30,10,20
Ultrabenzo,ravencrest,955,paladin,holy,18,10,8
Shockhoe,tarren-mill,955,paladin,holy,24,10,14
Holyless,draenor,955,paladin,holy,24,10,14
Darkoulipal,ravencrest,954,paladin,holy,18,10,8
Paluladin,turalyon,954,paladin,holy,18,10,8
Zymotíx,stormscale,954,paladin,holy,30,10,20
Ugimuji,magtheridon,953,paladin,holy,24,10,14
Roshï,tarren-mill,953,paladin,holy,30,10,20
Cenox,antonidas,952,paladin,holy,30,14,16
Iauna,tarren-mill,952,paladin,holy,30,10,20
Calipse,outland,952,paladin,holy,30,10,20
Fruitschaal,moonglade,951,paladin,holy,24,10,14
Leekai,stormscale,950,paladin,holy,18,10,8
Dánn,outland,950,paladin,holy,18,10,8
Legenda,grim-batol,950,paladin,holy,54,23,31
Dunutunicorn,argent-dawn,950,paladin,holy,24,10,14
Schaaboowyy,burning-legion,950,paladin,holy,106,38,68
Bcrp,ragnaros,950,paladin,holy,30,10,20
Випанк,howling-fjord,949,paladin,holy,155,60,95
Fotmfactory,burning-blade,949,paladin,holy,36,10,26
Savitri,drakthul,948,paladin,holy,24,10,14
Böömie,blackmoore,948,paladin,holy,51,20,31
Enslar,sanguino,947,paladin,holy,12,10,2
Макспал,lich-king,947,paladin,holy,65,29,36
Tmàc,twisting-nether,946,paladin,holy,36,10,26
Xonika,outland,945,paladin,holy,31,13,18
Omnimus,draenor,944,paladin,holy,37,19,18
Aulen,draenor,943,paladin,holy,16,11,5
Datz,nerathor,943,paladin,holy,24,10,14
Визавад,goldrinn,942,paladin,holy,30,13,17
Ромчке,gordunni,942,paladin,holy,84,35,49
Groove,colinas-pardas,941,paladin,holy,40,11,29
Messîah,outland,939,paladin,holy,43,19,24
Colpadeltank,kazzak,939,paladin,holy,54,15,39
Алекссис,blackscar,938,paladin,holy,142,59,83
Wisplol,kazzak,937,paladin,holy,84,45,39
Holyhooves,thrall,936,paladin,holy,18,10,8
Clerik,eredar,936,paladin,holy,88,42,46
Paladons,darksorrow,933,paladin,holy,41,22,19
Pallnatoke,silvermoon,932,paladin,holy,45,13,32
Catali,sanguino,931,paladin,holy,115,54,61
Elsirosel,dun-modr,930,paladin,holy,24,10,14
Khaerhadur,argent-dawn,930,paladin,holy,89,28,61
Ázot,burning-legion,929,paladin,holy,48,19,29
Gunshøtx,archimonde,929,paladin,holy,46,15,31
Djalexx,kazzak,927,paladin,holy,23,10,13
Bzuko,draenor,925,paladin,holy,25,10,15
Pepegasensei,ravencrest,924,paladin,holy,57,22,35
Ridethelight,nemesis,922,paladin,holy,30,15,15
Flòope,destromath,922,paladin,holy,45,19,26
Silvers,steamwheedle-cartel,922,paladin,holy,190,80,110
Alearai,ravenholdt,921,paladin,holy,46,20,26
Gogetax,magtheridon,920,paladin,holy,30,10,20
Zeret,twisting-nether,918,paladin,holy,40,16,24
Menagron,tarren-mill,917,paladin,holy,43,19,24
Imaturtle,darksorrow,915,paladin,holy,41,10,31
Herdekbaba,draenor,914,paladin,holy,36,10,26
Revrenaud,magtheridon,913,paladin,holy,42,11,31
Scumbakitty,ysondre,911,paladin,holy,29,10,19
Crsader,antonidas,908,paladin,holy,84,40,44
Schukka,azshara,905,paladin,holy,24,10,14
Cøllinz,ragnaros,904,paladin,holy,21,10,11
Holyblast,archimonde,904,paladin,holy,24,11,13
Heyley,twisting-nether,903,paladin,holy,21,11,10
Dragg,kirin-tor,903,paladin,holy,23,12,11
Ðavai,kazzak,903,paladin,holy,29,10,19
Yeetadin,silvermoon,903,paladin,holy,32,11,21
Vintar,quelthalas,901,paladin,holy,87,46,41
Maxímoose,defias-brotherhood,901,paladin,holy,24,10,14
Паблойд,deathguard,897,paladin,holy,81,30,51
Chantal,gilneas,890,paladin,holy,53,26,27
Amolan,drakthul,888,paladin,holy,115,63,52
Яполковник,gordunni,887,paladin,holy,53,30,23
Theisixtus,drakthul,883,paladin,holy,23,12,11
Bjammin,burning-legion,883,paladin,holy,60,25,35
Àkí,blackmoore,883,paladin,holy,35,14,21
Mustangs,archimonde,882,paladin,holy,86,38,48
Nykothpn,ghostlands,881,paladin,holy,59,19,40
Atomics,wildhammer,875,paladin,holy,116,42,74
Swormp,aggra-português,874,paladin,holy,41,14,27
Æffy,nemesis,864,paladin,holy,12,9,3
Криптонитх,blackscar,864,paladin,holy,18,9,9
Scoobydoo,argent-dawn,863,paladin,holy,12,9,3
Cunix,draenor,863,paladin,holy,12,9,3
Gomadin,azuremyst,863,paladin,holy,20,10,10
Flavourful,cthun,863,paladin,holy,18,9,9
Язвавгорле,soulflayer,863,paladin,holy,24,9,15
Нетораре,howling-fjord,863,paladin,holy,24,9,15
Istani,twisting-nether,863,paladin,holy,36,9,27
Yoanie,draenor,862,paladin,holy,12,9,3
Spiritbreak,archimonde,862,paladin,holy,24,9,15
Rane,arthas,861,paladin,holy,18,9,9
Mohamedx,tarren-mill,861,paladin,holy,24,9,15
Fahqmeh,thrall,861,paladin,holy,24,9,15
Reinhàrdt,ravencrest,861,paladin,holy,27,10,17
Firetorch,twisting-nether,861,paladin,holy,30,9,21
Elfaza,uldum,860,paladin,holy,36,9,27
Averagepala,stormscale,858,paladin,holy,30,9,21
Zallehh,draenor,858,paladin,holy,30,9,21
Dalfor,aggramar,856,paladin,holy,12,9,3
Elganor,hyjal,856,paladin,holy,18,9,9
Lurdz,sylvanas,855,paladin,holy,20,11,9
Davykuro,medivh,854,paladin,holy,56,18,38
Langibo,malfurion,853,paladin,holy,30,14,16
Holyherb,the-maelstrom,852,paladin,holy,18,9,9
Rubadubskrub,silvermoon,852,paladin,holy,72,21,51
Johrian,silvermoon,849,paladin,holy,79,29,50
Clegâne,antonidas,847,paladin,holy,12,9,3
Qyrija,malganis,845,paladin,holy,18,9,9
Vanghelie,doomhammer,843,paladin,holy,24,11,13
Tarhal,guldan,841,paladin,holy,18,9,9
Salubrifie,archimonde,841,paladin,holy,24,10,14
Первыйпал,blackscar,832,paladin,holy,94,49,45
Rezilience,archimonde,829,paladin,holy,16,9,7
Óverdóse,nagrand,825,paladin,holy,146,75,71
Razx,draenor,820,paladin,holy,55,24,31
Arabicbomb,archimonde,819,paladin,holy,23,9,14
Palafrugell,sanguino,817,paladin,holy,68,31,37
Chuppimuñaño,minahonda,816,paladin,holy,133,48,85
Eïnï,kazzak,814,paladin,holy,17,9,8
Manetheren,grim-batol,810,paladin,holy,58,24,34
Mýv,archimonde,809,paladin,holy,199,93,106
Stierchen,aegwynn,809,paladin,holy,28,10,18
Veelris,kazzak,806,paladin,holy,82,37,45
Antrapo,khaz-modan,805,paladin,holy,84,27,57
Iñgkara,tarren-mill,805,paladin,holy,92,29,63
Marcosaurio,stormscale,800,paladin,holy,28,9,19
Старыймачо,howling-fjord,800,paladin,holy,78,23,55
Bbcanalyzed,blackmoore,798,paladin,holy,32,10,22
Котейкинус,blackscar,798,paladin,holy,36,9,27
Lèonarth,pozzo-delleternità,794,paladin,holy,22,10,12
Миллагрессия,soulflayer,793,paladin,holy,155,62,93
Azzael,thrall,786,paladin,holy,54,14,40
Superp,sanguino,780,paladin,holy,26,10,16
Telninio,ravencrest,778,paladin,holy,48,11,37
Ринрэи,howling-fjord,768,paladin,holy,12,8,4
Morthiel,burning-blade,768,paladin,holy,18,8,10
Brindefolie,ravencrest,768,paladin,holy,18,8,10
Isprinsessan,twisting-nether,768,paladin,holy,24,8,16
Léinãd,kazzak,768,paladin,holy,24,8,16
Otush,blackmoore,767,paladin,holy,12,8,4
Tyraïa,archimonde,767,paladin,holy,18,8,10
Qpax,twisting-nether,767,paladin,holy,18,8,10
Micrøsi,thrall,767,paladin,holy,18,8,10
Wingcomander,aegwynn,767,paladin,holy,18,8,10
Ethurospal,tarren-mill,767,paladin,holy,18,8,10
Achtfufzig,eredar,767,paladin,holy,24,8,16
Bjôrnstad,ravencrest,766,paladin,holy,12,8,4
Tytharion,silvermoon,766,paladin,holy,18,8,10
Бебралом,howling-fjord,766,paladin,holy,18,8,10
Thudor,ravencrest,766,paladin,holy,27,9,18
Eggelados,boulderfist,766,paladin,holy,24,8,16
Superkudden,kazzak,765,paladin,holy,18,8,10
Влажныйбоб,soulflayer,765,paladin,holy,18,8,10
Bighammerx,ravencrest,765,paladin,holy,18,8,10
Sterklight,draenor,765,paladin,holy,24,8,16
Спэнсэр,gordunni,764,paladin,holy,12,8,4
Ballefrikase,tarren-mill,764,paladin,holy,24,8,16
Vøøtt,ravencrest,764,paladin,holy,24,8,16
Hölymu,ragnaros,763,paladin,holy,18,8,10
Ganadorie,twisting-nether,763,paladin,holy,30,8,22
Kaelorian,silvermoon,763,paladin,holy,30,8,22
Paintdafence,kazzak,763,paladin,holy,36,8,28
Kiwia,burning-legion,762,paladin,holy,18,8,10
Biót,tarren-mill,762,paladin,holy,24,8,16
Wrede,the-maelstrom,760,paladin,holy,24,8,16
Tenac,confrérie-du-thorium,759,paladin,holy,71,22,49
Mortalitis,tarren-mill,753,paladin,holy,42,8,34
Foshizzlemyn,sylvanas,751,paladin,holy,18,8,10
Pallydoll,doomhammer,750,paladin,holy,30,8,22
Palateh,ysondre,749,paladin,holy,49,8,41
Jeunepadawan,dalaran,744,paladin,holy,22,9,13
Khalicies,archimonde,741,paladin,holy,41,10,31
Vindorus,archimonde,740,paladin,holy,58,18,40
Palabel,blackrock,740,paladin,holy,78,20,58
Drdeus,silvermoon,734,paladin,holy,16,9,7
Gardaken,draenor,732,paladin,holy,29,8,21
Amnésía,twisting-nether,728,paladin,holy,23,8,15
Palolog,burning-legion,723,paladin,holy,85,17,68
Anemonaa,argent-dawn,722,paladin,holy,18,8,10
Sanguiniûs,kirin-tor,720,paladin,holy,20,8,12
Niou,alleria,711,paladin,holy,28,10,18
Jâybee,ravencrest,707,paladin,holy,20,9,11
Genatia,khaz-modan,702,paladin,holy,17,8,9
Lacertosus,nemesis,687,paladin,holy,17,8,9
Аидахо,gordunni,679,paladin,holy,31,12,19
Gigajudge,blackrock,672,paladin,holy,12,7,5
Sínístèr,kazzak,672,paladin,holy,12,7,5
Mearsheimer,ysondre,672,paladin,holy,12,7,5
Gtgpiscine,kirin-tor,672,paladin,holy,12,7,5
Электрокинг,lich-king,672,paladin,holy,12,7,5
Richik,outland,672,paladin,holy,12,7,5
Tharelion,twisting-nether,672,paladin,holy,18,7,11
Tacodin,blackrock,672,paladin,holy,18,7,11
Djalex,kazzak,672,paladin,holy,18,7,11
Dopeé,stormscale,672,paladin,holy,18,7,11
Katsümï,archimonde,672,paladin,holy,30,7,23
Tejbzx,blackmoore,671,paladin,holy,12,7,5
Rápunzél,blackmoore,671,paladin,holy,12,7,5
Цианат,eversong,671,paladin,holy,18,7,11
Íva,twisting-nether,671,paladin,holy,18,7,11
Yrony,gorgonnash,671,paladin,holy,18,7,11
Hampoof,blackrock,671,paladin,holy,18,7,11
Skatiaringos,silvermoon,671,paladin,holy,18,7,11
Хоулик,howling-fjord,671,paladin,holy,18,7,11
Ämkaz,archimonde,671,paladin,holy,18,7,11
Shredyopala,tarren-mill,671,paladin,holy,22,8,14
Linnea,kazzak,671,paladin,holy,24,7,17
Hølymaid,blackmoore,670,paladin,holy,12,7,5
Ownkas,kazzak,670,paladin,holy,12,7,5
Gilgares,twisting-nether,670,paladin,holy,17,7,10
Lele,kazzak,670,paladin,holy,18,7,11
Waldpaladin,malganis,669,paladin,holy,18,7,11
Бладиполи,soulflayer,669,paladin,holy,24,7,17
Kejnen,eredar,668,paladin,holy,18,7,11
Wäsabi,khaz-modan,668,paladin,holy,18,7,11
Kárlsberg,aegwynn,668,paladin,holy,41,15,26
Divinehàmer,hyjal,667,paladin,holy,12,7,5
Unkillablee,stormscale,667,paladin,holy,24,7,17
Рамго,grom,665,paladin,holy,12,7,5
Leadfoot,argent-dawn,665,paladin,holy,24,7,17
Ракнапали,gordunni,661,paladin,holy,12,7,5
Forgottenn,drakthul,660,paladin,holy,12,7,5
Jargot,antonidas,660,paladin,holy,56,23,33
Pjmoncrack,outland,660,paladin,holy,39,11,28
Oswoldio,ravencrest,659,paladin,holy,24,7,17
Slayah,blackmoore,657,paladin,holy,18,7,11
Kubrat,eredar,653,paladin,holy,355,143,212
Lumïnescïa,archimonde,652,paladin,holy,18,7,11
Finpála,kul-tiras,648,paladin,holy,13,9,4
Selì,die-aldor,639,paladin,holy,22,7,15
Bubskispala,ravencrest,638,paladin,holy,14,8,6
Kansenbass,outland,637,paladin,holy,23,7,16
Soulskin,sylvanas,634,paladin,holy,17,7,10
Торсгард,howling-fjord,622,paladin,holy,15,8,7
Yezel,dalaran,621,paladin,holy,17,7,10
Bonsamedi,garona,620,paladin,holy,27,8,19
Djozeeph,burning-legion,618,paladin,holy,11,7,4
Fluentx,ravencrest,618,paladin,holy,22,8,14
Bsepal,silvermoon,605,paladin,holy,26,7,19
Evillight,antonidas,587,paladin,holy,25,7,18
Touchpally,ravencrest,576,paladin,holy,12,6,6
Iîvîl,ravencrest,576,paladin,holy,12,6,6
Kiingen,ragnaros,576,paladin,holy,12,6,6
Vôltuxx,outland,576,paladin,holy,12,6,6
Holyfuchsia,ravencrest,576,paladin,holy,12,6,6
Zunis,ravencrest,576,paladin,holy,12,6,6
Zewéx,stormscale,576,paladin,holy,12,6,6
Ben,ghostlands,576,paladin,holy,12,6,6
Жухолова,howling-fjord,576,paladin,holy,12,6,6
Tereyan,draenor,576,paladin,holy,12,6,6
Ajany,blackmoore,576,paladin,holy,12,6,6
Idontknow,nemesis,576,paladin,holy,12,6,6
Sebrillant,nemesis,576,paladin,holy,12,6,6
Roqu,nathrezim,576,paladin,holy,12,6,6
Nádrüstál,kazzak,576,paladin,holy,12,6,6
Хохахо,howling-fjord,576,paladin,holy,12,6,6
Téssá,sylvanas,576,paladin,holy,12,6,6
Youngkiwi,blackrock,576,paladin,holy,18,6,12
Wladimir,stormreaver,576,paladin,holy,18,6,12
Êzekiel,draenor,576,paladin,holy,18,6,12
Westranspal,ravencrest,576,paladin,holy,18,6,12
Mingleejr,stormscale,576,paladin,holy,25,7,18
Semtexx,antonidas,576,paladin,holy,24,6,18
Amôn,outland,576,paladin,holy,28,6,22
Gulyas,tarren-mill,575,paladin,holy,12,6,6
Cóól,cthun,575,paladin,holy,12,6,6
Redjager,silvermoon,575,paladin,holy,12,6,6
Omgsoholy,stormscale,575,paladin,holy,12,6,6
Rohanan,blackrock,575,paladin,holy,12,6,6
Friendadin,chamber-of-aspects,575,paladin,holy,12,6,6
Zarispal,tarren-mill,575,paladin,holy,12,6,6
Vinmoo,deathwing,575,paladin,holy,12,6,6
Joypal,tarren-mill,575,paladin,holy,12,6,6
Juliebee,blackmoore,575,paladin,holy,12,6,6
Limy,twisting-nether,575,paladin,holy,18,6,12
Pressthere,tarren-mill,575,paladin,holy,18,6,12
Ejoz,suramar,575,paladin,holy,18,6,12
Lichbörnè,outland,575,paladin,holy,18,6,12
Boldi,stormscale,575,paladin,holy,18,6,12
Pussas,burning-legion,575,paladin,holy,18,6,12
Милиуайт,azuregos,575,paladin,holy,24,6,18
Jeyløl,antonidas,574,paladin,holy,12,6,6
Wogtrainer,burning-blade,574,paladin,holy,12,6,6
Эзомус,howling-fjord,574,paladin,holy,12,6,6
Lgz,outland,574,paladin,holy,18,6,12
Béniima,archimonde,574,paladin,holy,23,6,17
Vulgati,kazzak,574,paladin,holy,24,6,18
Holyspike,drakthul,573,paladin,holy,18,6,12
Panzzeur,hyjal,572,paladin,holy,12,6,6
Darthdin,stormscale,572,paladin,holy,12,6,6
Grafes,sanguino,572,paladin,holy,18,6,12
Tnkfrank,ravencrest,572,paladin,holy,18,6,12
Mogettelum,ysondre,571,paladin,holy,12,6,6
Averyholycow,the-maelstrom,570,paladin,holy,12,6,6
Rosemary,mugthol,570,paladin,holy,12,6,6
Kytmna,drakthul,568,paladin,holy,12,6,6
Giggs,turalyon,539,paladin,holy,14,7,7
Nam,culte-de-la-rive-noire,527,paladin,holy,11,6,5
Heavel,thrall,527,paladin,holy,17,6,11
Sinofpride,wrathbringer,520,paladin,holy,17,7,10
Noonebetter,ravencrest,519,paladin,holy,23,7,16
Athàs,ysondre,480,paladin,holy,6,5,1
Teksor,frostmourne,480,paladin,holy,6,5,1
Glymlól,drakthul,480,paladin,holy,6,5,1
Vänëssä,sylvanas,480,paladin,holy,6,5,1
Azælæ,ravencrest,480,paladin,holy,6,5,1
Leonlasvegas,blackrock,480,paladin,holy,6,5,1
Deliveröö,silvermoon,480,paladin,holy,6,5,1
Mokow,chogall,480,paladin,holy,6,5,1
Jínnx,outland,480,paladin,holy,12,5,7
Docoùla,twisting-nether,480,paladin,holy,12,5,7
Glassbaren,draenor,480,paladin,holy,12,5,7
Papichuló,aegwynn,480,paladin,holy,12,5,7
Alennya,dalaran,480,paladin,holy,12,5,7
Tyrella,exodar,480,paladin,holy,12,5,7
Jinchúriki,aegwynn,480,paladin,holy,12,5,7
Ornosh,draenor,480,paladin,holy,12,5,7
Shinesalot,kazzak,480,paladin,holy,12,5,7
Chodegobbler,draenor,480,paladin,holy,12,5,7
Dohmie,twisting-nether,480,paladin,holy,12,5,7
Gijar,ravencrest,480,paladin,holy,12,5,7
Люмиэро,gordunni,480,paladin,holy,12,5,7
Schockx,blackhand,480,paladin,holy,12,5,7
Анягэмбл,soulflayer,480,paladin,holy,12,5,7
Аффикстинка,soulflayer,480,paladin,holy,12,5,7
Ljusmys,stormscale,480,paladin,holy,12,5,7
Înphy,cthun,480,paladin,holy,12,5,7
Kinesen,defias-brotherhood,480,paladin,holy,12,5,7
Justix,arathor,480,paladin,holy,12,5,7
Haterandoms,turalyon,480,paladin,holy,12,5,7
Kroghct,tarren-mill,480,paladin,holy,12,5,7
Faëndel,hyjal,480,paladin,holy,15,6,9
Snoogléface,grim-batol,480,paladin,holy,14,5,9
Jogging,thrall,480,paladin,holy,16,5,11
Zonde,kazzak,480,paladin,holy,18,5,13
Asmaril,rexxar,480,paladin,holy,18,5,13
Conker,malganis,480,paladin,holy,18,5,13
Дюве,blackscar,480,paladin,holy,18,5,13
Marronblade,blackhand,480,paladin,holy,18,5,13
Assÿria,ravencrest,480,paladin,holy,18,5,13
Flamabella,argent-dawn,480,paladin,holy,18,5,13
Ãgra,hyjal,480,paladin,holy,18,5,13
Déstructor,mannoroth,480,paladin,holy,18,5,13
Holydhanas,outland,480,paladin,holy,18,5,13
Холидугги,howling-fjord,480,paladin,holy,18,5,13
Keft,twisting-nether,480,paladin,holy,19,5,14
Omgimapala,kazzak,480,paladin,holy,20,5,15
Ague,spinebreaker,480,paladin,holy,28,6,22
Elfaza,dun-modr,480,paladin,holy,24,5,19
Ilikejudge,blackmoore,480,paladin,holy,30,5,25
Joân,mannoroth,479,paladin,holy,6,5,1
Spacepal,archimonde,479,paladin,holy,12,5,7
Руслаанеш,soulflayer,479,paladin,holy,12,5,7
Малимон,soulflayer,479,paladin,holy,12,5,7
Cabritâ,antonidas,479,paladin,holy,12,5,7
Stinkytoes,draenor,479,paladin,holy,12,5,7
Cfjygzuiqkm,silvermoon,479,paladin,holy,12,5,7
Gavril,bloodfeather,479,paladin,holy,12,5,7
Nidaime,zuljin,479,paladin,holy,12,5,7
Лазуриса,deathguard,479,paladin,holy,12,5,7
Erthelios,silvermoon,479,paladin,holy,17,5,12
Daminika,das-syndikat,479,paladin,holy,18,5,13
Brölin,sanguino,479,paladin,holy,18,5,13
Bellamy,vashj,479,paladin,holy,18,5,13
Dramaria,burning-legion,479,paladin,holy,18,5,13
Sultaani,ravencrest,479,paladin,holy,18,5,13
Лакостик,howling-fjord,479,paladin,holy,24,5,19
Ladodolela,chogall,478,paladin,holy,12,5,7
Âtom,outland,478,paladin,holy,12,5,7
Noukia,ysondre,478,paladin,holy,12,5,7
Bubblegum,dentarg,478,paladin,holy,18,5,13
Рюфэнь,howling-fjord,478,paladin,holy,18,5,13
Lianowar,nemesis,478,paladin,holy,24,5,19
Axone,ravencrest,477,paladin,holy,12,5,7
Lionpic,nemesis,477,paladin,holy,18,5,13
Kaedena,kaelthas,476,paladin,holy,12,5,7
Csalók,bloodscalp,476,paladin,holy,12,5,7
Greenléaf,auchindoun,476,paladin,holy,12,5,7
Grayscale,dun-morogh,476,paladin,holy,18,5,13
Styflor,dalaran,476,paladin,holy,18,5,13
Flameshield,turalyon,476,paladin,holy,24,5,19
Alone,sporeggar,473,paladin,holy,12,5,7
Chasie,antonidas,473,paladin,holy,24,5,19
Hølynøøkîé,antonidas,466,paladin,holy,21,10,11
Лералучшая,gordunni,464,paladin,holy,19,7,12
Preamx,blackrock,463,paladin,holy,17,5,12
Harlight,hyjal,462,paladin,holy,11,5,6
Árcangel,minahonda,447,paladin,holy,17,5,12
Émilia,frostwolf,432,paladin,holy,15,5,10
Unstobubblex,burning-blade,431,paladin,holy,11,5,6
Bämbunga,madmortem,426,paladin,holy,16,6,10
Memewings,tarren-mill,426,paladin,holy,23,7,16
Тейдехан,gordunni,426,paladin,holy,21,6,15
Tressðr,dun-modr,426,paladin,holy,27,6,21
Iive,frostwolf,425,paladin,holy,11,7,4
Liadry,sylvanas,424,paladin,holy,22,6,16
Exødus,defias-brotherhood,414,paladin,holy,14,5,9
Ñnñnñnñnñnñn,stormscale,384,paladin,holy,6,4,2
Pastabianco,ravencrest,384,paladin,holy,6,4,2
Zal,arygos,384,paladin,holy,6,4,2
Wiffy,ravencrest,384,paladin,holy,6,4,2
Kesq,ravencrest,384,paladin,holy,6,4,2
Denounce,defias-brotherhood,384,paladin,holy,6,4,2
Rikiji,ravencrest,384,paladin,holy,6,4,2
Zaystevaa,drakthul,384,paladin,holy,6,4,2
Heilpaladin,blackrock,384,paladin,holy,6,4,2
Sartorius,hyjal,384,paladin,holy,6,4,2
Djcrusade,twisting-nether,384,paladin,holy,6,4,2
Lancelotx,darksorrow,384,paladin,holy,12,4,8
Vhaine,kult-der-verdammten,384,paladin,holy,12,4,8
Vânwêêd,thrall,384,paladin,holy,12,4,8
Sacredx,tarren-mill,384,paladin,holy,12,4,8
Êggsy,grim-batol,384,paladin,holy,12,4,8
Visersion,tarren-mill,384,paladin,holy,12,4,8
Hipokratos,twisting-nether,384,paladin,holy,12,4,8
Arikan,destromath,384,paladin,holy,12,4,8
Brüllt,dun-modr,384,paladin,holy,12,4,8
Riukÿ,nemesis,384,paladin,holy,12,4,8
Victwo,burning-legion,384,paladin,holy,12,4,8
Tyrø,ravencrest,384,paladin,holy,12,4,8
Góò,frostmane,384,paladin,holy,12,4,8
Imitrex,hyjal,384,paladin,holy,12,4,8
Gummypala,kazzak,384,paladin,holy,12,4,8
Rienpalasozz,kazzak,384,paladin,holy,12,4,8
Sebatrøz,ravencrest,384,paladin,holy,12,4,8
Hutson,drakthul,384,paladin,holy,12,4,8
Zixxo,outland,384,paladin,holy,12,4,8
Chopocrisp,dun-modr,384,paladin,holy,12,4,8
Akazâ,ysondre,384,paladin,holy,12,4,8
Kairo,dethecus,384,paladin,holy,12,4,8
Hammarfall,ravencrest,384,paladin,holy,12,4,8
Shockadin,khazgoroth,384,paladin,holy,12,4,8
Yunax,silvermoon,384,paladin,holy,12,4,8
Hølyknicks,thrall,384,paladin,holy,12,4,8
Gunpowderx,silvermoon,384,paladin,holy,12,4,8
Хикз,gordunni,384,paladin,holy,12,4,8
Mooderna,ravencrest,384,paladin,holy,12,4,8
Экстазируй,howling-fjord,384,paladin,holy,12,4,8
Stepmum,stormscale,384,paladin,holy,12,4,8
Bwser,silvermoon,384,paladin,holy,12,4,8
Flashhèart,draenor,384,paladin,holy,12,4,8
Rasmu,kazzak,384,paladin,holy,12,4,8
Jokkepaappa,darksorrow,384,paladin,holy,12,4,8
Fedaikin,stormscale,384,paladin,holy,12,4,8
Crazyclass,outland,384,paladin,holy,14,4,10
Divinemove,stormscale,384,paladin,holy,18,4,14
Талрэн,howling-fjord,384,paladin,holy,18,4,14
Visus,kiljaeden,384,paladin,holy,18,4,14
Przemedron,burning-legion,384,paladin,holy,18,4,14
Cykond,aegwynn,384,paladin,holy,18,4,14
Bigholy,tarren-mill,384,paladin,holy,18,4,14
Лортремар,howling-fjord,384,paladin,holy,18,4,14
Insomnias,silvermoon,384,paladin,holy,18,4,14
Crunchybeef,tarren-mill,384,paladin,holy,18,4,14
Сакон,borean-tundra,384,paladin,holy,18,4,14
Кирюшафридом,gordunni,384,paladin,holy,19,4,15
Taxpayer,aegwynn,384,paladin,holy,24,4,20
Caps,the-venture-co,383,paladin,holy,6,4,2
Steeger,blackhand,383,paladin,holy,6,4,2
Raratina,draenor,383,paladin,holy,6,4,2
Dáìsy,blackmoore,383,paladin,holy,6,4,2
Najir,hyjal,383,paladin,holy,6,4,2
Angellinä,ragnaros,383,paladin,holy,12,4,8
Selaphíel,kazzak,383,paladin,holy,12,4,8
Abdullach,silvermoon,383,paladin,holy,12,4,8
Ênmâ,archimonde,383,paladin,holy,12,4,8
Nostromus,antonidas,383,paladin,holy,12,4,8
Caumon,los-errantes,383,paladin,holy,12,4,8
Anfe,silvermoon,383,paladin,holy,12,4,8
Allesandra,antonidas,383,paladin,holy,12,4,8
Aggressìon,twisting-nether,383,paladin,holy,12,4,8
Uoloop,kazzak,383,paladin,holy,12,4,8
Кэлви,blackscar,383,paladin,holy,12,4,8
Duine,the-venture-co,383,paladin,holy,12,4,8
Toygun,antonidas,383,paladin,holy,12,4,8
Superpaladin,draenor,383,paladin,holy,18,4,14
Nornom,antonidas,383,paladin,holy,18,4,14
Scissors,dun-morogh,383,paladin,holy,18,4,14
Овахус,soulflayer,382,paladin,holy,12,4,8
Nêkro,dun-modr,382,paladin,holy,18,4,14
Theodun,xavius,382,paladin,holy,27,5,22
Ardyl,drakthul,379,paladin,holy,12,4,8
Pyhälehmä,alakir,377,paladin,holy,18,4,14
Konpala,blackmoore,367,paladin,holy,11,4,7
Handsomeguyx,outland,367,paladin,holy,17,4,13
Nolylight,tarren-mill,365,paladin,holy,11,4,7
Justyowx,archimonde,352,paladin,holy,16,5,11
Vergogne,ysondre,351,paladin,holy,20,5,15
Bigxburst,kazzak,330,paladin,holy,15,5,10
Acongojante,zuljin,330,paladin,holy,27,5,22
Onys,onyxia,329,paladin,holy,16,5,11
Ysnee,sanguino,320,paladin,holy,16,4,12
Holydin,argent-dawn,319,paladin,holy,5,4,1
Arshlicht,frostwolf,296,paladin,holy,21,5,16
Tyn,dragonmaw,288,paladin,holy,6,3,3
Trólldii,outland,288,paladin,holy,6,3,3
Mlatimudann,terokkar,288,paladin,holy,6,3,3
Lunalovesyou,blackmoore,288,paladin,holy,6,3,3
Хилвиновен,gordunni,288,paladin,holy,6,3,3
Penthxoxo,outland,288,paladin,holy,6,3,3
Bandrogina,shattered-hand,288,paladin,holy,6,3,3
Zimxao,ravencrest,288,paladin,holy,6,3,3
Xrayzz,tarren-mill,288,paladin,holy,6,3,3
Holynoby,kazzak,288,paladin,holy,6,3,3
Amazja,eredar,288,paladin,holy,6,3,3
Gahar,grim-batol,288,paladin,holy,6,3,3
Thingus,argent-dawn,288,paladin,holy,6,3,3
Vashavi,tarren-mill,288,paladin,holy,6,3,3
Évox,drakthul,288,paladin,holy,6,3,3
Âmba,blackrock,288,paladin,holy,6,3,3
Fenrixlol,shendralar,288,paladin,holy,6,3,3
Belzepal,blackrock,288,paladin,holy,6,3,3
Pilinhás,aggra-português,288,paladin,holy,6,3,3
Solumon,gorgonnash,288,paladin,holy,6,3,3
Lalli,korgall,288,paladin,holy,6,3,3
Rudirumms,die-aldor,288,paladin,holy,6,3,3
Shairin,sylvanas,288,paladin,holy,6,3,3
Naiconpala,kazzak,288,paladin,holy,6,3,3
Hugmonster,twisting-nether,288,paladin,holy,6,3,3
Killiria,kazzak,288,paladin,holy,6,3,3
Neoz,ravencrest,288,paladin,holy,6,3,3
Гиркин,ashenvale,288,paladin,holy,6,3,3
Yungboii,kazzak,288,paladin,holy,6,3,3
Verivertikal,blackmoore,288,paladin,holy,9,4,5
Eruth,ravencrest,288,paladin,holy,8,3,5
Høbz,outland,288,paladin,holy,8,3,5
Awdly,draenor,288,paladin,holy,8,3,5
Lògàn,pozzo-delleternità,288,paladin,holy,9,3,6
Noanoshy,eredar,288,paladin,holy,12,3,9
Bigdamjudge,argent-dawn,288,paladin,holy,12,3,9
Linxo,argent-dawn,288,paladin,holy,12,3,9
Rouge,eredar,288,paladin,holy,12,3,9
Chusterb,draenor,288,paladin,holy,12,3,9
Nÿwa,temple-noir,288,paladin,holy,12,3,9
Arbuzno,draenor,288,paladin,holy,12,3,9
Estellar,bronze-dragonflight,288,paladin,holy,12,3,9
Klumie,silvermoon,288,paladin,holy,12,3,9
Dojamoo,twisting-nether,288,paladin,holy,12,3,9
Sâfcon,eredar,288,paladin,holy,12,3,9
Azthin,outland,288,paladin,holy,12,3,9
Redeem,nemesis,288,paladin,holy,12,3,9
Kelmarr,blackmoore,288,paladin,holy,12,3,9
Lifthorn,twisting-nether,288,paladin,holy,12,3,9
Jctp,ravencrest,288,paladin,holy,12,3,9
Nhum,destromath,288,paladin,holy,12,3,9
Покаяние,howling-fjord,288,paladin,holy,12,3,9
Vissticks,nagrand,288,paladin,holy,12,3,9
Баблейми,gordunni,288,paladin,holy,12,3,9
Specz,ragnaros,288,paladin,holy,12,3,9
Komen,dalaran,288,paladin,holy,12,3,9
Kolts,ragnaros,288,paladin,holy,12,3,9
Zerohour,kilrogg,288,paladin,holy,12,3,9
Гигаиисус,gordunni,288,paladin,holy,12,3,9
Winjina,twisting-nether,288,paladin,holy,12,3,9
Glooni,blackmoore,288,paladin,holy,18,3,15
Offl,eredar,288,paladin,holy,18,3,15
Màti,burning-legion,288,paladin,holy,18,3,15
Pallileuka,ravencrest,288,paladin,holy,18,3,15
Yaldly,dun-modr,288,paladin,holy,18,3,15
Негропаладин,soulflayer,288,paladin,holy,24,3,21
Kickvandoo,blackmoore,287,paladin,holy,6,3,3
Livspartner,twisting-nether,287,paladin,holy,6,3,3
Скрепыш,soulflayer,287,paladin,holy,6,3,3
Drazzill,archimonde,287,paladin,holy,6,3,3
Woopaly,silvermoon,287,paladin,holy,13,4,9
Jellish,argent-dawn,287,paladin,holy,12,3,9
Toxií,argent-dawn,287,paladin,holy,12,3,9
Faustan,rexxar,287,paladin,holy,12,3,9
Järnkroken,tarren-mill,287,paladin,holy,13,3,10
Мерасфард,howling-fjord,287,paladin,holy,18,3,15
Auliæ,chogall,287,paladin,holy,18,3,15
Zàrílâ,dun-morogh,286,paladin,holy,6,3,3
Belgblue,ravenholdt,286,paladin,holy,6,3,3
Lorithias,sargeras,286,paladin,holy,12,3,9
Bkbstormcrow,thrall,286,paladin,holy,12,3,9
Salamaych,ysondre,271,paladin,holy,11,3,8
Sarka,argent-dawn,256,paladin,holy,4,4,0
Studeersnel,twisting-nether,256,paladin,holy,10,3,7
Hitaki,tarren-mill,256,paladin,holy,10,3,7
Keyla,los-errantes,256,paladin,holy,10,3,7
Nothol,malganis,255,paladin,holy,8,4,4
Ланиева,gordunni,240,paladin,holy,15,4,11
Flamxd,blackmoore,234,paladin,holy,10,5,5
Тамерланх,gordunni,234,paladin,holy,9,4,5
Calimmacil,amanthul,234,paladin,holy,14,5,9
Shivèns,archimonde,234,paladin,holy,17,5,12
Bvrlyhills,blackrock,234,paladin,holy,14,4,10
Mustardio,tarren-mill,234,paladin,holy,14,4,10
Dewastør,blackmoore,234,paladin,holy,15,4,11
Хепипал,soulflayer,234,paladin,holy,16,4,12
Zeiserig,antonidas,234,paladin,holy,17,4,13
Faranume,sylvanas,233,paladin,holy,16,4,12
Waltgyubeef,argent-dawn,222,paladin,holy,28,8,20
Andokaî,blackrock,192,paladin,holy,6,2,4
Panomecon,magtheridon,192,paladin,holy,6,2,4
Палжиза,gordunni,192,paladin,holy,6,2,4
Прожектор,gordunni,192,paladin,holy,6,2,4
Генералсвет,gordunni,192,paladin,holy,6,2,4
Teflonmagìc,ravencrest,192,paladin,holy,6,2,4
Wvwwvwvwvwwv,ravencrest,192,paladin,holy,6,2,4
Bígmachine,draenor,192,paladin,holy,6,2,4
Овоссч,soulflayer,192,paladin,holy,6,2,4
Galadrion,dun-modr,192,paladin,holy,6,2,4
Hardfor,ravencrest,192,paladin,holy,6,2,4
Ришардебюр,soulflayer,192,paladin,holy,6,2,4
Eim,moonglade,192,paladin,holy,6,2,4
Атомщица,deathguard,192,paladin,holy,6,2,4
Miastenia,tarren-mill,192,paladin,holy,6,2,4
Rävnev,twisting-nether,192,paladin,holy,6,2,4
Skølir,rashgarroth,192,paladin,holy,6,2,4
Nirvanä,drakthul,192,paladin,holy,6,2,4
Tamarian,frostwhisper,192,paladin,holy,6,2,4
Lafrogge,culte-de-la-rive-noire,192,paladin,holy,6,2,4
Galad,exodar,192,paladin,holy,6,2,4
Bopbacca,stormscale,192,paladin,holy,6,2,4
Freijam,ravencrest,192,paladin,holy,6,2,4
Tîk,stormscale,192,paladin,holy,6,2,4
Pansarplåt,argent-dawn,192,paladin,holy,6,2,4
Duqezx,stormreaver,192,paladin,holy,6,2,4
Yuz,archimonde,192,paladin,holy,6,2,4
Palaneuía,antonidas,192,paladin,holy,6,2,4
Pizigoi,ravencrest,192,paladin,holy,6,2,4
Samyang,stormscale,192,paladin,holy,6,2,4
Хилстинг,howling-fjord,192,paladin,holy,6,2,4
Lompe,karazhan,192,paladin,holy,6,2,4
Bàrlo,kazzak,192,paladin,holy,6,2,4
Rulîx,blackmoore,192,paladin,holy,6,2,4
Durnell,sylvanas,192,paladin,holy,6,2,4
Xirôs,zirkel-des-cenarius,192,paladin,holy,6,2,4
Hezekielh,hyjal,192,paladin,holy,6,2,4
Bubbloseven,archimonde,192,paladin,holy,6,2,4
Темапал,howling-fjord,192,paladin,holy,6,2,4
Essentíal,aegwynn,192,paladin,holy,6,2,4
Poonky,dun-modr,192,paladin,holy,6,2,4
Bubblenoób,kazzak,192,paladin,holy,6,2,4
Elrack,blackhand,192,paladin,holy,6,2,4
Defianze,tarren-mill,192,paladin,holy,6,2,4
Twoßiased,kazzak,192,paladin,holy,6,2,4
Ladika,turalyon,192,paladin,holy,6,2,4
Pagadi,blackhand,192,paladin,holy,6,2,4
Benedikt,stormscale,192,paladin,holy,6,2,4
Lxvideoscom,blackrock,192,paladin,holy,6,2,4
Realdeal,argent-dawn,192,paladin,holy,6,2,4
Uriels,pozzo-delleternità,192,paladin,holy,6,2,4
Palabron,dun-modr,192,paladin,holy,6,2,4
Wtfpalalølz,khaz-modan,192,paladin,holy,6,2,4
Alisonquínn,argent-dawn,192,paladin,holy,6,2,4
Qüizzly,ragnaros,192,paladin,holy,6,2,4
Botaref,kazzak,192,paladin,holy,6,2,4
Dafukx,ragnaros,192,paladin,holy,6,2,4
Whiskeyx,lightbringer,192,paladin,holy,6,2,4
Exploenjoyer,ragnaros,192,paladin,holy,6,2,4
Sulfyra,quelthalas,192,paladin,holy,16,3,13
Faenril,hyjal,192,paladin,holy,11,2,9
Lazyboo,blackrock,192,paladin,holy,12,2,10
Ascendeadqt,kazzak,192,paladin,holy,12,2,10
Pichuflor,sanguino,192,paladin,holy,12,2,10
Uldurin,ravencrest,192,paladin,holy,12,2,10
Iamheal,blackhand,192,paladin,holy,12,2,10
Croptol,dun-modr,192,paladin,holy,12,2,10
Aienest,ragnaros,192,paladin,holy,12,2,10
Krièr,aggra-português,192,paladin,holy,12,2,10
Kÿsse,hyjal,192,paladin,holy,12,2,10
Bubbleslxt,blackmoore,192,paladin,holy,12,2,10
Холидугги,blackscar,192,paladin,holy,12,2,10
Ucu,terokkar,192,paladin,holy,12,2,10
Essina,argent-dawn,192,paladin,holy,12,2,10
Bala,ravenholdt,192,paladin,holy,12,2,10
Égi,azshara,192,paladin,holy,12,2,10
Zeleron,darksorrow,192,paladin,holy,12,2,10
Awer,magtheridon,192,paladin,holy,12,2,10
Týr,forscherliga,192,paladin,holy,12,2,10
Eyesore,malganis,192,paladin,holy,12,2,10
Вишенций,howling-fjord,192,paladin,holy,12,2,10
Bjutiful,silvermoon,192,paladin,holy,15,2,13
Biplas,twisting-nether,192,paladin,holy,18,2,16
Getblessed,rexxar,192,paladin,holy,18,2,16
Mistoflight,sylvanas,192,paladin,holy,18,2,16
Blancucky,kazzak,192,paladin,holy,18,2,16
Harycon,thrall,192,paladin,holy,24,2,22
Liilya,pozzo-delleternità,191,paladin,holy,6,2,4
Secônd,azjolnerub,191,paladin,holy,6,2,4
Tiboeufpéi,archimonde,191,paladin,holy,6,2,4
Zuplex,deathwing,191,paladin,holy,6,2,4
Showjustice,blackmoore,191,paladin,holy,12,2,10
Bulinazor,stormscale,191,paladin,holy,12,2,10
Yums,tarren-mill,186,paladin,holy,14,5,9
Sharn,ravencrest,159,paladin,holy,5,2,3
Orogerrabbit,archimonde,144,paladin,holy,3,3,0
Lightfoot,kazzak,144,paladin,holy,9,2,7
Freyjä,turalyon,138,paladin,holy,9,4,5
Néedbüffs,silvermoon,138,paladin,holy,8,3,5
Spizz,dun-modr,138,paladin,holy,8,3,5
Dacilez,ravencrest,138,paladin,holy,10,3,7
Drylink,kazzak,138,paladin,holy,11,3,8
Альбусор,galakrond,138,paladin,holy,11,3,8
Pïñkñætðøðÿ,tarren-mill,138,paladin,holy,14,3,11
Hotchíck,outland,138,paladin,holy,15,3,12
Водомафия,greymane,96,paladin,holy,6,1,5
Bubbleheart,ahnqiraj,96,paladin,holy,6,1,5
Xaldrèk,silvermoon,96,paladin,holy,6,1,5
Dayr,sylvanas,96,paladin,holy,6,1,5
Xzarat,kazzak,96,paladin,holy,6,1,5
Goatti,lightnings-blade,96,paladin,holy,6,1,5
Bubblebun,kazzak,96,paladin,holy,6,1,5
Bittersweex,stormscale,96,paladin,holy,6,1,5
Orphëus,blackhand,96,paladin,holy,6,1,5
Tacita,nazjatar,96,paladin,holy,6,1,5
Dilly,uldaman,96,paladin,holy,6,1,5
Nyryaa,archimonde,96,paladin,holy,6,1,5
Druidinoob,uldaman,96,paladin,holy,6,1,5
Holysheto,sanguino,96,paladin,holy,6,1,5
Mybadvibes,tarren-mill,96,paladin,holy,6,1,5
Пепсекольный,soulflayer,96,paladin,holy,6,1,5
Jjlxk,kazzak,96,paladin,holy,6,1,5
Vindex,die-nachtwache,96,paladin,holy,6,1,5
Alisthair,tyrande,96,paladin,holy,6,1,5
Belgradee,silvermoon,96,paladin,holy,6,1,5
Sèrgàs,blackhand,96,paladin,holy,6,1,5
Regista,ravencrest,96,paladin,holy,6,1,5
Fumbz,alakir,96,paladin,holy,6,1,5
Iamyellow,silvermoon,96,paladin,holy,6,1,5
Therador,dun-morogh,96,paladin,holy,6,1,5
Kirane,hyjal,96,paladin,holy,6,1,5
Popeadìn,the-maelstrom,96,paladin,holy,6,1,5
Andrøiz,dun-modr,96,paladin,holy,6,1,5
Hasart,tarren-mill,96,paladin,holy,6,1,5
Eàrànël,les-clairvoyants,96,paladin,holy,6,1,5
Zeyz,defias-brotherhood,96,paladin,holy,6,1,5
Playprist,aegwynn,96,paladin,holy,6,1,5
Qpala,quelthalas,96,paladin,holy,6,1,5
Xephiroxus,the-venture-co,96,paladin,holy,6,1,5
Felling,silvermoon,96,paladin,holy,6,1,5
Enriel,temple-noir,96,paladin,holy,6,1,5
Vadheterjag,ravencrest,96,paladin,holy,6,1,5
Hugeragè,stormreaver,96,paladin,holy,6,1,5
Mínara,drakthul,96,paladin,holy,6,1,5
Clarkie,stormscale,96,paladin,holy,6,1,5
Fugll,ravencrest,96,paladin,holy,6,1,5
Tønyx,les-clairvoyants,96,paladin,holy,6,1,5
Éxcèlsior,blackmoore,96,paladin,holy,6,1,5
Rethus,burning-legion,96,paladin,holy,6,1,5
Lommeuld,auchindoun,96,paladin,holy,6,1,5
Хочусметанки,howling-fjord,96,paladin,holy,6,1,5
Kyarï,culte-de-la-rive-noire,96,paladin,holy,6,1,5
Nôxi,garona,96,paladin,holy,6,1,5
Minirempart,khaz-modan,96,paladin,holy,6,1,5
Whatapity,silvermoon,96,paladin,holy,6,1,5
Agorasieya,frostwolf,96,paladin,holy,6,1,5
Lyciha,blackrock,96,paladin,holy,6,1,5
Stingeryar,terokkar,96,paladin,holy,6,1,5
Holyfalls,blackmoore,96,paladin,holy,6,1,5
Razztafari,tarren-mill,96,paladin,holy,6,1,5
Mg,kul-tiras,96,paladin,holy,6,1,5
Buladin,darkspear,96,paladin,holy,6,1,5
Visaria,twisting-nether,96,paladin,holy,6,1,5
Palariaan,defias-brotherhood,96,paladin,holy,6,1,5
Fükdîscláss,ravencrest,96,paladin,holy,6,1,5
Ерфати,gordunni,96,paladin,holy,6,1,5
Thelvadam,blackhand,96,paladin,holy,6,1,5
Sozzerienpal,kazzak,96,paladin,holy,6,1,5
Fatalism,draenor,96,paladin,holy,6,1,5
Crupth,outland,96,paladin,holy,6,1,5
Switchflip,frostmane,96,paladin,holy,6,1,5
Zapeloni,blackmoore,96,paladin,holy,6,1,5
Thatmook,twisting-nether,96,paladin,holy,6,1,5
Asgâroth,chogall,96,paladin,holy,6,1,5
Reøl,blackmoore,96,paladin,holy,6,1,5
Whiskeypal,draenor,96,paladin,holy,6,1,5
Shandju,norgannon,96,paladin,holy,6,1,5
Надеко,howling-fjord,96,paladin,holy,6,1,5
Dedicatèd,draenor,96,paladin,holy,6,1,5
Kimozabie,ravencrest,96,paladin,holy,6,1,5
Shanwipe,thrall,96,paladin,holy,6,1,5
Синерина,blackscar,96,paladin,holy,6,1,5
Shanik,zuljin,96,paladin,holy,8,1,7
Goldenstern,blackhand,96,paladin,holy,12,1,11
Byakkospal,tarren-mill,96,paladin,holy,12,1,11
Mathelac,argent-dawn,96,paladin,holy,12,1,11
Ксаиотх,blackscar,96,paladin,holy,12,1,11
Ahronius,stormscale,96,paladin,holy,12,1,11
Catali,dalaran,96,paladin,holy,12,1,11
Veest,doomhammer,96,paladin,holy,12,1,11
Лейфи,howling-fjord,96,paladin,holy,12,1,11
Mystychock,elune,96,paladin,holy,12,1,11
Trennbolone,outland,96,paladin,holy,12,1,11
Pigma,outland,96,paladin,holy,12,1,11
Fonz,ysondre,96,paladin,holy,12,1,11
Hasler,drakthul,96,paladin,holy,12,1,11
Светиздырки,howling-fjord,96,paladin,holy,12,1,11
Tpaxocvetka,ravencrest,96,paladin,holy,18,1,17
Hancipapa,ragnaros,95,paladin,holy,6,1,5
Callon,das-syndikat,95,paladin,holy,6,1,5
Laidevon,twisting-nether,84,paladin,holy,21,6,15
Fearclass,hyjal,84,paladin,holy,16,4,12
Защешот,gordunni,79,paladin,holy,5,1,4
Shaxxzii,kazzak,79,paladin,holy,5,1,4
Shánnon,twisting-nether,79,paladin,holy,5,1,4
Firfiris,twisting-nether,64,paladin,holy,4,1,3
Champal,hyjal,48,paladin,holy,3,1,2
Ashbtw,outland,48,paladin,holy,3,1,2
Sixqti,blackrock,42,paladin,holy,6,2,4
Envli,ragnaros,42,paladin,holy,10,3,7
Spryxx,draenor,42,paladin,holy,8,2,6
Holymerda,grim-batol,42,paladin,holy,8,2,6
Ìu,draenor,42,paladin,holy,9,2,7
Xpurcica,twisting-nether,42,paladin,holy,10,2,8
Akilës,dun-modr,41,paladin,holy,8,2,6
Aodren,varimathras,41,paladin,holy,8,2,6
Veluj,antonidas,16,paladin,holy,1,1,0
Dobbygotsock,kazzak,9,paladin,holy,17,3,14
Kjn,tarren-mill,2329,paladin,retribution,182,100,82
Syruplol,blackrock,2290,paladin,retribution,243,131,112
Ranitwo,tarren-mill,2271,paladin,retribution,90,53,37
Stracciatell,archimonde,2243,paladin,retribution,121,89,32
Drkp,blackrock,2228,paladin,retribution,73,51,22
Ctierpala,ravencrest,2224,paladin,retribution,96,52,44
Exolix,archimonde,2221,paladin,retribution,96,52,44
Legodudex,ravencrest,2221,paladin,retribution,222,115,107
Mýstíc,ravencrest,2219,paladin,retribution,320,163,157
Suprisexd,ravencrest,2215,paladin,retribution,108,56,52
Pïkachû,ravencrest,2213,paladin,retribution,84,45,39
Bakawolf,burning-legion,2213,paladin,retribution,101,54,47
Exolis,archimonde,2193,paladin,retribution,90,49,41
Синодх,eversong,2189,paladin,retribution,166,86,80
Daveboss,dragonblight,2183,paladin,retribution,84,44,40
Elypsia,tarren-mill,2183,paladin,retribution,351,177,174
Dibzi,argent-dawn,2163,paladin,retribution,90,46,44
Opettaja,ravencrest,2157,paladin,retribution,138,74,64
Синодушка,blackscar,2152,paladin,retribution,106,56,50
Daybreak,kazzak,2146,paladin,retribution,170,85,85
Kriszi,burning-legion,2141,paladin,retribution,206,104,102
Ritoru,drekthar,2139,paladin,retribution,70,39,31
Lättäkamerus,ravencrest,2135,paladin,retribution,175,89,86
Radeto,outland,2134,paladin,retribution,96,51,45
Harridin,ravencrest,2134,paladin,retribution,386,195,191
Cosmicstâr,kazzak,2131,paladin,retribution,234,119,115
Fkadin,kazzak,2130,paladin,retribution,342,184,158
Ðâny,elune,2130,paladin,retribution,141,71,70
Galadrion,dun-modr,2129,paladin,retribution,87,47,40
Royki,the-maelstrom,2127,paladin,retribution,186,95,91
Freshreroll,tarren-mill,2125,paladin,retribution,72,43,29
Ёйхйё,blackscar,2124,paladin,retribution,377,213,164
Miilicium,archimonde,2124,paladin,retribution,107,54,53
Milipal,hyjal,2123,paladin,retribution,90,48,42
Mainôs,ravencrest,2120,paladin,retribution,142,73,69
Loratheon,stormscale,2120,paladin,retribution,84,43,41
Nedith,pozzo-delleternità,2119,paladin,retribution,240,128,112
Âlßêdø,ravencrest,2118,paladin,retribution,201,102,99
Mcret,ravencrest,2118,paladin,retribution,148,74,74
Ultrabenzo,ravencrest,2117,paladin,retribution,139,68,71
Herrius,ravencrest,2116,paladin,retribution,90,45,45
Insanepvplol,archimonde,2115,paladin,retribution,81,45,36
Swahadon,stormscale,2115,paladin,retribution,132,67,65
Vatix,trollbane,2112,paladin,retribution,90,45,45
Wickedwings,silvermoon,2111,paladin,retribution,118,59,59
Retwar,ravencrest,2110,paladin,retribution,107,63,44
Flaapz,hyjal,2109,paladin,retribution,521,284,237
Renaseh,twisting-nether,2108,paladin,retribution,112,57,55
Mcweedy,aegwynn,2108,paladin,retribution,84,42,42
Аеррис,gordunni,2106,paladin,retribution,113,57,56
Matinacc,tarren-mill,2105,paladin,retribution,126,73,53
Соулерт,ashenvale,2103,paladin,retribution,150,82,68
Pog,azshara,2102,paladin,retribution,87,46,41
Eysn,blackrock,2102,paladin,retribution,93,49,44
Sacredwrath,burning-legion,2102,paladin,retribution,147,74,73
Pancakee,the-maelstrom,2101,paladin,retribution,95,52,43
Steelsuit,argent-dawn,2100,paladin,retribution,290,154,136
Peiker,blackrock,2100,paladin,retribution,244,121,123
Bernhoftxd,ravencrest,2099,paladin,retribution,330,164,166
Tadashì,aegwynn,2093,paladin,retribution,108,53,55
Lübu,archimonde,2087,paladin,retribution,120,58,62
Maxes,twisting-nether,2085,paladin,retribution,293,156,137
Shinøaa,wrathbringer,2085,paladin,retribution,263,140,123
Sonne,tarren-mill,2079,paladin,retribution,156,80,76
Отловщик,gordunni,2069,paladin,retribution,130,63,67
Ноулайфир,eversong,2068,paladin,retribution,102,63,39
Perxx,stormscale,2066,paladin,retribution,72,36,36
Альмор,blackscar,2064,paladin,retribution,60,31,29
Стимулин,howling-fjord,2055,paladin,retribution,229,119,110
Drdo,blackrock,2048,paladin,retribution,53,40,13
Блэкхарм,gordunni,2048,paladin,retribution,96,46,50
Bigspin,ravencrest,2044,paladin,retribution,345,175,170
Хадакур,howling-fjord,2044,paladin,retribution,213,107,106
Pestomp,tarren-mill,2042,paladin,retribution,89,43,46
Vabz,blackrock,2041,paladin,retribution,89,44,45
Qshadow,frostwhisper,2038,paladin,retribution,232,114,118
Davewins,dragonblight,2033,paladin,retribution,42,34,8
Rankoneretri,arathor,2032,paladin,retribution,78,42,36
Pallyprinces,dentarg,2030,paladin,retribution,126,59,67
Ricexoxo,blackhand,2029,paladin,retribution,144,70,74
Мэднессх,howling-fjord,2027,paladin,retribution,79,37,42
Zerørespect,ravencrest,2025,paladin,retribution,161,81,80
Clessington,die-aldor,2018,paladin,retribution,81,43,38
Мевар,gordunni,2018,paladin,retribution,154,74,80
Holyhäätz,aegwynn,2017,paladin,retribution,129,70,59
Gìne,archimonde,2017,paladin,retribution,248,126,122
Ðeathron,blackmoore,2012,paladin,retribution,182,93,89
Hotchíck,outland,2012,paladin,retribution,120,61,59
Crysania,twisting-nether,2012,paladin,retribution,78,36,42
Модрит,soulflayer,2011,paladin,retribution,133,83,50
Gluttön,tarren-mill,2011,paladin,retribution,89,47,42
Tsunà,antonidas,2011,paladin,retribution,108,55,53
Smirky,silvermoon,2011,paladin,retribution,72,36,36
Избиватель,soulflayer,2011,paladin,retribution,297,147,150
Milkyavenger,sylvanas,2007,paladin,retribution,139,90,49
Alloüt,outland,2007,paladin,retribution,61,34,27
Ðaegos,blackmoore,2006,paladin,retribution,183,93,90
Марчи,howling-fjord,2005,paladin,retribution,247,123,124
Tròth,twisting-nether,2004,paladin,retribution,66,33,33
Saygexx,draenor,2003,paladin,retribution,74,43,31
Ibnkrook,archimonde,2003,paladin,retribution,78,39,39
Кэйно,soulflayer,1999,paladin,retribution,93,42,51
Jinchúriki,aegwynn,1997,paladin,retribution,144,75,69
Bigducc,draenor,1997,paladin,retribution,84,40,44
Jualom,colinas-pardas,1995,paladin,retribution,134,70,64
Unholybeefs,draenor,1994,paladin,retribution,78,47,31
Møøgødx,bronzebeard,1993,paladin,retribution,228,110,118
Мрч,howling-fjord,1992,paladin,retribution,66,34,32
Tpainjr,kazzak,1991,paladin,retribution,78,40,38
Franclovis,hyjal,1991,paladin,retribution,81,36,45
Palior,sylvanas,1990,paladin,retribution,84,44,40
Ниашес,howling-fjord,1988,paladin,retribution,129,59,70
Ollebala,ravencrest,1987,paladin,retribution,196,115,81
Zarrex,blackrock,1987,paladin,retribution,72,37,35
Rettalius,ravencrest,1985,paladin,retribution,297,153,144
Elganor,hyjal,1983,paladin,retribution,163,102,61
Sofhiya,silvermoon,1982,paladin,retribution,72,41,31
Galaadh,archimonde,1981,paladin,retribution,96,44,52
Beautýbeast,ravencrest,1977,paladin,retribution,227,117,110
Tavil,sylvanas,1975,paladin,retribution,95,59,36
Réfractio,die-aldor,1975,paladin,retribution,186,96,90
Kírin,drakthul,1975,paladin,retribution,124,62,62
Xourens,twisting-nether,1975,paladin,retribution,139,65,74
Skyrose,ravencrest,1968,paladin,retribution,270,147,123
Васапрагиб,howling-fjord,1966,paladin,retribution,156,88,68
Kazuroo,blackmoore,1966,paladin,retribution,132,70,62
Hornyret,kazzak,1966,paladin,retribution,152,78,74
Nîhil,silvermoon,1966,paladin,retribution,154,75,79
Elisight,ravencrest,1963,paladin,retribution,108,61,47
Kasualwrath,stormscale,1963,paladin,retribution,84,45,39
Ufø,magtheridon,1963,paladin,retribution,241,118,123
Babyboo,aggra-português,1961,paladin,retribution,108,53,55
Lazaraat,antonidas,1960,paladin,retribution,131,63,68
Fullsendbro,ravencrest,1959,paladin,retribution,149,83,66
Yungboihoj,twisting-nether,1959,paladin,retribution,359,182,177
Biggerspin,ravencrest,1957,paladin,retribution,36,28,8
Fwb,xavius,1957,paladin,retribution,132,81,51
Гуэргос,gordunni,1957,paladin,retribution,90,50,40
Brassaren,stormscale,1955,paladin,retribution,78,42,36
Xillindion,blackhand,1955,paladin,retribution,314,158,156
Valkûn,rexxar,1955,paladin,retribution,114,55,59
Retbùll,stormscale,1954,paladin,retribution,43,31,12
Argentø,ravencrest,1954,paladin,retribution,299,167,132
Mezor,dun-modr,1954,paladin,retribution,337,169,168
Запалтосик,blackscar,1952,paladin,retribution,42,25,17
Greywords,silvermoon,1952,paladin,retribution,53,30,23
Chyve,tarren-mill,1952,paladin,retribution,216,107,109
Exolie,archimonde,1950,paladin,retribution,60,32,28
Хохахо,howling-fjord,1950,paladin,retribution,167,89,78
Холиврас,gordunni,1950,paladin,retribution,120,61,59
Prex,dun-modr,1948,paladin,retribution,72,39,33
Алепос,soulflayer,1947,paladin,retribution,186,87,99
Jowanno,stormscale,1944,paladin,retribution,165,84,81
Синодушка,howling-fjord,1943,paladin,retribution,72,32,40
Morri,ravencrest,1940,paladin,retribution,249,126,123
Esito,draenor,1938,paladin,retribution,124,63,61
Тардариус,gordunni,1937,paladin,retribution,90,42,48
Агинон,howling-fjord,1936,paladin,retribution,78,46,32
Sorannian,hyjal,1936,paladin,retribution,257,122,135
Claymore,ravenholdt,1936,paladin,retribution,77,36,41
Хемминг,gordunni,1935,paladin,retribution,131,81,50
Zscrew,nemesis,1935,paladin,retribution,48,27,21
Iagö,argent-dawn,1935,paladin,retribution,95,48,47
Bigdblaster,twisting-nether,1935,paladin,retribution,102,49,53
Nyxbane,kazzak,1935,paladin,retribution,72,33,39
Dízeltekurva,ragnaros,1933,paladin,retribution,89,45,44
Rqd,blackrock,1932,paladin,retribution,60,34,26
Spacknas,blackmoore,1931,paladin,retribution,110,62,48
Granfort,argent-dawn,1930,paladin,retribution,131,67,64
Нейтхигерс,howling-fjord,1930,paladin,retribution,104,52,52
Denastys,nemesis,1930,paladin,retribution,120,59,61
Tj,dun-modr,1930,paladin,retribution,152,70,82
Aetecii,archimonde,1929,paladin,retribution,51,40,11
Азерит,galakrond,1929,paladin,retribution,66,37,29
Pepehands,nazjatar,1929,paladin,retribution,90,48,42
Valterus,burning-legion,1929,paladin,retribution,252,130,122
Gimly,anachronos,1926,paladin,retribution,368,180,188
Îiî,archimonde,1923,paladin,retribution,104,53,51
Арморих,gordunni,1922,paladin,retribution,70,37,33
Dragonwingz,kazzak,1919,paladin,retribution,64,39,25
Анофарин,gordunni,1919,paladin,retribution,285,145,140
Denounce,defias-brotherhood,1919,paladin,retribution,110,53,57
Lightstorm,voljin,1919,paladin,retribution,78,36,42
Xeaa,tarren-mill,1918,paladin,retribution,54,28,26
Йёкипавер,gordunni,1917,paladin,retribution,58,36,22
Yungboii,kazzak,1917,paladin,retribution,209,118,91
Carlá,silvermoon,1917,paladin,retribution,96,48,48
Rmpzeroskill,argent-dawn,1916,paladin,retribution,42,29,13
Inkzen,silvermoon,1916,paladin,retribution,124,62,62
Charcoalman,argent-dawn,1915,paladin,retribution,36,28,8
Babaluga,blackrock,1913,paladin,retribution,60,32,28
Pâsla,hyjal,1913,paladin,retribution,312,159,153
Kêkbûrâgol,kazzak,1912,paladin,retribution,94,50,44
Nabbi,ravencrest,1912,paladin,retribution,206,96,110
Агинон,gordunni,1911,paladin,retribution,168,82,86
Nastalia,elune,1910,paladin,retribution,200,104,96
Мегопалл,blackscar,1910,paladin,retribution,236,117,119
ßancu,ragnaros,1910,paladin,retribution,88,40,48
Exolia,archimonde,1909,paladin,retribution,60,33,27
Obackbarama,outland,1909,paladin,retribution,72,37,35
Msharix,kazzak,1909,paladin,retribution,286,143,143
Tj,sanguino,1908,paladin,retribution,84,40,44
Mélli,eredar,1907,paladin,retribution,105,58,47
Kriszaa,burning-legion,1907,paladin,retribution,126,58,68
Sigmud,turalyon,1906,paladin,retribution,78,46,32
Serberen,ravencrest,1905,paladin,retribution,66,31,35
Riyo,twisting-nether,1905,paladin,retribution,60,27,33
Vadya,ravencrest,1904,paladin,retribution,701,355,346
Døgpaladin,outland,1903,paladin,retribution,77,39,38
Lorex,grim-batol,1903,paladin,retribution,66,33,33
Krýptø,ravencrest,1903,paladin,retribution,66,26,40
Mouku,stormreaver,1902,paladin,retribution,220,113,107
Mekluba,twisting-nether,1900,paladin,retribution,54,27,27
Byths,blackmoore,1900,paladin,retribution,238,114,124
Меварх,howling-fjord,1898,paladin,retribution,48,23,25
Littlelíght,silvermoon,1897,paladin,retribution,220,110,110
Kreozz,destromath,1897,paladin,retribution,103,48,55
Aresdin,blackmoore,1896,paladin,retribution,77,44,33
Nlyrld,magtheridon,1896,paladin,retribution,66,36,30
Melantus,eredar,1895,paladin,retribution,111,56,55
Knøp,outland,1895,paladin,retribution,116,56,60
Pappnas,aegwynn,1894,paladin,retribution,60,37,23
Холирайз,gordunni,1894,paladin,retribution,42,21,21
Honorkill,silvermoon,1892,paladin,retribution,298,168,130
Jedzy,ragnaros,1892,paladin,retribution,48,26,22
Hammerzemall,tarren-mill,1892,paladin,retribution,77,39,38
Ças,quelthalas,1892,paladin,retribution,84,39,45
Декионзхц,howling-fjord,1892,paladin,retribution,138,61,77
Джедай,blackscar,1892,paladin,retribution,114,50,64
Мува,soulflayer,1891,paladin,retribution,116,60,56
Angryturk,ravencrest,1891,paladin,retribution,54,23,31
Knoxblue,tarren-mill,1890,paladin,retribution,134,67,67
Darkkissret,lightbringer,1889,paladin,retribution,108,54,54
Xòtrios,argent-dawn,1888,paladin,retribution,72,38,34
Smilé,sylvanas,1888,paladin,retribution,150,76,74
Doomsoom,kazzak,1885,paladin,retribution,58,37,21
Hódle,silvermoon,1885,paladin,retribution,163,89,74
Ðeusvult,draenor,1885,paladin,retribution,108,57,51
Sonne,kazzak,1885,paladin,retribution,66,30,36
Smirk,aggra-português,1884,paladin,retribution,161,76,85
Askenor,blackrock,1884,paladin,retribution,77,36,41
Hojinson,blackrock,1883,paladin,retribution,60,39,21
Holzer,azshara,1883,paladin,retribution,71,40,31
Wingsmode,kazzak,1883,paladin,retribution,124,56,68
Phaewingsftw,kazzak,1882,paladin,retribution,60,30,30
Ilealstras,twisting-nether,1882,paladin,retribution,56,23,33
Толвард,gordunni,1881,paladin,retribution,25,21,4
Baxuz,draenor,1880,paladin,retribution,76,38,38
Кхабелех,howling-fjord,1880,paladin,retribution,114,50,64
Сотранокинг,soulflayer,1878,paladin,retribution,48,23,25
Davoss,outland,1878,paladin,retribution,69,30,39
Rikimâro,kazzak,1876,paladin,retribution,30,20,10
Номос,soulflayer,1875,paladin,retribution,84,49,35
Antimov,twisting-nether,1875,paladin,retribution,162,81,81
Neiiz,ragnaros,1874,paladin,retribution,185,90,95
Ганка,blackscar,1874,paladin,retribution,131,57,74
Apolloos,grim-batol,1873,paladin,retribution,89,40,49
Pætter,aggra-português,1872,paladin,retribution,72,40,32
Elbígotes,dun-modr,1870,paladin,retribution,90,51,39
Батллграунд,soulflayer,1870,paladin,retribution,108,61,47
Nam,culte-de-la-rive-noire,1869,paladin,retribution,84,41,43
Yuber,ravencrest,1869,paladin,retribution,140,66,74
Retforlife,sylvanas,1868,paladin,retribution,48,28,20
Малиновыйбох,gordunni,1868,paladin,retribution,213,117,96
Verbrännter,grim-batol,1867,paladin,retribution,130,69,61
Miru,defias-brotherhood,1867,paladin,retribution,114,53,61
Timmes,blackhand,1867,paladin,retribution,101,45,56
Дэнискарз,gordunni,1866,paladin,retribution,48,26,22
Whitebronco,tarren-mill,1866,paladin,retribution,60,29,31
Purgebop,ravencrest,1865,paladin,retribution,116,69,47
Thyrec,blackmoore,1865,paladin,retribution,54,32,22
Mögräine,grim-batol,1865,paladin,retribution,84,42,42
Охоху,gordunni,1864,paladin,retribution,173,96,77
Holymerda,grim-batol,1864,paladin,retribution,65,36,29
Gùtz,xavius,1864,paladin,retribution,86,47,39
Foreskinx,draenor,1863,paladin,retribution,48,28,20
Hammarfall,ravencrest,1863,paladin,retribution,156,88,68
Тутн,gordunni,1863,paladin,retribution,66,37,29
Rígel,silvermoon,1863,paladin,retribution,106,58,48
Weekly,outland,1863,paladin,retribution,42,22,20
Zïlda,archimonde,1863,paladin,retribution,447,233,214
Tìberias,blackmoore,1863,paladin,retribution,54,25,29
Nellyrld,stormscale,1863,paladin,retribution,95,41,54
Nutqtgodx,archimonde,1861,paladin,retribution,66,33,33
Oliverrar,blackrock,1861,paladin,retribution,90,44,46
Киото,gordunni,1861,paladin,retribution,54,24,30
Terrozina,stormscale,1860,paladin,retribution,53,28,25
Nizzlee,eredar,1860,paladin,retribution,120,59,61
Thedarksteel,ravencrest,1860,paladin,retribution,76,37,39
Günykoloke,blackrock,1859,paladin,retribution,108,52,56
Bregowine,doomhammer,1857,paladin,retribution,291,163,128
Icekissz,hyjal,1856,paladin,retribution,30,23,7
Kinvqt,tarren-mill,1856,paladin,retribution,130,68,62
Phalex,outland,1855,paladin,retribution,102,53,49
Мэибибэиби,howling-fjord,1855,paladin,retribution,174,90,84
Tazken,tarren-mill,1855,paladin,retribution,190,93,97
Kaleyra,argent-dawn,1855,paladin,retribution,89,38,51
Валендил,gordunni,1854,paladin,retribution,72,39,33
Эвангер,gordunni,1854,paladin,retribution,72,35,37
Vanthael,chamber-of-aspects,1853,paladin,retribution,201,115,86
Smackhammer,tarren-mill,1853,paladin,retribution,48,25,23
Gladiator,die-aldor,1853,paladin,retribution,96,48,48
Zóran,kazzak,1852,paladin,retribution,93,46,47
Calaestra,twisting-nether,1852,paladin,retribution,108,53,55
Monaatamis,kazzak,1852,paladin,retribution,66,30,36
Losër,ravencrest,1852,paladin,retribution,78,30,48
Jicob,ravencrest,1851,paladin,retribution,48,30,18
Zion,runetotem,1851,paladin,retribution,42,25,17
Deriøt,dun-modr,1851,paladin,retribution,179,96,83
Elisabeth,kazzak,1851,paladin,retribution,118,61,57
Dasar,twisting-nether,1851,paladin,retribution,72,31,41
Súnshìne,blackhand,1850,paladin,retribution,42,29,13
Сынбогов,gordunni,1850,paladin,retribution,90,50,40
Утипутя,goldrinn,1850,paladin,retribution,102,53,49
Jessrabit,tarren-mill,1850,paladin,retribution,84,40,44
Enîgmä,ravencrest,1850,paladin,retribution,82,33,49
Rùuru,archimonde,1849,paladin,retribution,330,157,173
Mcrunt,ravencrest,1848,paladin,retribution,35,27,8
Yana,blackrock,1848,paladin,retribution,55,32,23
Malapal,hyjal,1848,paladin,retribution,64,37,27
Caladys,silvermoon,1848,paladin,retribution,135,76,59
Muhnnin,archimonde,1848,paladin,retribution,78,41,37
Darkkissx,lightbringer,1847,paladin,retribution,54,26,28
Cheradin,ragnaros,1847,paladin,retribution,73,35,38
Oslopal,stormscale,1847,paladin,retribution,76,36,40
Ксандэр,soulflayer,1846,paladin,retribution,47,27,20
Estellar,bronze-dragonflight,1846,paladin,retribution,213,117,96
Winkz,rajaxx,1846,paladin,retribution,102,51,51
Jacadin,sunstrider,1845,paladin,retribution,80,47,33
Kaileena,archimonde,1845,paladin,retribution,71,41,30
Wickedret,kazzak,1845,paladin,retribution,69,35,34
Беспощадие,gordunni,1844,paladin,retribution,117,67,50
Chuy,burning-legion,1844,paladin,retribution,72,32,40
Ykzy,hyjal,1843,paladin,retribution,42,28,14
Saedrick,nemesis,1843,paladin,retribution,123,60,63
Misú,ravencrest,1843,paladin,retribution,60,29,31
Nein,blackhand,1843,paladin,retribution,192,92,100
Karnabahar,twisting-nether,1843,paladin,retribution,42,20,22
Rullatôrsven,stormscale,1843,paladin,retribution,66,28,38
Ethurospal,tarren-mill,1843,paladin,retribution,51,21,30
Drhammerdin,antonidas,1842,paladin,retribution,66,31,35
Якунии,blackscar,1841,paladin,retribution,54,30,24
Namapala,silvermoon,1841,paladin,retribution,161,86,75
Alatàríèl,dalaran,1841,paladin,retribution,96,51,45
Стьюпидбой,howling-fjord,1841,paladin,retribution,234,119,115
Courage,stormscale,1841,paladin,retribution,137,68,69
Блэканус,blackscar,1841,paladin,retribution,75,35,40
Bloodaxjr,archimonde,1840,paladin,retribution,244,136,108
Lïnea,aegwynn,1840,paladin,retribution,48,25,23
Saiyaan,silvermoon,1840,paladin,retribution,120,59,61
Eimaqt,stormscale,1840,paladin,retribution,76,35,41
Ijudgeppl,stormscale,1839,paladin,retribution,60,33,27
Lbj,eredar,1839,paladin,retribution,48,26,22
Ревирант,gordunni,1839,paladin,retribution,63,33,30
Halevia,kazzak,1839,paladin,retribution,107,54,53
Lecutus,sunstrider,1839,paladin,retribution,149,72,77
Stepakonch,ravencrest,1838,paladin,retribution,96,52,44
Sitekx,burning-legion,1838,paladin,retribution,186,84,102
Panicmaker,ravencrest,1837,paladin,retribution,90,59,31
Phix,outland,1837,paladin,retribution,231,113,118
Ghosti,festung-der-stürme,1837,paladin,retribution,60,29,31
Actionjack,area-52,1837,paladin,retribution,78,36,42
Ilòvekris,draenor,1836,paladin,retribution,249,126,123
Ophillan,draenor,1835,paladin,retribution,72,34,38
Murkyxd,sanguino,1835,paladin,retribution,66,30,36
Stjeans,kazzak,1834,paladin,retribution,78,55,23
Vankwok,stormscale,1834,paladin,retribution,53,30,23
Ruath,xavius,1834,paladin,retribution,202,107,95
Bajheeroth,kazzak,1833,paladin,retribution,117,72,45
Инфернох,howling-fjord,1833,paladin,retribution,236,124,112
Netharia,antonidas,1833,paladin,retribution,132,66,66
Miriokekw,archimonde,1833,paladin,retribution,180,80,100
Lesterqt,thrall,1832,paladin,retribution,186,92,94
Draìgo,nemesis,1832,paladin,retribution,115,56,59
Miju,blackmoore,1831,paladin,retribution,51,28,23
Danrock,ravencrest,1831,paladin,retribution,65,34,31
Aranael,nemesis,1831,paladin,retribution,66,32,34
Sloug,archimonde,1831,paladin,retribution,108,48,60
Blacked,baelgun,1830,paladin,retribution,39,21,18
Lightlogic,ravencrest,1830,paladin,retribution,104,52,52
Skyf,outland,1830,paladin,retribution,102,44,58
Shârâs,kazzak,1829,paladin,retribution,108,51,57
Youmistpew,antonidas,1829,paladin,retribution,72,28,44
Аниф,ashenvale,1828,paladin,retribution,240,126,114
Аполодориан,gordunni,1828,paladin,retribution,144,71,73
Лиспорий,gordunni,1828,paladin,retribution,102,48,54
Monkeytm,archimonde,1828,paladin,retribution,98,42,56
Sántouryu,ravencrest,1827,paladin,retribution,448,230,218
Dréamypie,silvermoon,1827,paladin,retribution,65,26,39
Tembe,draenor,1826,paladin,retribution,59,27,32
Bigdamjudgee,outland,1825,paladin,retribution,53,28,25
Tremelay,silvermoon,1825,paladin,retribution,240,122,118
Zazalamel,hyjal,1824,paladin,retribution,102,58,44
Zagwan,ravencrest,1824,paladin,retribution,90,51,39
Alatie,dentarg,1824,paladin,retribution,156,85,71
Wellmetqt,aegwynn,1824,paladin,retribution,146,73,73
Ajani,la-croisade-écarlate,1823,paladin,retribution,45,25,20
Игры,gordunni,1823,paladin,retribution,76,39,37
Zubxp,ravencrest,1823,paladin,retribution,189,96,93
Рикшак,howling-fjord,1823,paladin,retribution,63,31,32
Keinah,silvermoon,1822,paladin,retribution,54,36,18
Retaxx,outland,1822,paladin,retribution,54,33,21
Auriuss,defias-brotherhood,1822,paladin,retribution,237,131,106
Retlikeme,ravencrest,1822,paladin,retribution,76,38,38
Ríppex,kazzak,1822,paladin,retribution,66,33,33
Окилан,gordunni,1822,paladin,retribution,74,34,40
Eskanor,kilrogg,1821,paladin,retribution,56,36,20
Stavrosy,outland,1821,paladin,retribution,107,52,55
Xairo,twisting-nether,1821,paladin,retribution,60,29,31
Posttal,aggra-português,1821,paladin,retribution,48,23,25
Ërzã,outland,1821,paladin,retribution,72,31,41
Тельбрук,gordunni,1820,paladin,retribution,73,39,34
Coldcuts,sylvanas,1820,paladin,retribution,102,47,55
Aaes,argent-dawn,1819,paladin,retribution,95,65,30
Koly,dun-modr,1819,paladin,retribution,152,84,68
Arígato,argent-dawn,1819,paladin,retribution,173,95,78
Дюрьвючыф,razuvious,1819,paladin,retribution,143,74,69
Zondãn,blackrock,1819,paladin,retribution,54,27,27
Âtlas,ragnaros,1819,paladin,retribution,48,24,24
Kamata,kazzak,1819,paladin,retribution,93,44,49
Воркаллес,gordunni,1818,paladin,retribution,220,130,90
Feelmylight,tarren-mill,1818,paladin,retribution,53,27,26
Wingsgodx,archimonde,1818,paladin,retribution,60,28,32
Astragore,archimonde,1818,paladin,retribution,95,42,53
Кошкотяночка,ashenvale,1818,paladin,retribution,54,23,31
Rullatorsvèn,stormscale,1818,paladin,retribution,66,28,38
Nikkibenzqt,blackmoore,1818,paladin,retribution,84,35,49
Quelän,draenor,1817,paladin,retribution,47,29,18
Odin,silvermoon,1817,paladin,retribution,104,58,46
Hirako,nemesis,1817,paladin,retribution,72,39,33
Larnbert,argent-dawn,1817,paladin,retribution,66,34,32
Bjornulfr,ravencrest,1817,paladin,retribution,160,78,82
Menephannt,outland,1817,paladin,retribution,69,32,37
Фэйсрол,gordunni,1817,paladin,retribution,93,37,56
Shaniquua,dun-modr,1816,paladin,retribution,84,41,43
Алекхей,gordunni,1816,paladin,retribution,92,38,54
Geilershrimp,blackrock,1815,paladin,retribution,201,102,99
Madmartigane,ysondre,1815,paladin,retribution,114,48,66
Фемдом,blackscar,1814,paladin,retribution,48,27,21
Tepowze,twisting-nether,1814,paladin,retribution,54,30,24
Valnyr,the-maelstrom,1814,paladin,retribution,121,64,57
Hargreeve,ravencrest,1813,paladin,retribution,102,57,45
Déna,draenor,1813,paladin,retribution,52,29,23
Ktk,ravencrest,1813,paladin,retribution,121,67,54
Пинкпуссибой,howling-fjord,1813,paladin,retribution,142,77,65
Kårnaj,archimonde,1813,paladin,retribution,67,35,32
Wellick,ravencrest,1813,paladin,retribution,47,24,23
Bancu,outland,1813,paladin,retribution,59,30,29
Archibäld,silvermoon,1812,paladin,retribution,49,27,22
Bangßros,archimonde,1812,paladin,retribution,60,33,27
Quasimod,ravencrest,1812,paladin,retribution,138,75,63
Djuwuu,twisting-nether,1812,paladin,retribution,62,30,32
Батллграунт,soulflayer,1811,paladin,retribution,205,122,83
Wingzy,hyjal,1811,paladin,retribution,116,57,59
Bulkpwders,burning-legion,1811,paladin,retribution,66,31,35
Коварное,borean-tundra,1810,paladin,retribution,66,36,30
Reth,tarren-mill,1810,paladin,retribution,60,32,28
Mythsion,blackmoore,1810,paladin,retribution,96,49,47
Baelwynn,defias-brotherhood,1810,paladin,retribution,59,30,29
Ironquist,doomhammer,1809,paladin,retribution,42,22,20
Io,frostwolf,1809,paladin,retribution,257,133,124
Thun,azjolnerub,1809,paladin,retribution,72,37,35
Nordiusek,drakthul,1809,paladin,retribution,64,31,33
Nerrona,silvermoon,1809,paladin,retribution,90,41,49
Amburet,kazzak,1809,paladin,retribution,42,19,23
Zayaka,ragnaros,1809,paladin,retribution,120,51,69
Модрес,soulflayer,1808,paladin,retribution,37,24,13
Saintseiya,pozzo-delleternità,1808,paladin,retribution,60,33,27
Spiritbreak,archimonde,1808,paladin,retribution,54,29,25
Djrayk,archimonde,1808,paladin,retribution,42,22,20
Mâttyy,stormscale,1808,paladin,retribution,66,29,37
Tolgerias,twisting-nether,1807,paladin,retribution,78,39,39
Ertheus,argent-dawn,1807,paladin,retribution,72,34,38
Джамбит,howling-fjord,1806,paladin,retribution,72,45,27
Tivv,blackhand,1806,paladin,retribution,53,28,25
Магрейм,gordunni,1806,paladin,retribution,89,41,48
Kewell,dun-modr,1806,paladin,retribution,66,30,36
Kiriel,dun-modr,1806,paladin,retribution,144,65,79
Réaxon,archimonde,1806,paladin,retribution,69,30,39
Ookleb,tarren-mill,1805,paladin,retribution,120,60,60
Matriarchxd,kazzak,1805,paladin,retribution,48,24,24
Vhardan,archimonde,1805,paladin,retribution,209,104,105
Geneundreitt,dethecus,1805,paladin,retribution,54,26,28
Krîstal,aegwynn,1805,paladin,retribution,77,33,44
Taneren,argent-dawn,1804,paladin,retribution,48,29,19
Heiimdal,dun-morogh,1804,paladin,retribution,46,26,20
Tsorig,tarren-mill,1804,paladin,retribution,177,98,79
Wingsbtw,archimonde,1804,paladin,retribution,78,41,37
Летвамар,gordunni,1804,paladin,retribution,162,82,80
Торсгард,howling-fjord,1804,paladin,retribution,243,113,130
Aqualisse,hyjal,1804,paladin,retribution,66,30,36
Zey,auchindoun,1804,paladin,retribution,66,29,37
Facerøll,silvermoon,1803,paladin,retribution,79,53,26
Wannabis,twisting-nether,1803,paladin,retribution,179,99,80
Umîrînbrah,twisting-nether,1803,paladin,retribution,147,80,67
Racduck,dunemaul,1803,paladin,retribution,160,85,75
Qpala,quelthalas,1803,paladin,retribution,36,19,17
Crîîngêr,blackhand,1803,paladin,retribution,86,42,44
Breakdøwñ,blackrock,1803,paladin,retribution,196,93,103
Ogpullava,sylvanas,1802,paladin,retribution,60,34,26
Boëndil,ravencrest,1802,paladin,retribution,189,106,83
Loani,dalaran,1802,paladin,retribution,60,33,27
Атмх,soulflayer,1802,paladin,retribution,54,28,26
Antou,twisting-nether,1802,paladin,retribution,211,108,103
Meruem,blackrock,1802,paladin,retribution,53,26,27
Xsÿde,archimonde,1802,paladin,retribution,128,59,69
Elesmerias,dalaran,1801,paladin,retribution,107,65,42
Seraphyonhd,blackmoore,1801,paladin,retribution,163,93,70
Shanice,twilights-hammer,1801,paladin,retribution,83,47,36
Thoriz,elune,1801,paladin,retribution,84,43,41
Всеволорд,howling-fjord,1801,paladin,retribution,72,36,36
Brõw,hyjal,1801,paladin,retribution,42,21,21
Martoretard,archimonde,1801,paladin,retribution,430,212,218
Bluehustler,tarren-mill,1801,paladin,retribution,189,90,99
Brudiwinkler,blackrock,1800,paladin,retribution,60,39,21
Nurti,kazzak,1800,paladin,retribution,88,50,38
Retdead,nordrassil,1800,paladin,retribution,60,32,28
Delgato,kazzak,1800,paladin,retribution,152,80,72
Alphaladin,stormscale,1800,paladin,retribution,72,37,35
Лакостик,howling-fjord,1800,paladin,retribution,156,78,78
Zachäus,kirin-tor,1800,paladin,retribution,114,57,57
Råckamoo,emerald-dream,1800,paladin,retribution,100,45,55
Tauskiz,sylvanas,1800,paladin,retribution,48,19,29
Мидэас,gordunni,1798,paladin,retribution,96,44,52
Aylion,blackrock,1797,paladin,retribution,66,45,21
Maybach,onyxia,1797,paladin,retribution,186,100,86
Хашон,gordunni,1797,paladin,retribution,60,32,28
Mbappê,kazzak,1796,paladin,retribution,66,29,37
Телканапалке,blackscar,1795,paladin,retribution,48,35,13
Wingsteak,draenor,1795,paladin,retribution,83,44,39
Papichuló,aegwynn,1794,paladin,retribution,96,45,51
Kotnusher,blackrock,1793,paladin,retribution,36,21,15
Cappy,twisting-nether,1793,paladin,retribution,85,49,36
Ilililì,silvermoon,1792,paladin,retribution,58,34,24
Zialo,ravencrest,1792,paladin,retribution,99,44,55
Drownlord,eredar,1789,paladin,retribution,70,36,34
Sunhalo,twisting-nether,1789,paladin,retribution,101,51,50
Pridehammer,stormscale,1788,paladin,retribution,48,31,17
Eiennoai,argent-dawn,1788,paladin,retribution,91,57,34
Kayllan,ravencrest,1788,paladin,retribution,182,100,82
Allenn,tarren-mill,1788,paladin,retribution,65,31,34
Iurim,blackmoore,1787,paladin,retribution,24,19,5
Risingfi,kult-der-verdammten,1787,paladin,retribution,84,48,36
Tanny,kazzak,1787,paladin,retribution,126,60,66
Elitest,hyjal,1787,paladin,retribution,73,34,39
Bubbleteâ,blackhand,1786,paladin,retribution,233,116,117
Mayhemx,ravencrest,1786,paladin,retribution,359,174,185
Thmas,tarren-mill,1785,paladin,retribution,264,141,123
Wingcomandêr,aegwynn,1785,paladin,retribution,66,32,34
Scillá,aegwynn,1785,paladin,retribution,121,55,66
Funchö,grim-batol,1784,paladin,retribution,86,32,54
Nukkss,silvermoon,1782,paladin,retribution,114,53,61
ßßæßßæßß,stormscale,1782,paladin,retribution,96,43,53
Bèéf,kazzak,1781,paladin,retribution,60,39,21
Serjudge,kazzak,1781,paladin,retribution,99,53,46
Dominikcro,sylvanas,1780,paladin,retribution,78,42,36
Наспидах,grom,1779,paladin,retribution,114,53,61
Djstompyamom,stormscale,1778,paladin,retribution,152,71,81
Bobjohnny,bloodfeather,1776,paladin,retribution,48,21,27
Вайлдбебриз,eversong,1775,paladin,retribution,94,58,36
Karadøc,archimonde,1775,paladin,retribution,108,49,59
Lûvmølly,silvermoon,1775,paladin,retribution,60,27,33
Brianxd,tarren-mill,1774,paladin,retribution,181,96,85
Tcret,sanguino,1773,paladin,retribution,53,26,27
Деленка,gordunni,1772,paladin,retribution,382,201,181
Justyowx,archimonde,1772,paladin,retribution,108,50,58
Кухонныйвор,howling-fjord,1771,paladin,retribution,114,58,56
Enlightendz,ravencrest,1771,paladin,retribution,126,62,64
Typhadin,sylvanas,1771,paladin,retribution,60,28,32
Irondawg,rajaxx,1771,paladin,retribution,103,46,57
Bersercute,sylvanas,1770,paladin,retribution,178,83,95
Ayylmeow,tarren-mill,1767,paladin,retribution,62,33,29
Bìzzan,ravencrest,1767,paladin,retribution,82,36,46
Ablaa,blackhand,1766,paladin,retribution,54,27,27
Heavensfang,outland,1765,paladin,retribution,89,44,45
Starworkal,ragnaros,1764,paladin,retribution,170,89,81
Nìcky,stormscale,1764,paladin,retribution,101,44,57
Surian,kazzak,1763,paladin,retribution,78,45,33
Testør,ragnaros,1763,paladin,retribution,256,123,133
Naneno,silvermoon,1763,paladin,retribution,152,71,81
Humangüy,kazzak,1763,paladin,retribution,106,48,58
Extremnäsa,outland,1762,paladin,retribution,222,103,119
Holysiah,kazzak,1762,paladin,retribution,114,51,63
Athená,baelgun,1761,paladin,retribution,46,29,17
Bigolcritty,silvermoon,1761,paladin,retribution,94,49,45
Mhehø,hyjal,1760,paladin,retribution,343,169,174
Artoriaz,ravencrest,1760,paladin,retribution,54,25,29
Selina,burning-legion,1759,paladin,retribution,172,88,84
Дезоиль,gordunni,1759,paladin,retribution,72,36,36
Runhexi,silvermoon,1758,paladin,retribution,181,98,83
Опгоп,gordunni,1758,paladin,retribution,89,45,44
Ослепителен,eversong,1758,paladin,retribution,120,54,66
Threathor,outland,1757,paladin,retribution,207,113,94
Goofymits,twisting-nether,1757,paladin,retribution,102,53,49
ßlacklight,archimonde,1757,paladin,retribution,72,28,44
Kayback,archimonde,1756,paladin,retribution,142,76,66
Лайтфури,gordunni,1756,paladin,retribution,101,48,53
Molgran,defias-brotherhood,1756,paladin,retribution,190,89,101
Рапсодихх,gordunni,1755,paladin,retribution,152,85,67
Holyinvictus,twisting-nether,1755,paladin,retribution,270,140,130
Kanyewesh,dalaran,1755,paladin,retribution,77,39,38
Analnydarek,silvermoon,1754,paladin,retribution,204,108,96
Lyliananl,outland,1754,paladin,retribution,168,83,85
Evelisyze,twisting-nether,1754,paladin,retribution,144,71,73
Sulask,argent-dawn,1754,paladin,retribution,48,21,27
Gilgadlor,stormscale,1754,paladin,retribution,48,20,28
Venepal,eredar,1753,paladin,retribution,42,26,16
Холихит,gordunni,1753,paladin,retribution,154,79,75
Ïdø,hyjal,1753,paladin,retribution,204,100,104
Shorykezu,kazzak,1752,paladin,retribution,52,26,26
Cqt,ravencrest,1752,paladin,retribution,84,36,48
Llya,blackrock,1751,paladin,retribution,96,61,35
Walorez,ragnaros,1751,paladin,retribution,41,23,18
Galenhad,kazzak,1751,paladin,retribution,132,61,71
Bubbloseven,archimonde,1750,paladin,retribution,126,73,53
Asærý,blackmoore,1750,paladin,retribution,105,58,47
Kipperb,kazzak,1750,paladin,retribution,77,41,36
Альфазеро,howling-fjord,1750,paladin,retribution,250,131,119
Mordar,ravencrest,1750,paladin,retribution,121,62,59
Братстепина,gordunni,1749,paladin,retribution,112,58,54
Memororo,stormscale,1749,paladin,retribution,104,50,54
Реальныйпал,gordunni,1748,paladin,retribution,156,73,83
Vanithar,thrall,1747,paladin,retribution,110,55,55
Roostersucka,stormreaver,1747,paladin,retribution,66,29,37
Huevo,frostmane,1747,paladin,retribution,48,20,28
Биоразлагаем,gordunni,1746,paladin,retribution,204,111,93
Duno,archimonde,1746,paladin,retribution,49,26,23
Flaweldin,ravencrest,1744,paladin,retribution,139,83,56
Сводимиаое,soulflayer,1744,paladin,retribution,58,27,31
Cursedd,sanguino,1742,paladin,retribution,36,23,13
Xinze,ravencrest,1742,paladin,retribution,107,55,52
Райтивуд,howling-fjord,1741,paladin,retribution,140,76,64
Wertre,sanguino,1740,paladin,retribution,36,22,14
Razrpal,tarren-mill,1740,paladin,retribution,56,29,27
Flamabella,argent-dawn,1740,paladin,retribution,42,21,21
Justrhino,kazzak,1740,paladin,retribution,59,25,34
Данбро,borean-tundra,1739,paladin,retribution,114,58,56
Gõm,aegwynn,1739,paladin,retribution,45,22,23
Fullflavor,bladefist,1739,paladin,retribution,150,70,80
Бэйгреон,gordunni,1738,paladin,retribution,202,114,88
Kayøz,aegwynn,1738,paladin,retribution,146,77,69
Dje,taerar,1738,paladin,retribution,54,28,26
Taurski,sylvanas,1737,paladin,retribution,83,49,34
Jíyü,blackmoore,1737,paladin,retribution,42,23,19
Торсгад,gordunni,1737,paladin,retribution,66,36,30
Dainan,blackmoore,1737,paladin,retribution,199,98,101
Plarbo,blackmoore,1737,paladin,retribution,72,35,37
Stazo,drakthul,1737,paladin,retribution,80,35,45
Ezetrol,xavius,1736,paladin,retribution,60,28,32
Zarispal,tarren-mill,1735,paladin,retribution,69,39,30
Niou,alleria,1735,paladin,retribution,116,61,55
Bubbledøtcøm,blackmoore,1735,paladin,retribution,90,47,43
Солошафл,howling-fjord,1735,paladin,retribution,48,24,24
Апония,gordunni,1735,paladin,retribution,93,35,58
Korendil,frostmane,1734,paladin,retribution,73,33,40
Lightbrîng,hyjal,1733,paladin,retribution,223,116,107
Durenai,aegwynn,1733,paladin,retribution,260,121,139
Johannx,tarren-mill,1732,paladin,retribution,240,118,122
Gwynel,argent-dawn,1732,paladin,retribution,96,47,49
Testør,outland,1731,paladin,retribution,72,40,32
Staticdeath,ravencrest,1731,paladin,retribution,288,148,140
Blakethorn,silvermoon,1731,paladin,retribution,54,27,27
Laaserjörö,outland,1731,paladin,retribution,42,20,22
Vonadams,ysondre,1731,paladin,retribution,60,28,32
Gangb,ravencrest,1730,paladin,retribution,63,34,29
Vanques,burning-legion,1730,paladin,retribution,59,28,31
Holybubble,stormscale,1730,paladin,retribution,86,37,49
Arayël,archimonde,1728,paladin,retribution,114,61,53
Krivonis,tarren-mill,1728,paladin,retribution,111,58,53
Lightfôrce,blackmoore,1727,paladin,retribution,121,61,60
Зондарк,booty-bay,1727,paladin,retribution,118,56,62
Mirøku,silvermoon,1726,paladin,retribution,109,53,56
Refuse,blackrock,1726,paladin,retribution,142,68,74
Knôp,outland,1726,paladin,retribution,56,25,31
Guilt,aegwynn,1726,paladin,retribution,140,62,78
Русэльф,howling-fjord,1725,paladin,retribution,171,89,82
Lostfire,sinstralis,1725,paladin,retribution,96,49,47
Dalemiar,ravencrest,1725,paladin,retribution,177,84,93
Кхарнх,soulflayer,1724,paladin,retribution,66,33,33
Glàdiator,outland,1724,paladin,retribution,212,105,107
Mimð,kazzak,1723,paladin,retribution,42,24,18
Ðivine,stormscale,1723,paladin,retribution,319,172,147
Pârabellum,the-maelstrom,1723,paladin,retribution,185,86,99
Фэрплэйн,gordunni,1722,paladin,retribution,72,41,31
Azryn,kazzak,1722,paladin,retribution,122,68,54
Schukow,blackhand,1722,paladin,retribution,36,18,18
Lydriana,die-aldor,1722,paladin,retribution,70,33,37
Sübôvîñ,ravencrest,1721,paladin,retribution,71,40,31
Лаунесса,gordunni,1721,paladin,retribution,54,29,25
Iiwar,silvermoon,1721,paladin,retribution,101,49,52
Elektek,archimonde,1720,paladin,retribution,48,25,23
Harlequina,argent-dawn,1720,paladin,retribution,93,48,45
Johnnÿsins,hyjal,1719,paladin,retribution,78,38,40
Факофф,gordunni,1718,paladin,retribution,72,46,26
Highfivè,ravencrest,1718,paladin,retribution,90,49,41
Fløcki,blackhand,1718,paladin,retribution,72,38,34
Joekickass,madmortem,1718,paladin,retribution,58,28,30
Reivah,silvermoon,1718,paladin,retribution,83,36,47
Xinxin,azshara,1717,paladin,retribution,90,44,46
Varioon,antonidas,1717,paladin,retribution,131,63,68
Ðox,frostmane,1716,paladin,retribution,36,23,13
Rubína,aegwynn,1716,paladin,retribution,38,21,17
Макракура,gordunni,1715,paladin,retribution,30,18,12
Cerfica,drakthul,1715,paladin,retribution,174,92,82
Kaarsius,defias-brotherhood,1715,paladin,retribution,48,23,25
Pallygân,thrall,1715,paladin,retribution,54,25,29
Beigerbala,blackrock,1715,paladin,retribution,42,18,24
Schôck,eredar,1714,paladin,retribution,87,45,42
Витурус,howling-fjord,1714,paladin,retribution,114,48,66
Mûhkûh,blackrock,1713,paladin,retribution,36,18,18
Trølled,aegwynn,1713,paladin,retribution,239,116,123
Zeusp,archimonde,1713,paladin,retribution,54,26,28
Нижмубабл,soulflayer,1713,paladin,retribution,69,31,38
Répo,twisting-nether,1712,paladin,retribution,48,23,25
Xciepo,rexxar,1712,paladin,retribution,138,66,72
Мизуриэль,howling-fjord,1711,paladin,retribution,78,48,30
Данхайк,gordunni,1711,paladin,retribution,210,115,95
Thesavage,magtheridon,1711,paladin,retribution,113,60,53
Dacilez,ravencrest,1711,paladin,retribution,266,130,136
Enviniv,tarren-mill,1711,paladin,retribution,84,37,47
Иев,howling-fjord,1710,paladin,retribution,127,62,65
Nurix,dun-modr,1710,paladin,retribution,48,18,30
Uliko,twisting-nether,1709,paladin,retribution,120,67,53
Менетиил,galakrond,1709,paladin,retribution,136,65,71
Deidâra,blackhand,1709,paladin,retribution,42,18,24
Noxaer,archimonde,1708,paladin,retribution,24,18,6
Аилерия,howling-fjord,1708,paladin,retribution,457,242,215
Yourredead,shadowsong,1708,paladin,retribution,90,45,45
Асканиэль,howling-fjord,1708,paladin,retribution,319,158,161
Делимнаноль,blackscar,1708,paladin,retribution,396,196,200
Dornu,tarren-mill,1708,paladin,retribution,48,22,26
Reito,eredar,1707,paladin,retribution,102,51,51
Шакиори,gordunni,1707,paladin,retribution,82,40,42
Lifepower,nemesis,1706,paladin,retribution,45,27,18
Palwig,tarren-mill,1706,paladin,retribution,178,95,83
Shenwarr,twisting-nether,1706,paladin,retribution,76,40,36
Anesthesiax,ravencrest,1706,paladin,retribution,77,36,41
Ттиаматт,howling-fjord,1706,paladin,retribution,58,25,33
Elendor,shadowsong,1705,paladin,retribution,78,44,34
Zeackzs,rajaxx,1704,paladin,retribution,42,26,16
Jugga,durotan,1704,paladin,retribution,64,37,27
Crascch,blackmoore,1704,paladin,retribution,48,25,23
Ngel,marécage-de-zangar,1704,paladin,retribution,42,21,21
Rafflesia,sanguino,1704,paladin,retribution,65,25,40
Bubblebuttx,ghostlands,1703,paladin,retribution,113,66,47
Яидваклоуна,soulflayer,1703,paladin,retribution,36,18,18
Matchstick,defias-brotherhood,1703,paladin,retribution,71,31,40
Unschúld,blackrock,1702,paladin,retribution,193,107,86
Eniste,silvermoon,1702,paladin,retribution,208,105,103
Tyristrum,kilrogg,1702,paladin,retribution,72,36,36
Limitles,nemesis,1702,paladin,retribution,93,40,53
Retstaar,draenor,1701,paladin,retribution,66,35,31
Azrpal,ravencrest,1701,paladin,retribution,56,26,30
Baraya,archimonde,1701,paladin,retribution,41,19,22
Scarabeus,ravencrest,1700,paladin,retribution,137,81,56
Thórvaldr,argent-dawn,1700,paladin,retribution,54,30,24
Ливх,blackscar,1700,paladin,retribution,133,71,62
Lílou,blackmoore,1700,paladin,retribution,99,52,47
Holyhannes,blackmoore,1699,paladin,retribution,77,39,38
Ðenlox,destromath,1699,paladin,retribution,72,29,43
Jiniboy,garrosh,1698,paladin,retribution,128,80,48
Serim,dun-modr,1698,paladin,retribution,66,38,28
Xëlâ,archimonde,1698,paladin,retribution,103,58,45
Laptop,aegwynn,1698,paladin,retribution,48,27,21
Bubbls,laughing-skull,1698,paladin,retribution,36,20,16
Pingla,argent-dawn,1698,paladin,retribution,151,81,70
Tîrana,ysondre,1698,paladin,retribution,145,72,73
Астта,fordragon,1698,paladin,retribution,96,46,50
Tekåpal,tarren-mill,1698,paladin,retribution,110,52,58
Salladín,stormscale,1697,paladin,retribution,63,37,26
Simjon,defias-brotherhood,1697,paladin,retribution,199,108,91
Мяумяухх,soulflayer,1697,paladin,retribution,302,161,141
Hojacat,ravencrest,1697,paladin,retribution,42,22,20
Shuukz,blackmoore,1695,paladin,retribution,114,55,59
Qarak,argent-dawn,1695,paladin,retribution,71,32,39
Blaîzer,archimonde,1695,paladin,retribution,111,49,62
Pawelinus,blackrock,1694,paladin,retribution,42,25,17
Ceccil,dun-modr,1694,paladin,retribution,168,96,72
Таптыгин,gordunni,1694,paladin,retribution,96,45,51
Salti,magtheridon,1693,paladin,retribution,142,77,65
Bobilous,twisting-nether,1693,paladin,retribution,90,44,46
Bigbuffdaddy,draenor,1692,paladin,retribution,504,253,251
Sharn,ravencrest,1692,paladin,retribution,112,56,56
Ilj,archimonde,1691,paladin,retribution,36,23,13
Teenage,colinas-pardas,1691,paladin,retribution,53,30,23
Skoopey,twisting-nether,1691,paladin,retribution,133,64,69
Коссандра,greymane,1691,paladin,retribution,88,35,53
Biqmac,mugthol,1690,paladin,retribution,45,25,20
Nataii,argent-dawn,1690,paladin,retribution,72,38,34
Ingenuous,draenor,1689,paladin,retribution,81,42,39
Waneis,ravencrest,1689,paladin,retribution,60,31,29
Käyle,alakir,1689,paladin,retribution,60,29,31
Lisma,bloodfeather,1688,paladin,retribution,71,40,31
Mommyret,draenor,1688,paladin,retribution,107,59,48
Akoumb,twisting-nether,1688,paladin,retribution,180,93,87
Djandja,blackrock,1688,paladin,retribution,119,61,58
Адвакаад,soulflayer,1688,paladin,retribution,66,33,33
Lightsaint,kazzak,1687,paladin,retribution,66,37,29
Nórman,blackhand,1687,paladin,retribution,162,85,77
Vvsdiamonds,archimonde,1687,paladin,retribution,65,29,36
Toxií,argent-dawn,1687,paladin,retribution,100,43,57
Sulfuroloyd,hyjal,1686,paladin,retribution,194,111,83
Holyshet,blackrock,1686,paladin,retribution,79,44,35
Строу,blackscar,1686,paladin,retribution,67,36,31
Rekktadin,grim-batol,1686,paladin,retribution,203,99,104
Хилерскийхил,soulflayer,1685,paladin,retribution,140,71,69
Yo,azshara,1684,paladin,retribution,66,34,32
Арагонис,howling-fjord,1684,paladin,retribution,84,43,41
Вэндрик,azuregos,1684,paladin,retribution,123,56,67
Ðoømhammer,kazzak,1684,paladin,retribution,66,22,44
Elastuc,silvermoon,1683,paladin,retribution,78,44,34
Silverglaze,defias-brotherhood,1683,paladin,retribution,54,30,24
Pesso,blackrock,1683,paladin,retribution,75,39,36
Gaalarr,burning-legion,1683,paladin,retribution,172,89,83
Refléx,zirkel-des-cenarius,1683,paladin,retribution,54,23,31
Curt,sanguino,1683,paladin,retribution,78,32,46
Budgetcara,stormscale,1682,paladin,retribution,41,22,19
Otsutsuki,darkspear,1682,paladin,retribution,62,33,29
Guskey,draenor,1682,paladin,retribution,138,71,67
Чупаа,howling-fjord,1682,paladin,retribution,106,54,52
Tyrael,darksorrow,1682,paladin,retribution,251,127,124
Milkadìn,twisting-nether,1681,paladin,retribution,138,72,66
Libertum,silvermoon,1681,paladin,retribution,54,28,26
Vpl,ravencrest,1681,paladin,retribution,38,19,19
Starcker,sanguino,1680,paladin,retribution,98,36,62
Slapmedaddy,die-ewige-wacht,1679,paladin,retribution,60,31,29
Varunyyo,blackrock,1679,paladin,retribution,82,40,42
Blookedaro,sanguino,1678,paladin,retribution,42,24,18
Varathraz,ravencrest,1678,paladin,retribution,162,75,87
Holyblast,archimonde,1676,paladin,retribution,54,30,24
Keft,twisting-nether,1676,paladin,retribution,59,32,27
Blademàster,twisting-nether,1676,paladin,retribution,96,40,56
Bsepal,silvermoon,1675,paladin,retribution,206,112,94
Baxxster,blackhand,1675,paladin,retribution,118,57,61
Jaegeer,draenor,1675,paladin,retribution,88,39,49
Arkk,blackrock,1675,paladin,retribution,60,25,35
Кинбул,ashenvale,1674,paladin,retribution,77,36,41
Diccari,stormreaver,1674,paladin,retribution,90,41,49
Badpal,blackhand,1673,paladin,retribution,85,45,40
Mistérion,archimonde,1673,paladin,retribution,86,37,49
Kedaris,antonidas,1672,paladin,retribution,143,77,66
Саймум,blackscar,1672,paladin,retribution,143,73,70
Eldrial,argent-dawn,1672,paladin,retribution,65,32,33
Daddypal,ravencrest,1671,paladin,retribution,36,20,16
Graeme,ysondre,1671,paladin,retribution,119,62,57
Tyri,silvermoon,1671,paladin,retribution,114,59,55
Ryxxii,ravencrest,1671,paladin,retribution,156,72,84
Грайндсет,galakrond,1671,paladin,retribution,41,18,23
Imaturtle,darksorrow,1671,paladin,retribution,133,58,75
Altundrdel,ravencrest,1670,paladin,retribution,113,62,51
Kíamhalifa,twisting-nether,1670,paladin,retribution,36,18,18
Letharen,argent-dawn,1669,paladin,retribution,74,36,38
Vylnoa,twisting-nether,1669,paladin,retribution,163,76,87
Astilia,sylvanas,1669,paladin,retribution,132,61,71
Korneta,sanguino,1669,paladin,retribution,78,36,42
Frutte,malganis,1668,paladin,retribution,90,56,34
Testament,antonidas,1668,paladin,retribution,128,65,63
Riares,darkspear,1668,paladin,retribution,187,92,95
Кельритос,soulflayer,1668,paladin,retribution,115,55,60
Ruehlsbestes,silvermoon,1667,paladin,retribution,61,43,18
Néero,defias-brotherhood,1667,paladin,retribution,51,30,21
Эмилиялавс,gordunni,1667,paladin,retribution,181,87,94
Scralet,tarren-mill,1667,paladin,retribution,41,19,22
Bätïk,blackmoore,1667,paladin,retribution,126,58,68
Almighty,ravencrest,1667,paladin,retribution,90,39,51
Merkury,sanguino,1667,paladin,retribution,84,35,49
Mefrandie,frostwolf,1666,paladin,retribution,48,26,22
Vivike,silvermoon,1666,paladin,retribution,130,66,64
Tirral,ravencrest,1666,paladin,retribution,198,100,98
Hèllkeepêr,archimonde,1666,paladin,retribution,41,20,21
Cardedeu,zuljin,1666,paladin,retribution,84,38,46
Ashbi,dun-modr,1666,paladin,retribution,60,25,35
Littlenight,emerald-dream,1665,paladin,retribution,72,35,37
Rli,twisting-nether,1664,paladin,retribution,90,45,45
Peachead,archimonde,1664,paladin,retribution,116,51,65
Zeggayodax,nemesis,1663,paladin,retribution,42,22,20
Fisslol,kazzak,1663,paladin,retribution,105,53,52
Arear,kazzak,1663,paladin,retribution,268,135,133
Neverdeath,stormscale,1663,paladin,retribution,72,32,40
Небестворлд,gordunni,1662,paladin,retribution,59,31,28
Deadholland,ravencrest,1662,paladin,retribution,140,73,67
Jout,tarren-mill,1662,paladin,retribution,150,75,75
Liendry,antonidas,1662,paladin,retribution,77,37,40
Wordup,senjin,1662,paladin,retribution,60,20,40
Instaquez,stormscale,1661,paladin,retribution,169,85,84
Meìster,blackmoore,1661,paladin,retribution,93,45,48
Pruntadin,silvermoon,1661,paladin,retribution,78,36,42
Qpalax,outland,1661,paladin,retribution,74,33,41
Аргонис,gordunni,1661,paladin,retribution,54,24,30
Jannene,draenor,1661,paladin,retribution,66,29,37
Lezira,ravencrest,1660,paladin,retribution,48,20,28
Bumaye,tarren-mill,1659,paladin,retribution,42,24,18
Wlåð,archimonde,1659,paladin,retribution,51,27,24
Layonpants,twisting-nether,1659,paladin,retribution,36,19,17
Âyasê,blackhand,1659,paladin,retribution,100,49,51
Wakke,outland,1658,paladin,retribution,38,26,12
Xyzl,argent-dawn,1658,paladin,retribution,192,106,86
Slump,ravencrest,1658,paladin,retribution,97,53,44
Hydrolic,blackrock,1658,paladin,retribution,48,24,24
Drakingsang,blackhand,1658,paladin,retribution,102,44,58
Seductîve,kazzak,1657,paladin,retribution,162,93,69
Zuveron,the-maelstrom,1657,paladin,retribution,78,35,43
Fordragon,twisting-nether,1657,paladin,retribution,60,24,36
Bovinepope,tarren-mill,1656,paladin,retribution,78,44,34
Tapsgg,silvermoon,1656,paladin,retribution,111,54,57
Häppïhïppø,ambossar,1656,paladin,retribution,95,41,54
Armas,stormscale,1656,paladin,retribution,64,27,37
Akaasix,stormscale,1655,paladin,retribution,118,63,55
Telionrootan,die-aldor,1655,paladin,retribution,58,29,29
Sünlight,nemesis,1655,paladin,retribution,186,89,97
Modeladin,ragnaros,1655,paladin,retribution,130,62,68
Novania,perenolde,1655,paladin,retribution,69,32,37
Wingsuit,eredar,1655,paladin,retribution,86,35,51
Onevr,tarren-mill,1654,paladin,retribution,172,94,78
Willmot,stormscale,1654,paladin,retribution,64,33,31
Malthred,ravenholdt,1654,paladin,retribution,267,134,133
Erasdin,silvermoon,1653,paladin,retribution,36,21,15
Zynuwu,blackmoore,1653,paladin,retribution,42,22,20
Ruotollo,ravencrest,1653,paladin,retribution,51,23,28
Dudjaw,stormscale,1653,paladin,retribution,166,73,93
Wohx,archimonde,1652,paladin,retribution,54,30,24
Karyouka,archimonde,1651,paladin,retribution,66,40,26
Анстапблх,gordunni,1651,paladin,retribution,54,31,23
Denlow,silvermoon,1651,paladin,retribution,162,90,72
Поласс,gordunni,1651,paladin,retribution,76,39,37
Tylaerion,magtheridon,1650,paladin,retribution,30,18,12
Ratklng,ravencrest,1650,paladin,retribution,102,61,41
Ruggero,stormscale,1650,paladin,retribution,43,24,19
Ilikejudge,blackmoore,1650,paladin,retribution,192,89,103
Screws,dun-modr,1650,paladin,retribution,54,22,32
Pxæn,archimonde,1650,paladin,retribution,53,21,32
Aederec,argent-dawn,1649,paladin,retribution,78,42,36
Килмонгир,gordunni,1649,paladin,retribution,42,21,21
Сиаобэла,gordunni,1649,paladin,retribution,90,44,46
Andrejz,sylvanas,1648,paladin,retribution,42,21,21
Deltapower,archimonde,1648,paladin,retribution,103,49,54
Холивеник,gordunni,1648,paladin,retribution,48,22,26
Jst,twisting-nether,1647,paladin,retribution,36,24,12
Kìngeh,tarren-mill,1647,paladin,retribution,30,18,12
Петуретрик,gordunni,1647,paladin,retribution,268,141,127
Tamilekimono,archimonde,1647,paladin,retribution,52,23,29
Relius,outland,1647,paladin,retribution,115,50,65
Тевеон,gordunni,1647,paladin,retribution,48,20,28
Exoblade,twisting-nether,1646,paladin,retribution,72,40,32
Trenvendor,ravencrest,1646,paladin,retribution,43,23,20
Júdger,twisting-nether,1646,paladin,retribution,173,90,83
Tuppo,argent-dawn,1646,paladin,retribution,404,206,198
Serratus,thunderhorn,1646,paladin,retribution,56,25,31
Rimva,alleria,1645,paladin,retribution,72,45,27
Бордюрчег,howling-fjord,1645,paladin,retribution,36,21,15
Eazybubble,blackhand,1645,paladin,retribution,42,22,20
Gilet,argent-dawn,1645,paladin,retribution,60,31,29
Mcfëë,ysondre,1645,paladin,retribution,150,77,73
Kreselia,ravencrest,1645,paladin,retribution,184,92,92
Сёмаигрок,soulflayer,1645,paladin,retribution,101,49,52
Фантаззер,soulflayer,1645,paladin,retribution,82,39,43
Neithi,twisting-nether,1645,paladin,retribution,72,34,38
Xila,blackrock,1645,paladin,retribution,90,39,51
Защешот,gordunni,1645,paladin,retribution,48,18,30
Keladen,burning-legion,1644,paladin,retribution,84,51,33
Cîzzar,burning-legion,1644,paladin,retribution,153,85,68
Sytharel,sylvanas,1644,paladin,retribution,90,50,40
Destya,eredar,1644,paladin,retribution,56,20,36
Spegepølse,silvermoon,1643,paladin,retribution,86,48,38
Emíly,dun-morogh,1643,paladin,retribution,42,23,19
Wadey,tarren-mill,1643,paladin,retribution,165,87,78
Ysell,sargeras,1643,paladin,retribution,86,44,42
Râkim,malganis,1643,paladin,retribution,42,21,21
Muuclear,twisting-nether,1643,paladin,retribution,87,42,45
Baebe,silvermoon,1643,paladin,retribution,66,22,44
Guidone,sylvanas,1642,paladin,retribution,30,20,10
Zarelie,tarren-mill,1642,paladin,retribution,84,50,34
Диманватикан,howling-fjord,1642,paladin,retribution,140,67,73
Grìmmjøw,silvermoon,1642,paladin,retribution,51,22,29
Juicycheeks,frostwolf,1642,paladin,retribution,88,36,52
Bikkuz,kazzak,1641,paladin,retribution,42,28,14
Gigasack,ravencrest,1641,paladin,retribution,36,23,13
Farata,ravencrest,1641,paladin,retribution,184,100,84
Báldür,silvermoon,1641,paladin,retribution,156,80,76
Mercuria,dun-modr,1641,paladin,retribution,58,26,32
Briman,neptulon,1640,paladin,retribution,66,41,25
Powerpuffret,antonidas,1640,paladin,retribution,72,40,32
Йосяфлексер,howling-fjord,1640,paladin,retribution,200,108,92
Сэдвиг,gordunni,1640,paladin,retribution,41,21,20
Vakaza,cthun,1639,paladin,retribution,72,37,35
Lorthaél,karazhan,1639,paladin,retribution,171,85,86
Темплеар,gordunni,1639,paladin,retribution,226,106,120
Sinclo,hyjal,1639,paladin,retribution,95,42,53
Димасгачи,gordunni,1638,paladin,retribution,42,32,10
Thaldrael,colinas-pardas,1638,paladin,retribution,77,41,36
Lawtõn,argent-dawn,1638,paladin,retribution,251,132,119
Ajkulaa,kazzak,1638,paladin,retribution,92,45,47
Måxrajoy,dun-modr,1638,paladin,retribution,42,20,22
Kalanthor,outland,1638,paladin,retribution,70,32,38
Dreamwatcher,outland,1638,paladin,retribution,51,23,28
Screâm,eredar,1638,paladin,retribution,84,31,53
Splendida,festung-der-stürme,1637,paladin,retribution,35,23,12
Donwone,aegwynn,1637,paladin,retribution,33,21,12
Brabop,zirkel-des-cenarius,1637,paladin,retribution,42,22,20
Shakkur,varimathras,1637,paladin,retribution,82,42,40
Раффаэло,borean-tundra,1637,paladin,retribution,174,88,86
Дохлаяженах,gordunni,1637,paladin,retribution,54,27,27
Yséria,kirin-tor,1637,paladin,retribution,228,112,116
Nanisunda,thrall,1637,paladin,retribution,154,75,79
Vickdicator,stormscale,1637,paladin,retribution,177,85,92
Kraakz,sanguino,1637,paladin,retribution,89,42,47
Amix,darksorrow,1636,paladin,retribution,68,33,35
Ague,spinebreaker,1636,paladin,retribution,118,54,64
Badbuññy,sylvanas,1636,paladin,retribution,54,24,30
Ashleigh,stormscale,1636,paladin,retribution,78,30,48
Mácá,outland,1635,paladin,retribution,30,20,10
Диваин,gordunni,1635,paladin,retribution,396,210,186
Стальгор,ashenvale,1635,paladin,retribution,60,30,30
Хаспадин,gordunni,1635,paladin,retribution,83,41,42
Шульц,borean-tundra,1635,paladin,retribution,64,31,33
Naexea,archimonde,1635,paladin,retribution,60,28,32
Hornybìlly,stormscale,1635,paladin,retribution,48,21,27
Байстр,soulflayer,1635,paladin,retribution,94,40,54
Addwyr,blackrock,1634,paladin,retribution,78,42,36
Римидал,howling-fjord,1634,paladin,retribution,42,22,20
Arturius,ravencrest,1634,paladin,retribution,60,30,30
Kouyhalaide,hyjal,1634,paladin,retribution,86,42,44
Ragen,kazzak,1634,paladin,retribution,72,33,39
Ædrenn,archimonde,1634,paladin,retribution,60,24,36
Zneeks,shattered-hand,1633,paladin,retribution,83,48,35
Palagray,blackmoore,1633,paladin,retribution,173,100,73
Omaw,ragnaros,1633,paladin,retribution,41,23,18
Azûl,archimonde,1633,paladin,retribution,246,125,121
Justivo,tarren-mill,1633,paladin,retribution,97,49,48
Shockashy,stormscale,1633,paladin,retribution,90,45,45
Xestie,twisting-nether,1633,paladin,retribution,68,32,36
Тайронх,soulflayer,1633,paladin,retribution,42,18,24
Bagok,drakthul,1632,paladin,retribution,54,34,20
Ojn,tarren-mill,1632,paladin,retribution,134,80,54
Галиор,soulflayer,1632,paladin,retribution,52,31,21
Tawaraa,archimonde,1632,paladin,retribution,36,21,15
Цитология,borean-tundra,1632,paladin,retribution,186,108,78
Pinx,kazzak,1632,paladin,retribution,78,39,39
Theladrie,blackhand,1632,paladin,retribution,48,24,24
Zefirin,ragnaros,1632,paladin,retribution,66,30,36
Mavesauce,blackrock,1631,paladin,retribution,26,18,8
Копаю,gordunni,1631,paladin,retribution,150,88,62
Олегсудья,howling-fjord,1631,paladin,retribution,82,46,36
Earendìl,blackmoore,1631,paladin,retribution,66,37,29
Needel,argent-dawn,1631,paladin,retribution,59,32,27
Litaren,ragnaros,1631,paladin,retribution,66,35,31
Кавайнекс,azuregos,1631,paladin,retribution,134,67,67
Rexare,blackhand,1631,paladin,retribution,52,26,26
Нормвал,gordunni,1631,paladin,retribution,61,29,32
Draizor,twisting-nether,1631,paladin,retribution,89,42,47
Fîzè,blackmoore,1631,paladin,retribution,46,21,25
Kæycc,blackmoore,1631,paladin,retribution,69,29,40
Adiútrix,silvermoon,1630,paladin,retribution,96,59,37
Ibuc,blackrock,1630,paladin,retribution,36,21,15
Djcurry,archimonde,1630,paladin,retribution,30,17,13
Lindrone,aggra-português,1630,paladin,retribution,36,17,19
Antsh,nemesis,1629,paladin,retribution,36,22,14
Nfxx,argent-dawn,1629,paladin,retribution,87,53,34
Holyhi,silvermoon,1629,paladin,retribution,90,54,36
Bobiwan,ravencrest,1629,paladin,retribution,30,17,13
Моррзито,soulflayer,1629,paladin,retribution,78,37,41
Фатумм,howling-fjord,1629,paladin,retribution,42,19,23
Ønlyfâns,dragonblight,1629,paladin,retribution,78,34,44
Саламанлдрыч,soulflayer,1629,paladin,retribution,125,54,71
Pepsimaxpvp,blackmoore,1629,paladin,retribution,43,18,25
Neijih,blackrock,1629,paladin,retribution,74,29,45
Mudos,burning-legion,1628,paladin,retribution,24,18,6
Swäagg,hyjal,1628,paladin,retribution,41,25,16
Stelanâal,archimonde,1628,paladin,retribution,170,90,80
Wyllian,grim-batol,1628,paladin,retribution,48,23,25
Pikoman,hellfire,1628,paladin,retribution,89,42,47
Clamjam,sylvanas,1628,paladin,retribution,126,59,67
Néméssisx,ravencrest,1628,paladin,retribution,54,22,32
Хилоретка,blackscar,1627,paladin,retribution,36,24,12
Gulinborsti,aegwynn,1627,paladin,retribution,78,50,28
Boomboomciao,draenor,1627,paladin,retribution,123,74,49
Lightsguard,outland,1627,paladin,retribution,54,30,24
Násty,twisting-nether,1627,paladin,retribution,221,114,107
Válé,silvermoon,1627,paladin,retribution,295,149,146
Toschapala,blackmoore,1627,paladin,retribution,90,45,45
Сандалар,gordunni,1627,paladin,retribution,138,64,74
Runhil,nemesis,1627,paladin,retribution,48,22,26
Tabriz,rexxar,1627,paladin,retribution,70,32,38
Ласковыйкуфа,howling-fjord,1626,paladin,retribution,27,18,9
Yæø,archimonde,1626,paladin,retribution,84,49,35
Soossi,silvermoon,1626,paladin,retribution,30,17,13
Шандарм,howling-fjord,1626,paladin,retribution,54,28,26
Deloréane,archimonde,1626,paladin,retribution,130,67,63
Оззмо,howling-fjord,1626,paladin,retribution,195,99,96
Naenel,dun-modr,1626,paladin,retribution,54,26,28
Zarron,blackrock,1626,paladin,retribution,42,20,22
Tracsiee,twisting-nether,1626,paladin,retribution,56,22,34
Maloumnik,stormscale,1625,paladin,retribution,24,17,7
Redex,tarren-mill,1625,paladin,retribution,120,64,56
Skippadin,ravencrest,1625,paladin,retribution,107,55,52
Strykar,aggra-português,1625,paladin,retribution,48,22,26
Konardos,burning-legion,1625,paladin,retribution,48,21,27
Jay,arathor,1624,paladin,retribution,54,29,25
Leoxander,outland,1624,paladin,retribution,146,75,71
Атикинс,gordunni,1624,paladin,retribution,316,158,158
Zeroeffect,blackhand,1624,paladin,retribution,90,44,46
Kaní,eredar,1624,paladin,retribution,54,22,32
Рипкарт,gordunni,1623,paladin,retribution,67,42,25
Valarians,nemesis,1623,paladin,retribution,48,28,20
Blazeer,pozzo-delleternità,1623,paladin,retribution,42,23,19
Waltgyubeef,argent-dawn,1623,paladin,retribution,33,18,15
Notpitball,kazzak,1623,paladin,retribution,48,23,25
Brecs,frostmourne,1623,paladin,retribution,84,36,48
Неиспоримый,soulflayer,1622,paladin,retribution,30,20,10
Лакоста,ashenvale,1622,paladin,retribution,122,61,61
Valin,frostmane,1622,paladin,retribution,219,105,114
Anatollia,silvermoon,1622,paladin,retribution,36,17,19
Blademasteer,jaedenar,1622,paladin,retribution,72,31,41
Gøretterøg,archimonde,1621,paladin,retribution,30,18,12
Escânôr,blackmoore,1620,paladin,retribution,30,18,12
Disadin,sylvanas,1620,paladin,retribution,42,25,17
Wrathlight,nemesis,1620,paladin,retribution,84,49,35
Ultret,silvermoon,1620,paladin,retribution,79,44,35
Trisunonvaki,khazgoroth,1620,paladin,retribution,205,112,93
Belnadris,eredar,1620,paladin,retribution,148,80,68
Валькирия,grom,1620,paladin,retribution,36,17,19
Salelol,ravencrest,1620,paladin,retribution,158,72,86
Brinkz,argent-dawn,1620,paladin,retribution,54,23,31
Kathí,kazzak,1619,paladin,retribution,54,35,19
Destrutkorka,burning-legion,1619,paladin,retribution,73,45,28
Zzloud,darksorrow,1619,paladin,retribution,42,23,19
Jaro,alleria,1619,paladin,retribution,75,40,35
Combinecka,chamber-of-aspects,1619,paladin,retribution,118,60,58
Azlaya,sargeras,1619,paladin,retribution,255,127,128
Jiricech,tarren-mill,1619,paladin,retribution,42,17,25
Nillenkäse,antonidas,1618,paladin,retribution,36,22,14
Charmxx,stormscale,1618,paladin,retribution,30,18,12
Kobleda,ravencrest,1618,paladin,retribution,41,23,18
Lonesolo,sylvanas,1618,paladin,retribution,36,20,16
Vleisboom,ravencrest,1618,paladin,retribution,120,64,56
Crohnox,nemesis,1618,paladin,retribution,82,41,41
Novania,teldrassil,1617,paladin,retribution,60,39,21
Bloodsworn,stormrage,1617,paladin,retribution,90,58,32
Gucix,sylvanas,1617,paladin,retribution,75,42,33
Bâbass,sargeras,1617,paladin,retribution,48,25,23
Яправ,borean-tundra,1617,paladin,retribution,161,83,78
Okcså,ragnaros,1617,paladin,retribution,64,25,39
Илонка,gordunni,1616,paladin,retribution,70,41,29
Lerîan,dun-modr,1616,paladin,retribution,157,88,69
Superhick,veknilash,1616,paladin,retribution,42,22,20
Эледвен,howling-fjord,1616,paladin,retribution,104,49,55
Mezokist,silvermoon,1616,paladin,retribution,48,22,26
Sharkayne,anubarak,1616,paladin,retribution,130,59,71
Найдэкер,gordunni,1616,paladin,retribution,54,22,32
Shabbyy,bronzebeard,1616,paladin,retribution,54,21,33
Pøpz,kilrogg,1615,paladin,retribution,182,96,86
Shénggi,kazzak,1615,paladin,retribution,78,41,37
Shufflee,drakthul,1615,paladin,retribution,84,44,40
Katanaclówn,eredar,1615,paladin,retribution,347,175,172
Wootschi,arthas,1615,paladin,retribution,83,40,43
Nocleanse,argent-dawn,1614,paladin,retribution,65,45,20
Batteldin,blackmoore,1614,paladin,retribution,158,91,67
Váliant,tarren-mill,1614,paladin,retribution,42,24,18
Синерина,blackscar,1614,paladin,retribution,137,75,62
Aurasis,archimonde,1614,paladin,retribution,83,41,42
Прожектор,gordunni,1614,paladin,retribution,60,29,31
Proximo,burning-legion,1614,paladin,retribution,48,23,25
Scorebit,draenor,1614,paladin,retribution,71,30,41
Blâzer,hyjal,1614,paladin,retribution,54,22,32
Dragon,zenedar,1613,paladin,retribution,48,27,21
Aflogistina,sylvanas,1613,paladin,retribution,36,20,16
Pav,eredar,1613,paladin,retribution,107,56,51
Apokalipsnik,drakthul,1613,paladin,retribution,66,34,32
Bloodyret,outland,1613,paladin,retribution,89,45,44
Nazjra,twisting-nether,1613,paladin,retribution,36,18,18
Bullsy,kazzak,1613,paladin,retribution,123,61,62
Nøvå,ravencrest,1613,paladin,retribution,108,50,58
Hýpærpøp,ravencrest,1613,paladin,retribution,115,53,62
Ассайоу,soulflayer,1613,paladin,retribution,138,58,80
Holyzero,ravencrest,1612,paladin,retribution,24,17,7
Mangz,ysondre,1612,paladin,retribution,36,25,11
Lelight,ravencrest,1612,paladin,retribution,36,24,12
Topzin,argent-dawn,1612,paladin,retribution,49,30,19
Astolfia,silvermoon,1612,paladin,retribution,73,44,29
Davidas,drakthul,1612,paladin,retribution,127,67,60
Blickyman,arathor,1612,paladin,retribution,96,49,47
Сангвиний,howling-fjord,1612,paladin,retribution,322,158,164
Nergigante,drekthar,1612,paladin,retribution,48,23,25
Paradoxiâ,thrall,1612,paladin,retribution,60,28,32
Кизарыч,galakrond,1612,paladin,retribution,48,17,31
Palladain,draenor,1611,paladin,retribution,118,73,45
Vâlkyrîe,outland,1611,paladin,retribution,55,32,23
Santaclaus,zuljin,1611,paladin,retribution,139,79,60
Hempodius,silvermoon,1611,paladin,retribution,57,31,26
Ришардебюр,soulflayer,1611,paladin,retribution,157,80,77
Focuspally,outland,1611,paladin,retribution,113,57,56
Hito,sylvanas,1611,paladin,retribution,159,73,86
Madman,drakthul,1611,paladin,retribution,72,33,39
Booskipal,burning-legion,1611,paladin,retribution,57,25,32
Bidulemachin,chogall,1610,paladin,retribution,30,19,11
Файнпал,howling-fjord,1610,paladin,retribution,78,44,34
Discølove,blackmoore,1610,paladin,retribution,43,21,22
Torvik,eredar,1610,paladin,retribution,113,55,58
Harbiter,ravencrest,1610,paladin,retribution,96,39,57
Biggboii,twisting-nether,1610,paladin,retribution,54,21,33
Zebramann,silvermoon,1609,paladin,retribution,117,69,48
Témpézt,ravencrest,1609,paladin,retribution,30,17,13
Ryuzu,khazgoroth,1609,paladin,retribution,84,47,37
Promise,dun-modr,1609,paladin,retribution,60,32,28
Medieh,ravencrest,1609,paladin,retribution,86,45,41
Bíceron,sanguino,1609,paladin,retribution,76,38,38
Lazone,ysondre,1609,paladin,retribution,46,22,24
Mystixd,talnivarr,1608,paladin,retribution,42,31,11
Hølypowah,tarren-mill,1608,paladin,retribution,24,17,7
Glückskreuza,die-aldor,1608,paladin,retribution,54,33,21
Alammar,burning-legion,1608,paladin,retribution,30,18,12
Leköngen,ravencrest,1608,paladin,retribution,50,29,21
Oldsurehand,blackmoore,1608,paladin,retribution,68,36,32
Колсет,soulflayer,1608,paladin,retribution,91,48,43
Swânn,sanguino,1608,paladin,retribution,127,65,62
Dragonlancer,silvermoon,1608,paladin,retribution,288,143,145
Elohim,echsenkessel,1608,paladin,retribution,75,36,39
Ashmight,outland,1607,paladin,retribution,48,28,20
Тьёрн,gordunni,1607,paladin,retribution,90,52,38
Anmila,anetheron,1607,paladin,retribution,30,17,13
Ямыч,ashenvale,1607,paladin,retribution,109,61,48
Legitpower,silvermoon,1607,paladin,retribution,82,41,41
Ромерл,gordunni,1607,paladin,retribution,556,277,279
Zala,culte-de-la-rive-noire,1607,paladin,retribution,76,37,39
Эллесар,blackscar,1607,paladin,retribution,132,62,70
Гоудин,razuvious,1607,paladin,retribution,66,30,36
Meliödas,sylvanas,1607,paladin,retribution,46,20,26
Hippiehuman,darkspear,1606,paladin,retribution,36,23,13
Zaelija,antonidas,1606,paladin,retribution,36,22,14
Милликсайс,howling-fjord,1606,paladin,retribution,51,29,22
Ampxd,ravencrest,1606,paladin,retribution,78,42,36
Melior,skullcrusher,1606,paladin,retribution,284,151,133
Splasher,grim-batol,1606,paladin,retribution,186,97,89
Dollicia,outland,1606,paladin,retribution,66,28,38
ßean,dun-modr,1605,paladin,retribution,46,23,23
Akrobatka,sanguino,1605,paladin,retribution,114,52,62
Bázer,antonidas,1605,paladin,retribution,46,18,28
Riskha,archimonde,1604,paladin,retribution,82,52,30
Taiiki,archimonde,1604,paladin,retribution,156,92,64
Stfortt,ragnaros,1604,paladin,retribution,178,102,76
Taytay,dentarg,1604,paladin,retribution,66,37,29
Tìtan,ravencrest,1604,paladin,retribution,48,25,23
Toxxor,die-arguswacht,1604,paladin,retribution,54,28,26
Кронкс,howling-fjord,1604,paladin,retribution,141,73,68
Ваэлин,deathweaver,1604,paladin,retribution,64,29,35
Tinyandy,blackrock,1604,paladin,retribution,48,21,27
Ivarladin,draenor,1604,paladin,retribution,78,34,44
Valiscar,antonidas,1604,paladin,retribution,42,17,25
Tavyy,sylvanas,1603,paladin,retribution,107,81,26
Релаин,gordunni,1603,paladin,retribution,156,69,87
Joniopala,stormreaver,1603,paladin,retribution,89,37,52
Tosá,antonidas,1603,paladin,retribution,54,22,32
Mistyweavey,grim-batol,1602,paladin,retribution,66,43,23
Palabrüx,dun-modr,1602,paladin,retribution,48,30,18
Overgeared,twisting-nether,1602,paladin,retribution,283,158,125
Neicha,trollbane,1602,paladin,retribution,108,60,48
Ferlen,nagrand,1602,paladin,retribution,72,39,33
Beefdaddyy,kazzak,1602,paladin,retribution,94,50,44
Crimq,twisting-nether,1602,paladin,retribution,102,50,52
Cowwithspell,stormscale,1602,paladin,retribution,224,108,116
Neverdiex,blackrock,1602,paladin,retribution,54,20,34
Quééfwemust,outland,1601,paladin,retribution,59,33,26
Gymly,kazzak,1601,paladin,retribution,244,136,108
Timal,eitrigg,1601,paladin,retribution,157,82,75
Zwergicus,alexstrasza,1601,paladin,retribution,71,33,38
Далходж,soulflayer,1601,paladin,retribution,134,62,72
Retrehsacul,blackrock,1601,paladin,retribution,42,19,23
Крутикрит,goldrinn,1601,paladin,retribution,113,48,65
Elvina,kiljaeden,1600,paladin,retribution,24,17,7
Xealyy,ravencrest,1600,paladin,retribution,36,22,14
Guccishock,twisting-nether,1600,paladin,retribution,85,48,37
Bartelemeus,draenor,1600,paladin,retribution,48,25,23
Elyox,ravencrest,1600,paladin,retribution,42,21,21
Vereth,tarren-mill,1600,paladin,retribution,156,77,79
Bormann,burning-legion,1600,paladin,retribution,53,26,27
Cilise,bronzebeard,1600,paladin,retribution,173,84,89
Zader,ravencrest,1600,paladin,retribution,48,23,25
Кузькинамать,greymane,1600,paladin,retribution,161,74,87
Nanduil,stormscale,1600,paladin,retribution,48,22,26
Зена,gordunni,1600,paladin,retribution,42,17,25
Stille,blackrock,1599,paladin,retribution,36,20,16
Carlash,draenor,1599,paladin,retribution,96,53,43
Zerosixsix,silvermoon,1599,paladin,retribution,48,17,31
Djcrusade,twisting-nether,1598,paladin,retribution,183,98,85
Jorhall,antonidas,1598,paladin,retribution,127,68,59
Vuup,silvermoon,1598,paladin,retribution,108,51,57
Demsi,ravencrest,1597,paladin,retribution,38,24,14
Wuzzle,azshara,1597,paladin,retribution,36,22,14
Милостьрока,gordunni,1597,paladin,retribution,128,70,58
Хитвэйв,soulflayer,1597,paladin,retribution,41,20,21
Justyferr,nemesis,1597,paladin,retribution,176,77,99
Eldrack,defias-brotherhood,1597,paladin,retribution,47,20,27
Kptayn,archimonde,1596,paladin,retribution,79,44,35
Анастэриан,thermaplugg,1596,paladin,retribution,120,59,61
Vorber,darksorrow,1596,paladin,retribution,71,31,40
Yaldly,dun-modr,1595,paladin,retribution,42,21,21
Serenityxo,twisting-nether,1594,paladin,retribution,29,22,7
Saabnaab,outland,1594,paladin,retribution,233,133,100
Íbossít,doomhammer,1594,paladin,retribution,84,43,41
Каштоуны,soulflayer,1594,paladin,retribution,121,59,62
Asfen,archimonde,1593,paladin,retribution,42,24,18
Veejxo,silvermoon,1593,paladin,retribution,54,30,24
Hetrox,silvermoon,1593,paladin,retribution,54,28,26
Cloudlight,argent-dawn,1593,paladin,retribution,122,62,60
Paakz,stormscale,1593,paladin,retribution,202,101,101
Círuq,eredar,1593,paladin,retribution,36,17,19
Siorraidh,archimonde,1592,paladin,retribution,48,26,22
Zuldekk,sanguino,1592,paladin,retribution,160,78,82
Opsyoudie,kazzak,1592,paladin,retribution,173,83,90
Holmat,twisting-nether,1591,paladin,retribution,72,35,37
Imtheßoss,pozzo-delleternità,1591,paladin,retribution,42,20,22
Kjobergen,tarren-mill,1591,paladin,retribution,48,21,27
Израф,borean-tundra,1591,paladin,retribution,48,19,29
Dabeefchief,outland,1590,paladin,retribution,28,21,7
Hülä,antonidas,1590,paladin,retribution,84,38,46
Pallidino,antonidas,1590,paladin,retribution,47,20,27
Mearsheimer,ysondre,1590,paladin,retribution,48,19,29
Бладиполи,soulflayer,1589,paladin,retribution,114,63,51
Sstalowy,silvermoon,1589,paladin,retribution,151,74,77
Títanîa,blackmoore,1589,paladin,retribution,47,23,24
Valeantz,draenor,1589,paladin,retribution,95,39,56
Ahpoual,archimonde,1588,paladin,retribution,64,39,25
Майлайт,gordunni,1588,paladin,retribution,129,73,56
Hipo,zuljin,1588,paladin,retribution,36,19,17
Supergallows,shattered-hand,1588,paladin,retribution,129,62,67
Рамзеса,soulflayer,1588,paladin,retribution,102,48,54
Erthelios,silvermoon,1587,paladin,retribution,42,25,17
Shaylaru,tarren-mill,1587,paladin,retribution,41,22,19
Jimrogier,argent-dawn,1587,paladin,retribution,210,106,104
Blader,darksorrow,1587,paladin,retribution,180,90,90
Sanzar,twisting-nether,1586,paladin,retribution,36,21,15
Eruth,ravencrest,1586,paladin,retribution,78,41,37
Романтик,deathweaver,1586,paladin,retribution,164,83,81
Whiskeyx,lightbringer,1585,paladin,retribution,42,29,13
Пивняк,eversong,1585,paladin,retribution,159,91,68
Хентайбогиня,ashenvale,1585,paladin,retribution,74,38,36
Ichimaru,burning-legion,1585,paladin,retribution,41,20,21
Trixbunny,arathor,1585,paladin,retribution,35,17,18
Painshield,outland,1585,paladin,retribution,53,19,34
Антрасс,soulflayer,1584,paladin,retribution,42,24,18
Râoh,arathi,1584,paladin,retribution,108,57,51
Wingdude,ysera,1584,paladin,retribution,36,19,17
Limitlez,blackhand,1584,paladin,retribution,36,19,17
Swàyz,archimonde,1584,paladin,retribution,200,95,105
Komen,dalaran,1583,paladin,retribution,36,19,17
Horran,archimonde,1583,paladin,retribution,35,18,17
Fufth,pozzo-delleternità,1583,paladin,retribution,42,20,22
Ramro,magtheridon,1582,paladin,retribution,70,45,25
Aerieon,draenor,1582,paladin,retribution,42,21,21
Талрэн,howling-fjord,1582,paladin,retribution,66,32,34
Retenki,silvermoon,1582,paladin,retribution,54,25,29
Irenita,kazzak,1582,paladin,retribution,54,23,31
Thàø,chants-éternels,1581,paladin,retribution,100,48,52
Poohsie,ravencrest,1580,paladin,retribution,107,61,46
Kyrokonserve,blackmoore,1580,paladin,retribution,145,80,65
Zaaen,burning-legion,1580,paladin,retribution,96,49,47
Retstarr,draenor,1580,paladin,retribution,114,57,57
Palarïns,dalaran,1580,paladin,retribution,36,18,18
Аскеттх,gordunni,1580,paladin,retribution,90,43,47
Eosan,argent-dawn,1579,paladin,retribution,39,27,12
Dd,blackmoore,1579,paladin,retribution,205,107,98
Misako,sanguino,1579,paladin,retribution,202,98,104
Apolytos,laughing-skull,1579,paladin,retribution,195,94,101
Эйзенхорн,grom,1579,paladin,retribution,126,60,66
Sacramento,tarren-mill,1579,paladin,retribution,48,21,27
Grimstark,argent-dawn,1578,paladin,retribution,42,25,17
Remthas,argent-dawn,1578,paladin,retribution,323,174,149
Blessedpapi,draenor,1578,paladin,retribution,42,22,20
Paellysuir,blackmoore,1578,paladin,retribution,258,130,128
Raoun,archimonde,1578,paladin,retribution,84,41,43
Gîn,aszune,1578,paladin,retribution,90,42,48
Lavawraith,argent-dawn,1578,paladin,retribution,44,20,24
Emostylex,draenor,1578,paladin,retribution,143,61,82
Lyraestra,hyjal,1578,paladin,retribution,78,33,45
Frazyl,kilrogg,1578,paladin,retribution,48,20,28
Vakoslav,burning-legion,1578,paladin,retribution,88,35,53
Sorkohoho,silvermoon,1577,paladin,retribution,42,25,17
Пурджпал,soulflayer,1577,paladin,retribution,101,58,43
Johnßlake,dun-modr,1577,paladin,retribution,159,82,77
Aguerx,alleria,1577,paladin,retribution,72,34,38
Noiwings,sanguino,1576,paladin,retribution,36,23,13
Bullstorm,burning-legion,1576,paladin,retribution,57,31,26
Athain,sanguino,1576,paladin,retribution,48,26,22
Búbbles,nerathor,1576,paladin,retribution,72,38,34
Yngild,antonidas,1576,paladin,retribution,48,23,25
Реализатор,howling-fjord,1576,paladin,retribution,109,46,63
Maltazar,arygos,1575,paladin,retribution,36,24,12
Rimlod,saurfang,1575,paladin,retribution,218,114,104
Тирлас,gordunni,1575,paladin,retribution,161,84,77
Тэлматос,soulflayer,1575,paladin,retribution,155,79,76
Nollieflip,tarren-mill,1575,paladin,retribution,42,21,21
Xtekz,tarren-mill,1575,paladin,retribution,97,47,50
Piti,burning-legion,1575,paladin,retribution,90,39,51
Truebeliever,ravencrest,1574,paladin,retribution,60,35,25
Emìnem,kazzak,1574,paladin,retribution,152,77,75
Robdob,kazzak,1574,paladin,retribution,132,66,66
Darkdeal,tarren-mill,1574,paladin,retribution,56,25,31
Angelisho,zuljin,1574,paladin,retribution,145,64,81
Vodax,argent-dawn,1573,paladin,retribution,86,43,43
Nashret,kazzak,1573,paladin,retribution,60,30,30
Quennten,grim-batol,1573,paladin,retribution,44,22,22
Hýox,malganis,1573,paladin,retribution,138,64,74
Ретриксвета,eversong,1573,paladin,retribution,42,19,23
Llighthand,ravencrest,1573,paladin,retribution,67,30,37
Heallgodxx,ragnaros,1572,paladin,retribution,30,17,13
Artal,tarren-mill,1571,paladin,retribution,60,31,29
Valhella,stormscale,1571,paladin,retribution,472,238,234
Daoht,ysondre,1571,paladin,retribution,60,30,30
Гневнебес,howling-fjord,1571,paladin,retribution,96,44,52
Wyzpal,archimonde,1570,paladin,retribution,59,31,28
Somixd,ragnaros,1570,paladin,retribution,350,178,172
Dankin,pozzo-delleternità,1570,paladin,retribution,100,47,53
Ønyxqt,archimonde,1569,paladin,retribution,41,22,19
Çhè,blackmoore,1569,paladin,retribution,41,21,20
Hammerofmilk,drakthul,1569,paladin,retribution,66,32,34
Lightwitcher,silvermoon,1569,paladin,retribution,227,108,119
Fleckige,nethersturm,1569,paladin,retribution,78,34,44
Socx,outland,1569,paladin,retribution,101,36,65
Irhoy,dalaran,1568,paladin,retribution,34,23,11
Luhae,archimonde,1568,paladin,retribution,72,44,28
Sâfcon,eredar,1568,paladin,retribution,61,34,27
Andocay,das-syndikat,1568,paladin,retribution,167,90,77
Danaklies,dragonblight,1568,paladin,retribution,48,24,24
Snødunkern,outland,1568,paladin,retribution,199,94,105
Kýríl,antonidas,1568,paladin,retribution,182,81,101
Mïnnîe,ysondre,1567,paladin,retribution,78,42,36
Crusshqt,silvermoon,1567,paladin,retribution,174,85,89
Истенен,blackscar,1567,paladin,retribution,126,59,67
Аностазия,ashenvale,1567,paladin,retribution,150,65,85
Diaéna,kirin-tor,1566,paladin,retribution,84,40,44
Zayonix,amanthul,1565,paladin,retribution,49,32,17
Arosyr,alleria,1565,paladin,retribution,92,50,42
Liadrîn,blackhand,1565,paladin,retribution,42,22,20
Aethelwold,ragnaros,1565,paladin,retribution,132,56,76
Okroschka,blackrock,1564,paladin,retribution,30,18,12
Saht,silvermoon,1564,paladin,retribution,76,38,38
Hssn,stormscale,1564,paladin,retribution,62,29,33
Warmâchiine,burning-legion,1563,paladin,retribution,155,78,77
Trixzie,blackhand,1563,paladin,retribution,36,18,18
Llaynn,argent-dawn,1563,paladin,retribution,84,36,48
Борссалино,gordunni,1562,paladin,retribution,193,97,96
Ralphias,tarren-mill,1562,paladin,retribution,127,62,65
Lynndora,outland,1561,paladin,retribution,132,78,54
Qïkarï,antonidas,1561,paladin,retribution,61,35,26
Dalbo,aegwynn,1560,paladin,retribution,46,31,15
Hideinlight,hellscream,1560,paladin,retribution,57,31,26
Mimsy,dalaran,1560,paladin,retribution,229,116,113
Decain,twisting-nether,1560,paladin,retribution,96,46,50
Lysander,antonidas,1560,paladin,retribution,36,17,19
Lumosboy,archimonde,1559,paladin,retribution,113,61,52
Leilla,blackmoore,1558,paladin,retribution,30,18,12
Mufuqa,ragnaros,1558,paladin,retribution,79,39,40
Unzufrieden,silvermoon,1558,paladin,retribution,129,63,66
Хексали,soulflayer,1558,paladin,retribution,69,32,37
Гташник,gordunni,1557,paladin,retribution,72,28,44
Ranish,aegwynn,1557,paladin,retribution,51,18,33
Unkillablee,stormscale,1556,paladin,retribution,88,52,36
Teahero,doomhammer,1556,paladin,retribution,36,21,15
Kríssu,burning-legion,1556,paladin,retribution,67,30,37
Holÿbeard,ravencrest,1555,paladin,retribution,89,54,35
Akâshi,dalaran,1555,paladin,retribution,60,36,24
Fishnchips,twisting-nether,1555,paladin,retribution,42,24,18
Kawabanga,the-maelstrom,1555,paladin,retribution,70,38,32
Giroud,dalaran,1555,paladin,retribution,36,17,19
Хеллкик,howling-fjord,1555,paladin,retribution,115,54,61
Destroyer,archimonde,1555,paladin,retribution,40,17,23
Tastán,aegwynn,1554,paladin,retribution,36,21,15
Ùthér,sylvanas,1554,paladin,retribution,79,40,39
Kaitlyne,tarren-mill,1554,paladin,retribution,555,277,278
Puers,burning-blade,1554,paladin,retribution,47,22,25
Trendragon,argent-dawn,1554,paladin,retribution,77,33,44
Deadlydawn,kazzak,1554,paladin,retribution,72,23,49
Kuhfleisch,eredar,1553,paladin,retribution,132,75,57
Odisea,burning-blade,1553,paladin,retribution,84,43,41
Alë,sanguino,1553,paladin,retribution,47,23,24
Arethos,twisting-nether,1553,paladin,retribution,54,19,35
Taiso,alonsus,1552,paladin,retribution,59,30,29
Spéos,archimonde,1552,paladin,retribution,106,51,55
Спидфрик,blackscar,1551,paladin,retribution,104,57,47
Drylands,ravencrest,1551,paladin,retribution,54,28,26
Eldrielle,culte-de-la-rive-noire,1551,paladin,retribution,71,35,36
Àræs,archimonde,1551,paladin,retribution,147,71,76
Rhyvar,outland,1551,paladin,retribution,42,19,23
Dantrag,eredar,1551,paladin,retribution,72,31,41
Møg,blackrock,1551,paladin,retribution,101,39,62
Hatrius,ravencrest,1549,paladin,retribution,93,58,35
Dufftroll,kazzak,1549,paladin,retribution,42,24,18
Джагадаптер,gordunni,1549,paladin,retribution,206,112,94
Ficsuur,ragnaros,1549,paladin,retribution,467,240,227
Хельдотер,howling-fjord,1549,paladin,retribution,55,27,28
Ксамо,howling-fjord,1548,paladin,retribution,41,25,16
Ämÿcüs,zuljin,1548,paladin,retribution,96,51,45
Антитеррор,greymane,1548,paladin,retribution,42,22,20
Кериас,gordunni,1548,paladin,retribution,42,22,20
Deresos,anetheron,1548,paladin,retribution,48,21,27
Dadoog,kazzak,1547,paladin,retribution,28,18,10
Avalindro,wrathbringer,1547,paladin,retribution,108,52,56
Sîlversun,grim-batol,1547,paladin,retribution,90,43,47
Gunpowderx,silvermoon,1547,paladin,retribution,42,18,24
Цитрон,blackscar,1546,paladin,retribution,24,17,7
Nexzz,outland,1546,paladin,retribution,41,28,13
Jonquiillee,dalaran,1546,paladin,retribution,83,43,40
Kerstyxd,blackrock,1546,paladin,retribution,162,83,79
Dodgerwilly,outland,1546,paladin,retribution,42,18,24
Vaako,blackrock,1545,paladin,retribution,110,61,49
Osïrïs,kazzak,1545,paladin,retribution,180,86,94
Fítzgerald,antonidas,1544,paladin,retribution,107,57,50
Медверус,gordunni,1544,paladin,retribution,89,47,42
Afhvahj,tichondrius,1544,paladin,retribution,218,108,110
Doubtfire,tarren-mill,1544,paladin,retribution,88,43,45
Девствениица,gordunni,1543,paladin,retribution,107,56,51
Howard,dalaran,1543,paladin,retribution,60,28,32
Legiuneax,darkspear,1543,paladin,retribution,54,22,32
Holycowe,kazzak,1542,paladin,retribution,36,20,16
Móóñý,silvermoon,1542,paladin,retribution,122,67,55
Kènpachî,blackrock,1542,paladin,retribution,48,22,26
Chocòbon,archimonde,1542,paladin,retribution,42,18,24
Itsgossiplol,twisting-nether,1542,paladin,retribution,98,39,59
Interop,tarren-mill,1541,paladin,retribution,54,30,24
Nîcolascage,stormscale,1541,paladin,retribution,42,19,23
Zeldalòl,outland,1541,paladin,retribution,59,25,34
Rapwnzel,sylvanas,1540,paladin,retribution,66,34,32
Zaatar,stormscale,1539,paladin,retribution,119,62,57
Lucyd,stormscale,1539,paladin,retribution,78,33,45
Krakr,ravencrest,1538,paladin,retribution,102,51,51
Cianna,shattered-hand,1538,paladin,retribution,69,27,42
Dijkie,boulderfist,1537,paladin,retribution,42,22,20
Zehnya,grim-batol,1537,paladin,retribution,411,214,197
Pný,silvermoon,1537,paladin,retribution,78,38,40
Sletlana,burning-blade,1537,paladin,retribution,110,48,62
Lycasia,hyjal,1537,paladin,retribution,84,36,48
Forja,silvermoon,1536,paladin,retribution,122,60,62
Obsidyen,outland,1536,paladin,retribution,63,29,34
Eleuterus,bloodfeather,1536,paladin,retribution,84,38,46
Blagori,blackhand,1535,paladin,retribution,30,20,10
Thazyru,frostmane,1535,paladin,retribution,80,48,32
Catar,arathor,1535,paladin,retribution,169,95,74
Lightleon,kazzak,1535,paladin,retribution,30,16,14
Enolaer,ragnaros,1535,paladin,retribution,95,49,46
Cauze,ravencrest,1535,paladin,retribution,204,105,99
Jaq,karazhan,1535,paladin,retribution,37,19,18
Shrôômîê,silvermoon,1535,paladin,retribution,81,41,40
Byakkospal,tarren-mill,1534,paladin,retribution,114,58,56
Бигшор,soulflayer,1534,paladin,retribution,54,22,32
Лаитнем,gordunni,1533,paladin,retribution,90,52,38
Zoltes,twisting-nether,1533,paladin,retribution,196,99,97
Ephialtis,hyjal,1532,paladin,retribution,30,24,6
Хоулик,howling-fjord,1532,paladin,retribution,87,50,37
Kunam,gorgonnash,1532,paladin,retribution,53,29,24
Sikthorlan,ravencrest,1532,paladin,retribution,42,22,20
Ashe,burning-legion,1531,paladin,retribution,24,16,8
Gigajudge,ravencrest,1531,paladin,retribution,60,29,31
Лантана,howling-fjord,1530,paladin,retribution,30,17,13
Proletardk,draenor,1530,paladin,retribution,150,82,68
Samueel,blackmoore,1529,paladin,retribution,146,80,66
Orti,sanguino,1529,paladin,retribution,107,57,50
Kreyvin,argent-dawn,1529,paladin,retribution,161,84,77
Румоур,gordunni,1529,paladin,retribution,48,19,29
Liadrineá,burning-blade,1528,paladin,retribution,30,16,14
Blooregard,nathrezim,1528,paladin,retribution,54,25,29
Mathrixo,silvermoon,1528,paladin,retribution,48,20,28
Snowife,drakthul,1528,paladin,retribution,54,22,32
Kelianna,drakthul,1527,paladin,retribution,39,21,18
Lynaé,blackhand,1527,paladin,retribution,37,18,19
Strätholme,drakthul,1527,paladin,retribution,42,18,24
Sheleftyou,stormreaver,1526,paladin,retribution,65,38,27
Pappnas,blackmoore,1526,paladin,retribution,30,16,14
Андерлайт,azuregos,1526,paladin,retribution,53,28,25
Мётод,howling-fjord,1526,paladin,retribution,42,22,20
Юкамилайт,howling-fjord,1526,paladin,retribution,60,28,32
Flawx,blackmoore,1525,paladin,retribution,77,44,33
Дракула,howling-fjord,1525,paladin,retribution,156,75,81
Bailleya,drakthul,1525,paladin,retribution,120,53,67
Lightstrike,stormrage,1524,paladin,retribution,42,26,16
Arfeniel,stormscale,1524,paladin,retribution,156,74,82
Gllorya,ragnaros,1524,paladin,retribution,70,31,39
Slipoj,blackhand,1523,paladin,retribution,78,44,34
Juliea,aegwynn,1523,paladin,retribution,144,75,69
Ínvi,aegwynn,1523,paladin,retribution,93,48,45
Moodý,ragnaros,1523,paladin,retribution,132,67,65
Kurøneko,hyjal,1523,paladin,retribution,58,29,29
Johnnypal,doomhammer,1523,paladin,retribution,36,18,18
Valkyrjai,silvermoon,1523,paladin,retribution,71,32,39
Jobsu,defias-brotherhood,1522,paladin,retribution,38,21,17
Celiath,draenor,1522,paladin,retribution,48,24,24
Ibntaymiyyah,ravencrest,1522,paladin,retribution,36,18,18
Deathlyblaze,draenor,1521,paladin,retribution,60,33,27
Valunajhnwar,azuremyst,1521,paladin,retribution,152,75,77
Jerremia,silvermoon,1521,paladin,retribution,61,30,31
Blegret,antonidas,1521,paladin,retribution,78,36,42
Кливерти,gordunni,1521,paladin,retribution,96,43,53
Rudî,sanguino,1520,paladin,retribution,64,45,19
Lechita,darksorrow,1520,paladin,retribution,30,16,14
Tibirius,outland,1520,paladin,retribution,66,35,31
Hanksolos,drakthul,1520,paladin,retribution,70,37,33
Palstarr,malorne,1520,paladin,retribution,70,37,33
Havefunzqt,archimonde,1520,paladin,retribution,203,101,102
Скадих,soulflayer,1520,paladin,retribution,46,21,25
Brorgustav,doomhammer,1520,paladin,retribution,36,16,20
Sunforged,bloodhoof,1520,paladin,retribution,56,23,33
Keógh,kazzak,1519,paladin,retribution,36,26,10
Гогрик,soulflayer,1519,paladin,retribution,30,17,13
Blecheímer,blackrock,1519,paladin,retribution,45,23,22
Buyamazon,kazzak,1519,paladin,retribution,36,17,19
Nikibrahboi,outland,1519,paladin,retribution,47,16,31
Холишокович,deathweaver,1518,paladin,retribution,120,58,62
Vitacé,burning-legion,1518,paladin,retribution,132,63,69
Nexo,bloodscalp,1518,paladin,retribution,38,18,20
Acepally,antonidas,1518,paladin,retribution,90,35,55
Emprò,kazzak,1517,paladin,retribution,48,27,21
Fauel,burning-legion,1517,paladin,retribution,160,82,78
Codindio,silvermoon,1517,paladin,retribution,112,57,55
Shroomez,frostmane,1517,paladin,retribution,57,28,29
Greko,ysera,1517,paladin,retribution,35,16,19
Ллосла,howling-fjord,1517,paladin,retribution,54,19,35
Stinkytoes,draenor,1516,paladin,retribution,36,20,16
Zatoxi,frostmane,1516,paladin,retribution,30,16,14
Celerius,trollbane,1516,paladin,retribution,60,24,36
Mytet,burning-legion,1515,paladin,retribution,30,16,14
Windsor,argent-dawn,1515,paladin,retribution,147,78,69
Mâterîa,antonidas,1515,paladin,retribution,166,83,83
Mansoureagle,kazzak,1515,paladin,retribution,42,21,21
Waks,dalaran,1515,paladin,retribution,48,21,27
Zeffêx,stormscale,1515,paladin,retribution,42,18,24
Jøøs,sargeras,1514,paladin,retribution,123,68,55
Hys,stormscale,1514,paladin,retribution,42,23,19
Владыкасвета,borean-tundra,1514,paladin,retribution,129,67,62
Herrod,hyjal,1514,paladin,retribution,62,29,33
Chelan,thrall,1514,paladin,retribution,66,28,38
Crooswijk,doomhammer,1513,paladin,retribution,69,35,34
Эеомли,blackscar,1513,paladin,retribution,131,64,67
Ярослэйв,howling-fjord,1513,paladin,retribution,140,64,76
Заххо,howling-fjord,1512,paladin,retribution,30,16,14
Свётаякорова,thermaplugg,1512,paladin,retribution,30,16,14
Росиель,soulflayer,1512,paladin,retribution,148,74,74
Cenie,dunemaul,1512,paladin,retribution,134,55,79
Phorios,agamaggan,1512,paladin,retribution,90,35,55
Gashqx,hyjal,1511,paladin,retribution,92,55,37
Evililz,kazzak,1511,paladin,retribution,157,82,75
Lìdspridaren,xavius,1511,paladin,retribution,42,20,22
Holyshied,silvermoon,1510,paladin,retribution,84,41,43
Impaross,shattrath,1509,paladin,retribution,159,87,72
Aroyul,silvermoon,1509,paladin,retribution,36,17,19
Cornfalke,silvermoon,1508,paladin,retribution,42,27,15
Lawlight,frostmane,1508,paladin,retribution,111,57,54
Blekadin,ragnaros,1508,paladin,retribution,134,68,66
Iljanaqt,blackrock,1508,paladin,retribution,111,52,59
Ксенджин,gordunni,1507,paladin,retribution,64,32,32
Igrael,argent-dawn,1507,paladin,retribution,108,53,55
Ретридор,soulflayer,1507,paladin,retribution,48,21,27
Викиллер,grom,1506,paladin,retribution,120,66,54
Hajzlbaba,outland,1506,paladin,retribution,32,17,15
Tharizod,nagrand,1506,paladin,retribution,87,43,44
Gökbörû,blackmoore,1506,paladin,retribution,83,41,42
Mommy,darksorrow,1506,paladin,retribution,108,49,59
Blazehammer,drakthul,1506,paladin,retribution,69,31,38
Падаетслезаа,howling-fjord,1506,paladin,retribution,54,24,30
Ulrhik,nemesis,1506,paladin,retribution,81,33,48
Murodin,twisting-nether,1506,paladin,retribution,42,16,26
Imreallybadx,blackrock,1505,paladin,retribution,85,46,39
Exirtius,haomarush,1505,paladin,retribution,128,69,59
Paradoax,quelthalas,1505,paladin,retribution,30,16,14
Kytonic,silvermoon,1505,paladin,retribution,76,37,39
Tazkaz,archimonde,1505,paladin,retribution,68,33,35
Pak,amanthul,1505,paladin,retribution,63,28,35
Kaarakartall,silvermoon,1504,paladin,retribution,36,24,12
Lovetospoonn,ravencrest,1504,paladin,retribution,72,44,28
Rînedaman,ysondre,1504,paladin,retribution,42,21,21
Diviney,twisting-nether,1504,paladin,retribution,71,34,37
Mílkme,antonidas,1503,paladin,retribution,24,16,8
Йзериль,howling-fjord,1503,paladin,retribution,52,31,21
Günselsen,antonidas,1503,paladin,retribution,416,215,201
Séanors,archimonde,1502,paladin,retribution,22,17,5
Barakisback,silvermoon,1502,paladin,retribution,86,52,34
Irini,sylvanas,1502,paladin,retribution,43,26,17
Unogym,dragonblight,1502,paladin,retribution,72,39,33
Daerthe,twisting-nether,1502,paladin,retribution,42,16,26
Holymunt,sylvanas,1501,paladin,retribution,34,20,14
Elrandil,kazzak,1501,paladin,retribution,78,35,43
Enveador,garrosh,1500,paladin,retribution,78,44,34
Rèmi,pozzo-delleternità,1500,paladin,retribution,72,40,32
Ландри,greymane,1500,paladin,retribution,36,20,16
Svetijuju,kazzak,1500,paladin,retribution,113,61,52
Veckra,kazzak,1500,paladin,retribution,170,89,81
Blówout,tarren-mill,1500,paladin,retribution,54,27,27
Dìe,silvermoon,1500,paladin,retribution,47,19,28
Esdras,sanguino,1499,paladin,retribution,390,200,190
Çronus,tarren-mill,1498,paladin,retribution,44,30,14
Swan,chogall,1498,paladin,retribution,60,32,28
Divinenoob,ravencrest,1498,paladin,retribution,60,32,28
Arrious,frostmane,1498,paladin,retribution,64,33,31
Logikoma,tarren-mill,1497,paladin,retribution,60,35,25
Greyeyed,kazzak,1497,paladin,retribution,92,49,43
Mattiesko,kazzak,1497,paladin,retribution,151,78,73
Амнон,goldrinn,1497,paladin,retribution,57,28,29
Lamperos,eonar,1497,paladin,retribution,37,16,21
Эезекииль,howling-fjord,1496,paladin,retribution,169,95,74
Shmndr,kazzak,1496,paladin,retribution,46,25,21
Tscheba,kazzak,1496,paladin,retribution,117,62,55
Galevar,argent-dawn,1496,paladin,retribution,174,88,86
Níthag,ragnaros,1496,paladin,retribution,72,35,37
Eärendil,drakthul,1496,paladin,retribution,72,32,40
Dananas,draenor,1496,paladin,retribution,72,27,45
Варблэйз,gordunni,1495,paladin,retribution,30,16,14
Azhrei,archimonde,1495,paladin,retribution,36,16,20
Lamohru,argent-dawn,1495,paladin,retribution,72,31,41
Tarenath,aegwynn,1495,paladin,retribution,47,20,27
Sacredlol,blackmoore,1495,paladin,retribution,63,24,39
Aegend,antonidas,1494,paladin,retribution,220,112,108
Snackzy,twisting-nether,1494,paladin,retribution,174,84,90
Saintys,sylvanas,1494,paladin,retribution,116,55,61
Nobo,hellfire,1494,paladin,retribution,47,20,27
Skittlespala,twisting-nether,1493,paladin,retribution,47,33,14
Ксаиотх,blackscar,1493,paladin,retribution,84,34,50
Milkâ,burning-legion,1492,paladin,retribution,40,25,15
Волатбай,gordunni,1492,paladin,retribution,90,50,40
Блуудс,howling-fjord,1492,paladin,retribution,115,59,56
Hângôrlo,blackrock,1491,paladin,retribution,30,16,14
Riukÿ,nemesis,1491,paladin,retribution,71,37,34
Bashanger,boulderfist,1491,paladin,retribution,60,31,29
Кветирон,soulflayer,1491,paladin,retribution,174,86,88
Kaliano,twisting-nether,1491,paladin,retribution,89,43,46
Créo,draenor,1491,paladin,retribution,90,42,48
Toompaa,ravencrest,1490,paladin,retribution,57,36,21
Baé,drakthul,1490,paladin,retribution,76,34,42
Theodór,antonidas,1490,paladin,retribution,128,57,71
Ketherian,blutkessel,1490,paladin,retribution,64,23,41
Cos,stormscale,1489,paladin,retribution,58,30,28
Aurroraa,doomhammer,1489,paladin,retribution,93,46,47
Ilovemylay,area-52,1489,paladin,retribution,69,34,35
Camembert,sanguino,1489,paladin,retribution,48,23,25
Wolluna,frostwolf,1489,paladin,retribution,94,44,50
Базапал,fordragon,1489,paladin,retribution,48,22,26
Traýan,blackmoore,1488,paladin,retribution,30,18,12
Ковбаскаа,gordunni,1488,paladin,retribution,44,23,21
Sonarix,blackrock,1488,paladin,retribution,51,26,25
Blokeedaro,sanguino,1488,paladin,retribution,104,46,58
Alextrazite,kazzak,1488,paladin,retribution,60,23,37
Paulìe,draenor,1487,paladin,retribution,48,24,24
Doxynator,silvermoon,1487,paladin,retribution,83,40,43
Bjaï,hyjal,1487,paladin,retribution,87,40,47
Morniarn,argent-dawn,1486,paladin,retribution,96,54,42
Vangottwald,drakthul,1486,paladin,retribution,114,59,55
Draeymora,thrall,1486,paladin,retribution,145,72,73
Nînaninja,silvermoon,1486,paladin,retribution,121,60,61
Exley,blackmoore,1485,paladin,retribution,28,18,10
Mataleo,archimonde,1485,paladin,retribution,129,79,50
Мистеравадон,gordunni,1484,paladin,retribution,158,71,87
Síndorí,frostwolf,1484,paladin,retribution,96,41,55
Тейдерган,soulflayer,1483,paladin,retribution,177,96,81
Dyöw,elune,1483,paladin,retribution,37,18,19
Ауё,blackscar,1483,paladin,retribution,53,25,28
Кольт,borean-tundra,1483,paladin,retribution,46,20,26
Savitri,drakthul,1482,paladin,retribution,72,39,33
Drivenlight,twisting-nether,1482,paladin,retribution,71,37,34
Icearth,pozzo-delleternità,1482,paladin,retribution,342,176,166
Жэж,howling-fjord,1481,paladin,retribution,156,86,70
Скварлетх,howling-fjord,1481,paladin,retribution,35,19,16
Диджейнобабл,howling-fjord,1481,paladin,retribution,34,18,16
Koami,blackmoore,1481,paladin,retribution,108,56,52
Spartain,draenor,1481,paladin,retribution,72,37,35
Sieghard,aegwynn,1481,paladin,retribution,244,122,122
Ramese,outland,1481,paladin,retribution,36,16,20
Frankostyle,sanguino,1481,paladin,retribution,79,33,46
Aderos,sylvanas,1480,paladin,retribution,30,18,12
Runcarsnwpen,kazzak,1480,paladin,retribution,53,31,22
Артреал,blackscar,1480,paladin,retribution,162,91,71
Endar,drakthul,1480,paladin,retribution,112,60,52
Némesis,frostmane,1480,paladin,retribution,54,24,30
Uxxer,sanguino,1479,paladin,retribution,41,23,18
Zélix,bronzebeard,1479,paladin,retribution,141,73,68
Rugila,ragnaros,1479,paladin,retribution,350,181,169
Slipmax,eredar,1479,paladin,retribution,66,31,35
Snottybrat,draenor,1478,paladin,retribution,128,73,55
Indye,hyjal,1478,paladin,retribution,60,34,26
Aisolôn,thrall,1478,paladin,retribution,83,47,36
Névér,steamwheedle-cartel,1478,paladin,retribution,83,45,38
Paladinguy,argent-dawn,1478,paladin,retribution,110,55,55
Лусейд,howling-fjord,1477,paladin,retribution,65,40,25
Sunrazor,kazzak,1477,paladin,retribution,132,67,65
Салутан,thermaplugg,1477,paladin,retribution,323,155,168
Fatâl,antonidas,1477,paladin,retribution,69,32,37
Øsgar,dun-modr,1477,paladin,retribution,49,22,27
Синдикатх,soulflayer,1476,paladin,retribution,179,97,82
Itiswhatitis,blackmoore,1476,paladin,retribution,32,17,15
Эсканор,galakrond,1476,paladin,retribution,61,31,30
Bloodpaly,silvermoon,1476,paladin,retribution,76,33,43
Aisnil,twilights-hammer,1475,paladin,retribution,149,78,71
Pliscken,kazzak,1475,paladin,retribution,95,45,50
Tobzin,argent-dawn,1474,paladin,retribution,72,37,35
Mograine,die-aldor,1474,paladin,retribution,192,97,95
Quaterbâck,antonidas,1474,paladin,retribution,86,43,43
Prelates,argent-dawn,1474,paladin,retribution,34,16,18
Melverti,kazzak,1473,paladin,retribution,30,17,13
Selaphíel,kazzak,1473,paladin,retribution,203,104,99
Шоринг,gordunni,1473,paladin,retribution,66,33,33
Snibsxpala,silvermoon,1473,paladin,retribution,47,23,24
Essenz,eredar,1473,paladin,retribution,87,36,51
Грузор,gordunni,1471,paladin,retribution,124,66,58
Gazïel,kaelthas,1471,paladin,retribution,117,61,56
Sralana,malfurion,1471,paladin,retribution,48,24,24
Romfis,arathor,1470,paladin,retribution,90,51,39
Sebatrøz,ravencrest,1470,paladin,retribution,48,26,22
Вессори,blackscar,1470,paladin,retribution,67,35,32
Brightgrove,silvermoon,1470,paladin,retribution,41,16,25
Kalkandelen,silvermoon,1469,paladin,retribution,55,35,20
Serethor,blackrock,1469,paladin,retribution,42,24,18
Luzmortal,zuljin,1469,paladin,retribution,102,54,48
Wize,steamwheedle-cartel,1469,paladin,retribution,176,92,84
Palarezz,ysondre,1469,paladin,retribution,70,33,37
Morninnstaar,kazzak,1469,paladin,retribution,66,31,35
Myrieni,silvermoon,1469,paladin,retribution,48,22,26
Benzimus,ragnaros,1469,paladin,retribution,93,35,58
Ippî,blackmoore,1467,paladin,retribution,37,23,14
Petitê,blackmoore,1467,paladin,retribution,161,91,70
Aumium,sunstrider,1467,paladin,retribution,130,61,69
Devilsangel,antonidas,1467,paladin,retribution,106,47,59
Stocks,burning-blade,1466,paladin,retribution,48,25,23
Syracx,blackhand,1466,paladin,retribution,120,61,59
Hydrath,ysondre,1466,paladin,retribution,120,58,62
Armadamadrid,outland,1466,paladin,retribution,50,24,26
Neêsoldr,blackmoore,1465,paladin,retribution,146,73,73
Mazekiel,archimonde,1465,paladin,retribution,60,30,30
Bubblefett,ysera,1465,paladin,retribution,36,18,18
Pyscys,dun-modr,1465,paladin,retribution,66,31,35
Blvckshxc,kazzak,1465,paladin,retribution,102,45,57
Paladiodinos,hyjal,1464,paladin,retribution,90,48,42
Leeroyjinks,twisting-nether,1464,paladin,retribution,110,58,52
Rethardz,grim-batol,1464,paladin,retribution,40,21,19
Hugins,chamber-of-aspects,1464,paladin,retribution,75,35,40
Teryanna,ragnaros,1464,paladin,retribution,140,62,78
Olivaresx,ravencrest,1464,paladin,retribution,72,30,42
Sházen,silvermoon,1464,paladin,retribution,48,19,29
Æfhm,blackrock,1463,paladin,retribution,54,32,22
Жанож,gordunni,1463,paladin,retribution,92,48,44
Røck,aggra-português,1463,paladin,retribution,207,107,100
Shtaladin,sylvanas,1463,paladin,retribution,185,90,95
Neltix,blackrock,1463,paladin,retribution,88,42,46
Rulîx,blackmoore,1463,paladin,retribution,227,104,123
Majk,hellscream,1463,paladin,retribution,97,42,55
Uøx,blackrock,1462,paladin,retribution,30,16,14
Loscar,silvermoon,1462,paladin,retribution,36,17,19
Иродиада,gordunni,1462,paladin,retribution,36,16,20
Molenko,rexxar,1462,paladin,retribution,96,42,54
Tiæ,archimonde,1461,paladin,retribution,29,16,13
Mustach,aggra-português,1461,paladin,retribution,95,51,44
Wälläce,sanguino,1461,paladin,retribution,41,16,25
Khouvec,tarren-mill,1460,paladin,retribution,30,19,11
Dagôn,sanguino,1460,paladin,retribution,30,18,12
Malemanlad,silvermoon,1460,paladin,retribution,132,67,65
Blakkjack,xavius,1460,paladin,retribution,107,51,56
Paladiaz,blackhand,1460,paladin,retribution,42,20,22
Жёстиксхилер,howling-fjord,1460,paladin,retribution,94,44,50
Naree,stormreaver,1460,paladin,retribution,96,44,52
Slayfer,dun-modr,1459,paladin,retribution,102,45,57
Goüstà,ysondre,1459,paladin,retribution,58,23,35
Humphry,vashj,1458,paladin,retribution,72,35,37
Deathlaf,argent-dawn,1458,paladin,retribution,42,19,23
Baldivar,silvermoon,1457,paladin,retribution,107,58,49
Leroya,blackrock,1457,paladin,retribution,35,18,17
Jeriiret,khaz-modan,1457,paladin,retribution,92,46,46
Frequencer,ragnaros,1457,paladin,retribution,66,28,38
Stellartois,thunderhorn,1457,paladin,retribution,52,17,35
Yumhi,dun-modr,1456,paladin,retribution,111,55,56
Jiraaqi,silvermoon,1456,paladin,retribution,137,67,70
Tóxicpaladín,kazzak,1456,paladin,retribution,139,66,73
Хоулишит,blackscar,1455,paladin,retribution,95,58,37
Gojesi,silvermoon,1455,paladin,retribution,141,70,71
Udimir,pozzo-delleternità,1455,paladin,retribution,70,28,42
Elinmogz,kazzak,1454,paladin,retribution,26,16,10
Pastaflwras,twisting-nether,1454,paladin,retribution,39,21,18
Серёжблондин,gordunni,1454,paladin,retribution,72,38,34
Dehanath,draenor,1454,paladin,retribution,231,119,112
Leelemon,frostmane,1454,paladin,retribution,70,36,34
Айэмбомб,howling-fjord,1454,paladin,retribution,46,22,24
Atemes,malorne,1453,paladin,retribution,27,17,10
Jathx,silvermoon,1453,paladin,retribution,127,68,59
Dopämine,tarren-mill,1453,paladin,retribution,154,74,80
Vangerot,ravencrest,1453,paladin,retribution,42,19,23
Æthëlflæd,ravencrest,1452,paladin,retribution,141,82,59
Крода,deepholm,1452,paladin,retribution,72,37,35
Nessùm,hyjal,1452,paladin,retribution,114,57,57
Lestaf,the-maelstrom,1452,paladin,retribution,90,43,47
Vedaar,dun-modr,1451,paladin,retribution,36,25,11
Obé,argent-dawn,1451,paladin,retribution,329,180,149
Thalia,dalvengyr,1451,paladin,retribution,32,17,15
Сенлеида,gordunni,1451,paladin,retribution,103,52,51
Yømø,antonidas,1451,paladin,retribution,125,63,62
Ðøñe,draenor,1451,paladin,retribution,64,32,32
Dagren,arathor,1450,paladin,retribution,30,19,11
Wrappers,archimonde,1450,paladin,retribution,54,29,25
Portgas,hyjal,1450,paladin,retribution,54,26,28
Неффко,howling-fjord,1449,paladin,retribution,106,52,54
Albz,laughing-skull,1449,paladin,retribution,48,22,26
Yaoiri,argent-dawn,1448,paladin,retribution,71,39,32
Ëlësilf,sanguino,1448,paladin,retribution,116,63,53
Мизиола,galakrond,1448,paladin,retribution,167,89,78
Raerion,ragnaros,1447,paladin,retribution,94,61,33
Hanknpank,quelthalas,1447,paladin,retribution,40,24,16
Dimes,argent-dawn,1446,paladin,retribution,25,18,7
Шмайтормвп,gordunni,1446,paladin,retribution,54,29,25
Boabux,draenor,1446,paladin,retribution,104,55,49
Хиккудоджер,eversong,1446,paladin,retribution,262,138,124
Teìltaus,eredar,1446,paladin,retribution,60,28,32
Сакермвп,howling-fjord,1445,paladin,retribution,36,23,13
Блатш,greymane,1445,paladin,retribution,91,32,59
Hutimeni,turalyon,1444,paladin,retribution,36,21,15
Fryl,quelthalas,1444,paladin,retribution,96,53,43
Наваляка,deathguard,1444,paladin,retribution,36,19,17
Shrøømz,antonidas,1443,paladin,retribution,60,33,27
Støøk,shendralar,1443,paladin,retribution,124,67,57
Raerk,dalaran,1443,paladin,retribution,226,122,104
Neverknõw,draenor,1442,paladin,retribution,38,21,17
Кариил,blackscar,1442,paladin,retribution,29,16,13
Dvouklik,burning-blade,1442,paladin,retribution,97,53,44
Unohana,shattered-halls,1442,paladin,retribution,142,65,77
Nothonnest,archimonde,1440,paladin,retribution,34,23,11
Overheals,blackmoore,1440,paladin,retribution,24,16,8
Palyx,cthun,1440,paladin,retribution,36,20,16
Lééroÿ,sylvanas,1440,paladin,retribution,132,67,65
Alithyra,earthen-ring,1440,paladin,retribution,97,49,48
Mííss,silvermoon,1440,paladin,retribution,84,42,42
Tomkü,burning-legion,1440,paladin,retribution,75,37,38
Малоко,thermaplugg,1440,paladin,retribution,72,33,39
Shatar,culte-de-la-rive-noire,1440,paladin,retribution,91,35,56
Naethan,malganis,1439,paladin,retribution,48,24,24
Twomog,ravencrest,1438,paladin,retribution,18,15,3
Onyr,hyjal,1438,paladin,retribution,78,40,38
Inkuboss,nemesis,1438,paladin,retribution,90,46,44
Dinønuggets,ravencrest,1438,paladin,retribution,30,15,15
Шэйкер,blackscar,1438,paladin,retribution,157,69,88
Aury,mannoroth,1437,paladin,retribution,60,36,24
Jojomann,stormscale,1437,paladin,retribution,66,35,31
Zenfret,kazzak,1437,paladin,retribution,40,21,19
Ben,ghostlands,1437,paladin,retribution,42,22,20
Hàsbulla,khaz-modan,1437,paladin,retribution,202,103,99
Cheerrios,arathor,1437,paladin,retribution,30,15,15
Mezzí,aegwynn,1436,paladin,retribution,48,27,21
Suge,azjolnerub,1436,paladin,retribution,82,44,38
Exceed,blackmoore,1436,paladin,retribution,30,15,15
Cùpìdstunt,draenor,1436,paladin,retribution,30,15,15
Джибути,soulflayer,1436,paladin,retribution,105,51,54
Enanon,zuljin,1436,paladin,retribution,58,25,33
Chíllpills,silvermoon,1436,paladin,retribution,72,31,41
Thyrna,alleria,1435,paladin,retribution,44,25,19
Storpixpala,drakthul,1435,paladin,retribution,114,63,51
Teho,dragonblight,1435,paladin,retribution,282,146,136
Viivox,draenor,1435,paladin,retribution,125,60,65
Palatimi,blackhand,1435,paladin,retribution,41,18,23
Buddabob,antonidas,1435,paladin,retribution,162,68,94
Gallifreya,archimonde,1435,paladin,retribution,36,15,21
Holycide,twisting-nether,1434,paladin,retribution,48,27,21
Nowitzki,sanguino,1434,paladin,retribution,48,25,23
Вэис,borean-tundra,1434,paladin,retribution,77,38,39
Lìadrin,nemesis,1434,paladin,retribution,42,19,23
Hegazy,darkmoon-faire,1434,paladin,retribution,108,48,60
Альбусор,galakrond,1434,paladin,retribution,54,24,30
Yasuomid,sanguino,1434,paladin,retribution,36,16,20
Yull,twisting-nether,1433,paladin,retribution,95,51,44
Бинур,eversong,1433,paladin,retribution,86,45,41
Lipsvirgin,kazzak,1433,paladin,retribution,30,15,15
Izolated,aegwynn,1433,paladin,retribution,96,44,52
Paterymon,ravencrest,1433,paladin,retribution,36,15,21
Unleashed,antonidas,1433,paladin,retribution,37,15,22
Notdeadfred,silvermoon,1432,paladin,retribution,78,40,38
Thrinea,blackrock,1432,paladin,retribution,80,41,39
Cassandrina,kazzak,1432,paladin,retribution,65,33,32
Moraru,neptulon,1432,paladin,retribution,139,67,72
Eazyé,twisting-nether,1432,paladin,retribution,50,24,26
Reinas,sanguino,1432,paladin,retribution,42,18,24
Schoolbus,blackrock,1431,paladin,retribution,36,18,18
Keele,stormscale,1431,paladin,retribution,36,18,18
Quordthor,sanguino,1431,paladin,retribution,66,32,34
Shebapaladin,silvermoon,1431,paladin,retribution,36,16,20
Aston,sylvanas,1431,paladin,retribution,66,28,38
Khoping,silvermoon,1430,paladin,retribution,24,15,9
Stratarxis,kazzak,1430,paladin,retribution,24,15,9
Cästiël,arathor,1430,paladin,retribution,179,95,84
Anathena,twisting-nether,1430,paladin,retribution,36,17,19
Боевикс,ashenvale,1429,paladin,retribution,120,66,54
Гигаиисус,gordunni,1429,paladin,retribution,39,21,18
Zethadin,kazzak,1429,paladin,retribution,75,40,35
Тарйья,gordunni,1429,paladin,retribution,65,33,32
Zanreti,outland,1429,paladin,retribution,134,68,66
Brigholm,argent-dawn,1429,paladin,retribution,80,36,44
Ветрум,gordunni,1428,paladin,retribution,48,23,25
Emet,twisting-nether,1428,paladin,retribution,61,29,32
Galath,drakthul,1428,paladin,retribution,54,23,31
Nzmamba,burning-legion,1428,paladin,retribution,36,15,21
Kelore,hyjal,1428,paladin,retribution,48,17,31
Thormentâ,sanguino,1427,paladin,retribution,78,40,38
Skålf,outland,1427,paladin,retribution,30,15,15
Garthoronir,antonidas,1427,paladin,retribution,69,29,40
Nomercyl,suramar,1426,paladin,retribution,64,38,26
Æxiroa,antonidas,1426,paladin,retribution,36,19,17
Velikor,dun-modr,1426,paladin,retribution,42,22,20
Сазар,gordunni,1426,paladin,retribution,51,21,30
Ùthër,silvermoon,1425,paladin,retribution,105,57,48
Dmascus,blackrock,1425,paladin,retribution,48,25,23
Вэйсспал,howling-fjord,1425,paladin,retribution,30,15,15
Turskah,shattered-hand,1425,paladin,retribution,30,15,15
Rent,sylvanas,1425,paladin,retribution,52,23,29
Clementine,spinebreaker,1425,paladin,retribution,45,19,26
Retenki,draenor,1425,paladin,retribution,42,17,25
Csvepanszul,ragnaros,1424,paladin,retribution,24,15,9
Mofawilli,blackrock,1424,paladin,retribution,100,53,47
Maegli,thrall,1424,paladin,retribution,49,22,27
Ericafontës,kazzak,1424,paladin,retribution,59,26,33
Malianterø,ravencrest,1424,paladin,retribution,149,65,84
Delishious,twisting-nether,1423,paladin,retribution,24,16,8
Astralz,aegwynn,1423,paladin,retribution,24,15,9
Рэгнволд,deathguard,1423,paladin,retribution,70,37,33
Brøkên,archimonde,1423,paladin,retribution,78,40,38
Nalaea,arathor,1423,paladin,retribution,60,29,31
Nozgot,chromaggus,1423,paladin,retribution,54,26,28
Roxter,burning-legion,1423,paladin,retribution,84,40,44
Hammertom,stormscale,1423,paladin,retribution,34,16,18
Autrup,defias-brotherhood,1422,paladin,retribution,24,15,9
Hehtmonghour,sanguino,1422,paladin,retribution,65,34,31
Jâybee,ravencrest,1422,paladin,retribution,66,34,32
Asteriia,frostwolf,1422,paladin,retribution,225,114,111
Cracish,ragnaros,1422,paladin,retribution,30,15,15
Malagat,die-todeskrallen,1422,paladin,retribution,102,50,52
Finñ,sylvanas,1422,paladin,retribution,119,58,61
Pratt,deathwing,1422,paladin,retribution,117,56,61
Knigh,draenor,1422,paladin,retribution,126,60,66
Xawier,ghostlands,1422,paladin,retribution,105,50,55
Feelinara,blackmoore,1421,paladin,retribution,66,36,30
Asunea,silvermoon,1421,paladin,retribution,130,70,60
Myxas,tarren-mill,1421,paladin,retribution,38,20,18
Xalthan,defias-brotherhood,1421,paladin,retribution,54,27,27
Ско,lich-king,1420,paladin,retribution,27,16,11
Rodakinos,outland,1420,paladin,retribution,76,44,32
Valerner,argent-dawn,1420,paladin,retribution,74,39,35
Софилион,gordunni,1420,paladin,retribution,93,49,44
Xanesha,archimonde,1420,paladin,retribution,66,25,41
Barqin,ragnaros,1419,paladin,retribution,109,60,49
Асшура,howling-fjord,1419,paladin,retribution,58,28,30
Тромбб,soulflayer,1419,paladin,retribution,100,46,54
Sheaps,les-sentinelles,1419,paladin,retribution,42,18,24
Utherion,ysera,1418,paladin,retribution,24,15,9
Kerchal,dalaran,1418,paladin,retribution,48,26,22
Лотранир,gordunni,1418,paladin,retribution,30,16,14
Sixqti,blackrock,1418,paladin,retribution,217,109,108
Wøømy,hyjal,1418,paladin,retribution,100,49,51
ßrav,hyjal,1418,paladin,retribution,44,21,23
Yuri,voljin,1418,paladin,retribution,40,17,23
Alliencookie,elune,1418,paladin,retribution,51,19,32
Wankerjim,ghostlands,1418,paladin,retribution,54,17,37
Veriø,dun-modr,1417,paladin,retribution,52,22,30
Diamir,rajaxx,1417,paladin,retribution,51,20,31
Ustnivkusni,kazzak,1416,paladin,retribution,31,19,12
Uraraka,burning-blade,1416,paladin,retribution,54,33,21
Ханпаладин,howling-fjord,1416,paladin,retribution,119,67,52
Holydhanas,outland,1416,paladin,retribution,30,15,15
Offa,draenor,1416,paladin,retribution,48,23,25
Тюрр,lich-king,1416,paladin,retribution,115,55,60
Ljumá,kazzak,1416,paladin,retribution,114,54,60
Kaelthir,bladefist,1415,paladin,retribution,80,46,34
Suavé,ravencrest,1415,paladin,retribution,80,40,40
Goldhand,vashj,1415,paladin,retribution,127,63,64
Notingvar,doomhammer,1415,paladin,retribution,93,43,50
Notsomuch,alakir,1414,paladin,retribution,69,39,30
Цвандр,gordunni,1414,paladin,retribution,212,111,101
Маркант,gordunni,1414,paladin,retribution,240,123,117
Reiwyn,archimonde,1414,paladin,retribution,93,42,51
Primle,thrall,1413,paladin,retribution,88,49,39
Sangiorgio,nemesis,1413,paladin,retribution,100,48,52
Jackub,draenor,1412,paladin,retribution,62,34,28
Киръпич,grom,1412,paladin,retribution,36,15,21
Синфуледи,gordunni,1412,paladin,retribution,66,23,43
Wigsnatcher,argent-dawn,1411,paladin,retribution,36,19,17
Lakster,blackmoore,1411,paladin,retribution,48,20,28
Whatapity,silvermoon,1411,paladin,retribution,60,24,36
Pállis,ravencrest,1410,paladin,retribution,24,16,8
Tehacê,blackrock,1410,paladin,retribution,38,17,21
Demecir,twisting-nether,1409,paladin,retribution,24,16,8
Лурири,gordunni,1409,paladin,retribution,54,35,19
Arien,zuljin,1409,paladin,retribution,199,104,95
Karthvitall,kaelthas,1409,paladin,retribution,48,25,23
Goodfail,sanguino,1409,paladin,retribution,76,38,38
Slageth,argent-dawn,1409,paladin,retribution,68,34,34
Freedomwinds,kazzak,1409,paladin,retribution,36,15,21
Квемсис,ashenvale,1408,paladin,retribution,214,120,94
Atanasum,dun-modr,1408,paladin,retribution,60,32,28
Pornado,ragnaros,1408,paladin,retribution,72,34,38
Puré,festung-der-stürme,1408,paladin,retribution,119,55,64
Vlodthar,uldum,1407,paladin,retribution,48,28,20
Вандиир,soulflayer,1407,paladin,retribution,64,34,30
Veliios,silvermoon,1407,paladin,retribution,74,36,38
Arrens,silvermoon,1407,paladin,retribution,44,21,23
Animouse,drakthul,1406,paladin,retribution,52,33,19
Grapaladin,sanguino,1406,paladin,retribution,44,23,21
Sylazz,blackrock,1406,paladin,retribution,343,175,168
Eken,hyjal,1406,paladin,retribution,48,23,25
Hammertime,guldan,1406,paladin,retribution,72,33,39
Gaveren,ravencrest,1406,paladin,retribution,68,29,39
Oldsqlmofu,blackrock,1406,paladin,retribution,42,17,25
Quuri,frostwolf,1405,paladin,retribution,24,15,9
Darnero,blackrock,1405,paladin,retribution,48,29,19
Burstyléz,silvermoon,1405,paladin,retribution,59,34,25
Curtwizz,silvermoon,1405,paladin,retribution,57,29,28
Torpala,burning-legion,1405,paladin,retribution,58,27,31
Fleshoflight,arathor,1404,paladin,retribution,45,27,18
Дорогаснега,gordunni,1404,paladin,retribution,82,43,39
Ashent,stormscale,1404,paladin,retribution,76,38,38
Noxxiê,blackmoore,1404,paladin,retribution,48,24,24
Pwnyú,aegwynn,1404,paladin,retribution,102,49,53
Lìmier,ysondre,1404,paladin,retribution,36,17,19
Zeramur,malygos,1404,paladin,retribution,48,17,31
Schaaboowyy,burning-legion,1403,paladin,retribution,37,20,17
Booyaahh,ravencrest,1403,paladin,retribution,65,35,30
Vanyon,malganis,1403,paladin,retribution,62,33,29
Azovstal,terokkar,1403,paladin,retribution,80,42,38
Hurmôk,tarren-mill,1403,paladin,retribution,115,58,57
Balthassar,kirin-tor,1403,paladin,retribution,232,116,116
Наолина,gordunni,1403,paladin,retribution,94,45,49
Craaw,archimonde,1403,paladin,retribution,106,44,62
Jcpd,drakthul,1403,paladin,retribution,70,25,45
Oûtplâyêd,blackmoore,1402,paladin,retribution,30,19,11
Åriel,uldum,1402,paladin,retribution,68,32,36
Aleixodolphi,argent-dawn,1402,paladin,retribution,209,93,116
Blubbajoe,blackmoore,1402,paladin,retribution,48,21,27
Eletha,senjin,1402,paladin,retribution,36,15,21
Sinalia,shattrath,1401,paladin,retribution,54,30,24
Argonak,sanguino,1401,paladin,retribution,96,49,47
Palamanyaka,kazzak,1401,paladin,retribution,30,15,15
Ruben,kirin-tor,1401,paladin,retribution,36,16,20
Liett,archimonde,1401,paladin,retribution,36,15,21
Pyronort,eredar,1400,paladin,retribution,42,24,18
Fizzyy,ragnaros,1400,paladin,retribution,38,20,18
Хочучерешни,lich-king,1399,paladin,retribution,93,50,43
Rîex,alleria,1399,paladin,retribution,77,36,41
Адирон,booty-bay,1398,paladin,retribution,30,22,8
Crêuyf,elune,1398,paladin,retribution,55,27,28
Crazzylight,kazzak,1398,paladin,retribution,86,41,45
Ekzykes,ravencrest,1397,paladin,retribution,24,15,9
Nyren,guldan,1397,paladin,retribution,31,18,13
Serawyn,twisting-nether,1397,paladin,retribution,37,21,16
Ventsi,kazzak,1397,paladin,retribution,389,201,188
Ryaz,blackrock,1397,paladin,retribution,54,27,27
Wingedtruck,draenor,1397,paladin,retribution,30,15,15
Rosallyn,argent-dawn,1397,paladin,retribution,89,35,54
Monkeylight,ambossar,1396,paladin,retribution,76,39,37
Balderstomp,jaedenar,1396,paladin,retribution,75,34,41
Vendikor,nemesis,1396,paladin,retribution,156,69,87
Duron,dragonblight,1396,paladin,retribution,45,19,26
Harycon,thrall,1395,paladin,retribution,42,20,22
Баблспула,soulflayer,1395,paladin,retribution,133,63,70
Crest,frostwolf,1394,paladin,retribution,48,29,19
Palantex,drakthul,1394,paladin,retribution,150,72,78
Palacetámol,gorgonnash,1394,paladin,retribution,94,45,49
Холигор,deathguard,1394,paladin,retribution,84,40,44
Кадаврициан,howling-fjord,1394,paladin,retribution,72,32,40
Snowlyi,stormscale,1394,paladin,retribution,42,17,25
Hydarr,twisting-nether,1393,paladin,retribution,86,48,38
Загошслакер,howling-fjord,1392,paladin,retribution,42,22,20
Whitebreeze,sanguino,1392,paladin,retribution,88,44,44
Lowsonzretri,doomhammer,1392,paladin,retribution,90,41,49
Isora,twisting-nether,1392,paladin,retribution,159,67,92
Zalandy,aggra-português,1391,paladin,retribution,71,39,32
Gélan,stormscale,1391,paladin,retribution,176,88,88
Dragonous,darkmoon-faire,1391,paladin,retribution,181,89,92
Palaradis,doomhammer,1391,paladin,retribution,35,17,18
Leoniidas,cthun,1391,paladin,retribution,65,30,35
Trefino,blackrock,1390,paladin,retribution,24,15,9
Белкоксю,booty-bay,1390,paladin,retribution,132,65,67
Proxypala,silvermoon,1390,paladin,retribution,125,59,66
Valerionn,blackmoore,1389,paladin,retribution,125,62,63
Arkiol,marécage-de-zangar,1388,paladin,retribution,60,29,31
Dramaking,the-maelstrom,1388,paladin,retribution,52,25,27
Wisupl,silvermoon,1387,paladin,retribution,42,29,13
Йенфира,gordunni,1387,paladin,retribution,30,18,12
Røse,argent-dawn,1387,paladin,retribution,30,16,14
Revinox,silvermoon,1386,paladin,retribution,71,42,29
Fumaça,dun-modr,1386,paladin,retribution,119,66,53
Zandorath,argent-dawn,1386,paladin,retribution,54,24,30
Angelcore,tarren-mill,1385,paladin,retribution,207,103,104
Kaelron,sanguino,1384,paladin,retribution,33,21,12
Элавин,gordunni,1384,paladin,retribution,31,16,15
Mareshki,outland,1384,paladin,retribution,72,32,40
Leomealux,pozzo-delleternità,1383,paladin,retribution,42,22,20
Kirikoro,blackmoore,1383,paladin,retribution,42,16,26
Iklohz,sanguino,1382,paladin,retribution,82,45,37
Lògàn,pozzo-delleternità,1382,paladin,retribution,38,16,22
Vörtëx,tarren-mill,1381,paladin,retribution,77,43,34
Lukeus,the-maelstrom,1381,paladin,retribution,120,63,57
Grobididi,malygos,1381,paladin,retribution,368,185,183
Hordiienko,silvermoon,1381,paladin,retribution,82,39,43
Nishe,earthen-ring,1380,paladin,retribution,30,17,13
Манддалорец,howling-fjord,1380,paladin,retribution,229,113,116
Sanduciorba,chamber-of-aspects,1379,paladin,retribution,77,41,36
Holycowqt,eredar,1379,paladin,retribution,45,18,27
Вартэгпал,blackscar,1379,paladin,retribution,54,21,33
Càrláßrùní,hyjal,1378,paladin,retribution,48,29,19
Legendaryxw,drakthul,1378,paladin,retribution,100,49,51
Protos,ambossar,1378,paladin,retribution,62,28,34
Cherenpetur,neptulon,1377,paladin,retribution,56,30,26
Blodin,silvermoon,1377,paladin,retribution,42,16,26
Artplex,ravencrest,1376,paladin,retribution,143,86,57
Yuopps,draenor,1376,paladin,retribution,66,35,31
Bezúziusz,ragnaros,1376,paladin,retribution,86,45,41
Miqee,burning-legion,1376,paladin,retribution,99,49,50
Juozas,argent-dawn,1376,paladin,retribution,36,16,20
Straxotia,twisting-nether,1375,paladin,retribution,58,31,27
Hogan,blackmoore,1375,paladin,retribution,48,24,24
Walladin,stormscale,1375,paladin,retribution,93,45,48
Гримгалл,soulflayer,1375,paladin,retribution,54,25,29
Whipyohead,burning-blade,1375,paladin,retribution,46,17,29
Perrinaybull,magtheridon,1374,paladin,retribution,62,27,35
Твойвайб,gordunni,1373,paladin,retribution,159,77,82
Xavios,eredar,1373,paladin,retribution,75,35,40
Блейзерфайт,eversong,1373,paladin,retribution,58,26,32
Annyaiva,outland,1372,paladin,retribution,126,54,72
Dmytropal,draenor,1372,paladin,retribution,57,24,33
Telredor,rexxar,1372,paladin,retribution,42,15,27
Bettemý,tarren-mill,1371,paladin,retribution,36,24,12
Hemdâl,kirin-tor,1371,paladin,retribution,120,65,55
Hella,dunemaul,1371,paladin,retribution,73,39,34
Shröömïë,silvermoon,1371,paladin,retribution,164,80,84
Olaghkan,dun-modr,1370,paladin,retribution,70,37,33
Mexou,la-croisade-écarlate,1370,paladin,retribution,42,20,22
Soulglo,ragnaros,1370,paladin,retribution,96,45,51
Badtrip,bloodscalp,1370,paladin,retribution,48,15,33
Dodu,vashj,1369,paladin,retribution,35,20,15
Akelad,arathor,1369,paladin,retribution,90,33,57
Patriok,moonglade,1368,paladin,retribution,75,43,32
Вэйзмон,gordunni,1368,paladin,retribution,65,36,29
Beyma,twisting-nether,1368,paladin,retribution,29,15,14
Uwelist,arathor,1368,paladin,retribution,85,40,45
Nomurabeta,naxxramas,1368,paladin,retribution,62,29,33
Slaaneesh,zuljin,1368,paladin,retribution,36,15,21
Judgement,the-maelstrom,1367,paladin,retribution,48,25,23
Lothacia,blackmoore,1367,paladin,retribution,36,17,19
Архэла,gordunni,1367,paladin,retribution,65,29,36
Держимордва,razuvious,1367,paladin,retribution,71,31,40
Ruftadin,ragnaros,1367,paladin,retribution,78,33,45
Tosuro,sunstrider,1366,paladin,retribution,37,16,21
Террорх,blackscar,1366,paladin,retribution,72,29,43
Eulion,burning-legion,1365,paladin,retribution,24,16,8
Bladê,kazzak,1365,paladin,retribution,33,19,14
Tecknó,ragnaros,1365,paladin,retribution,42,23,19
Uragan,blackmoore,1365,paladin,retribution,122,64,58
Prosteprazak,ragnaros,1365,paladin,retribution,63,29,34
Розовыйужас,howling-fjord,1365,paladin,retribution,36,16,20
Mozg,silvermoon,1365,paladin,retribution,35,15,20
Tuplavv,dunemaul,1365,paladin,retribution,48,20,28
Gxdéon,hyjal,1364,paladin,retribution,117,67,50
Acp,twisting-nether,1364,paladin,retribution,48,25,23
Dhb,darksorrow,1364,paladin,retribution,37,16,21
Exiztant,ravencrest,1363,paladin,retribution,165,91,74
Халва,deathguard,1363,paladin,retribution,38,19,19
Mbp,blackmoore,1363,paladin,retribution,36,18,18
Logossh,dun-modr,1363,paladin,retribution,50,24,26
Лефша,soulflayer,1362,paladin,retribution,47,32,15
Kolts,ragnaros,1362,paladin,retribution,51,29,22
Mirithaz,stormscale,1362,paladin,retribution,42,22,20
Tykki,stormreaver,1362,paladin,retribution,51,20,31
Panthalassá,argent-dawn,1361,paladin,retribution,70,36,34
Holypurger,shattered-hand,1361,paladin,retribution,97,45,52
Foxcroft,argent-dawn,1360,paladin,retribution,30,15,15
Pascual,magtheridon,1360,paladin,retribution,56,27,29
Paajaxd,drakthul,1360,paladin,retribution,48,22,26
Fluppy,the-maelstrom,1360,paladin,retribution,134,61,73
Нэксти,howling-fjord,1360,paladin,retribution,95,43,52
Orzix,sylvanas,1359,paladin,retribution,53,30,23
Sagittaxx,kazzak,1359,paladin,retribution,182,93,89
Эзарх,gordunni,1359,paladin,retribution,58,29,29
Юримия,blackscar,1359,paladin,retribution,47,21,26
Holaa,blackrock,1359,paladin,retribution,111,49,62
Licht,sanguino,1358,paladin,retribution,24,15,9
Кенториус,soulflayer,1358,paladin,retribution,78,48,30
Lerie,ravencrest,1358,paladin,retribution,108,51,57
Thallear,thrall,1358,paladin,retribution,53,25,28
Ayàhuazka,ysondre,1358,paladin,retribution,156,72,84
Caps,the-venture-co,1357,paladin,retribution,40,15,25
Эльбабло,lich-king,1356,paladin,retribution,63,33,30
Ylzik,archimonde,1356,paladin,retribution,87,43,44
Quarrel,kul-tiras,1356,paladin,retribution,38,15,23
Lilles,argent-dawn,1355,paladin,retribution,48,24,24
Дджаб,booty-bay,1355,paladin,retribution,133,63,70
Limbik,silvermoon,1355,paladin,retribution,69,30,39
Гучив,howling-fjord,1354,paladin,retribution,48,27,21
Apolomaeuz,blackhand,1354,paladin,retribution,36,20,16
Âlßêdø,silvermoon,1354,paladin,retribution,84,43,41
Таурусс,booty-bay,1354,paladin,retribution,110,53,57
Bloodlord,twisting-nether,1354,paladin,retribution,67,30,37
Bullight,archimonde,1354,paladin,retribution,36,15,21
Ludø,ysondre,1353,paladin,retribution,68,36,32
Mughena,kazzak,1353,paladin,retribution,54,27,27
Brightening,kazzak,1353,paladin,retribution,96,46,50
Plésmo,blackmoore,1352,paladin,retribution,71,38,33
Kyríé,tarren-mill,1352,paladin,retribution,60,31,29
Tríbunus,blackmoore,1352,paladin,retribution,37,19,18
Ahnaa,argent-dawn,1352,paladin,retribution,160,81,79
Karnator,eldrethalas,1352,paladin,retribution,36,17,19
Илюшагодх,gordunni,1351,paladin,retribution,60,32,28
Iamnami,earthen-ring,1351,paladin,retribution,58,23,35
Vendrick,silvermoon,1351,paladin,retribution,76,29,47
Horgar,nagrand,1350,paladin,retribution,124,61,63
Troublebuble,silvermoon,1350,paladin,retribution,68,30,38
Auryel,nemesis,1350,paladin,retribution,96,42,54
Elaidja,illidan,1350,paladin,retribution,48,20,28
Sukinsin,aegwynn,1350,paladin,retribution,37,15,22
Thyalon,ragnaros,1349,paladin,retribution,96,52,44
Thærõck,thrall,1349,paladin,retribution,60,31,29
Muradun,aegwynn,1349,paladin,retribution,48,24,24
Chimurei,silvermoon,1349,paladin,retribution,83,40,43
Panzerberg,blackrock,1349,paladin,retribution,48,23,25
Ironhide,echsenkessel,1349,paladin,retribution,48,19,29
Bootybanger,thrall,1348,paladin,retribution,30,16,14
Sixtêên,silvermoon,1348,paladin,retribution,29,15,14
Бэдбой,howling-fjord,1347,paladin,retribution,120,58,62
Sànguinius,silvermoon,1347,paladin,retribution,54,19,35
Holydeath,aegwynn,1346,paladin,retribution,63,30,33
Tønyx,les-clairvoyants,1346,paladin,retribution,38,16,22
Mosih,bloodfeather,1345,paladin,retribution,103,63,40
Hazorarh,argent-dawn,1345,paladin,retribution,43,22,21
Zeyz,defias-brotherhood,1345,paladin,retribution,78,39,39
Кранштейн,gordunni,1345,paladin,retribution,96,46,50
Goosybumpy,draenor,1345,paladin,retribution,66,27,39
Questos,burning-legion,1344,paladin,retribution,117,69,48
Ljusbågen,silvermoon,1344,paladin,retribution,34,18,16
Hèmera,archimonde,1344,paladin,retribution,30,15,15
Хамили,gordunni,1344,paladin,retribution,126,55,71
Rifzy,kazzak,1344,paladin,retribution,42,18,24
Budweison,silvermoon,1344,paladin,retribution,54,22,32
Zerad,quelthalas,1344,paladin,retribution,153,62,91
Lycíus,outland,1344,paladin,retribution,60,23,37
Лонса,soulflayer,1344,paladin,retribution,41,15,26
Necorínex,silvermoon,1343,paladin,retribution,24,14,10
Lightbreaker,alleria,1343,paladin,retribution,33,18,15
Ixøne,kazzak,1343,paladin,retribution,30,14,16
Demool,the-maelstrom,1343,paladin,retribution,71,33,38
Djmontana,archimonde,1343,paladin,retribution,36,14,22
Хен,blackscar,1342,paladin,retribution,92,49,43
Duckiboy,ragnaros,1342,paladin,retribution,162,85,77
Mooses,stormscale,1342,paladin,retribution,160,76,84
Penknife,ravencrest,1342,paladin,retribution,98,46,52
Evölution,frostmane,1342,paladin,retribution,36,14,22
Hislifelmao,kazzak,1342,paladin,retribution,36,14,22
Нажим,howling-fjord,1341,paladin,retribution,126,65,61
Chocbear,tarren-mill,1341,paladin,retribution,30,14,16
Энжел,soulflayer,1341,paladin,retribution,30,14,16
Tibiscovus,silvermoon,1341,paladin,retribution,101,47,54
Dioxius,stormscale,1341,paladin,retribution,36,14,22
Alus,blackmoore,1341,paladin,retribution,42,16,26
Brölin,sanguino,1340,paladin,retribution,48,22,26
Твилайд,gordunni,1339,paladin,retribution,58,30,28
Dwangl,silvermoon,1339,paladin,retribution,36,18,18
Adnachiel,blackhand,1339,paladin,retribution,61,30,31
Lighteousnes,blackmoore,1339,paladin,retribution,30,14,16
Ashernos,tarren-mill,1339,paladin,retribution,89,41,48
Платинум,blackscar,1339,paladin,retribution,36,14,22
Aryza,hellfire,1338,paladin,retribution,57,29,28
Беймикс,gordunni,1338,paladin,retribution,132,67,65
Morsadin,burning-legion,1338,paladin,retribution,30,14,16
Ôrus,minahonda,1338,paladin,retribution,87,40,47
Gindolon,blackhand,1338,paladin,retribution,48,21,27
Mendril,malorne,1337,paladin,retribution,42,27,15
Shuraé,blackmoore,1337,paladin,retribution,24,14,10
Lanny,blackhand,1337,paladin,retribution,54,26,28
Timôro,archimonde,1337,paladin,retribution,88,42,46
Syrkxion,silvermoon,1337,paladin,retribution,30,14,16
Джекадамс,gordunni,1337,paladin,retribution,249,105,144
Lightmyst,outland,1336,paladin,retribution,24,14,10
Töphuria,silvermoon,1336,paladin,retribution,89,44,45
Ahzut,rashgarroth,1336,paladin,retribution,52,25,27
Tjabo,burning-blade,1336,paladin,retribution,36,14,22
Rustig,talnivarr,1335,paladin,retribution,26,16,10
Hølypwnjk,forscherliga,1335,paladin,retribution,30,14,16
Vorsip,tarren-mill,1335,paladin,retribution,60,27,33
Arkura,nozdormu,1334,paladin,retribution,30,18,12
Zipoohun,arathor,1334,paladin,retribution,97,52,45
Serkunkoira,emeriss,1334,paladin,retribution,36,19,17
Легейнда,soulflayer,1334,paladin,retribution,30,14,16
Tomiris,twisting-nether,1333,paladin,retribution,59,29,30
Kalaraja,dunemaul,1333,paladin,retribution,36,16,20
Rothmans,aggra-português,1332,paladin,retribution,71,38,33
Азов,thermaplugg,1332,paladin,retribution,83,38,45
Víii,outland,1332,paladin,retribution,73,33,40
Judgemented,turalyon,1331,paladin,retribution,152,78,74
Strongman,twilights-hammer,1331,paladin,retribution,30,15,15
Lukinio,silvermoon,1331,paladin,retribution,187,88,99
Негропаладин,soulflayer,1330,paladin,retribution,26,15,11
Jebenatreba,sporeggar,1330,paladin,retribution,47,24,23
Amnell,marécage-de-zangar,1330,paladin,retribution,77,37,40
Lightheartx,argent-dawn,1330,paladin,retribution,67,28,39
Giglix,twisting-nether,1330,paladin,retribution,60,23,37
Imoss,hyjal,1329,paladin,retribution,36,22,14
Hisblade,emerald-dream,1329,paladin,retribution,57,30,27
Khrotos,draenor,1329,paladin,retribution,150,78,72
Thebestpala,tarren-mill,1329,paladin,retribution,50,21,29
Ridethelight,nemesis,1328,paladin,retribution,27,15,12
Egx,draenor,1328,paladin,retribution,36,15,21
Áramor,blackmoore,1327,paladin,retribution,59,30,29
Belldog,tarren-mill,1327,paladin,retribution,78,37,41
Paliax,outland,1327,paladin,retribution,30,14,16
Зольвинталь,deathguard,1327,paladin,retribution,33,15,18
Aasimar,twilights-hammer,1326,paladin,retribution,278,140,138
Tidus,conseil-des-ombres,1326,paladin,retribution,75,37,38
Uweósas,aegwynn,1326,paladin,retribution,66,28,38
Milojcica,kazzak,1325,paladin,retribution,22,15,7
Jagen,tyrande,1325,paladin,retribution,141,71,70
Nissesolsken,outland,1325,paladin,retribution,29,14,15
Arthuriân,outland,1325,paladin,retribution,48,21,27
Xinti,silvermoon,1324,paladin,retribution,23,14,9
Enriel,temple-noir,1324,paladin,retribution,30,16,14
Érléuchtas,kazzak,1324,paladin,retribution,58,30,28
Nëphilim,arakarahm,1324,paladin,retribution,60,28,32
Defeero,das-syndikat,1324,paladin,retribution,30,14,16
Bâby,arathi,1324,paladin,retribution,65,28,37
Эйтэр,howling-fjord,1324,paladin,retribution,48,14,34
Fëanôr,tarren-mill,1323,paladin,retribution,404,212,192
Tikkiraj,guldan,1323,paladin,retribution,30,14,16
Starr,confrérie-du-thorium,1323,paladin,retribution,44,20,24
Valaeryanae,nemesis,1323,paladin,retribution,62,28,34
Этокомедия,howling-fjord,1323,paladin,retribution,36,14,22
Thëone,exodar,1322,paladin,retribution,64,36,28
Servius,ragnaros,1322,paladin,retribution,83,39,44
Sienna,kazzak,1322,paladin,retribution,36,15,21
Raluz,kazzak,1322,paladin,retribution,35,14,21
Mantinel,hellfire,1321,paladin,retribution,38,24,14
Neîlyô,dalaran,1321,paladin,retribution,24,14,10
Kimberveils,blackrock,1321,paladin,retribution,30,15,15
Baddaddy,stormscale,1321,paladin,retribution,30,14,16
Nicolae,colinas-pardas,1321,paladin,retribution,71,31,40
Alcadeias,nefarian,1321,paladin,retribution,52,22,30
Shiëld,khaz-modan,1321,paladin,retribution,60,24,36
Assyr,blackmoore,1320,paladin,retribution,83,43,40
Hagën,minahonda,1320,paladin,retribution,71,35,36
Sweetkick,archimonde,1320,paladin,retribution,30,14,16
Ironstealman,shattered-hand,1320,paladin,retribution,102,43,59
Titteii,tarren-mill,1319,paladin,retribution,32,15,17
Bunurata,silvermoon,1319,paladin,retribution,30,14,16
Kirlight,blackrock,1318,paladin,retribution,24,14,10
Merkurial,sylvanas,1318,paladin,retribution,30,17,13
Lightwimer,zuljin,1318,paladin,retribution,68,32,36
Авараан,galakrond,1318,paladin,retribution,36,14,22
Wtfudo,sylvanas,1317,paladin,retribution,47,24,23
Gigap,ragnaros,1317,paladin,retribution,52,21,31
Furiös,ysondre,1317,paladin,retribution,48,17,31
Вэлвэлвэл,soulflayer,1316,paladin,retribution,122,63,59
Benno,dun-modr,1316,paladin,retribution,157,70,87
Doomgape,alakir,1316,paladin,retribution,153,66,87
Skieras,draenor,1315,paladin,retribution,24,14,10
Edwards,sanguino,1315,paladin,retribution,36,18,18
Radamanthes,ysondre,1315,paladin,retribution,133,65,68
Oepabakkez,burning-legion,1315,paladin,retribution,30,14,16
Gaizilla,burning-blade,1314,paladin,retribution,57,33,24
Yrgin,ravencrest,1314,paladin,retribution,316,159,157
Æïs,blackrock,1313,paladin,retribution,75,40,35
Irinor,rashgarroth,1313,paladin,retribution,60,32,28
Дэвсон,greymane,1313,paladin,retribution,36,14,22
Faventu,ragnaros,1312,paladin,retribution,36,21,15
Foxare,burning-legion,1312,paladin,retribution,53,29,24
Пепсекольный,soulflayer,1312,paladin,retribution,48,25,23
Gaab,aggra-português,1312,paladin,retribution,166,85,81
Мильфорд,eversong,1312,paladin,retribution,156,78,78
Derian,antonidas,1312,paladin,retribution,66,29,37
Mashijudge,blackhand,1311,paladin,retribution,84,42,42
Merliphel,burning-legion,1311,paladin,retribution,36,16,20
Bärghest,sanguino,1310,paladin,retribution,66,40,26
Sparrda,dun-modr,1310,paladin,retribution,72,36,36
Нероблр,gordunni,1310,paladin,retribution,37,15,22
Äthénâ,archimonde,1310,paladin,retribution,53,19,34
Doomsaw,alexstrasza,1309,paladin,retribution,20,15,5
Bandaga,sanguino,1309,paladin,retribution,43,27,16
Amberkå,burning-legion,1309,paladin,retribution,30,16,14
Nardindindou,ysondre,1309,paladin,retribution,170,86,84
Pallachyrk,kazzak,1309,paladin,retribution,30,14,16
Варасса,grom,1309,paladin,retribution,48,22,26
Gabe,aggra-português,1309,paladin,retribution,33,15,18
Hogsy,malfurion,1308,paladin,retribution,118,56,62
Saró,ravencrest,1307,paladin,retribution,41,22,19
Эррор,azuregos,1307,paladin,retribution,36,19,17
Erin,wildhammer,1307,paladin,retribution,56,28,28
Mjoky,the-maelstrom,1307,paladin,retribution,30,15,15
Jelcz,burning-legion,1307,paladin,retribution,48,23,25
Пьющая,gordunni,1307,paladin,retribution,36,17,19
Pitusá,dun-modr,1307,paladin,retribution,105,49,56
Ryozupala,frostwolf,1306,paladin,retribution,24,15,9
Öwai,dun-modr,1306,paladin,retribution,83,49,34
Молотоборец,gordunni,1306,paladin,retribution,110,60,50
Hypothalamus,silvermoon,1306,paladin,retribution,66,36,30
Kaizêr,silvermoon,1306,paladin,retribution,97,46,51
Palangel,eldrethalas,1306,paladin,retribution,132,61,71
Émilia,frostwolf,1306,paladin,retribution,58,23,35
Celsia,blackrock,1304,paladin,retribution,30,16,14
Singedth,defias-brotherhood,1304,paladin,retribution,119,62,57
Købìtø,archimonde,1304,paladin,retribution,88,41,47
Azaël,illidan,1304,paladin,retribution,56,26,30
Klittsurf,bloodhoof,1303,paladin,retribution,78,45,33
Skrýmir,marécage-de-zangar,1303,paladin,retribution,30,16,14
Takaret,hyjal,1303,paladin,retribution,274,134,140
Cyclope,frostmane,1303,paladin,retribution,142,69,73
Nazdarvole,drakthul,1302,paladin,retribution,110,58,52
Karnage,zenedar,1302,paladin,retribution,157,80,77
Zpock,archimonde,1300,paladin,retribution,24,14,10
Палнапалм,gordunni,1300,paladin,retribution,30,16,14
Ymersa,stormscale,1300,paladin,retribution,97,49,48
Лейфи,howling-fjord,1300,paladin,retribution,54,27,27
Pianiste,sinstralis,1300,paladin,retribution,42,20,22
Prínce,blackmoore,1300,paladin,retribution,56,26,30
Daminika,das-syndikat,1300,paladin,retribution,60,25,35
Инидор,blackscar,1300,paladin,retribution,48,19,29
Nelasson,eredar,1299,paladin,retribution,32,18,14
Jac,nemesis,1299,paladin,retribution,259,123,136
Patsani,twilights-hammer,1298,paladin,retribution,115,64,51
Jackypala,ravencrest,1298,paladin,retribution,48,25,23
Crawladin,eonar,1298,paladin,retribution,267,128,139
Siphi,frostwolf,1298,paladin,retribution,88,42,46
Маразоточка,howling-fjord,1298,paladin,retribution,65,29,36
Truezero,draenor,1297,paladin,retribution,42,23,19
Artorya,outland,1297,paladin,retribution,36,17,19
Melnes,draenor,1296,paladin,retribution,59,33,26
Депреседмодх,soulflayer,1296,paladin,retribution,72,39,33
Мистерху,gordunni,1296,paladin,retribution,214,112,102
Gerin,ulduar,1296,paladin,retribution,77,38,39
Alâkir,kazzak,1296,paladin,retribution,44,18,26
Ретриванлав,gordunni,1296,paladin,retribution,72,24,48
Paillasson,nerzhul,1295,paladin,retribution,104,62,42
Парсефон,soulflayer,1295,paladin,retribution,36,20,16
Тэмплари,galakrond,1295,paladin,retribution,111,56,55
Raweo,kilrogg,1294,paladin,retribution,78,47,31
Iqso,argent-dawn,1294,paladin,retribution,30,16,14
Retroon,doomhammer,1294,paladin,retribution,36,19,17
Teliriyon,blackrock,1294,paladin,retribution,44,19,25
Malbi,kazzak,1291,paladin,retribution,58,24,34
Масачусетсс,gordunni,1290,paladin,retribution,84,44,40
Perícles,the-maelstrom,1290,paladin,retribution,42,20,22
Ahramanyu,blackrock,1289,paladin,retribution,48,23,25
Sødaz,hyjal,1287,paladin,retribution,152,73,79
Чотут,howling-fjord,1287,paladin,retribution,54,22,32
Bubblemama,aegwynn,1286,paladin,retribution,54,33,21
Håmmer,hellfire,1286,paladin,retribution,42,21,21
Светонносец,gordunni,1286,paladin,retribution,221,102,119
Reticles,ravencrest,1286,paladin,retribution,47,21,26
Святорусс,gordunni,1286,paladin,retribution,142,61,81
Proteiin,drakthul,1285,paladin,retribution,30,17,13
Catsnek,darksorrow,1285,paladin,retribution,30,16,14
Valoren,todeswache,1285,paladin,retribution,35,17,18
Blessmedaddy,tarren-mill,1285,paladin,retribution,76,36,40
Tpaktopuct,kazzak,1284,paladin,retribution,44,22,22
Dayr,sylvanas,1284,paladin,retribution,75,36,39
Anndersen,aszune,1284,paladin,retribution,36,17,19
Jameshowlett,archimonde,1284,paladin,retribution,42,16,26
Holylimx,draenor,1283,paladin,retribution,114,56,58
Eagleone,shattrath,1282,paladin,retribution,80,40,40
Vicirius,doomhammer,1282,paladin,retribution,36,15,21
Aipal,silvermoon,1282,paladin,retribution,36,14,22
Línke,sanguino,1281,paladin,retribution,102,58,44
Vvaarok,blackmoore,1281,paladin,retribution,83,35,48
Mootaindew,tarren-mill,1280,paladin,retribution,54,34,20
Snobypala,onyxia,1280,paladin,retribution,73,36,37
Bjoorrn,hyjal,1280,paladin,retribution,31,15,16
Enary,zuljin,1280,paladin,retribution,44,20,24
Dieversity,stormscale,1280,paladin,retribution,41,16,25
Хепипал,soulflayer,1279,paladin,retribution,67,34,33
Hekta,wildhammer,1279,paladin,retribution,60,30,30
Bonzai,blackrock,1279,paladin,retribution,241,119,122
Krullfar,ravencrest,1279,paladin,retribution,86,37,49
Mindoxlawlz,sanguino,1279,paladin,retribution,60,25,35
Bagarlisa,silvermoon,1278,paladin,retribution,41,23,18
Edyk,silvermoon,1278,paladin,retribution,131,72,59
Shädyss,hyjal,1278,paladin,retribution,129,67,62
Furmund,stormscale,1277,paladin,retribution,44,25,19
Gatsßy,archimonde,1277,paladin,retribution,42,21,21
Lagaminë,dalaran,1277,paladin,retribution,153,76,77
Algoric,suramar,1277,paladin,retribution,78,29,49
Chuntterz,shadowsong,1276,paladin,retribution,33,16,17
Óoc,outland,1276,paladin,retribution,29,14,15
Zulem,grim-batol,1276,paladin,retribution,36,17,19
Rickbeato,neptulon,1276,paladin,retribution,36,16,20
Ïnata,khaz-modan,1276,paladin,retribution,50,22,28
Snowydin,tarren-mill,1275,paladin,retribution,36,22,14
Ocgynle,alonsus,1274,paladin,retribution,358,186,172
Gavril,bloodfeather,1274,paladin,retribution,132,63,69
Veest,doomhammer,1274,paladin,retribution,40,17,23
Ayunagodx,archimonde,1274,paladin,retribution,49,20,29
Sprited,twisting-nether,1274,paladin,retribution,36,14,22
Kaljir,archimonde,1272,paladin,retribution,27,15,12
Миссйеллоу,gordunni,1272,paladin,retribution,29,14,15
Palladia,rexxar,1272,paladin,retribution,42,16,26
Westplays,turalyon,1271,paladin,retribution,225,117,108
Кс,greymane,1271,paladin,retribution,60,30,30
Angarx,draenor,1271,paladin,retribution,145,72,73
Hammexõr,sylvanas,1271,paladin,retribution,87,39,48
Methires,burning-legion,1270,paladin,retribution,95,49,46
Bulina,stormscale,1270,paladin,retribution,36,18,18
Pörriäinen,ragnaros,1270,paladin,retribution,31,15,16
Hellschwert,hyjal,1270,paladin,retribution,36,15,21
Santafuu,blackhand,1270,paladin,retribution,65,26,39
Paraðox,ysondre,1270,paladin,retribution,36,14,22
Powerphally,outland,1270,paladin,retribution,44,16,28
Айронс,ashenvale,1267,paladin,retribution,42,27,15
Thorold,earthen-ring,1267,paladin,retribution,75,44,31
Перизкопец,gordunni,1267,paladin,retribution,32,17,15
Trollarage,confrérie-du-thorium,1267,paladin,retribution,105,53,52
Hardliquor,blades-edge,1267,paladin,retribution,95,45,50
Auditõr,argent-dawn,1267,paladin,retribution,85,32,53
Alard,sanguino,1267,paladin,retribution,66,24,42
Флаила,ashenvale,1266,paladin,retribution,101,53,48
Vhredny,burning-legion,1266,paladin,retribution,60,29,31
Antón,dun-modr,1266,paladin,retribution,36,16,20
Vaníos,nazjatar,1265,paladin,retribution,40,19,21
Syng,garona,1265,paladin,retribution,42,18,24
Spizz,dun-modr,1265,paladin,retribution,36,14,22
Nykothpn,ghostlands,1264,paladin,retribution,29,24,5
Retgaffeooku,conseil-des-ombres,1264,paladin,retribution,84,40,44
Redeem,nemesis,1264,paladin,retribution,38,14,24
Gustavus,emeriss,1264,paladin,retribution,82,30,52
Sufrion,outland,1263,paladin,retribution,81,42,39
Ralfx,ragnaros,1263,paladin,retribution,42,20,22
Froxies,drakthul,1263,paladin,retribution,32,14,18
Holycow,temple-noir,1263,paladin,retribution,66,22,44
Valpen,veknilash,1262,paladin,retribution,48,25,23
Belight,burning-legion,1262,paladin,retribution,93,36,57
Shuler,silvermoon,1260,paladin,retribution,106,58,48
Thoorval,silvermoon,1260,paladin,retribution,123,60,63
Акерсарин,gordunni,1259,paladin,retribution,60,34,26
Owiganowi,ulduar,1258,paladin,retribution,66,37,29
Gotra,stormscale,1258,paladin,retribution,111,52,59
Maýlin,das-konsortium,1258,paladin,retribution,30,14,16
Taptreus,antonidas,1258,paladin,retribution,51,21,30
Ziggyz,kul-tiras,1257,paladin,retribution,61,32,29
Alexii,azjolnerub,1257,paladin,retribution,42,18,24
Rafistor,khaz-modan,1257,paladin,retribution,59,19,40
Viiri,burning-legion,1256,paladin,retribution,113,59,54
Olwie,argent-dawn,1256,paladin,retribution,47,24,23
Daicic,kazzak,1256,paladin,retribution,31,15,16
Каридин,galakrond,1256,paladin,retribution,60,22,38
Dildodin,ravencrest,1255,paladin,retribution,24,14,10
Askimo,twisting-nether,1255,paladin,retribution,42,24,18
Хэппипала,soulflayer,1255,paladin,retribution,25,14,11
Mystíque,die-todeskrallen,1255,paladin,retribution,113,63,50
Jeyløl,antonidas,1255,paladin,retribution,34,15,19
Carpetcummer,ravencrest,1255,paladin,retribution,36,15,21
Руказакона,deathguard,1255,paladin,retribution,121,50,71
Goatti,lightnings-blade,1254,paladin,retribution,118,58,60
Миоцуки,gordunni,1254,paladin,retribution,82,37,45
Рионор,soulflayer,1253,paladin,retribution,48,24,24
Vâskt,dun-modr,1253,paladin,retribution,303,150,153
Крусейд,deathguard,1253,paladin,retribution,119,57,62
Fredas,hyjal,1253,paladin,retribution,119,57,62
Sherulz,sylvanas,1252,paladin,retribution,42,25,17
Майдмен,gordunni,1252,paladin,retribution,96,43,53
Myralions,burning-legion,1251,paladin,retribution,53,33,20
Hollylady,outland,1251,paladin,retribution,42,25,17
Troj,ahnqiraj,1251,paladin,retribution,95,51,44
Pytha,nozdormu,1251,paladin,retribution,136,73,63
Faithsmemory,silvermoon,1251,paladin,retribution,92,40,52
Frâncoforte,blackmoore,1251,paladin,retribution,48,18,30
Espada,anachronos,1249,paladin,retribution,24,14,10
Justsush,hyjal,1249,paladin,retribution,46,25,21
Deathzinger,aszune,1249,paladin,retribution,108,52,56
Onishu,blackhand,1249,paladin,retribution,36,14,22
Galodina,blackmoore,1248,paladin,retribution,29,16,13
Yanisx,burning-legion,1248,paladin,retribution,82,41,41
Mámmon,arthas,1248,paladin,retribution,52,26,26
Swagged,kazzak,1248,paladin,retribution,58,28,30
Baltyros,thrall,1248,paladin,retribution,58,27,31
Шаларион,borean-tundra,1248,paladin,retribution,45,17,28
Elení,thrall,1248,paladin,retribution,43,16,27
Kazui,lordaeron,1247,paladin,retribution,18,13,5
Retdream,nemesis,1247,paladin,retribution,18,13,5
Kaedena,kaelthas,1247,paladin,retribution,48,27,21
Teamchelsey,outland,1247,paladin,retribution,24,13,11
Gonhilda,kazzak,1247,paladin,retribution,54,27,27
Leyawin,sanguino,1247,paladin,retribution,48,24,24
Umirinbruv,zenedar,1247,paladin,retribution,36,13,23
Ezbonk,kazzak,1247,paladin,retribution,36,13,23
Lôrelei,blackrock,1247,paladin,retribution,36,13,23
Нурти,gordunni,1246,paladin,retribution,18,13,5
Taeran,dun-modr,1246,paladin,retribution,24,13,11
Luckyman,aszune,1246,paladin,retribution,24,13,11
Mooriel,burning-legion,1246,paladin,retribution,27,14,13
Пантро,gordunni,1246,paladin,retribution,78,31,47
Jâuche,blackhand,1246,paladin,retribution,36,13,23
Styxpl,blackhand,1246,paladin,retribution,36,13,23
Daddyret,ravencrest,1245,paladin,retribution,18,13,5
Cinderlight,aszune,1245,paladin,retribution,42,25,17
Øttøø,outland,1245,paladin,retribution,24,13,11
Amycus,zuljin,1245,paladin,retribution,24,13,11
Forneus,nemesis,1245,paladin,retribution,204,104,100
Groelin,frostmane,1245,paladin,retribution,158,79,79
Ahreesh,blackrock,1245,paladin,retribution,36,18,18
Blackthorne,azuremyst,1245,paladin,retribution,27,13,14
Mohamedx,tarren-mill,1245,paladin,retribution,30,13,17
Gromzed,burning-legion,1245,paladin,retribution,30,13,17
Âgreë,frostwhisper,1245,paladin,retribution,38,14,24
Gljeto,tarren-mill,1244,paladin,retribution,24,17,7
Angeal,ysondre,1244,paladin,retribution,25,14,11
Anamary,ravencrest,1244,paladin,retribution,87,46,41
Skullreaper,mannoroth,1244,paladin,retribution,36,17,19
Toruk,burning-legion,1244,paladin,retribution,60,26,34
Gulyas,tarren-mill,1244,paladin,retribution,30,13,17
Marthawise,eredar,1244,paladin,retribution,30,13,17
Proxidus,blackmoore,1244,paladin,retribution,41,16,25
Ariad,kazzak,1243,paladin,retribution,24,13,11
Dêadgame,aegwynn,1243,paladin,retribution,37,14,23
Mattüsälëmm,sanguino,1242,paladin,retribution,33,22,11
Juicyhammers,ragnaros,1242,paladin,retribution,24,13,11
Meltrox,runetotem,1242,paladin,retribution,24,13,11
Lonesoul,tarren-mill,1242,paladin,retribution,24,13,11
Fujszi,arathor,1242,paladin,retribution,24,13,11
Sileria,kazzak,1242,paladin,retribution,30,13,17
Razzim,eredar,1242,paladin,retribution,36,13,23
Helmed,tarren-mill,1241,paladin,retribution,63,35,28
Rangorian,defias-brotherhood,1241,paladin,retribution,36,15,21
ßlitzkrieg,blackmoore,1241,paladin,retribution,36,13,23
Lightsbreath,ragnaros,1240,paladin,retribution,24,13,11
Рашенс,gordunni,1240,paladin,retribution,96,42,54
Marnaø,ysondre,1240,paladin,retribution,38,16,22
Jdizzy,tarren-mill,1239,paladin,retribution,24,13,11
Saucisse,archimonde,1239,paladin,retribution,24,13,11
Negash,archimonde,1239,paladin,retribution,24,13,11
Jezrien,khazgoroth,1239,paladin,retribution,78,37,41
Ráikou,sylvanas,1239,paladin,retribution,30,14,16
Авелай,eversong,1239,paladin,retribution,30,13,17
Ashmaker,khaz-modan,1239,paladin,retribution,36,13,23
Carï,ravencrest,1239,paladin,retribution,48,13,35
Yunax,silvermoon,1238,paladin,retribution,70,36,34
Steakenstein,nathrezim,1238,paladin,retribution,152,76,76
Taylerr,drakthul,1238,paladin,retribution,30,15,15
Dàrkùsh,archimonde,1238,paladin,retribution,89,44,45
Luveria,der-rat-von-dalaran,1238,paladin,retribution,37,16,21
Purjolöken,tarren-mill,1238,paladin,retribution,44,18,26
Nála,boulderfist,1237,paladin,retribution,147,84,63
Talyâh,dalaran,1237,paladin,retribution,24,13,11
Cáli,forscherliga,1237,paladin,retribution,30,15,15
Peterholy,hyjal,1237,paladin,retribution,30,13,17
Powericius,drakthul,1237,paladin,retribution,30,13,17
Ulderoth,dun-modr,1237,paladin,retribution,74,32,42
Æe,blackmoore,1236,paladin,retribution,37,22,15
Zhroomxx,blackmoore,1236,paladin,retribution,24,13,11
Líghtmare,sylvanas,1236,paladin,retribution,24,13,11
Khaelor,frostwolf,1235,paladin,retribution,24,13,11
Sorciex,blackmoore,1235,paladin,retribution,24,13,11
Kayle,khaz-modan,1235,paladin,retribution,28,15,13
Greald,argent-dawn,1235,paladin,retribution,116,56,60
Nevermoore,doomhammer,1235,paladin,retribution,75,33,42
Rushtank,dragonmaw,1235,paladin,retribution,30,13,17
Lewp,tarren-mill,1234,paladin,retribution,18,13,5
Megashafted,ravencrest,1234,paladin,retribution,24,13,11
Anatorka,drakthul,1234,paladin,retribution,78,39,39
Armani,ysera,1234,paladin,retribution,65,32,33
Angrykorean,blackmoore,1234,paladin,retribution,82,38,44
Liardin,draenor,1233,paladin,retribution,30,14,16
Baxteria,dun-modr,1233,paladin,retribution,102,43,59
Dragg,kirin-tor,1233,paladin,retribution,34,14,20
Lightppl,outland,1232,paladin,retribution,119,60,59
Fintros,silvermoon,1232,paladin,retribution,78,37,41
Zhaz,blackmoore,1232,paladin,retribution,84,38,46
Kanot,outland,1231,paladin,retribution,108,60,48
Fannypoo,sylvanas,1231,paladin,retribution,24,13,11
Liana,alexstrasza,1231,paladin,retribution,42,16,26
Savaara,argent-dawn,1230,paladin,retribution,95,46,49
Beiluoshimen,archimonde,1230,paladin,retribution,56,27,29
Darkmetal,draenor,1230,paladin,retribution,30,13,17
Cigyal,hyjal,1229,paladin,retribution,104,55,49
Palafurax,hyjal,1229,paladin,retribution,36,16,20
Methiv,magtheridon,1229,paladin,retribution,30,13,17
Wtyou,blackhand,1228,paladin,retribution,18,13,5
Pipiczek,outland,1228,paladin,retribution,47,18,29
Palaur,silvermoon,1228,paladin,retribution,48,17,31
Tillak,draenor,1227,paladin,retribution,24,13,11
Bitether,burning-legion,1227,paladin,retribution,42,19,23
Émøùki,dalaran,1227,paladin,retribution,47,21,26
Tripani,twisting-nether,1226,paladin,retribution,54,29,25
Legenda,grim-batol,1226,paladin,retribution,37,19,18
Тайела,gordunni,1226,paladin,retribution,76,31,45
Zâre,sanguino,1225,paladin,retribution,175,86,89
Atomicbubble,balnazzar,1225,paladin,retribution,54,26,28
Ðarkjøjø,hyjal,1224,paladin,retribution,36,17,19
Сапфирия,galakrond,1224,paladin,retribution,135,63,72
Ènyalius,silvermoon,1224,paladin,retribution,48,20,28
Biermaxx,blackmoore,1224,paladin,retribution,36,13,23
Deldrina,nozdormu,1223,paladin,retribution,84,38,46
Watie,thunderhorn,1222,paladin,retribution,58,31,27
Ратомир,howling-fjord,1222,paladin,retribution,65,32,33
Aikm,tarren-mill,1222,paladin,retribution,80,37,43
Uthelf,ragnaros,1222,paladin,retribution,53,24,29
Velkar,frostmane,1221,paladin,retribution,56,29,27
Blechdøse,onyxia,1221,paladin,retribution,84,38,46
Keith,dragonmaw,1221,paladin,retribution,54,24,30
Stahlmann,argent-dawn,1221,paladin,retribution,48,21,27
Trefata,kazzak,1221,paladin,retribution,35,13,22
Larialaya,thrall,1221,paladin,retribution,42,15,27
Энилейт,lich-king,1220,paladin,retribution,70,44,26
Хеллпанч,howling-fjord,1220,paladin,retribution,165,93,72
Monchéri,stormscale,1220,paladin,retribution,24,13,11
Keol,sanguino,1220,paladin,retribution,37,19,18
Matharr,kazzak,1220,paladin,retribution,267,130,137
Hornox,ragnaros,1220,paladin,retribution,71,34,37
Джараксисс,soulflayer,1220,paladin,retribution,30,13,17
Platanid,doomhammer,1219,paladin,retribution,122,66,56
Dinøx,archimonde,1218,paladin,retribution,152,73,79
Eleiktra,suramar,1218,paladin,retribution,48,23,25
Wumbo,sinstralis,1217,paladin,retribution,66,34,32
Alvagur,zirkel-des-cenarius,1217,paladin,retribution,55,28,27
Dorian,durotan,1217,paladin,retribution,48,20,28
Boaz,norgannon,1217,paladin,retribution,36,14,22
Rokaur,ragnaros,1217,paladin,retribution,48,18,30
Гацкан,gordunni,1216,paladin,retribution,40,21,19
Holyblast,shattered-hand,1216,paladin,retribution,75,39,36
Аракиль,gordunni,1216,paladin,retribution,28,13,15
Chúm,the-maelstrom,1216,paladin,retribution,48,22,26
Pallyman,arthas,1216,paladin,retribution,36,15,21
Авроравайт,gordunni,1215,paladin,retribution,88,51,37
Гарраж,howling-fjord,1215,paladin,retribution,36,14,22
Бьюттасттл,howling-fjord,1215,paladin,retribution,35,13,22
Rilledread,stormscale,1214,paladin,retribution,114,57,57
Kuelzar,kazzak,1214,paladin,retribution,30,15,15
Кэшбэкер,fordragon,1214,paladin,retribution,48,23,25
Ragnarük,khaz-modan,1214,paladin,retribution,90,43,47
Джагашарага,soulflayer,1214,paladin,retribution,29,13,16
Doban,shattered-hand,1213,paladin,retribution,57,34,23
Ghallandre,khaz-modan,1213,paladin,retribution,48,25,23
Järnkroken,tarren-mill,1212,paladin,retribution,55,33,22
Øybiornz,stormscale,1212,paladin,retribution,61,34,27
Lightmonger,drakthul,1212,paladin,retribution,42,21,21
Ayoitsme,twisting-nether,1210,paladin,retribution,30,15,15
Darhuun,antonidas,1210,paladin,retribution,111,50,61
Princépretty,frostwolf,1210,paladin,retribution,139,61,78
Retribuser,tarren-mill,1208,paladin,retribution,24,14,10
Kompot,dun-morogh,1208,paladin,retribution,41,16,25
Knockz,zuluhed,1208,paladin,retribution,71,27,44
Yasfy,stormscale,1208,paladin,retribution,36,13,23
Didtaras,terokkar,1208,paladin,retribution,42,13,29
Krustenkaese,kelthuzad,1207,paladin,retribution,30,14,16
Kýrp,stormreaver,1207,paladin,retribution,43,16,27
Diøstemplar,dun-modr,1206,paladin,retribution,70,36,34
Joelosteen,neptulon,1206,paladin,retribution,99,50,49
Asorte,chants-éternels,1206,paladin,retribution,137,59,78
Mírato,blackhand,1205,paladin,retribution,75,40,35
Aleksandor,kazzak,1203,paladin,retribution,42,23,19
Hylion,kirin-tor,1203,paladin,retribution,60,28,32
Jamdog,sylvanas,1203,paladin,retribution,30,13,17
Ликанн,soulflayer,1203,paladin,retribution,104,44,60
Kaioss,argent-dawn,1203,paladin,retribution,35,14,21
Skénder,kazzak,1203,paladin,retribution,84,31,53
Heinzdwise,ravencrest,1203,paladin,retribution,42,14,28
Lightstormi,norgannon,1202,paladin,retribution,101,54,47
Stepamusicz,stormreaver,1202,paladin,retribution,84,43,41
Ramsay,arthas,1201,paladin,retribution,61,31,30
Ночнаябуря,gordunni,1201,paladin,retribution,66,33,33
Seigi,tarren-mill,1201,paladin,retribution,104,51,53
Spánkit,stormscale,1201,paladin,retribution,62,30,32
Deyvan,dalaran,1201,paladin,retribution,36,17,19
Allucere,blackmoore,1201,paladin,retribution,70,30,40
Bagolt,quelthalas,1201,paladin,retribution,68,28,40
Кетран,howling-fjord,1201,paladin,retribution,67,27,40
Ukey,sanguino,1200,paladin,retribution,118,70,48
Лайсен,gordunni,1200,paladin,retribution,60,33,27
Rayshield,tarren-mill,1200,paladin,retribution,53,28,25
Windîr,draenor,1200,paladin,retribution,41,21,20
Unboostable,archimonde,1200,paladin,retribution,72,36,36
Saraanneline,tarren-mill,1200,paladin,retribution,29,13,16
Kóternoga,burning-legion,1200,paladin,retribution,54,19,35
Isess,nozdormu,1199,paladin,retribution,28,15,13
Tyirel,blackmoore,1199,paladin,retribution,131,65,66
Qzoveca,steamwheedle-cartel,1199,paladin,retribution,78,28,50
Fatique,twisting-nether,1197,paladin,retribution,126,67,59
Saltletts,thrall,1197,paladin,retribution,61,28,33
Freyjä,turalyon,1195,paladin,retribution,180,86,94
Davairabotai,kazzak,1195,paladin,retribution,32,14,18
Sorâ,archimonde,1195,paladin,retribution,36,15,21
Ustex,argent-dawn,1195,paladin,retribution,35,13,22
Siuras,blackmoore,1194,paladin,retribution,23,13,10
Leith,neptulon,1194,paladin,retribution,82,40,42
Caleel,nemesis,1193,paladin,retribution,27,14,13
Таурмакус,howling-fjord,1193,paladin,retribution,72,35,37
Bucaxin,cthun,1192,paladin,retribution,24,14,10
Vhalkur,dun-modr,1192,paladin,retribution,25,14,11
Bierkapítän,blackrock,1191,paladin,retribution,42,26,16
Tåke,defias-brotherhood,1191,paladin,retribution,42,18,24
Mirauda,nemesis,1190,paladin,retribution,136,59,77
Hïto,dun-modr,1189,paladin,retribution,24,14,10
Morrpheus,darkspear,1188,paladin,retribution,24,14,10
Atreyu,stormscale,1188,paladin,retribution,42,24,18
Spanzer,dun-modr,1188,paladin,retribution,181,93,88
Ararion,tarren-mill,1188,paladin,retribution,30,14,16
Блэквилл,howling-fjord,1188,paladin,retribution,155,71,84
Rondel,dalaran,1187,paladin,retribution,30,15,15
Bonvivant,ragnaros,1186,paladin,retribution,21,14,7
Baddibubble,argent-dawn,1186,paladin,retribution,34,19,15
Whuarro,cthun,1185,paladin,retribution,42,14,28
Malodos,archimonde,1184,paladin,retribution,23,13,10
Mma,sylvanas,1184,paladin,retribution,97,47,50
Маефис,gordunni,1184,paladin,retribution,36,16,20
Helana,skullcrusher,1183,paladin,retribution,30,16,14
Palantyna,kazzak,1183,paladin,retribution,41,16,25
Nözderg,archimonde,1183,paladin,retribution,36,14,22
Perfectum,burning-legion,1182,paladin,retribution,28,13,15
Moløk,ysondre,1181,paladin,retribution,113,54,59
Bornir,khaz-modan,1181,paladin,retribution,89,40,49
Hàppy,malfurion,1180,paladin,retribution,35,14,21
Trainingdumy,aszune,1179,paladin,retribution,30,16,14
Geak,tarren-mill,1179,paladin,retribution,41,15,26
Conserva,jaedenar,1178,paladin,retribution,82,44,38
Ylvannka,blackmoore,1177,paladin,retribution,48,23,25
Zeex,darksorrow,1177,paladin,retribution,42,19,23
Юлец,galakrond,1177,paladin,retribution,73,32,41
Nauriell,blackmoore,1176,paladin,retribution,24,16,8
Calìa,hyjal,1176,paladin,retribution,59,25,34
Daríon,silvermoon,1176,paladin,retribution,54,18,36
Teogrim,blackmoore,1175,paladin,retribution,84,44,40
Styrke,sanguino,1175,paladin,retribution,34,13,21
Bicepsmir,blackrock,1175,paladin,retribution,60,19,41
Zvirblis,chamber-of-aspects,1173,paladin,retribution,63,31,32
Flashyplays,silvermoon,1172,paladin,retribution,48,27,21
Kawakii,outland,1172,paladin,retribution,36,20,16
Salsarr,spinebreaker,1172,paladin,retribution,54,29,25
Markomir,frostmourne,1172,paladin,retribution,31,14,17
Beefix,blackmoore,1171,paladin,retribution,36,21,15
Ilanyll,silvermoon,1171,paladin,retribution,30,16,14
Veshnu,blackrock,1170,paladin,retribution,162,78,84
Æternäl,arathor,1170,paladin,retribution,90,42,48
Servillo,outland,1170,paladin,retribution,60,23,37
Pelaghia,tarren-mill,1169,paladin,retribution,50,32,18
Valaudu,stormscale,1169,paladin,retribution,23,13,10
Epoke,archimonde,1169,paladin,retribution,96,46,50
Kurtjosef,draenor,1169,paladin,retribution,54,21,33
Gredain,argent-dawn,1168,paladin,retribution,24,16,8
Vell,bronze-dragonflight,1168,paladin,retribution,23,13,10
Pyhälehmä,alakir,1168,paladin,retribution,35,14,21
Duris,drakthul,1167,paladin,retribution,30,15,15
Lumino,twilights-hammer,1167,paladin,retribution,71,32,39
Bellùm,archimonde,1166,paladin,retribution,68,38,30
Luridity,argent-dawn,1166,paladin,retribution,60,22,38
Sunsaiy,doomhammer,1165,paladin,retribution,152,81,71
Msammus,kazzak,1165,paladin,retribution,34,13,21
Blackpalá,blackrock,1164,paladin,retribution,29,17,12
Holyreckonin,silvermoon,1164,paladin,retribution,197,98,99
Knoppix,antonidas,1164,paladin,retribution,48,19,29
Cpsuper,azuremyst,1163,paladin,retribution,42,23,19
Palitard,turalyon,1163,paladin,retribution,113,59,54
Sertoli,frostwhisper,1163,paladin,retribution,54,26,28
Orseis,anubarak,1163,paladin,retribution,100,43,57
Meljipson,kazzak,1163,paladin,retribution,52,13,39
Janie,dalaran,1162,paladin,retribution,41,23,18
Baldarlyset,tarren-mill,1162,paladin,retribution,51,17,34
Glarcouf,eldrethalas,1161,paladin,retribution,71,38,33
Torím,draenor,1161,paladin,retribution,29,13,16
Скелфер,soulflayer,1161,paladin,retribution,55,17,38
Danneris,sanguino,1160,paladin,retribution,123,66,57
Holybubo,tarren-mill,1160,paladin,retribution,72,37,35
Runkpaladin,kazzak,1159,paladin,retribution,80,44,36
Djpalacinka,drakthul,1159,paladin,retribution,48,21,27
Michele,skullcrusher,1159,paladin,retribution,63,27,36
Judgement,quelthalas,1158,paladin,retribution,30,20,10
Altrazel,archimonde,1158,paladin,retribution,32,15,17
Сильвернайт,soulflayer,1157,paladin,retribution,47,15,32
Бронепоест,gordunni,1156,paladin,retribution,24,14,10
Joti,proudmoore,1156,paladin,retribution,54,20,34
Цитри,borean-tundra,1155,paladin,retribution,42,26,16
Kaezerg,khaz-modan,1155,paladin,retribution,44,26,18
Azlan,nagrand,1155,paladin,retribution,52,27,25
Адептустер,gordunni,1154,paladin,retribution,56,27,29
Zoomzoom,sylvanas,1154,paladin,retribution,99,43,56
Matuth,arthas,1154,paladin,retribution,56,19,37
Светлыйкит,blackscar,1153,paladin,retribution,84,41,43
Ærîo,dalaran,1152,paladin,retribution,18,12,6
Kilô,sylvanas,1152,paladin,retribution,24,12,12
Noreturn,kazzak,1152,paladin,retribution,24,12,12
Nôva,stormscale,1152,paladin,retribution,29,12,17
Bighugg,draenor,1152,paladin,retribution,30,12,18
Vorthir,khaz-modan,1151,paladin,retribution,32,16,16
Notnerb,outland,1151,paladin,retribution,24,12,12
Tdchopa,ravencrest,1151,paladin,retribution,24,12,12
Jaing,magtheridon,1151,paladin,retribution,24,12,12
Fabsy,frostwolf,1151,paladin,retribution,24,12,12
Валандор,gordunni,1151,paladin,retribution,24,12,12
Бэкворд,soulflayer,1151,paladin,retribution,30,12,18
Memeadinxx,ravencrest,1151,paladin,retribution,30,12,18
Rizzdaddy,outland,1151,paladin,retribution,30,12,18
Kelaiah,argent-dawn,1150,paladin,retribution,24,12,12
Holzkern,blackmoore,1150,paladin,retribution,24,12,12
Navayo,frostmourne,1150,paladin,retribution,24,12,12
Herô,drakthul,1150,paladin,retribution,30,12,18
Knusern,dunemaul,1150,paladin,retribution,30,12,18
Missoii,khaz-modan,1149,paladin,retribution,18,12,6
Jkøø,sanguino,1149,paladin,retribution,24,12,12
Judgearnold,kul-tiras,1149,paladin,retribution,33,14,19
Alersia,twisting-nether,1149,paladin,retribution,30,12,18
Quasarxx,ravencrest,1149,paladin,retribution,36,12,24
Redmoo,tarren-mill,1149,paladin,retribution,36,12,24
Lagrops,chants-éternels,1149,paladin,retribution,36,12,24
Mìssaahh,archimonde,1148,paladin,retribution,19,13,6
Badjake,stormscale,1148,paladin,retribution,18,12,6
Даракар,deathguard,1148,paladin,retribution,18,12,6
Kevinprime,malfurion,1148,paladin,retribution,56,27,29
Spooder,xavius,1148,paladin,retribution,29,12,17
Jÿnxx,hyjal,1148,paladin,retribution,30,12,18
Annurra,quelthalas,1148,paladin,retribution,36,12,24
Pressthere,tarren-mill,1147,paladin,retribution,21,13,8
Themlstake,kazzak,1147,paladin,retribution,30,18,12
Paidien,twisting-nether,1147,paladin,retribution,23,12,11
Durnell,sylvanas,1147,paladin,retribution,24,12,12
Parléxd,auchindoun,1147,paladin,retribution,24,12,12
Milisha,the-maelstrom,1147,paladin,retribution,95,45,50
Думклиф,gordunni,1147,paladin,retribution,36,12,24
Mythorpala,dun-modr,1147,paladin,retribution,36,12,24
Nebrii,doomhammer,1146,paladin,retribution,36,19,17
Lovexhate,archimonde,1146,paladin,retribution,24,12,12
Judgedude,stormscale,1146,paladin,retribution,24,12,12
Teefex,stormscale,1145,paladin,retribution,21,13,8
Thardran,ravencrest,1145,paladin,retribution,102,53,49
Bannedchild,drakthul,1144,paladin,retribution,22,13,9
Цабля,gordunni,1144,paladin,retribution,44,24,20
Uoloop,kazzak,1144,paladin,retribution,90,46,44
Lôrdjp,blackmoore,1144,paladin,retribution,24,12,12
Shorella,malganis,1144,paladin,retribution,95,47,48
Melvòó,blackrock,1144,paladin,retribution,27,13,14
Nwnwnwnwnwnw,blackrock,1144,paladin,retribution,48,19,29
Asgardietis,kazzak,1144,paladin,retribution,33,13,20
Стиивоо,gordunni,1143,paladin,retribution,18,12,6
Woodygamer,chamber-of-aspects,1143,paladin,retribution,24,12,12
Vetron,drakthul,1143,paladin,retribution,24,12,12
Aeyalana,ragnaros,1143,paladin,retribution,42,17,25
Sfantull,spinebreaker,1143,paladin,retribution,30,12,18
Локопоезд,greymane,1143,paladin,retribution,30,12,18
Xersys,draenor,1143,paladin,retribution,30,12,18
Maycel,hyjal,1143,paladin,retribution,33,13,20
Janky,draenor,1143,paladin,retribution,60,22,38
Bigdamjudge,argent-dawn,1142,paladin,retribution,18,12,6
Shoogle,alonsus,1142,paladin,retribution,21,12,9
Pupperz,defias-brotherhood,1141,paladin,retribution,24,12,12
Sinnerknight,silvermoon,1141,paladin,retribution,50,21,29
Eywinn,silvermoon,1141,paladin,retribution,30,12,18
Rinocerb,ravencrest,1141,paladin,retribution,36,12,24
Retrystyle,ragnaros,1140,paladin,retribution,83,41,42
Grynd,blackmoore,1139,paladin,retribution,48,26,22
Yúlía,ravencrest,1138,paladin,retribution,30,15,15
Melastra,thrall,1138,paladin,retribution,24,12,12
Solarouz,draenor,1138,paladin,retribution,83,41,42
Vymer,ravencrest,1138,paladin,retribution,29,14,15
Pàlàthor,khaz-modan,1137,paladin,retribution,54,32,22
Summachos,kul-tiras,1137,paladin,retribution,39,20,19
Coralinê,sanguino,1137,paladin,retribution,24,12,12
Самерваль,borean-tundra,1137,paladin,retribution,133,66,67
Царьзверей,fordragon,1137,paladin,retribution,30,14,16
Whiffy,silvermoon,1137,paladin,retribution,66,26,40
Duragon,khaz-modan,1136,paladin,retribution,91,48,43
Sickbolt,eredar,1136,paladin,retribution,124,60,64
Myradur,burning-legion,1136,paladin,retribution,83,39,44
Évert,twisting-nether,1135,paladin,retribution,18,12,6
Böb,garona,1135,paladin,retribution,60,28,32
Yavodor,zirkel-des-cenarius,1134,paladin,retribution,24,14,10
Хампал,howling-fjord,1134,paladin,retribution,29,12,17
Dovel,kazzak,1133,paladin,retribution,24,12,12
Корсаро,deepholm,1133,paladin,retribution,113,54,59
Raptasenda,archimonde,1133,paladin,retribution,156,74,82
Iñgkara,tarren-mill,1133,paladin,retribution,35,13,22
Donttaskwhy,sylvanas,1133,paladin,retribution,48,17,31
Vrgingamer,kazzak,1133,paladin,retribution,60,21,39
Krïstâlùlz,archimonde,1132,paladin,retribution,64,33,31
Agelmar,zuluhed,1132,paladin,retribution,27,13,14
Gryan,stormscale,1132,paladin,retribution,41,18,23
Asshhbringer,burning-legion,1131,paladin,retribution,18,12,6
Kriteus,pozzo-delleternità,1131,paladin,retribution,18,12,6
Argkrath,blackhand,1131,paladin,retribution,18,12,6
Mimkoo,wildhammer,1130,paladin,retribution,27,16,11
Goldmamax,stormscale,1130,paladin,retribution,24,13,11
Flòope,destromath,1130,paladin,retribution,72,37,35
Шелволк,eversong,1130,paladin,retribution,51,26,25
Asthellis,kazzak,1130,paladin,retribution,96,44,52
Rady,neptulon,1130,paladin,retribution,38,17,21
Thallion,grim-batol,1129,paladin,retribution,45,14,31
Гервалт,blackscar,1128,paladin,retribution,30,12,18
Messîah,outland,1127,paladin,retribution,266,135,131
Palahôlika,antonidas,1127,paladin,retribution,24,12,12
Notholy,defias-brotherhood,1126,paladin,retribution,42,19,23
Arndt,lightbringer,1126,paladin,retribution,46,14,32
Dönki,hyjal,1125,paladin,retribution,18,12,6
Liléa,hyjal,1125,paladin,retribution,34,13,21
Bulle,the-venture-co,1125,paladin,retribution,41,15,26
Whoopzie,stormscale,1124,paladin,retribution,77,34,43
Duralyon,marécage-de-zangar,1123,paladin,retribution,48,23,25
Neytana,blackmoore,1123,paladin,retribution,98,45,53
Âchîle,garona,1122,paladin,retribution,117,65,52
Пропала,greymane,1122,paladin,retribution,119,56,63
Сенторин,borean-tundra,1122,paladin,retribution,39,14,25
Buckfizz,ysondre,1121,paladin,retribution,36,22,14
Palladinz,ravencrest,1121,paladin,retribution,36,19,17
Nécromåncien,khaz-modan,1121,paladin,retribution,30,12,18
Äalith,arathor,1120,paladin,retribution,24,13,11
Kirkmeister,terokkar,1120,paladin,retribution,55,24,31
Notorious,antonidas,1118,paladin,retribution,24,12,12
Nollieflipx,tarren-mill,1118,paladin,retribution,29,12,17
Vallorum,ravencrest,1118,paladin,retribution,47,14,33
Lóyal,kazzak,1117,paladin,retribution,31,14,17
Spóntaneous,ravencrest,1116,paladin,retribution,26,13,13
Òlymp,blackhand,1116,paladin,retribution,24,12,12
Fremuduin,argent-dawn,1114,paladin,retribution,24,12,12
Goungokuhrbo,doomhammer,1112,paladin,retribution,52,31,21
Gnarlds,doomhammer,1112,paladin,retribution,48,28,20
Zelphyr,pozzo-delleternità,1112,paladin,retribution,105,57,48
Babarush,nozdormu,1111,paladin,retribution,30,13,17
Séntúrús,kazzak,1111,paladin,retribution,59,25,34
Fumatelo,tyrande,1110,paladin,retribution,85,50,35
Valentianus,ravencrest,1110,paladin,retribution,24,12,12
Immortalkrux,archimonde,1110,paladin,retribution,157,74,83
Палуф,deathguard,1108,paladin,retribution,24,12,12
Palabido,nemesis,1105,paladin,retribution,559,269,290
Varreran,argent-dawn,1105,paladin,retribution,36,14,22
Helloim,tarren-mill,1104,paladin,retribution,21,13,8
Сверхпаладин,howling-fjord,1104,paladin,retribution,36,21,15
Lightpal,dentarg,1103,paladin,retribution,46,25,21
Pery,malganis,1103,paladin,retribution,86,45,41
Ayba,defias-brotherhood,1103,paladin,retribution,95,47,48
Фокспро,lich-king,1103,paladin,retribution,29,13,16
Raê,hyjal,1103,paladin,retribution,139,60,79
Palädörette,dalaran,1102,paladin,retribution,66,39,27
Neuverse,tarren-mill,1100,paladin,retribution,59,29,30
Javalie,sanguino,1099,paladin,retribution,21,12,9
Akeemys,ragnaros,1099,paladin,retribution,23,12,11
Naru,ravenholdt,1099,paladin,retribution,23,12,11
Моррдочка,soulflayer,1099,paladin,retribution,126,64,62
Paxillustral,twisting-nether,1098,paladin,retribution,36,20,16
Quoque,turalyon,1098,paladin,retribution,69,37,32
Tressah,silvermoon,1098,paladin,retribution,168,81,87
Beastyblodne,sylvanas,1098,paladin,retribution,54,25,29
Eldelapala,zuljin,1098,paladin,retribution,60,27,33
Bacilla,archimonde,1098,paladin,retribution,29,12,17
Xflye,khaz-modan,1096,paladin,retribution,41,22,19
Ashreaver,burning-legion,1096,paladin,retribution,36,17,19
Dronora,silvermoon,1096,paladin,retribution,60,22,38
Rêmo,blackrock,1094,paladin,retribution,76,43,33
Dewios,silvermoon,1094,paladin,retribution,67,31,36
Durwin,mazrigos,1094,paladin,retribution,98,41,57
Tharis,burning-legion,1093,paladin,retribution,23,13,10
Kaidox,frostwolf,1093,paladin,retribution,24,13,11
Paladie,dalaran,1091,paladin,retribution,328,168,160
Paladson,burning-blade,1089,paladin,retribution,97,39,58
Lighttitan,ravencrest,1089,paladin,retribution,30,12,18
Denathar,draenor,1088,paladin,retribution,41,15,26
Lliissaa,kazzak,1087,paladin,retribution,72,41,31
Кесару,goldrinn,1087,paladin,retribution,27,12,15
Vuuduux,twisting-nether,1086,paladin,retribution,24,13,11
Akakaboto,draenor,1086,paladin,retribution,69,30,39
Aistor,burning-legion,1086,paladin,retribution,84,34,50
Emlo,thrall,1085,paladin,retribution,20,12,8
Atírpákja,doomhammer,1085,paladin,retribution,78,38,40
Azzael,thrall,1085,paladin,retribution,95,35,60
Apoffis,burning-legion,1084,paladin,retribution,53,28,25
Fexulï,outland,1083,paladin,retribution,16,12,4
Thehuish,blades-edge,1083,paladin,retribution,59,29,30
Rivela,bloodhoof,1083,paladin,retribution,37,17,20
Valgar,ragnaros,1081,paladin,retribution,17,12,5
Donfilippo,burning-legion,1081,paladin,retribution,36,16,20
Aerathil,nethersturm,1079,paladin,retribution,41,22,19
Paladoon,ravencrest,1079,paladin,retribution,29,13,16
Stêx,anubarak,1078,paladin,retribution,24,13,11
Nisepise,argent-dawn,1078,paladin,retribution,68,31,37
Crazypits,silvermoon,1077,paladin,retribution,54,26,28
Cattelsaan,hyjal,1076,paladin,retribution,27,12,15
Zemoss,kazzak,1075,paladin,retribution,40,22,18
Ghostfacê,khaz-modan,1074,paladin,retribution,48,22,26
Coelslaw,azjolnerub,1074,paladin,retribution,35,12,23
Келлен,gordunni,1073,paladin,retribution,41,23,18
Starstríder,aszune,1073,paladin,retribution,24,12,12
Konst,argent-dawn,1073,paladin,retribution,63,30,33
Aryabarzan,draenor,1073,paladin,retribution,74,29,45
Izrak,stormscale,1072,paladin,retribution,30,19,11
Amoxapine,hyjal,1071,paladin,retribution,142,61,81
Êxood,archimonde,1071,paladin,retribution,47,18,29
Palazs,ravencrest,1070,paladin,retribution,30,19,11
Modf,draenor,1070,paladin,retribution,51,29,22
Omixlis,ragnaros,1070,paladin,retribution,48,22,26
Evilerpaly,stormscale,1069,paladin,retribution,75,43,32
Morhgain,kazzak,1069,paladin,retribution,60,32,28
Leilak,draenor,1068,paladin,retribution,95,53,42
Hazeman,colinas-pardas,1067,paladin,retribution,18,14,4
Dasvidania,uldum,1067,paladin,retribution,42,18,24
Dabstar,antonidas,1066,paladin,retribution,30,14,16
Crynó,blackmoore,1065,paladin,retribution,42,20,22
Bryllks,die-todeskrallen,1063,paladin,retribution,208,110,98
Аркрум,gordunni,1063,paladin,retribution,57,22,35
Toshvarak,turalyon,1062,paladin,retribution,124,57,67
Antidrasi,turalyon,1062,paladin,retribution,75,30,45
Bàroo,twisting-nether,1061,paladin,retribution,118,46,72
Auxiliary,doomhammer,1060,paladin,retribution,58,35,23
Lytza,frostwolf,1059,paladin,retribution,30,15,15
Glotzkowski,kelthuzad,1059,paladin,retribution,54,25,29
Dekabik,tarren-mill,1059,paladin,retribution,78,29,49
Gerannan,kirin-tor,1058,paladin,retribution,102,52,50
Thuurs,nerathor,1057,paladin,retribution,33,17,16
Chidorengan,burning-legion,1057,paladin,retribution,42,21,21
Бунча,gordunni,1057,paladin,retribution,144,66,78
Sølitude,kazzak,1056,paladin,retribution,18,11,7
Camusax,kazzak,1056,paladin,retribution,18,11,7
Injustice,chamber-of-aspects,1056,paladin,retribution,55,27,28
Franzîskûs,blackmoore,1056,paladin,retribution,24,11,13
Сакон,borean-tundra,1056,paladin,retribution,24,11,13
Pia,twisting-nether,1056,paladin,retribution,24,11,13
Lightham,nemesis,1056,paladin,retribution,24,11,13
Dadyolimp,kazzak,1056,paladin,retribution,30,11,19
Dobbygotsock,kazzak,1056,paladin,retribution,33,12,21
Eléndrên,blackrock,1055,paladin,retribution,18,11,7
Starkgaryen,dun-modr,1055,paladin,retribution,18,11,7
Blindhoj,ravencrest,1055,paladin,retribution,18,11,7
Fannii,ravencrest,1055,paladin,retribution,38,18,20
Kalimgor,theradras,1055,paladin,retribution,24,11,13
Palandiade,draenor,1055,paladin,retribution,24,11,13
Mîakhalîfa,tarren-mill,1055,paladin,retribution,24,11,13
Takezop,dun-modr,1055,paladin,retribution,24,11,13
Tyranius,bronzebeard,1055,paladin,retribution,24,11,13
Neqt,ravencrest,1055,paladin,retribution,24,11,13
Stukker,silvermoon,1055,paladin,retribution,24,11,13
Dafe,zuluhed,1055,paladin,retribution,56,22,34
Vazayo,ravencrest,1055,paladin,retribution,30,11,19
Ranelly,blackmoore,1055,paladin,retribution,30,11,19
Ерфати,gordunni,1055,paladin,retribution,36,11,25
Ibubbleqt,outland,1055,paladin,retribution,36,11,25
Атласс,gordunni,1055,paladin,retribution,36,11,25
Âtom,outland,1055,paladin,retribution,36,11,25
Sunblazer,draenor,1054,paladin,retribution,18,11,7
Покаяние,howling-fjord,1054,paladin,retribution,18,11,7
Baldcvnt,ravencrest,1054,paladin,retribution,18,11,7
Palidos,blackrock,1054,paladin,retribution,24,11,13
Диндинь,howling-fjord,1054,paladin,retribution,24,11,13
Lancelotas,defias-brotherhood,1054,paladin,retribution,30,11,19
Hazura,blackmoore,1054,paladin,retribution,30,11,19
Cheesus,argent-dawn,1054,paladin,retribution,33,12,21
Хэймердингер,howling-fjord,1054,paladin,retribution,39,12,27
Vendil,tarren-mill,1053,paladin,retribution,18,11,7
Ohmega,defias-brotherhood,1053,paladin,retribution,18,11,7
Deceneü,kazzak,1053,paladin,retribution,24,11,13
Trollilolz,eredar,1053,paladin,retribution,24,11,13
Moarcry,outland,1053,paladin,retribution,24,11,13
Roflemente,bladefist,1053,paladin,retribution,24,11,13
Mickeyvorace,archimonde,1053,paladin,retribution,66,30,36
Óldgreg,magtheridon,1053,paladin,retribution,30,12,18
Giggs,turalyon,1052,paladin,retribution,16,12,4
Vootele,draenor,1052,paladin,retribution,18,11,7
Mcnnuggets,ravencrest,1052,paladin,retribution,18,11,7
Паверармор,howling-fjord,1052,paladin,retribution,22,12,10
Souzzi,kazzak,1052,paladin,retribution,24,11,13
Kÿsse,hyjal,1052,paladin,retribution,24,11,13
Watermans,azjolnerub,1051,paladin,retribution,18,11,7
Liliane,eitrigg,1051,paladin,retribution,18,11,7
Эндоу,blackscar,1051,paladin,retribution,24,11,13
Widj,silvermoon,1051,paladin,retribution,24,11,13
Омникнайтх,howling-fjord,1051,paladin,retribution,36,11,25
Voyén,tarren-mill,1050,paladin,retribution,18,11,7
Ratedge,hyjal,1050,paladin,retribution,18,11,7
Buldras,zuljin,1050,paladin,retribution,18,11,7
Angelynor,ysondre,1050,paladin,retribution,24,11,13
Fettàrm,blackrock,1050,paladin,retribution,24,11,13
Jøløz,hyjal,1050,paladin,retribution,24,11,13
Holytrol,kazzak,1049,paladin,retribution,90,41,49
Grundgron,burning-legion,1049,paladin,retribution,57,25,32
Malleius,ravencrest,1049,paladin,retribution,30,11,19
Freetimer,norgannon,1049,paladin,retribution,30,11,19
Justïce,twisting-nether,1049,paladin,retribution,30,11,19
Добегуубью,thermaplugg,1049,paladin,retribution,33,12,21
Trondalohr,ambossar,1048,paladin,retribution,24,14,10
Dadpally,shattered-hand,1048,paladin,retribution,114,56,58
Torhamiir,outland,1048,paladin,retribution,24,11,13
Masgan,eredar,1048,paladin,retribution,24,11,13
Huhuu,outland,1048,paladin,retribution,24,11,13
Gropleindsup,ysondre,1048,paladin,retribution,54,21,33
Yournoboddy,turalyon,1048,paladin,retribution,30,11,19
Vonryan,defias-brotherhood,1047,paladin,retribution,115,53,62
Selerin,draenor,1047,paladin,retribution,24,11,13
Tzimon,antonidas,1047,paladin,retribution,27,12,15
Hargo,ravencrest,1046,paladin,retribution,27,12,15
Calluk,turalyon,1046,paladin,retribution,47,18,29
Бомберович,howling-fjord,1046,paladin,retribution,36,11,25
Bølegg,blackmoore,1045,paladin,retribution,18,11,7
Saszca,burning-legion,1045,paladin,retribution,21,12,9
Jpally,ravencrest,1045,paladin,retribution,24,11,13
Kishijoten,archimonde,1044,paladin,retribution,18,11,7
Nemestörp,silvermoon,1044,paladin,retribution,18,11,7
Jooki,drakthul,1044,paladin,retribution,18,11,7
Palladxx,twilights-hammer,1044,paladin,retribution,40,24,16
Sinthoràs,shattered-hand,1044,paladin,retribution,90,48,42
Traqnbilkarq,stormscale,1044,paladin,retribution,24,12,12
Atrexie,lightbringer,1043,paladin,retribution,18,11,7
Умберто,howling-fjord,1043,paladin,retribution,72,40,32
Rdmhrvojehr,tarren-mill,1043,paladin,retribution,67,34,33
Pzdr,tarren-mill,1043,paladin,retribution,88,41,47
Himmelsfuror,proudmoore,1043,paladin,retribution,36,11,25
Rocaviva,sanguino,1042,paladin,retribution,24,12,12
Shadderkpal,draenor,1042,paladin,retribution,30,11,19
Rèdjàck,nemesis,1042,paladin,retribution,30,11,19
Dildotbagins,argent-dawn,1041,paladin,retribution,70,40,30
Lurbo,neptulon,1041,paladin,retribution,54,19,35
Даркхолмь,howling-fjord,1040,paladin,retribution,22,12,10
Dragonpaly,sylvanas,1039,paladin,retribution,24,11,13
Matikosik,steamwheedle-cartel,1039,paladin,retribution,51,21,30
Kaatha,archimonde,1039,paladin,retribution,77,27,50
Meliodas,alleria,1038,paladin,retribution,60,30,30
Killa,stormrage,1038,paladin,retribution,24,11,13
Kollak,dun-modr,1038,paladin,retribution,63,25,38
Labier,tarren-mill,1038,paladin,retribution,36,11,25
Fortplus,pozzo-delleternità,1037,paladin,retribution,58,28,30
Wingzodoom,turalyon,1037,paladin,retribution,30,11,19
Ultiz,dun-modr,1037,paladin,retribution,30,11,19
Drizuc,bloodhoof,1037,paladin,retribution,78,26,52
Lowen,deathwing,1037,paladin,retribution,41,11,30
Thawn,dun-modr,1036,paladin,retribution,18,11,7
Tydrix,magtheridon,1036,paladin,retribution,18,11,7
Эллессар,howling-fjord,1036,paladin,retribution,30,12,18
Celdrin,silvermoon,1035,paladin,retribution,23,12,11
Ananasdaq,silvermoon,1034,paladin,retribution,18,11,7
Taomeba,runetotem,1033,paladin,retribution,27,14,13
Eihwåz,garona,1033,paladin,retribution,41,18,23
Gôdfâthér,kazzak,1031,paladin,retribution,23,11,12
Rileys,turalyon,1029,paladin,retribution,174,80,94
Zanathos,onyxia,1027,paladin,retribution,66,38,28
Arhu,stormscale,1027,paladin,retribution,73,38,35
Vardin,sanguino,1027,paladin,retribution,24,11,13
Gundahar,das-syndikat,1026,paladin,retribution,82,45,37
Khveasir,argent-dawn,1026,paladin,retribution,36,11,25
Supou,twisting-nether,1025,paladin,retribution,45,26,19
Pallido,exodar,1025,paladin,retribution,39,21,18
Aludra,twisting-nether,1025,paladin,retribution,154,80,74
Лютыйчпок,fordragon,1025,paladin,retribution,148,64,84
Makiwara,emeriss,1024,paladin,retribution,208,99,109
Hateless,tarren-mill,1024,paladin,retribution,28,11,17
Гермесиус,deepholm,1023,paladin,retribution,120,53,67
Sandorr,area-52,1021,paladin,retribution,36,18,18
Góò,frostmane,1021,paladin,retribution,26,12,14
Mhorcain,silvermoon,1020,paladin,retribution,36,17,19
Aelthir,kazzak,1019,paladin,retribution,25,13,12
Hølly,twisting-nether,1019,paladin,retribution,30,11,19
Cliffordd,doomhammer,1018,paladin,retribution,75,31,44
Stefàn,sylvanas,1017,paladin,retribution,26,12,14
Jesophar,archimonde,1017,paladin,retribution,36,15,21
Леруся,eversong,1017,paladin,retribution,109,42,67
Almohalhil,tarren-mill,1016,paladin,retribution,66,36,30
Mikipaki,tarren-mill,1016,paladin,retribution,29,11,18
Quasimotto,turalyon,1014,paladin,retribution,36,13,23
Mechoka,auchindoun,1013,paladin,retribution,25,14,11
Люфтер,gordunni,1013,paladin,retribution,65,32,33
Käylä,silvermoon,1013,paladin,retribution,24,11,13
Täntra,cthun,1013,paladin,retribution,49,21,28
Aégon,archimonde,1012,paladin,retribution,115,53,62
Vibeer,ravencrest,1011,paladin,retribution,146,75,71
Timesover,doomhammer,1011,paladin,retribution,54,24,30
Derbrècher,azshara,1009,paladin,retribution,40,20,20
Summuno,eredar,1009,paladin,retribution,222,95,127
Neftys,aegwynn,1009,paladin,retribution,48,20,28
Хйуго,soulflayer,1008,paladin,retribution,27,16,11
Макстипчик,howling-fjord,1008,paladin,retribution,21,12,9
Ункаль,ashenvale,1008,paladin,retribution,229,110,119
Bomsamdi,draenor,1007,paladin,retribution,85,37,48
Antrapo,khaz-modan,1006,paladin,retribution,72,31,41
Leifleur,silvermoon,1006,paladin,retribution,51,21,30
Коклюш,ashenvale,1004,paladin,retribution,30,14,16
Moodypala,doomhammer,1003,paladin,retribution,24,15,9
Flyingsnow,dunemaul,1003,paladin,retribution,36,12,24
Phaenre,pozzo-delleternità,1002,paladin,retribution,76,35,41
Харт,fordragon,1001,paladin,retribution,21,15,6
Nicopala,khaz-modan,1001,paladin,retribution,54,28,26
Монбиин,soulflayer,1001,paladin,retribution,24,12,12
Melissasee,wrathbringer,1001,paladin,retribution,42,19,23
Samail,malganis,1001,paladin,retribution,94,40,54
Kauto,aggra-português,1001,paladin,retribution,54,22,32
Loire,blackmoore,1000,paladin,retribution,17,11,6
Nizo,uldum,1000,paladin,retribution,30,15,15
Nerdcore,blackrock,999,paladin,retribution,24,11,13
Lilrettie,ravencrest,999,paladin,retribution,45,14,31
Asclepïos,sanguino,998,paladin,retribution,18,12,6
Påladinmamma,sunstrider,998,paladin,retribution,23,11,12
Killtauren,kazzak,998,paladin,retribution,132,63,69
Crazybones,marécage-de-zangar,998,paladin,retribution,53,22,31
Briggybomb,outland,998,paladin,retribution,37,15,22
Legiønr,ravencrest,997,paladin,retribution,18,11,7
Эксвайп,howling-fjord,997,paladin,retribution,23,11,12
Dathea,aegwynn,997,paladin,retribution,97,38,59
Refjâsk,drekthar,994,paladin,retribution,50,13,37
Актевс,grom,993,paladin,retribution,48,27,21
Meneth,elune,993,paladin,retribution,166,73,93
Eltruite,archimonde,991,paladin,retribution,66,29,37
Virusee,doomhammer,990,paladin,retribution,23,12,11
Deworld,tarren-mill,988,paladin,retribution,20,11,9
Plato,arthas,988,paladin,retribution,101,49,52
Avgudaren,draenor,988,paladin,retribution,26,11,15
Zerohour,kilrogg,987,paladin,retribution,34,11,23
Legâin,twisting-nether,987,paladin,retribution,48,11,37
Mckellen,antonidas,986,paladin,retribution,21,12,9
Klikas,twisting-nether,986,paladin,retribution,72,38,34
Jenyu,sanguino,986,paladin,retribution,29,13,16
Vuzetevacabo,doomhammer,984,paladin,retribution,319,159,160
Arathorin,ravencrest,983,paladin,retribution,36,17,19
Kealen,nemesis,982,paladin,retribution,91,36,55
Palakag,blackhand,982,paladin,retribution,77,25,52
Titoturixd,dun-modr,981,paladin,retribution,17,11,6
Схемас,gordunni,981,paladin,retribution,48,22,26
Kruan,archimonde,981,paladin,retribution,42,15,27
Cesarius,les-sentinelles,980,paladin,retribution,24,11,13
Антисеептик,gordunni,977,paladin,retribution,98,43,55
Dràgón,dethecus,976,paladin,retribution,31,11,20
Диканс,ashenvale,975,paladin,retribution,23,11,12
Светлаясторо,gordunni,974,paladin,retribution,31,11,20
Nazaninez,tarren-mill,973,paladin,retribution,72,35,37
Танси,fordragon,972,paladin,retribution,38,22,16
Noforgivenes,kazzak,972,paladin,retribution,22,11,11
Conviction,silvermoon,972,paladin,retribution,69,34,35
Имраил,gordunni,972,paladin,retribution,48,17,31
Sheïkka,hyjal,968,paladin,retribution,74,32,42
Bellatthrix,draenor,965,paladin,retribution,33,14,19
Balindrock,dalaran,963,paladin,retribution,78,24,54
Shubí,argent-dawn,960,paladin,retribution,12,10,2
Nobodyyx,stormscale,960,paladin,retribution,12,10,2
Stankow,kazzak,960,paladin,retribution,18,10,8
Blazerlolz,kazzak,960,paladin,retribution,18,10,8
Abukasol,kazzak,960,paladin,retribution,18,10,8
Heldarim,ysondre,960,paladin,retribution,18,10,8
Ginka,blackrock,960,paladin,retribution,18,10,8
Roklim,blackhand,960,paladin,retribution,18,10,8
Эксона,gordunni,960,paladin,retribution,18,10,8
Sucsii,outland,960,paladin,retribution,24,10,14
Kanollaras,tarren-mill,960,paladin,retribution,24,10,14
Hijh,tarren-mill,960,paladin,retribution,24,10,14
Smithx,kazzak,960,paladin,retribution,24,10,14
Artaxiad,sylvanas,960,paladin,retribution,24,10,14
Садистка,soulflayer,960,paladin,retribution,30,10,20
Saulencio,zuljin,960,paladin,retribution,36,10,26
Babycoomer,draenor,959,paladin,retribution,12,10,2
Zenfuki,draenor,959,paladin,retribution,15,11,4
Hesitated,kazzak,959,paladin,retribution,18,10,8
Vindicatê,stormscale,959,paladin,retribution,18,10,8
Kilogosa,frostmane,959,paladin,retribution,18,10,8
Makakí,twisting-nether,959,paladin,retribution,18,10,8
Daizen,blackrock,959,paladin,retribution,18,10,8
Xoriun,norgannon,959,paladin,retribution,18,10,8
Zacharis,drakthul,959,paladin,retribution,18,10,8
Âkäshi,khaz-modan,959,paladin,retribution,18,10,8
Davè,blackmoore,959,paladin,retribution,18,10,8
Kamî,sanguino,959,paladin,retribution,18,10,8
Plaguepal,quelthalas,959,paladin,retribution,18,10,8
Sashä,tarren-mill,959,paladin,retribution,18,10,8
Rømpelukt,auchindoun,959,paladin,retribution,18,10,8
Sweyz,archimonde,959,paladin,retribution,18,10,8
Ragnàr,aggra-português,959,paladin,retribution,120,60,60
Nenenita,cthun,959,paladin,retribution,246,120,126
Palamauka,kazzak,959,paladin,retribution,24,10,14
Bigdaddypump,ravencrest,959,paladin,retribution,24,10,14
Thaddios,burning-blade,959,paladin,retribution,24,10,14
Dàk,grim-batol,959,paladin,retribution,24,10,14
Mullinsilmä,stormreaver,959,paladin,retribution,24,10,14
Milkzaddy,kazzak,959,paladin,retribution,24,10,14
Dohmoo,kazzak,959,paladin,retribution,24,10,14
Croptol,dun-modr,959,paladin,retribution,24,10,14
Valarïs,outland,959,paladin,retribution,30,10,20
Астарин,gordunni,959,paladin,retribution,30,10,20
Yaloh,sylvanas,959,paladin,retribution,30,10,20
Teshkipowa,kazzak,959,paladin,retribution,30,10,20
Джейкл,gordunni,959,paladin,retribution,36,10,26
Violetex,blackmoore,958,paladin,retribution,12,10,2
Béhèlit,sargeras,958,paladin,retribution,18,10,8
Funshinè,thrall,958,paladin,retribution,18,10,8
Myû,die-aldor,958,paladin,retribution,18,10,8
Søal,blackrock,958,paladin,retribution,18,10,8
Faiella,argent-dawn,958,paladin,retribution,18,10,8
Valanysa,blackmoore,958,paladin,retribution,18,10,8
Sheldon,sylvanas,958,paladin,retribution,18,10,8
Deathzzaky,zuljin,958,paladin,retribution,18,10,8
Arcardi,dun-morogh,958,paladin,retribution,18,10,8
Shailwo,ysondre,958,paladin,retribution,18,10,8
Bobshock,twisting-nether,958,paladin,retribution,18,10,8
Леаркус,blackscar,958,paladin,retribution,24,10,14
Skinriper,stormscale,958,paladin,retribution,24,10,14
Nïke,dun-modr,958,paladin,retribution,24,10,14
Mudan,stormscale,958,paladin,retribution,24,10,14
Harnêlia,marécage-de-zangar,958,paladin,retribution,95,34,61
Axone,ravencrest,958,paladin,retribution,30,10,20
Мультас,gordunni,957,paladin,retribution,18,10,8
Retdemption,ravencrest,957,paladin,retribution,18,10,8
Saintjustice,hyjal,957,paladin,retribution,18,10,8
Albaladin,hyjal,957,paladin,retribution,18,10,8
Winterwall,sylvanas,957,paladin,retribution,24,10,14
Dimdon,silvermoon,957,paladin,retribution,24,10,14
Ligthe,archimonde,957,paladin,retribution,24,10,14
Septèmber,draenor,957,paladin,retribution,30,10,20
Feenux,drakthul,956,paladin,retribution,16,11,5
Wingz,trollbane,956,paladin,retribution,18,10,8
Ëhra,hyjal,956,paladin,retribution,18,10,8
Ayoub,argent-dawn,956,paladin,retribution,18,10,8
Nydilol,sylvanas,956,paladin,retribution,18,10,8
Mugraine,ravencrest,956,paladin,retribution,24,10,14
Szaporító,ragnaros,956,paladin,retribution,24,10,14
Unrealight,blackrock,956,paladin,retribution,36,10,26
Shemoistdoe,tarren-mill,955,paladin,retribution,16,11,5
Løøktår,ysondre,955,paladin,retribution,18,10,8
Enkir,sanguino,955,paladin,retribution,18,10,8
Sneptica,draenor,955,paladin,retribution,19,10,9
Pappipala,tarren-mill,955,paladin,retribution,24,10,14
Ббормотуха,thermaplugg,955,paladin,retribution,24,10,14
Aal,eredar,955,paladin,retribution,30,10,20
Paladikt,teldrassil,954,paladin,retribution,24,10,14
Phlakorn,blackhand,954,paladin,retribution,24,10,14
Yoggbaton,tarren-mill,954,paladin,retribution,36,10,26
Velóx,eredar,953,paladin,retribution,12,10,2
Roostei,shattered-hand,953,paladin,retribution,18,10,8
Palatarlouze,khaz-modan,952,paladin,retribution,24,10,14
Immortality,outland,952,paladin,retribution,27,11,16
Xrules,blackhand,952,paladin,retribution,61,23,38
Buddy,conseil-des-ombres,951,paladin,retribution,21,11,10
Kreathor,eredar,951,paladin,retribution,54,23,31
Inquîsîtor,bronze-dragonflight,951,paladin,retribution,24,10,14
Hidån,archimonde,951,paladin,retribution,30,10,20
Gottfrid,sunstrider,949,paladin,retribution,18,10,8
Mettã,hyjal,949,paladin,retribution,104,39,65
Goouse,marécage-de-zangar,948,paladin,retribution,18,10,8
Aïzo,archimonde,948,paladin,retribution,30,13,17
Xemoth,kazzak,947,paladin,retribution,18,10,8
Palan,los-errantes,947,paladin,retribution,24,10,14
Kazadin,argent-dawn,944,paladin,retribution,18,10,8
Ârthâstrâs,terrordar,944,paladin,retribution,96,47,49
Tomales,aggramar,944,paladin,retribution,75,36,39
Palahuakbar,sylvanas,943,paladin,retribution,23,10,13
Космонафт,howling-fjord,943,paladin,retribution,30,10,20
Sessian,bronze-dragonflight,942,paladin,retribution,82,42,40
Nitay,blades-edge,942,paladin,retribution,34,10,24
Calibretto,khaz-modan,941,paladin,retribution,23,10,13
Thòòr,blackmoore,940,paladin,retribution,18,10,8
Vexxus,blackrock,940,paladin,retribution,78,39,39
Gathalia,blackhand,939,paladin,retribution,24,14,10
Bafbaf,arathi,939,paladin,retribution,71,22,49
Minervre,confrérie-du-thorium,938,paladin,retribution,30,10,20
Atacan,twisting-nether,937,paladin,retribution,52,26,26
Святойбас,gordunni,936,paladin,retribution,18,10,8
Moriex,drakthul,936,paladin,retribution,30,10,20
Cydor,khaz-modan,934,paladin,retribution,54,20,34
Tirifal,voljin,933,paladin,retribution,18,10,8
Bugo,drakthul,933,paladin,retribution,23,10,13
Benø,malganis,933,paladin,retribution,30,10,20
Ruffus,magtheridon,931,paladin,retribution,18,11,7
Choppychop,defias-brotherhood,930,paladin,retribution,42,15,27
Haquiles,shendralar,929,paladin,retribution,73,34,39
Wolya,blackrock,927,paladin,retribution,21,11,10
Ghéttørèt,das-konsortium,927,paladin,retribution,26,11,15
Lihli,wildhammer,927,paladin,retribution,34,10,24
Healmacan,thrall,926,paladin,retribution,17,10,7
Josuaa,ragnaros,924,paladin,retribution,110,51,59
Lightblaze,doomhammer,924,paladin,retribution,60,21,39
Eatfasteatas,doomhammer,923,paladin,retribution,12,10,2
Kabusmassey,outland,923,paladin,retribution,16,10,6
Dreadlyn,bloodhoof,923,paladin,retribution,60,24,36
Crepak,blackrock,921,paladin,retribution,21,11,10
Zingler,norgannon,920,paladin,retribution,30,16,14
Aggipala,blackhand,920,paladin,retribution,56,20,36
Ressler,tichondrius,919,paladin,retribution,27,12,15
Snaty,khaz-modan,916,paladin,retribution,170,84,86
Methynox,khaz-modan,915,paladin,retribution,30,12,18
Azherok,archimonde,912,paladin,retribution,24,13,11
Snakedubaby,blackrock,910,paladin,retribution,41,10,31
Cheriedamour,ysondre,909,paladin,retribution,17,10,7
Шестьводных,galakrond,909,paladin,retribution,50,15,35
Ericpala,turalyon,907,paladin,retribution,30,11,19
Platronix,aegwynn,906,paladin,retribution,21,11,10
Milicos,sylvanas,906,paladin,retribution,108,55,53
Opgezwolle,draenor,904,paladin,retribution,129,65,64
Tsopunisherr,ravencrest,904,paladin,retribution,29,11,18
Hurrier,outland,902,paladin,retribution,27,11,16
Lieris,twisting-nether,901,paladin,retribution,20,11,9
Thiccfreak,tarren-mill,901,paladin,retribution,48,23,25
Darkironpala,argent-dawn,901,paladin,retribution,27,10,17
Dreadadin,silvermoon,900,paladin,retribution,34,15,19
Patzi,die-todeskrallen,897,paladin,retribution,109,52,57
Benkenoah,ragnaros,897,paladin,retribution,78,34,44
Gurutze,ragnaros,896,paladin,retribution,16,10,6
Quantox,frostwolf,896,paladin,retribution,54,26,28
Krisbull,kazzak,895,paladin,retribution,22,10,12
Tigerherz,antonidas,895,paladin,retribution,28,10,18
Dunarella,chogall,894,paladin,retribution,24,12,12
Torvela,ravencrest,894,paladin,retribution,22,10,12
Lolladin,blackmoore,894,paladin,retribution,26,10,16
Meýra,aegwynn,893,paladin,retribution,20,10,10
Ordain,senjin,891,paladin,retribution,92,47,45
Scrambler,grim-batol,890,paladin,retribution,26,10,16
Luxor,sporeggar,888,paladin,retribution,39,20,19
Tánk,twilights-hammer,888,paladin,retribution,48,22,26
Romkaq,silvermoon,884,paladin,retribution,18,11,7
Рэдиенс,howling-fjord,878,paladin,retribution,13,10,3
Windwings,drakthul,878,paladin,retribution,19,10,9
Celébriel,twisting-nether,877,paladin,retribution,19,10,9
Fardahr,ravencrest,877,paladin,retribution,24,10,14
Мраскор,howling-fjord,877,paladin,retribution,62,25,37
Sindur,perenolde,872,paladin,retribution,24,11,13
Othersideof,twisting-nether,871,paladin,retribution,36,16,20
Nikodemus,stormreaver,870,paladin,retribution,25,10,15
Ressurection,outland,869,paladin,retribution,182,85,97
Subzie,archimonde,864,paladin,retribution,12,9,3
Lannistèr,stormscale,864,paladin,retribution,12,9,3
Chocodin,drakthul,864,paladin,retribution,12,9,3
Preamx,blackrock,864,paladin,retribution,12,9,3
Holysnickers,tarren-mill,864,paladin,retribution,12,9,3
Îs,draenor,864,paladin,retribution,12,9,3
Kuski,stormreaver,864,paladin,retribution,12,9,3
Фэнон,gordunni,864,paladin,retribution,12,9,3
Greymagic,argent-dawn,864,paladin,retribution,12,9,3
Joeybananaa,blackhand,864,paladin,retribution,12,9,3
Ранрика,blackscar,864,paladin,retribution,12,9,3
Camusa,kazzak,864,paladin,retribution,12,9,3
Milowalens,ravencrest,864,paladin,retribution,12,9,3
Andriâ,blackhand,864,paladin,retribution,18,9,9
Divinemove,stormscale,864,paladin,retribution,18,9,9
Pesterci,draenor,864,paladin,retribution,18,9,9
Биллирэй,gordunni,864,paladin,retribution,18,9,9
Noxy,thrall,864,paladin,retribution,18,9,9
Extasey,ravencrest,864,paladin,retribution,18,9,9
Punlac,draenor,864,paladin,retribution,18,9,9
Retgodx,eredar,864,paladin,retribution,18,9,9
Ollepala,draenor,864,paladin,retribution,18,9,9
Reckonin,nagrand,864,paladin,retribution,18,9,9
Maximumtaste,ravencrest,864,paladin,retribution,18,9,9
Ilpreside,nemesis,864,paladin,retribution,18,9,9
Askmy,stormscale,864,paladin,retribution,18,9,9
Skycraft,kazzak,864,paladin,retribution,18,9,9
Püshup,archimonde,864,paladin,retribution,18,9,9
Corrâ,blackmoore,864,paladin,retribution,18,9,9
Arrakkis,ravencrest,864,paladin,retribution,24,9,15
Veldora,zuljin,864,paladin,retribution,24,9,15
Fluffyowo,argent-dawn,864,paladin,retribution,24,9,15
Jicekaa,archimonde,864,paladin,retribution,24,9,15
Gomadin,azuremyst,864,paladin,retribution,24,9,15
Mitsoû,archimonde,864,paladin,retribution,24,9,15
Ritaora,aggramar,864,paladin,retribution,24,9,15
Сэйберх,gordunni,864,paladin,retribution,24,9,15
Onlyfanuser,stormscale,864,paladin,retribution,24,9,15
Святстраж,gordunni,864,paladin,retribution,27,10,17
Zethhx,stormscale,864,paladin,retribution,30,9,21
Слоутавмвп,azuregos,864,paladin,retribution,36,9,27
Aksios,kazzak,863,paladin,retribution,12,9,3
Fenrixlol,shendralar,863,paladin,retribution,12,9,3
Nakedholy,draenor,863,paladin,retribution,12,9,3
Azanah,turalyon,863,paladin,retribution,12,9,3
Koltop,ravencrest,863,paladin,retribution,12,9,3
Nordkreuz,aegwynn,863,paladin,retribution,18,9,9
Steínsgate,ravencrest,863,paladin,retribution,18,9,9
Азмарио,gordunni,863,paladin,retribution,18,9,9
Rinjepeyet,rexxar,863,paladin,retribution,18,9,9
Slyper,dun-modr,863,paladin,retribution,18,9,9
Palapouffe,khaz-modan,863,paladin,retribution,18,9,9
Wipestorm,stormscale,863,paladin,retribution,18,9,9
Bramonier,blackmoore,863,paladin,retribution,18,9,9
Jínnx,outland,863,paladin,retribution,18,9,9
Ibanez,lightnings-blade,863,paladin,retribution,18,9,9
Dälaghetto,kilrogg,863,paladin,retribution,18,9,9
Bonkkar,antonidas,863,paladin,retribution,18,9,9
Badckes,sylvanas,863,paladin,retribution,18,9,9
Sérajón,ravencrest,863,paladin,retribution,18,9,9
Sildrit,draenor,863,paladin,retribution,18,9,9
Blauerwürger,blackmoore,863,paladin,retribution,24,9,15
Khantaro,twisting-nether,863,paladin,retribution,24,9,15
Zlatniq,kazzak,863,paladin,retribution,24,9,15
Tarhia,terokkar,863,paladin,retribution,24,9,15
Galerian,twilights-hammer,863,paladin,retribution,24,9,15
Getpawned,rexxar,863,paladin,retribution,24,9,15
Nicklovsofia,silvermoon,863,paladin,retribution,30,9,21
Myrmidan,magtheridon,863,paladin,retribution,30,9,21
Атмта,razuvious,863,paladin,retribution,30,9,21
Trumputin,ravencrest,863,paladin,retribution,30,9,21
Paduj,kazzak,862,paladin,retribution,12,9,3
Atkm,aggramar,862,paladin,retribution,12,9,3
Kabóm,kazzak,862,paladin,retribution,12,9,3
Blatrix,kazzak,862,paladin,retribution,12,9,3
Редрот,gordunni,862,paladin,retribution,18,9,9
Køllegah,ragnaros,862,paladin,retribution,18,9,9
Хикано,gordunni,862,paladin,retribution,18,9,9
Darkenorr,silvermoon,862,paladin,retribution,18,9,9
Praveednik,tarren-mill,862,paladin,retribution,18,9,9
Shakati,twisting-nether,862,paladin,retribution,18,9,9
Dáimion,defias-brotherhood,862,paladin,retribution,18,9,9
Londonn,silvermoon,862,paladin,retribution,18,9,9
Elendíl,azjolnerub,862,paladin,retribution,18,9,9
Sunwalker,bronzebeard,862,paladin,retribution,18,9,9
Финэдин,gordunni,862,paladin,retribution,21,10,11
Arthane,frostmane,862,paladin,retribution,22,10,12
Роллита,gordunni,862,paladin,retribution,24,9,15
Fízzybubble,blackmoore,862,paladin,retribution,24,9,15
Elyrax,nemesis,862,paladin,retribution,24,9,15
Boyard,silvermoon,862,paladin,retribution,30,9,21
Scoundrell,the-maelstrom,862,paladin,retribution,36,9,27
Viffi,darkspear,861,paladin,retribution,12,9,3
Saviourself,silvermoon,861,paladin,retribution,18,9,9
Liliána,ragnaros,861,paladin,retribution,18,9,9
Kochar,doomhammer,861,paladin,retribution,18,9,9
Retributon,madmortem,861,paladin,retribution,18,9,9
Киэрсис,howling-fjord,861,paladin,retribution,18,9,9
Sytrexxer,frostwolf,861,paladin,retribution,24,9,15
Dideta,colinas-pardas,861,paladin,retribution,24,9,15
Headflúx,argent-dawn,861,paladin,retribution,24,9,15
Ærøn,temple-noir,861,paladin,retribution,24,9,15
Sölaria,silvermoon,860,paladin,retribution,18,9,9
Ysunna,magtheridon,860,paladin,retribution,18,9,9
Humungus,sylvanas,860,paladin,retribution,18,9,9
Mustaach,grim-batol,860,paladin,retribution,24,9,15
Destroyér,blackmoore,860,paladin,retribution,24,9,15
Banister,eredar,860,paladin,retribution,24,9,15
Ezcanôr,archimonde,860,paladin,retribution,26,9,17
Гераций,howling-fjord,860,paladin,retribution,30,9,21
Tnkfrank,ravencrest,859,paladin,retribution,18,9,9
Câillou,hyjal,859,paladin,retribution,22,10,12
Jêzus,blackrock,858,paladin,retribution,12,9,3
Алланор,fordragon,858,paladin,retribution,19,11,8
Teuterix,drakthul,858,paladin,retribution,18,9,9
Rètbull,blackhand,858,paladin,retribution,18,9,9
Doomhornqt,outland,857,paladin,retribution,18,9,9
Foichtgebet,silvermoon,857,paladin,retribution,24,9,15
Kathly,madmortem,857,paladin,retribution,24,9,15
Fortination,suramar,853,paladin,retribution,18,9,9
Uriziel,the-shatar,853,paladin,retribution,42,19,23
Paladiume,drekthar,852,paladin,retribution,12,9,3
Funtle,kazzak,851,paladin,retribution,24,9,15
Palatak,outland,851,paladin,retribution,30,9,21
Fløki,blackrock,848,paladin,retribution,20,10,10
Secônd,azjolnerub,847,paladin,retribution,12,9,3
Явства,grom,847,paladin,retribution,30,9,21
Сашок,gordunni,846,paladin,retribution,18,10,8
Frankdux,archimonde,846,paladin,retribution,23,11,12
Draarks,archimonde,845,paladin,retribution,18,9,9
Bariel,lordaeron,845,paladin,retribution,18,9,9
Woezel,draenor,845,paladin,retribution,24,9,15
Knygnesys,silvermoon,844,paladin,retribution,21,11,10
Missybugla,turalyon,844,paladin,retribution,29,9,20
Lunarrider,ravencrest,844,paladin,retribution,30,9,21
Lgbtqlover,kazzak,841,paladin,retribution,18,11,7
Sunfather,twilights-hammer,836,paladin,retribution,233,115,118
Psykoosi,defias-brotherhood,834,paladin,retribution,52,24,28
Nomeel,twisting-nether,833,paladin,retribution,389,190,199
Bebcho,turalyon,833,paladin,retribution,38,15,23
Jorrel,bladefist,830,paladin,retribution,17,9,8
Влажныйбоб,soulflayer,830,paladin,retribution,22,9,13
Dôrä,ysondre,830,paladin,retribution,23,9,14
Nakkii,outland,829,paladin,retribution,17,9,8
Баблыч,borean-tundra,829,paladin,retribution,60,28,32
Sudija,ravencrest,827,paladin,retribution,22,10,12
Guckzu,malganis,823,paladin,retribution,49,22,27
Choyoki,blackmoore,816,paladin,retribution,56,22,34
Årés,sanguino,815,paladin,retribution,36,16,20
Bôomayé,archimonde,815,paladin,retribution,23,9,14
Sàbèr,blackmoore,815,paladin,retribution,29,9,20
Sunsera,blackrock,809,paladin,retribution,20,10,10
Tràktor,antonidas,809,paladin,retribution,20,10,10
Khadet,draenor,809,paladin,retribution,22,10,12
Pyrogon,malorne,807,paladin,retribution,231,105,126
Авереон,gordunni,806,paladin,retribution,35,10,25
Сакирий,gordunni,805,paladin,retribution,17,9,8
Helvirya,defias-brotherhood,804,paladin,retribution,342,148,194
Orelius,guldan,803,paladin,retribution,80,33,47
Boaka,outland,803,paladin,retribution,30,9,21
Luciiano,malygos,802,paladin,retribution,65,25,40
Eufenia,tarren-mill,800,paladin,retribution,18,9,9
Куоширо,goldrinn,800,paladin,retribution,78,32,46
Khyleancbum,sanguino,799,paladin,retribution,14,9,5
Neopleyadess,dun-modr,799,paladin,retribution,17,9,8
Alroxya,blackrock,799,paladin,retribution,23,9,14
Ultravíolett,kargath,799,paladin,retribution,23,9,14
Retriot,silvermoon,798,paladin,retribution,26,9,17
Ходерр,blackscar,797,paladin,retribution,26,10,16
Maffko,kazzak,796,paladin,retribution,14,9,5
Alerorn,kazzak,795,paladin,retribution,22,9,13
Farriborz,silvermoon,794,paladin,retribution,20,9,11
Fufenzee,stormscale,788,paladin,retribution,270,115,155
Bizin,drakthul,787,paladin,retribution,18,9,9
Niyahnie,kazzak,768,paladin,retribution,12,8,4
Pakór,blackrock,768,paladin,retribution,12,8,4
Jïncks,anachronos,768,paladin,retribution,12,8,4
Minpala,kazzak,768,paladin,retribution,12,8,4
Øñyxßß,ravencrest,768,paladin,retribution,12,8,4
Touch,vashj,768,paladin,retribution,12,8,4
Classicheroo,stormscale,768,paladin,retribution,12,8,4
Solntsepek,ravencrest,768,paladin,retribution,12,8,4
Ðiëu,culte-de-la-rive-noire,768,paladin,retribution,12,8,4
Hulkebulle,silvermoon,768,paladin,retribution,12,8,4
Balvir,kazzak,768,paladin,retribution,12,8,4
Rudelgemuese,blackmoore,768,paladin,retribution,12,8,4
Vérdugo,quelthalas,768,paladin,retribution,12,8,4
Ajany,blackmoore,768,paladin,retribution,12,8,4
Sixtynien,outland,768,paladin,retribution,12,8,4
Xephys,argent-dawn,768,paladin,retribution,12,8,4
Sariäza,argent-dawn,768,paladin,retribution,12,8,4
Palamag,grim-batol,768,paladin,retribution,18,8,10
Neldöwn,dalaran,768,paladin,retribution,18,8,10
Sekztokio,blackmoore,768,paladin,retribution,18,8,10
Bubblor,ravencrest,768,paladin,retribution,18,8,10
Søulréaper,stormscale,768,paladin,retribution,18,8,10
Кисаммэ,howling-fjord,768,paladin,retribution,18,8,10
Эйнис,goldrinn,768,paladin,retribution,18,8,10
Yîînkz,blackmoore,768,paladin,retribution,18,8,10
Retrigodx,ragnaros,768,paladin,retribution,18,8,10
Endavour,ravencrest,768,paladin,retribution,18,8,10
Пчелодин,howling-fjord,768,paladin,retribution,18,8,10
Bloodbeard,twisting-nether,768,paladin,retribution,18,8,10
Stîp,sanguino,768,paladin,retribution,18,8,10
Gala,archimonde,768,paladin,retribution,18,8,10
Piratalpha,thrall,768,paladin,retribution,18,8,10
Postî,eredar,768,paladin,retribution,18,8,10
Enmà,archimonde,768,paladin,retribution,18,8,10
Чемеряк,gordunni,768,paladin,retribution,18,8,10
Rétalin,blackhand,768,paladin,retribution,18,8,10
Phazio,twisting-nether,768,paladin,retribution,18,8,10
Alvinzinho,aggra-português,768,paladin,retribution,18,8,10
Synexy,kazzak,768,paladin,retribution,18,8,10
Morggann,drakthul,768,paladin,retribution,18,8,10
Камверин,soulflayer,768,paladin,retribution,18,8,10
Vikingensven,silvermoon,768,paladin,retribution,18,8,10
Matsuna,blackrock,768,paladin,retribution,18,8,10
Madeofsteel,silvermoon,768,paladin,retribution,18,8,10
Ббпп,howling-fjord,768,paladin,retribution,18,8,10
Swapxyr,aegwynn,768,paladin,retribution,18,8,10
Holyinstinct,bronze-dragonflight,768,paladin,retribution,18,8,10
Qotro,ravencrest,768,paladin,retribution,19,8,11
Caithlyne,ravencrest,768,paladin,retribution,23,8,15
Touchpally,ravencrest,768,paladin,retribution,24,8,16
Xblaj,draenor,768,paladin,retribution,24,8,16
Abbendis,twisting-nether,768,paladin,retribution,24,8,16
Рудиар,lich-king,768,paladin,retribution,24,8,16
Zhidria,twisting-nether,768,paladin,retribution,24,8,16
Wftw,draenor,768,paladin,retribution,24,8,16
Retisfine,silvermoon,768,paladin,retribution,24,8,16
Bóokah,blackhand,768,paladin,retribution,24,8,16
Retpala,eitrigg,768,paladin,retribution,24,8,16
Shownómercy,stormscale,768,paladin,retribution,24,8,16
Dàrì,archimonde,768,paladin,retribution,24,8,16
Mâgnùs,ravencrest,768,paladin,retribution,24,8,16
Obahtwerk,nemesis,768,paladin,retribution,24,8,16
Vilayesyo,ravencrest,768,paladin,retribution,24,8,16
Évo,drakthul,768,paladin,retribution,30,8,22
Tressðr,dun-modr,768,paladin,retribution,30,8,22
Aliceredlips,dun-modr,768,paladin,retribution,30,8,22
Mêyra,blackhand,768,paladin,retribution,32,8,24
Zycqo,silvermoon,768,paladin,retribution,37,8,29
Anathiel,khaz-modan,767,paladin,retribution,15,11,4
Spinzr,draenor,767,paladin,retribution,12,8,4
Dawnnslayer,kazzak,767,paladin,retribution,12,8,4
Szelena,outland,767,paladin,retribution,12,8,4
Crossfaded,azjolnerub,767,paladin,retribution,12,8,4
Lightblaster,argent-dawn,767,paladin,retribution,12,8,4
Justicebuktu,thrall,767,paladin,retribution,12,8,4
Neckcheese,spinebreaker,767,paladin,retribution,12,8,4
Unforsakenx,silvermoon,767,paladin,retribution,12,8,4
Jungergot,aegwynn,767,paladin,retribution,15,9,6
Pitux,dun-modr,767,paladin,retribution,16,9,7
Яшкино,soulflayer,767,paladin,retribution,18,8,10
Yerosoc,burning-legion,767,paladin,retribution,18,8,10
Бальтазёрыч,soulflayer,767,paladin,retribution,18,8,10
Selvich,darksorrow,767,paladin,retribution,18,8,10
Kuhreligion,blackmoore,767,paladin,retribution,18,8,10
Banderovez,silvermoon,767,paladin,retribution,18,8,10
Feliora,magtheridon,767,paladin,retribution,18,8,10
One,grim-batol,767,paladin,retribution,18,8,10
Atabaí,antonidas,767,paladin,retribution,18,8,10
Spikiz,kazzak,767,paladin,retribution,18,8,10
Halldvan,silvermoon,767,paladin,retribution,18,8,10
Sämaelia,ysondre,767,paladin,retribution,18,8,10
Retgrets,kazzak,767,paladin,retribution,18,8,10
Aoldur,ragnaros,767,paladin,retribution,18,8,10
Фуллбастэр,gordunni,767,paladin,retribution,18,8,10
Noåh,kazzak,767,paladin,retribution,18,8,10
Samuel,ahnqiraj,767,paladin,retribution,18,8,10
Lynéssa,twisting-nether,767,paladin,retribution,18,8,10
Плётка,howling-fjord,767,paladin,retribution,18,8,10
Xsali,kazzak,767,paladin,retribution,18,8,10
Шалайка,soulflayer,767,paladin,retribution,18,8,10
Baldrheim,culte-de-la-rive-noire,767,paladin,retribution,18,8,10
Hôrrible,ravencrest,767,paladin,retribution,18,8,10
Assÿria,ravencrest,767,paladin,retribution,18,8,10
Jericcho,dun-modr,767,paladin,retribution,18,8,10
Artonus,sylvanas,767,paladin,retribution,20,8,12
Pìnkyy,draenor,767,paladin,retribution,24,8,16
Lusugo,alakir,767,paladin,retribution,24,8,16
Тевтонец,goldrinn,767,paladin,retribution,24,8,16
Thoreas,perenolde,767,paladin,retribution,24,8,16
Freeloliipop,darksorrow,767,paladin,retribution,24,8,16
Saath,malfurion,767,paladin,retribution,24,8,16
Slainer,zuljin,767,paladin,retribution,24,8,16
Jolipapa,ragnaros,767,paladin,retribution,24,8,16
Jámesy,ravencrest,767,paladin,retribution,24,8,16
Hermmes,alakir,767,paladin,retribution,24,8,16
Dáìsy,blackmoore,767,paladin,retribution,34,9,25
Elovie,dun-modr,767,paladin,retribution,34,8,26
Konithis,doomhammer,766,paladin,retribution,12,8,4
Laugan,ysondre,766,paladin,retribution,12,8,4
Shandju,norgannon,766,paladin,retribution,46,23,23
Bpontes,aggra-português,766,paladin,retribution,18,8,10
Athomos,pozzo-delleternità,766,paladin,retribution,18,8,10
Митзефиста,soulflayer,766,paladin,retribution,18,8,10
Chuckbass,blackmoore,766,paladin,retribution,18,8,10
Méény,archimonde,766,paladin,retribution,18,8,10
Beefbombs,blackmoore,766,paladin,retribution,18,8,10
Sheynä,hyjal,766,paladin,retribution,18,8,10
Dominiq,argent-dawn,766,paladin,retribution,24,8,16
Sephirøth,thrall,766,paladin,retribution,24,8,16
Ôpheliâ,blackmoore,765,paladin,retribution,12,8,4
Darhz,garona,765,paladin,retribution,18,8,10
Disconnector,aegwynn,765,paladin,retribution,24,8,16
Стопкаст,ashenvale,765,paladin,retribution,24,8,16
Flokié,blackrock,764,paladin,retribution,12,8,4
Trøllørd,shattrath,764,paladin,retribution,18,8,10
Crussaden,stormscale,764,paladin,retribution,19,8,11
Werepala,drakthul,764,paladin,retribution,24,8,16
Leam,bronze-dragonflight,764,paladin,retribution,24,8,16
Ahritea,blackrock,763,paladin,retribution,12,8,4
Lewanor,tarren-mill,763,paladin,retribution,12,8,4
Wingedguard,ragnaros,763,paladin,retribution,12,8,4
Skimer,outland,763,paladin,retribution,13,8,5
Ньюзеропал,howling-fjord,763,paladin,retribution,18,8,10
Labadin,darkspear,763,paladin,retribution,18,8,10
Aramedes,eredar,763,paladin,retribution,18,8,10
Русскийяя,gordunni,762,paladin,retribution,13,9,4
Syldor,eredar,762,paladin,retribution,12,8,4
Tank,uldum,762,paladin,retribution,12,8,4
Gødee,silvermoon,762,paladin,retribution,12,8,4
Стекловатный,gordunni,762,paladin,retribution,12,8,4
Freddy,frostmane,762,paladin,retribution,18,8,10
Nasgar,nemesis,762,paladin,retribution,18,8,10
Mjukadin,ravencrest,762,paladin,retribution,18,8,10
Снупжук,soulflayer,761,paladin,retribution,12,8,4
Vondarkmoor,magtheridon,761,paladin,retribution,18,8,10
Maxelx,doomhammer,760,paladin,retribution,12,8,4
Torczy,frostwhisper,760,paladin,retribution,12,8,4
Lightie,aegwynn,759,paladin,retribution,18,8,10
Mormazor,outland,758,paladin,retribution,18,8,10
Curélien,argent-dawn,758,paladin,retribution,30,8,22
Oheiligster,kult-der-verdammten,755,paladin,retribution,18,8,10
Jily,suramar,755,paladin,retribution,18,8,10
Stealop,malfurion,752,paladin,retribution,24,8,16
Лентон,gordunni,751,paladin,retribution,12,8,4
Francos,cthun,751,paladin,retribution,33,8,25
Pigma,outland,749,paladin,retribution,24,11,13
Ryüü,uldaman,748,paladin,retribution,48,16,32
Lawrence,deathwing,748,paladin,retribution,24,8,16
Ukbling,steamwheedle-cartel,745,paladin,retribution,62,18,44
Драгун,gordunni,742,paladin,retribution,97,41,56
Grayparser,silvermoon,735,paladin,retribution,14,9,5
Trístesse,tarren-mill,735,paladin,retribution,29,8,21
Drestaen,drakthul,731,paladin,retribution,28,8,20
Naiirah,aegwynn,727,paladin,retribution,24,8,16
Baazza,chamber-of-aspects,723,paladin,retribution,28,9,19
Ragnarauc,elune,720,paladin,retribution,15,8,7
Slayerq,outland,719,paladin,retribution,23,8,15
Cøygonne,archimonde,719,paladin,retribution,27,8,19
Unbreakable,eredar,717,paladin,retribution,15,8,7
Esköll,hyjal,713,paladin,retribution,15,9,6
Pastabianco,ravencrest,713,paladin,retribution,18,9,9
Aldèbaràn,pozzo-delleternità,713,paladin,retribution,24,10,14
Marikido,archimonde,713,paladin,retribution,27,9,18
Aue,blackmoore,703,paladin,retribution,20,10,10
Солнцеснебес,gordunni,702,paladin,retribution,11,8,3
Lotarios,tarren-mill,702,paladin,retribution,17,9,8
Angelepetit,hyjal,701,paladin,retribution,16,8,8
Kubrat,eredar,700,paladin,retribution,54,18,36
Bubbelish,doomhammer,697,paladin,retribution,27,9,18
Hanterus,antonidas,691,paladin,retribution,20,8,12
Smackthepony,sylvanas,690,paladin,retribution,64,23,41
Sawier,ragnaros,688,paladin,retribution,19,8,11
Gradepal,drakthul,687,paladin,retribution,19,8,11
Barbarul,draenor,685,paladin,retribution,19,8,11
Fatherabdul,ravencrest,672,paladin,retribution,12,7,5
Decive,outland,672,paladin,retribution,12,7,5
Apokalypson,draenor,672,paladin,retribution,12,7,5
Skydrog,archimonde,672,paladin,retribution,12,7,5
Naylaeh,draenor,672,paladin,retribution,12,7,5
Vircy,outland,672,paladin,retribution,12,7,5
Миллиционер,razuvious,672,paladin,retribution,12,7,5
Leónardo,kazzak,672,paladin,retribution,12,7,5
Kamas,antonidas,672,paladin,retribution,12,7,5
Дикийчёрт,gordunni,672,paladin,retribution,12,7,5
Рэйног,gordunni,672,paladin,retribution,12,7,5
Xônia,sylvanas,672,paladin,retribution,12,7,5
Ellünca,ravencrest,672,paladin,retribution,12,7,5
Kralenko,archimonde,672,paladin,retribution,12,7,5
Лиривель,howling-fjord,672,paladin,retribution,12,7,5
Bämschi,blackrock,672,paladin,retribution,12,7,5
Percocetx,tarren-mill,672,paladin,retribution,12,7,5
Uriens,zuljin,672,paladin,retribution,12,7,5
Veo,sylvanas,672,paladin,retribution,12,7,5
Nøradin,argent-dawn,672,paladin,retribution,12,7,5
Catfordinner,silvermoon,672,paladin,retribution,12,7,5
Veganbeefman,draenor,672,paladin,retribution,12,7,5
Layonthese,alleria,672,paladin,retribution,12,7,5
Блудиз,howling-fjord,672,paladin,retribution,12,7,5
Johnyb,stormscale,672,paladin,retribution,12,7,5
Volkai,zuljin,672,paladin,retribution,12,7,5
Pssddgg,ragnaros,672,paladin,retribution,12,7,5
Christina,silvermoon,672,paladin,retribution,12,7,5
Нефростинг,gordunni,672,paladin,retribution,12,7,5
Проверялка,thermaplugg,672,paladin,retribution,12,7,5
Miriem,twisting-nether,672,paladin,retribution,12,7,5
Ufø,thrall,672,paladin,retribution,12,7,5
Ceca,lightnings-blade,672,paladin,retribution,12,7,5
Noskillxd,kragjin,672,paladin,retribution,12,7,5
Deckardpain,shattered-hand,672,paladin,retribution,12,7,5
Împala,twisting-nether,672,paladin,retribution,12,7,5
Sismast,argent-dawn,672,paladin,retribution,12,7,5
Troposin,thrall,672,paladin,retribution,12,7,5
Shjami,rexxar,672,paladin,retribution,12,7,5
Arkhàn,ravencrest,672,paladin,retribution,12,7,5
Xiliath,bloodfeather,672,paladin,retribution,12,7,5
Vulence,the-shatar,672,paladin,retribution,12,7,5
Шефлион,soulflayer,672,paladin,retribution,12,7,5
Ranishka,ravencrest,672,paladin,retribution,12,7,5
Kikipoti,ravenholdt,672,paladin,retribution,12,7,5
Pratiarch,kazzak,672,paladin,retribution,12,7,5
Pâlâpâm,blackmoore,672,paladin,retribution,12,7,5
Megadef,twisting-nether,672,paladin,retribution,12,7,5
Ljubav,ravencrest,672,paladin,retribution,12,7,5
Röcc,draenor,672,paladin,retribution,12,7,5
Solanarion,burning-legion,672,paladin,retribution,12,7,5
Petsadin,ravencrest,672,paladin,retribution,12,7,5
Mâlâk,dun-modr,672,paladin,retribution,12,7,5
Azzaelea,tarren-mill,672,paladin,retribution,12,7,5
Fetichistlov,drekthar,672,paladin,retribution,12,7,5
Henklord,jaedenar,672,paladin,retribution,12,7,5
Tizeo,thunderhorn,672,paladin,retribution,15,8,7
Twingo,defias-brotherhood,672,paladin,retribution,15,8,7
Тазикчая,soulflayer,672,paladin,retribution,16,8,8
Holymolee,blackmoore,672,paladin,retribution,15,7,8
Knugadin,stormscale,672,paladin,retribution,18,8,10
Prâtox,blackmoore,672,paladin,retribution,18,7,11
Vaalé,aegwynn,672,paladin,retribution,18,7,11
Yakuron,blackhand,672,paladin,retribution,18,7,11
Mawrâ,twisting-nether,672,paladin,retribution,18,7,11
Ênma,archimonde,672,paladin,retribution,18,7,11
Seekêr,tarren-mill,672,paladin,retribution,18,7,11
Lommeuld,auchindoun,672,paladin,retribution,18,7,11
Destaen,kazzak,672,paladin,retribution,18,7,11
Apocalypsé,twisting-nether,672,paladin,retribution,18,7,11
Calliopes,tarren-mill,672,paladin,retribution,18,7,11
Arbuzno,draenor,672,paladin,retribution,18,7,11
Divineovic,ravencrest,672,paladin,retribution,18,7,11
Tezmodian,antonidas,672,paladin,retribution,18,7,11
Plasmadieter,blackrock,672,paladin,retribution,18,7,11
Fróstíp,blackrock,672,paladin,retribution,18,7,11
Hännó,malganis,672,paladin,retribution,18,7,11
Rocheford,silvermoon,672,paladin,retribution,18,7,11
Jinxdadmilk,twisting-nether,672,paladin,retribution,18,7,11
Miscodepala,twisting-nether,672,paladin,retribution,18,7,11
Evilhoof,thrall,672,paladin,retribution,18,7,11
Reyhann,ravencrest,672,paladin,retribution,18,7,11
Мериатас,soulflayer,672,paladin,retribution,18,7,11
Trýhærd,ragnaros,672,paladin,retribution,18,7,11
Smutty,frostmane,672,paladin,retribution,18,7,11
Scairtin,ravencrest,672,paladin,retribution,18,7,11
Nanyami,blackhand,672,paladin,retribution,18,7,11
Drident,die-nachtwache,672,paladin,retribution,18,7,11
Eleånor,archimonde,672,paladin,retribution,18,7,11
Melyntholdra,argent-dawn,672,paladin,retribution,18,7,11
Himboqueenxo,argent-dawn,672,paladin,retribution,18,7,11
Mälcolm,argent-dawn,672,paladin,retribution,18,7,11
Алепос,gordunni,672,paladin,retribution,18,7,11
Norganpala,die-aldor,672,paladin,retribution,18,7,11
Fahrèl,hyjal,672,paladin,retribution,18,7,11
Tinia,azjolnerub,672,paladin,retribution,18,7,11
Lotheirid,antonidas,672,paladin,retribution,18,7,11
Azapala,kazzak,672,paladin,retribution,18,7,11
Darnito,blackmoore,672,paladin,retribution,21,8,13
Arshiaa,ravencrest,672,paladin,retribution,21,8,13
Глаймис,gordunni,672,paladin,retribution,22,8,14
Chiriner,drakthul,672,paladin,retribution,21,7,14
Npkk,outland,672,paladin,retribution,22,7,15
Boscho,argent-dawn,672,paladin,retribution,24,7,17
Iquny,frostwolf,672,paladin,retribution,24,7,17
Ramhal,stormscale,672,paladin,retribution,24,7,17
Ящеры,gordunni,672,paladin,retribution,24,7,17
Manole,ravencrest,672,paladin,retribution,24,7,17
Kareliaxd,tarren-mill,672,paladin,retribution,24,7,17
Zerlat,twisting-nether,672,paladin,retribution,24,7,17
Cáranthír,draenor,672,paladin,retribution,24,7,17
Elonmuskett,ysondre,672,paladin,retribution,24,7,17
Ашилолпро,soulflayer,672,paladin,retribution,24,7,17
Adalric,silvermoon,672,paladin,retribution,24,7,17
Fatalls,drakthul,671,paladin,retribution,12,7,5
Реснитеплес,gordunni,671,paladin,retribution,12,7,5
Bahamamama,ambossar,671,paladin,retribution,12,7,5
Bronan,draenor,671,paladin,retribution,12,7,5
Timoxas,kazzak,671,paladin,retribution,12,7,5
Kardinalos,drakthul,671,paladin,retribution,12,7,5
Каншеом,gordunni,671,paladin,retribution,12,7,5
Kambarius,antonidas,671,paladin,retribution,12,7,5
Wolfpala,drakthul,671,paladin,retribution,12,7,5
Bryelle,dalaran,671,paladin,retribution,12,7,5
Amatar,ravencrest,671,paladin,retribution,12,7,5
Paladøs,thrall,671,paladin,retribution,12,7,5
Vultrix,tarren-mill,671,paladin,retribution,12,7,5
Retzzo,ravencrest,671,paladin,retribution,12,7,5
Gbejr,xavius,671,paladin,retribution,12,7,5
Granadir,doomhammer,671,paladin,retribution,12,7,5
Sakred,hellscream,671,paladin,retribution,12,7,5
Mýv,archimonde,671,paladin,retribution,12,7,5
Gigaqueenie,karazhan,671,paladin,retribution,12,7,5
Isotun,kazzak,671,paladin,retribution,12,7,5
Раикерс,gordunni,671,paladin,retribution,12,7,5
Архемор,ashenvale,671,paladin,retribution,12,7,5
Liamisi,blackhand,671,paladin,retribution,12,7,5
Lightbinders,ragnaros,671,paladin,retribution,12,7,5
Odregon,draenor,671,paladin,retribution,12,7,5
Gavain,blackhand,671,paladin,retribution,12,7,5
Roskof,archimonde,671,paladin,retribution,12,7,5
Infería,blackhand,671,paladin,retribution,15,8,7
Arator,terenas,671,paladin,retribution,16,8,8
Тешеус,gordunni,671,paladin,retribution,17,7,10
Tunaonion,draenor,671,paladin,retribution,18,7,11
Zeturius,draenor,671,paladin,retribution,18,7,11
Erethes,magtheridon,671,paladin,retribution,18,7,11
Allepro,bronze-dragonflight,671,paladin,retribution,18,7,11
Divinetoll,argent-dawn,671,paladin,retribution,18,7,11
Uhtrèd,turalyon,671,paladin,retribution,18,7,11
Testovasara,ravencrest,671,paladin,retribution,18,7,11
Alvíss,sanguino,671,paladin,retribution,18,7,11
Cameron,taerar,671,paladin,retribution,18,7,11
Laenira,nemesis,671,paladin,retribution,18,7,11
Laethor,aerie-peak,671,paladin,retribution,18,7,11
Necadin,ravencrest,671,paladin,retribution,18,7,11
Patrice,blutkessel,671,paladin,retribution,18,7,11
Darkenkel,kazzak,671,paladin,retribution,18,7,11
Sàtos,hyjal,671,paladin,retribution,18,7,11
Grzegzolnik,twisting-nether,671,paladin,retribution,18,7,11
Konori,mannoroth,671,paladin,retribution,18,7,11
Рогафайти,goldrinn,671,paladin,retribution,18,7,11
Ardalìon,archimonde,671,paladin,retribution,18,7,11
Nézuko,frostwhisper,671,paladin,retribution,18,7,11
Tuutti,sylvanas,671,paladin,retribution,18,7,11
Qtek,draenor,671,paladin,retribution,18,7,11
Danierrs,burning-legion,671,paladin,retribution,18,7,11
Äggmackor,ravencrest,671,paladin,retribution,18,7,11
Öbedö,malganis,671,paladin,retribution,24,7,17
Zyklôn,antonidas,671,paladin,retribution,30,7,23
Onestone,wrathbringer,671,paladin,retribution,30,7,23
Quelthemar,stormscale,671,paladin,retribution,30,7,23
Grozdanus,ravencrest,670,paladin,retribution,12,7,5
Retxmode,ravencrest,670,paladin,retribution,12,7,5
Låncelot,sylvanas,670,paladin,retribution,12,7,5
Edb,silvermoon,670,paladin,retribution,12,7,5
Dalaly,kazzak,670,paladin,retribution,18,7,11
Thandoro,amanthul,670,paladin,retribution,18,7,11
Ракнапали,gordunni,670,paladin,retribution,18,7,11
Halldòr,ravencrest,670,paladin,retribution,24,7,17
Greifenstein,rexxar,670,paladin,retribution,24,7,17
Holyshd,stormscale,670,paladin,retribution,24,7,17
Babajõ,twisting-nether,669,paladin,retribution,12,7,5
Baymanda,tarren-mill,669,paladin,retribution,18,7,11
Nuvadaima,kazzak,669,paladin,retribution,24,7,17
Palafis,doomhammer,669,paladin,retribution,24,7,17
Гёрди,fordragon,668,paladin,retribution,13,7,6
Cirk,sylvanas,668,paladin,retribution,18,7,11
Ibus,silvermoon,668,paladin,retribution,18,7,11
Blagith,aggramar,668,paladin,retribution,18,7,11
Tobebryant,eonar,667,paladin,retribution,12,7,5
Shennzo,wildhammer,667,paladin,retribution,12,7,5
Megara,bronze-dragonflight,667,paladin,retribution,12,7,5
Willmasmashn,blackmoore,667,paladin,retribution,18,7,11
Cúraga,ravencrest,667,paladin,retribution,24,7,17
Bedrock,kirin-tor,666,paladin,retribution,12,7,5
Ксинем,howling-fjord,666,paladin,retribution,16,8,8
Paladinslaye,dun-modr,666,paladin,retribution,30,7,23
Kentarø,eldrethalas,665,paladin,retribution,12,7,5
Milfaddicted,aggra-português,665,paladin,retribution,18,7,11
Malzj,garrosh,664,paladin,retribution,12,7,5
Zealotic,doomhammer,664,paladin,retribution,12,7,5
Chikaz,archimonde,664,paladin,retribution,20,10,10
Halimox,terokkar,664,paladin,retribution,18,7,11
Blinklys,ragnaros,664,paladin,retribution,18,7,11
Schmetterlin,aszune,664,paladin,retribution,24,7,17
Nhum,destromath,663,paladin,retribution,18,7,11
Purpledurple,twisting-nether,663,paladin,retribution,18,7,11
Роклэс,gordunni,662,paladin,retribution,12,7,5
Sarinise,draenor,662,paladin,retribution,12,7,5
Thebøss,blackmoore,662,paladin,retribution,18,7,11
Belzed,draenor,660,paladin,retribution,15,8,7
Helm,emerald-dream,658,paladin,retribution,36,7,29
Purpleháze,drekthar,656,paladin,retribution,90,42,48
Izri,hellscream,655,paladin,retribution,18,7,11
Ядб,gordunni,655,paladin,retribution,18,7,11
Bogrács,silvermoon,655,paladin,retribution,23,7,16
Hegolas,terrordar,649,paladin,retribution,35,7,28
Mariaremarc,silvermoon,648,paladin,retribution,27,9,18
Shawn,archimonde,640,paladin,retribution,16,7,9
Gfugh,shadowsong,639,paladin,retribution,11,7,4
Саймэл,soulflayer,639,paladin,retribution,16,7,9
Breezpal,twisting-nether,639,paladin,retribution,17,7,10
Suri,shattrath,637,paladin,retribution,16,8,8
Bellight,sinstralis,634,paladin,retribution,25,7,18
Samànta,nemesis,623,paladin,retribution,11,7,4
Нимбоо,soulflayer,623,paladin,retribution,17,7,10
Эвони,gordunni,623,paladin,retribution,17,7,10
Gwynbleyd,twisting-nether,622,paladin,retribution,11,7,4
Belapala,tarren-mill,622,paladin,retribution,17,7,10
Nybrash,sanguino,620,paladin,retribution,15,7,8
Séphiran,hyjal,618,paladin,retribution,15,9,6
Goofyaf,ravencrest,618,paladin,retribution,16,9,7
Narkománen,shattered-hand,618,paladin,retribution,16,9,7
Ванпатчедчмо,soulflayer,618,paladin,retribution,22,8,14
Alïstia,archimonde,618,paladin,retribution,31,9,22
Trevarie,twisting-nether,617,paladin,retribution,24,10,14
Pelbo,ravencrest,617,paladin,retribution,21,8,13
Ренегадер,thermaplugg,615,paladin,retribution,12,8,4
Shrelia,eredar,615,paladin,retribution,21,9,12
Няшка,azuregos,615,paladin,retribution,19,8,11
Stonebeard,ahnqiraj,613,paladin,retribution,31,8,23
Zygerpal,outland,608,paladin,retribution,10,7,3
Ярлд,gordunni,607,paladin,retribution,17,7,10
Kicksnare,drakthul,607,paladin,retribution,17,7,10
Leouric,argent-dawn,607,paladin,retribution,20,7,13
Lightswrath,thunderhorn,606,paladin,retribution,12,7,5
Jockker,sinstralis,606,paladin,retribution,19,8,11
Mysticlight,sylvanas,602,paladin,retribution,22,10,12
Rockymarcian,hyjal,597,paladin,retribution,22,7,15
Teksor,frostmourne,592,paladin,retribution,19,7,12
Enoh,the-maelstrom,590,paladin,retribution,16,7,9
Piiskaaja,argent-dawn,576,paladin,retribution,6,6,0
Кенриэль,howling-fjord,576,paladin,retribution,6,6,0
Jeffreyz,twisting-nether,576,paladin,retribution,6,6,0
Toffíczq,burning-legion,576,paladin,retribution,6,6,0
Punis,aszune,576,paladin,retribution,6,6,0
Наладчикк,howling-fjord,576,paladin,retribution,12,6,6
Båbyløn,outland,576,paladin,retribution,12,6,6
Plainrage,blackrock,576,paladin,retribution,12,6,6
Nouhada,archimonde,576,paladin,retribution,12,6,6
Rözum,burning-legion,576,paladin,retribution,12,6,6
Cilodin,blackrock,576,paladin,retribution,12,6,6
Ауди,howling-fjord,576,paladin,retribution,12,6,6
Tamarian,frostwhisper,576,paladin,retribution,12,6,6
Cildan,talnivarr,576,paladin,retribution,12,6,6
Éllé,der-rat-von-dalaran,576,paladin,retribution,12,6,6
Сэдриш,howling-fjord,576,paladin,retribution,12,6,6
Retqt,eredar,576,paladin,retribution,12,6,6
Moossolin,tarren-mill,576,paladin,retribution,12,6,6
Skengdaddy,ragnaros,576,paladin,retribution,12,6,6
Иомос,soulflayer,576,paladin,retribution,12,6,6
Gothec,darksorrow,576,paladin,retribution,12,6,6
Vandergrift,archimonde,576,paladin,retribution,12,6,6
Vysavo,draenor,576,paladin,retribution,12,6,6
Mouncake,archimonde,576,paladin,retribution,12,6,6
Drekio,blackrock,576,paladin,retribution,12,6,6
Beyonze,ravencrest,576,paladin,retribution,12,6,6
Miridien,burning-steppes,576,paladin,retribution,12,6,6
Stève,ravencrest,576,paladin,retribution,12,6,6
Gerard,blackmoore,576,paladin,retribution,12,6,6
Tereth,kazzak,576,paladin,retribution,12,6,6
Alciera,silvermoon,576,paladin,retribution,12,6,6
Seothor,argent-dawn,576,paladin,retribution,12,6,6
Yurinovsky,aggra-português,576,paladin,retribution,12,6,6
Shockadiin,grim-batol,576,paladin,retribution,12,6,6
Arilend,grim-batol,576,paladin,retribution,12,6,6
Рамстафарай,gordunni,576,paladin,retribution,12,6,6
Holyshêêt,draenor,576,paladin,retribution,12,6,6
Wishram,frostmane,576,paladin,retribution,12,6,6
Mingyao,sanguino,576,paladin,retribution,12,6,6
Ashery,elune,576,paladin,retribution,12,6,6
Vuutnëx,twisting-nether,576,paladin,retribution,12,6,6
Таймкил,gordunni,576,paladin,retribution,12,6,6
Iamdurumrush,outland,576,paladin,retribution,12,6,6
Akcope,thunderhorn,576,paladin,retribution,12,6,6
Drdax,wildhammer,576,paladin,retribution,12,6,6
Aldio,pozzo-delleternità,576,paladin,retribution,12,6,6
Texxi,blackrock,576,paladin,retribution,12,6,6
Керантий,gordunni,576,paladin,retribution,12,6,6
Hølyspit,nemesis,576,paladin,retribution,12,6,6
Crusxder,kazzak,576,paladin,retribution,12,6,6
Sureklunker,silvermoon,576,paladin,retribution,12,6,6
Alekks,silvermoon,576,paladin,retribution,12,6,6
Luciter,silvermoon,576,paladin,retribution,12,6,6
Госпелька,blackscar,576,paladin,retribution,12,6,6
Ðos,ravencrest,576,paladin,retribution,12,6,6
Pöm,khaz-modan,576,paladin,retribution,12,6,6
Gabrîel,sanguino,576,paladin,retribution,12,6,6
Argeltal,auchindoun,576,paladin,retribution,12,6,6
Palím,blackrock,576,paladin,retribution,12,6,6
Упругийтуз,gordunni,576,paladin,retribution,12,6,6
Escanør,anetheron,576,paladin,retribution,12,6,6
Raceper,the-maelstrom,576,paladin,retribution,12,6,6
Ineffable,dun-modr,576,paladin,retribution,12,6,6
Pabló,azshara,576,paladin,retribution,12,6,6
Kjellus,tarren-mill,576,paladin,retribution,12,6,6
Aalbringer,blackmoore,576,paladin,retribution,12,6,6
Milner,stormreaver,576,paladin,retribution,12,6,6
Rothus,bronze-dragonflight,576,paladin,retribution,12,6,6
Стифаний,booty-bay,576,paladin,retribution,12,6,6
Nesquikudder,kazzak,576,paladin,retribution,12,6,6
Бляля,gordunni,576,paladin,retribution,12,6,6
Palapix,tarren-mill,576,paladin,retribution,12,6,6
Käiser,shendralar,576,paladin,retribution,12,6,6
Elrondyl,magtheridon,576,paladin,retribution,12,6,6
Téralus,ravencrest,576,paladin,retribution,12,6,6
Paladoom,magtheridon,576,paladin,retribution,12,6,6
Зебхан,thermaplugg,576,paladin,retribution,12,6,6
Superieur,kazzak,576,paladin,retribution,12,6,6
Ashsmiley,kazzak,576,paladin,retribution,12,6,6
Kamaska,antonidas,576,paladin,retribution,12,6,6
Lévrone,alexstrasza,576,paladin,retribution,12,6,6
Udrik,proudmoore,576,paladin,retribution,12,6,6
Athoman,nagrand,576,paladin,retribution,12,6,6
Fixzz,ravencrest,576,paladin,retribution,12,6,6
Ultimatix,stormscale,576,paladin,retribution,12,6,6
Holyjugs,outland,576,paladin,retribution,12,6,6
Fâlli,hyjal,576,paladin,retribution,12,6,6
Hollypala,stormscale,576,paladin,retribution,12,6,6
Raleknrnr,hyjal,576,paladin,retribution,12,6,6
Vnti,outland,576,paladin,retribution,12,6,6
Waaynejudgeu,blackhand,576,paladin,retribution,12,6,6
Rokarón,blackhand,576,paladin,retribution,12,6,6
Tharduk,outland,576,paladin,retribution,12,6,6
Arsinel,blackhand,576,paladin,retribution,12,6,6
Aimee,draenor,576,paladin,retribution,16,7,9
Stooti,ragnaros,576,paladin,retribution,14,6,8
Teebxu,outland,576,paladin,retribution,18,6,12
Armion,stormscale,576,paladin,retribution,18,6,12
Bigfatpig,ravencrest,576,paladin,retribution,18,6,12
Генатрамбон,howling-fjord,576,paladin,retribution,18,6,12
Exfire,daggerspine,576,paladin,retribution,18,6,12
Topoholy,tarren-mill,576,paladin,retribution,18,6,12
Amadeo,genjuros,576,paladin,retribution,18,6,12
Keineshoe,argent-dawn,576,paladin,retribution,18,6,12
Czachadymii,defias-brotherhood,576,paladin,retribution,18,6,12
Bothways,stormscale,576,paladin,retribution,18,6,12
Galica,kazzak,576,paladin,retribution,18,6,12
Mâêdhrøsx,ravencrest,576,paladin,retribution,18,6,12
Bopstar,tarren-mill,576,paladin,retribution,18,6,12
Tödelbröt,eredar,576,paladin,retribution,18,6,12
Dunklerzwerg,the-maelstrom,576,paladin,retribution,18,6,12
Kelduril,draenor,576,paladin,retribution,18,6,12
Glorfindel,tarren-mill,576,paladin,retribution,18,6,12
Illythia,anachronos,576,paladin,retribution,18,6,12
Mîskine,archimonde,576,paladin,retribution,18,6,12
Mooderna,ravencrest,576,paladin,retribution,18,6,12
Retríciusz,ragnaros,576,paladin,retribution,18,6,12
Izelv,dalaran,576,paladin,retribution,18,6,12
Fortasec,aggra-português,576,paladin,retribution,18,6,12
Эрогот,gordunni,576,paladin,retribution,18,6,12
Goatmode,echsenkessel,576,paladin,retribution,18,6,12
Dyna,outland,576,paladin,retribution,18,6,12
Анфлераж,gordunni,576,paladin,retribution,18,6,12
Aleya,arathor,576,paladin,retribution,18,6,12
Séphïröth,cthun,576,paladin,retribution,18,6,12
Sonil,les-sentinelles,576,paladin,retribution,18,6,12
Aschenpuddl,blackmoore,576,paladin,retribution,18,6,12
Bierstierr,blackrock,576,paladin,retribution,18,6,12
Hiloqtpala,blackmoore,576,paladin,retribution,18,6,12
Wìndy,stormreaver,576,paladin,retribution,18,6,12
Byczorek,turalyon,576,paladin,retribution,18,6,12
Verix,thrall,576,paladin,retribution,18,6,12
Darkoo,hyjal,576,paladin,retribution,18,6,12
Meldø,drakthul,576,paladin,retribution,18,6,12
Esebenjamin,dun-modr,576,paladin,retribution,18,6,12
Cycodin,garrosh,576,paladin,retribution,18,6,12
Mozaiczna,burning-legion,576,paladin,retribution,18,6,12
Демопал,fordragon,576,paladin,retribution,18,6,12
Valzyffs,twisting-nether,576,paladin,retribution,18,6,12
Cpthøjaløt,eredar,576,paladin,retribution,18,6,12
Ironkra,stormscale,576,paladin,retribution,18,6,12
Obelliskapd,doomhammer,576,paladin,retribution,18,6,12
Phannelle,ysondre,576,paladin,retribution,18,6,12
Thickets,argent-dawn,576,paladin,retribution,18,6,12
Îshybî,archimonde,576,paladin,retribution,24,6,18
Mylilholy,twisting-nether,576,paladin,retribution,24,6,18
Lacrossé,kazzak,576,paladin,retribution,24,6,18
Mirihi,ungoro,576,paladin,retribution,24,6,18
Dëadlywish,zenedar,576,paladin,retribution,24,6,18
Vokesh,silvermoon,576,paladin,retribution,24,6,18
Berethas,darksorrow,575,paladin,retribution,6,6,0
Tehdark,outland,575,paladin,retribution,12,6,6
Phillipe,illidan,575,paladin,retribution,12,6,6
Eyebluee,tarren-mill,575,paladin,retribution,12,6,6
Yourholyness,darksorrow,575,paladin,retribution,12,6,6
Sæsh,die-aldor,575,paladin,retribution,12,6,6
Protson,burning-legion,575,paladin,retribution,12,6,6
Eldivin,hyjal,575,paladin,retribution,12,6,6
Retornot,silvermoon,575,paladin,retribution,12,6,6
Runeington,silvermoon,575,paladin,retribution,12,6,6
Scärlette,sargeras,575,paladin,retribution,12,6,6
Reliquiem,quelthalas,575,paladin,retribution,12,6,6
Тамплиир,gordunni,575,paladin,retribution,12,6,6
Poutoux,archimonde,575,paladin,retribution,12,6,6
Bcrp,ragnaros,575,paladin,retribution,12,6,6
Kendomendo,ravencrest,575,paladin,retribution,12,6,6
Helson,draenor,575,paladin,retribution,12,6,6
Rohb,blackmoore,575,paladin,retribution,12,6,6
Naxvrim,antonidas,575,paladin,retribution,12,6,6
Blazix,kazzak,575,paladin,retribution,12,6,6
Pewpews,twisting-nether,575,paladin,retribution,12,6,6
Greatme,frostmane,575,paladin,retribution,12,6,6
Phystos,culte-de-la-rive-noire,575,paladin,retribution,12,6,6
Vandorin,dun-morogh,575,paladin,retribution,12,6,6
Luxeliel,zuljin,575,paladin,retribution,12,6,6
Lightchick,outland,575,paladin,retribution,12,6,6
Illusio,defias-brotherhood,575,paladin,retribution,12,6,6
Andrõs,argent-dawn,575,paladin,retribution,15,7,8
Câlon,twisting-nether,575,paladin,retribution,18,6,12
Vhestas,dun-modr,575,paladin,retribution,18,6,12
Solcustos,tarren-mill,575,paladin,retribution,18,6,12
Szuberto,silvermoon,575,paladin,retribution,18,6,12
Pecar,stormscale,575,paladin,retribution,18,6,12
Héphàïstøs,dalaran,575,paladin,retribution,18,6,12
Palaska,hyjal,575,paladin,retribution,18,6,12
Ippex,silvermoon,575,paladin,retribution,18,6,12
Crsader,antonidas,575,paladin,retribution,18,6,12
Seriosman,grim-batol,575,paladin,retribution,18,6,12
Бритыйносок,grom,575,paladin,retribution,18,6,12
Ragonas,mannoroth,575,paladin,retribution,18,6,12
Pålegg,emerald-dream,575,paladin,retribution,18,6,12
Tjfsiroko,neptulon,575,paladin,retribution,27,7,20
Edathar,argent-dawn,575,paladin,retribution,24,6,18
Nelieltu,dragonmaw,574,paladin,retribution,12,6,6
Edons,exodar,574,paladin,retribution,12,6,6
Tyrandia,burning-legion,574,paladin,retribution,12,6,6
Roxian,burning-blade,574,paladin,retribution,12,6,6
Легионор,galakrond,574,paladin,retribution,12,6,6
Angelwings,nefarian,574,paladin,retribution,18,6,12
Humaladi,draenor,574,paladin,retribution,18,6,12
Serafini,doomhammer,574,paladin,retribution,18,6,12
Fuyúrí,burning-legion,574,paladin,retribution,24,6,18
Areiia,antonidas,574,paladin,retribution,24,6,18
Healbro,ravencrest,573,paladin,retribution,6,6,0
Nasrudan,ravenholdt,573,paladin,retribution,30,6,24
Sèrgàs,blackhand,573,paladin,retribution,30,6,24
Renalex,ravencrest,572,paladin,retribution,12,6,6
Munuin,silvermoon,572,paladin,retribution,18,6,12
Туларион,grom,572,paladin,retribution,18,6,12
Hrubo,drakthul,570,paladin,retribution,12,6,6
Elannor,sylvanas,569,paladin,retribution,12,6,6
Marcelinin,khaz-modan,569,paladin,retribution,33,7,26
Nicgr,nemesis,566,paladin,retribution,12,6,6
Vengryn,turalyon,566,paladin,retribution,37,8,29
Shendis,uldaman,565,paladin,retribution,12,6,6
Севенола,galakrond,565,paladin,retribution,18,6,12
Dunedaym,cthun,562,paladin,retribution,18,6,12
Иусто,howling-fjord,559,paladin,retribution,17,6,11
Ràwx,twisting-nether,559,paladin,retribution,23,6,17
Tofrus,kazzak,559,paladin,retribution,23,6,17
Кристус,galakrond,556,paladin,retribution,23,6,17
Élion,les-clairvoyants,543,paladin,retribution,11,6,5
Ceasaro,silvermoon,543,paladin,retribution,11,6,5
Ретроградий,howling-fjord,543,paladin,retribution,16,6,10
Darkliight,kazzak,542,paladin,retribution,14,7,7
Yornoc,argent-dawn,528,paladin,retribution,15,6,9
Optì,eredar,527,paladin,retribution,11,6,5
Droidlle,kult-der-verdammten,527,paladin,retribution,11,6,5
Ragunav,draenor,527,paladin,retribution,11,6,5
Kurasame,eredar,527,paladin,retribution,11,6,5
Methoss,ravencrest,527,paladin,retribution,25,7,18
Abellá,silvermoon,527,paladin,retribution,23,6,17
Brunhildd,blackrock,526,paladin,retribution,15,6,9
Theodun,xavius,524,paladin,retribution,17,6,11
Plsdøntusemd,ravencrest,522,paladin,retribution,17,8,9
Purrifire,sylvanas,522,paladin,retribution,16,7,9
Burzìk,draenor,522,paladin,retribution,19,7,12
Grafleopold,lothar,522,paladin,retribution,23,8,15
Митахо,gordunni,522,paladin,retribution,21,7,14
Тошши,soulflayer,522,paladin,retribution,28,8,20
Uriel,scarshield-legion,520,paladin,retribution,16,8,8
Bulladin,silvermoon,512,paladin,retribution,10,6,4
Babypic,ambossar,511,paladin,retribution,14,6,8
Faldrinx,hyjal,511,paladin,retribution,14,6,8
Selfix,silvermoon,509,paladin,retribution,28,6,22
Shinka,blutkessel,507,paladin,retribution,23,6,17
Prínce,earthen-ring,495,paladin,retribution,13,6,7
Dunksunk,draenor,494,paladin,retribution,19,6,13
Rallerexi,silvermoon,480,paladin,retribution,6,5,1
Tryggt,the-shatar,480,paladin,retribution,6,5,1
Feaná,silvermoon,480,paladin,retribution,6,5,1
Zigane,hyjal,480,paladin,retribution,6,5,1
Кеймордор,soulflayer,480,paladin,retribution,6,5,1
Ryven,stormscale,480,paladin,retribution,6,5,1
Zïons,hyjal,480,paladin,retribution,6,5,1
Hästits,dragonblight,480,paladin,retribution,6,5,1
Paradok,thrall,480,paladin,retribution,6,5,1
Voycetwo,frostwolf,480,paladin,retribution,6,5,1
Röland,sanguino,480,paladin,retribution,6,5,1
Budás,sanguino,480,paladin,retribution,6,5,1
Lezin,thrall,480,paladin,retribution,6,5,1
Daj,draenor,480,paladin,retribution,6,5,1
Тенькопыт,howling-fjord,480,paladin,retribution,6,5,1
Sossiqt,silvermoon,480,paladin,retribution,6,5,1
Matoxin,silvermoon,480,paladin,retribution,6,5,1
Yezitzme,blackrock,480,paladin,retribution,6,5,1
Mörkepisod,tarren-mill,480,paladin,retribution,6,5,1
Mclovinn,hyjal,480,paladin,retribution,6,5,1
Vickolaïvïs,dun-modr,480,paladin,retribution,6,5,1
Bountyrider,kazzak,480,paladin,retribution,6,5,1
Mkyorchev,quelthalas,480,paladin,retribution,6,5,1
Antajesús,thrall,480,paladin,retribution,6,5,1
Luzdosol,blackrock,480,paladin,retribution,6,5,1
Holyfatherr,draenor,480,paladin,retribution,6,5,1
Жидкийваля,blackscar,480,paladin,retribution,6,5,1
Taurantes,garona,480,paladin,retribution,6,5,1
Holypowerr,ragnaros,480,paladin,retribution,6,5,1
Ravnz,ragnaros,480,paladin,retribution,6,5,1
Sabríel,ragnaros,480,paladin,retribution,6,5,1
Yochi,sinstralis,480,paladin,retribution,6,5,1
Zûrry,arthas,480,paladin,retribution,6,5,1
Mlws,ravencrest,480,paladin,retribution,6,5,1
Dykron,rexxar,480,paladin,retribution,9,6,3
Ralphwiggum,stormrage,480,paladin,retribution,9,6,3
Ryanretnolds,stormscale,480,paladin,retribution,10,6,4
Petrzajonc,outland,480,paladin,retribution,12,5,7
Gambá,stormscale,480,paladin,retribution,12,5,7
Sìlver,conseil-des-ombres,480,paladin,retribution,12,5,7
Hatoms,hyjal,480,paladin,retribution,12,5,7
Crupth,outland,480,paladin,retribution,12,5,7
Zaopink,blackhand,480,paladin,retribution,12,5,7
Zanzito,hyjal,480,paladin,retribution,12,5,7
Quelly,das-syndikat,480,paladin,retribution,12,5,7
Emloses,outland,480,paladin,retribution,12,5,7
Ihté,ravencrest,480,paladin,retribution,12,5,7
Fotmfactory,stormscale,480,paladin,retribution,12,5,7
Mecah,hyjal,480,paladin,retribution,12,5,7
Bassutei,outland,480,paladin,retribution,12,5,7
Mikalia,aegwynn,480,paladin,retribution,12,5,7
Greckoe,blackhand,480,paladin,retribution,12,5,7
Chillmachine,stormscale,480,paladin,retribution,12,5,7
Samypalouf,naxxramas,480,paladin,retribution,12,5,7
Seráphím,ravencrest,480,paladin,retribution,12,5,7
Kylaz,die-ewige-wacht,480,paladin,retribution,12,5,7
Pawlouf,hyjal,480,paladin,retribution,12,5,7
Bloodpala,malganis,480,paladin,retribution,12,5,7
Гниленький,razuvious,480,paladin,retribution,12,5,7
Cølalight,aegwynn,480,paladin,retribution,12,5,7
Dêstî,silvermoon,480,paladin,retribution,12,5,7
Partolina,twisting-nether,480,paladin,retribution,12,5,7
Deathseekerv,saurfang,480,paladin,retribution,12,5,7
Smygelicous,ragnaros,480,paladin,retribution,12,5,7
Holysznajt,burning-legion,480,paladin,retribution,12,5,7
Bascelik,outland,480,paladin,retribution,12,5,7
Рукибудды,soulflayer,480,paladin,retribution,12,5,7
Althread,silvermoon,480,paladin,retribution,12,5,7
Crusades,arathor,480,paladin,retribution,12,5,7
Optimes,blackmoore,480,paladin,retribution,12,5,7
Blazkowicz,twisting-nether,480,paladin,retribution,12,5,7
Zetnic,kazzak,480,paladin,retribution,12,5,7
Danielbróck,argent-dawn,480,paladin,retribution,12,5,7
Ðesolace,twisting-nether,480,paladin,retribution,12,5,7
Docoùla,twisting-nether,480,paladin,retribution,12,5,7
Himèji,pozzo-delleternità,480,paladin,retribution,12,5,7
Yuvile,destromath,480,paladin,retribution,12,5,7
Ozen,blackrock,480,paladin,retribution,12,5,7
Shanderhilo,pozzo-delleternità,480,paladin,retribution,12,5,7
Naïpah,archimonde,480,paladin,retribution,12,5,7
Deadpala,twisting-nether,480,paladin,retribution,12,5,7
Pallajalla,the-maelstrom,480,paladin,retribution,12,5,7
Evohammer,silvermoon,480,paladin,retribution,12,5,7
Eldhana,archimonde,480,paladin,retribution,12,5,7
Lyan,archimonde,480,paladin,retribution,12,5,7
Боремир,borean-tundra,480,paladin,retribution,12,5,7
Miøura,medivh,480,paladin,retribution,12,5,7
Paldarius,thrall,480,paladin,retribution,12,5,7
Héphäistos,silvermoon,480,paladin,retribution,12,5,7
Retzrik,kazzak,480,paladin,retribution,12,5,7
Hifyve,kazzak,480,paladin,retribution,12,5,7
Обиронн,howling-fjord,480,paladin,retribution,12,5,7
Takálus,eredar,480,paladin,retribution,12,5,7
Greebless,draenor,480,paladin,retribution,12,5,7
Ksama,ysondre,480,paladin,retribution,12,5,7
Kaähz,archimonde,480,paladin,retribution,12,5,7
Бортовский,ashenvale,480,paladin,retribution,12,5,7
Ichessepopel,blackrock,480,paladin,retribution,12,5,7
Heihåå,ravencrest,480,paladin,retribution,12,5,7
Melrov,twisting-nether,480,paladin,retribution,12,5,7
Karatus,ravencrest,480,paladin,retribution,12,5,7
Timias,silvermoon,480,paladin,retribution,12,5,7
Ньюфи,deathguard,480,paladin,retribution,12,5,7
Tiduqt,antonidas,480,paladin,retribution,12,5,7
Bvrlyhills,blackrock,480,paladin,retribution,12,5,7
Goofyret,ravencrest,480,paladin,retribution,12,5,7
Mikank,dun-modr,480,paladin,retribution,12,5,7
Fotoniy,kazzak,480,paladin,retribution,12,5,7
Høj,archimonde,480,paladin,retribution,12,5,7
Malakbel,ragnaros,480,paladin,retribution,12,5,7
Muúh,arthas,480,paladin,retribution,12,5,7
Ironhïde,defias-brotherhood,480,paladin,retribution,12,5,7
Purplepotato,tarren-mill,480,paladin,retribution,12,5,7
Oldo,eredar,480,paladin,retribution,12,5,7
Shirts,ravencrest,480,paladin,retribution,12,5,7
Роллерблэйд,gordunni,480,paladin,retribution,12,5,7
Soupra,silvermoon,480,paladin,retribution,12,5,7
Нойззмс,gordunni,480,paladin,retribution,12,5,7
Syjinora,teldrassil,480,paladin,retribution,12,5,7
Bootysmasher,silvermoon,480,paladin,retribution,12,5,7
Хам,razuvious,480,paladin,retribution,12,5,7
Arakir,ragnaros,480,paladin,retribution,12,5,7
Milenia,nemesis,480,paladin,retribution,12,5,7
Truman,draenor,480,paladin,retribution,12,5,7
Equityy,burning-legion,480,paladin,retribution,12,5,7
Ericsa,madmortem,480,paladin,retribution,12,5,7
Тирианн,gordunni,480,paladin,retribution,12,5,7
Маллинка,blackscar,480,paladin,retribution,12,5,7
Cêa,blackrock,480,paladin,retribution,12,5,7
Retina,antonidas,480,paladin,retribution,12,5,7
Trixiee,twisting-nether,480,paladin,retribution,12,5,7
Èternus,blackmoore,480,paladin,retribution,12,5,7
Vladium,argent-dawn,480,paladin,retribution,12,5,7
Valintor,burning-legion,480,paladin,retribution,12,5,7
Harakiri,kargath,480,paladin,retribution,12,5,7
Poporfour,archimonde,480,paladin,retribution,12,5,7
Clubpaladin,kazzak,480,paladin,retribution,12,5,7
Palá,dun-modr,480,paladin,retribution,12,5,7
Mailamasa,frostwhisper,480,paladin,retribution,12,5,7
Skølir,rashgarroth,480,paladin,retribution,12,5,7
Ðelusion,sanguino,480,paladin,retribution,12,5,7
Mauly,kazzak,480,paladin,retribution,12,5,7
Valonforth,magtheridon,480,paladin,retribution,12,5,7
Zynk,magtheridon,480,paladin,retribution,12,5,7
Ðarcy,ravencrest,480,paladin,retribution,12,5,7
Eisenbiaga,blackmoore,480,paladin,retribution,12,5,7
Strangerx,blackrock,480,paladin,retribution,12,5,7
Instaraid,blackmoore,480,paladin,retribution,12,5,7
Сладупся,gordunni,480,paladin,retribution,12,5,7
Скидульф,blackscar,480,paladin,retribution,12,5,7
Ascendeadqt,kazzak,480,paladin,retribution,12,5,7
Минорусс,gordunni,480,paladin,retribution,12,5,7
Ашурыч,gordunni,480,paladin,retribution,12,5,7
Ampersand,ravencrest,480,paladin,retribution,12,5,7
Scörpia,sanguino,480,paladin,retribution,12,5,7
Пашштет,gordunni,480,paladin,retribution,12,5,7
Scoobywooby,sanguino,480,paladin,retribution,12,5,7
Prd,grim-batol,480,paladin,retribution,12,5,7
Karabas,thrall,480,paladin,retribution,12,5,7
Palafrugell,sanguino,480,paladin,retribution,12,5,7
Holyrock,grim-batol,480,paladin,retribution,12,5,7
Ðraugÿr,kazzak,480,paladin,retribution,12,5,7
Pompée,dalaran,480,paladin,retribution,12,5,7
Heile,silvermoon,480,paladin,retribution,12,5,7
Aresian,burning-legion,480,paladin,retribution,13,5,8
Buddala,aerie-peak,480,paladin,retribution,14,5,9
Coome,argent-dawn,480,paladin,retribution,17,5,12
Светочпок,howling-fjord,480,paladin,retribution,18,5,13
Cøctab,kirin-tor,480,paladin,retribution,18,5,13
Зеппели,gordunni,480,paladin,retribution,18,5,13
Gahar,grim-batol,480,paladin,retribution,18,5,13
Teronk,terokkar,480,paladin,retribution,18,5,13
Diggs,draenor,480,paladin,retribution,18,5,13
Ywrow,burning-blade,480,paladin,retribution,18,5,13
Wrathènal,darksorrow,480,paladin,retribution,18,5,13
Maravena,nazjatar,480,paladin,retribution,18,5,13
Ijego,silvermoon,480,paladin,retribution,18,5,13
Lionie,grim-batol,480,paladin,retribution,18,5,13
Мэркес,fordragon,480,paladin,retribution,18,5,13
Xiuya,dun-modr,480,paladin,retribution,18,5,13
Копранесса,soulflayer,480,paladin,retribution,18,5,13
Meriween,ravencrest,480,paladin,retribution,18,5,13
Adevald,silvermoon,480,paladin,retribution,18,5,13
Onedayplay,blackmoore,480,paladin,retribution,18,5,13
Turbopal,burning-blade,480,paladin,retribution,18,5,13
Fatalism,draenor,480,paladin,retribution,18,5,13
Бладриус,howling-fjord,480,paladin,retribution,18,5,13
Spouny,archimonde,480,paladin,retribution,18,5,13
Eîon,argent-dawn,480,paladin,retribution,18,5,13
Trainors,chamber-of-aspects,480,paladin,retribution,18,5,13
Pyhätkonstit,twisting-nether,480,paladin,retribution,18,5,13
Shassera,ravencrest,480,paladin,retribution,18,5,13
Bildaum,pozzo-delleternità,480,paladin,retribution,18,5,13
Roshtrade,stormscale,480,paladin,retribution,18,5,13
Babyboink,kazzak,480,paladin,retribution,18,5,13
Skemfar,sanguino,480,paladin,retribution,24,5,19
Anaùtra,twisting-nether,480,paladin,retribution,24,5,19
Cadearas,antonidas,480,paladin,retribution,24,5,19
Exobyte,stormscale,480,paladin,retribution,24,5,19
Daskel,sanguino,480,paladin,retribution,24,5,19
Shuiwang,outland,480,paladin,retribution,24,5,19
Korgant,burning-legion,480,paladin,retribution,30,5,25
Phlek,drakthul,479,paladin,retribution,6,5,1
Amediell,silvermoon,479,paladin,retribution,6,5,1
Necroz,madmortem,479,paladin,retribution,6,5,1
Nosliw,frostwolf,479,paladin,retribution,6,5,1
Майнстер,gordunni,479,paladin,retribution,12,5,7
Missti,azjolnerub,479,paladin,retribution,12,5,7
Bakasnoop,hyjal,479,paladin,retribution,12,5,7
Zelenskiy,ravencrest,479,paladin,retribution,12,5,7
Bullser,anubarak,479,paladin,retribution,12,5,7
Grannybash,silvermoon,479,paladin,retribution,12,5,7
Solyra,blackhand,479,paladin,retribution,12,5,7
Dykopala,doomhammer,479,paladin,retribution,12,5,7
Hadthur,ragnaros,479,paladin,retribution,12,5,7
Tomforøl,aggramar,479,paladin,retribution,12,5,7
Rettarded,draenor,479,paladin,retribution,12,5,7
Subzerox,ravenholdt,479,paladin,retribution,12,5,7
Taffz,burning-legion,479,paladin,retribution,12,5,7
Brammers,doomhammer,479,paladin,retribution,12,5,7
Lightsblood,outland,479,paladin,retribution,12,5,7
Brutalpvper,argent-dawn,479,paladin,retribution,12,5,7
Сасмен,blackscar,479,paladin,retribution,12,5,7
Aion,chamber-of-aspects,479,paladin,retribution,18,5,13
Aelaris,dunemaul,479,paladin,retribution,18,5,13
Eriesh,cthun,479,paladin,retribution,18,5,13
Azhodiir,the-maelstrom,479,paladin,retribution,24,5,19
Klumie,silvermoon,479,paladin,retribution,24,5,19
Holydaybro,doomhammer,478,paladin,retribution,12,5,7
Bokadin,twisting-nether,478,paladin,retribution,12,5,7
Mirelaw,drakthul,478,paladin,retribution,12,5,7
Aluken,nemesis,478,paladin,retribution,12,5,7
Shrékhead,hellfire,478,paladin,retribution,12,5,7
Bloodfaith,arthas,478,paladin,retribution,18,5,13
Holyfriend,kazzak,478,paladin,retribution,18,5,13
Четкийчервь,soulflayer,478,paladin,retribution,18,5,13
Luminix,ragnaros,477,paladin,retribution,12,5,7
Chofre,thunderhorn,477,paladin,retribution,18,5,13
Zantria,alleria,476,paladin,retribution,12,5,7
Magott,doomhammer,475,paladin,retribution,12,5,7
Lysân,eredar,475,paladin,retribution,12,5,7
ßell,antonidas,475,paladin,retribution,12,5,7
Palabrïsa,sanguino,474,paladin,retribution,15,6,9
Parkla,twisting-nether,473,paladin,retribution,12,5,7
Корвинхорн,soulflayer,473,paladin,retribution,24,8,16
Hateze,kazzak,472,paladin,retribution,12,5,7
Yeretria,krasus,472,paladin,retribution,12,5,7
Yeohinyiu,khaz-modan,472,paladin,retribution,12,5,7
Stunheallol,blackrock,448,paladin,retribution,10,5,5
Чиленикс,soulflayer,447,paladin,retribution,8,6,2
Slayton,twisting-nether,447,paladin,retribution,11,5,6
Гкм,howling-fjord,447,paladin,retribution,11,5,6
Sacro,quelthalas,447,paladin,retribution,11,5,6
Seirén,grim-batol,447,paladin,retribution,11,5,6
Kevlar,frostmane,446,paladin,retribution,18,6,12
Ironyman,the-maelstrom,432,paladin,retribution,9,6,3
Kyeleen,shendralar,432,paladin,retribution,9,6,3
Emîly,blackrock,432,paladin,retribution,15,5,10
Åvra,ysondre,432,paladin,retribution,15,5,10
Sunnyboy,tarren-mill,431,paladin,retribution,11,5,6
Siirrinna,tarren-mill,426,paladin,retribution,12,6,6
Бэнсон,ashenvale,426,paladin,retribution,15,6,9
Sunzi,alakir,426,paladin,retribution,20,7,13
Mipendz,draenor,426,paladin,retribution,22,6,16
Buzzii,blackhand,424,paladin,retribution,15,6,9
Zell,silvermoon,414,paladin,retribution,16,5,11
Kûlu,alakir,410,paladin,retribution,10,5,5
Паланр,fordragon,400,paladin,retribution,7,5,2
Zouppis,ravencrest,400,paladin,retribution,7,5,2
Menikeas,quelthalas,400,paladin,retribution,13,5,8
Панзурджи,gordunni,398,paladin,retribution,13,6,7
Pilowpallo,kazzak,398,paladin,retribution,13,5,8
Célésté,ravencrest,393,paladin,retribution,16,7,9
Brothër,archimonde,384,paladin,retribution,9,6,3
Phiana,blackmoore,384,paladin,retribution,6,4,2
Spartacøn,kazzak,384,paladin,retribution,6,4,2
Neuz,minahonda,384,paladin,retribution,6,4,2
Daddyolimpp,kazzak,384,paladin,retribution,6,4,2
Raratina,draenor,384,paladin,retribution,6,4,2
Unhittable,draenor,384,paladin,retribution,6,4,2
Shevøçk,ravencrest,384,paladin,retribution,6,4,2
Gunnhilde,stormscale,384,paladin,retribution,6,4,2
Æmiø,blackmoore,384,paladin,retribution,6,4,2
Хегр,soulflayer,384,paladin,retribution,6,4,2
Chobb,thunderhorn,384,paladin,retribution,6,4,2
Jaime,magtheridon,384,paladin,retribution,6,4,2
Судья,greymane,384,paladin,retribution,6,4,2
Позабытый,deathweaver,384,paladin,retribution,6,4,2
Madarä,arathi,384,paladin,retribution,6,4,2
Aprânax,twisting-nether,384,paladin,retribution,6,4,2
Eorzea,auchindoun,384,paladin,retribution,6,4,2
Jamzypaladin,kazzak,384,paladin,retribution,6,4,2
Унаги,borean-tundra,384,paladin,retribution,6,4,2
Haldeimau,argent-dawn,384,paladin,retribution,6,4,2
Zùlka,krasus,384,paladin,retribution,6,4,2
Putïn,kazzak,384,paladin,retribution,6,4,2
Клэйсонгодхх,gordunni,384,paladin,retribution,6,4,2
Tegor,sylvanas,384,paladin,retribution,6,4,2
Diviticus,kazzak,384,paladin,retribution,6,4,2
Elenia,baelgun,384,paladin,retribution,6,4,2
Любитель,azuregos,384,paladin,retribution,6,4,2
Veléxis,outland,384,paladin,retribution,6,4,2
Holyret,blackhand,384,paladin,retribution,6,4,2
Blessingtits,sylvanas,384,paladin,retribution,6,4,2
Лиадринель,howling-fjord,384,paladin,retribution,6,4,2
Oriath,draenor,384,paladin,retribution,6,4,2
Arcillus,stormscale,384,paladin,retribution,6,4,2
Brendon,aegwynn,384,paladin,retribution,6,4,2
Ballefrikase,tarren-mill,384,paladin,retribution,6,4,2
Firfiris,twisting-nether,384,paladin,retribution,6,4,2
Бабичпал,soulflayer,384,paladin,retribution,6,4,2
Heatace,blackrock,384,paladin,retribution,6,4,2
Rektardin,quelthalas,384,paladin,retribution,6,4,2
Âmroth,blackrock,384,paladin,retribution,6,4,2
Naweed,kazzak,384,paladin,retribution,6,4,2
Paínzy,blackmoore,384,paladin,retribution,6,4,2
Morgoth,daggerspine,384,paladin,retribution,6,4,2
Kkrrh,kragjin,384,paladin,retribution,6,4,2
Nastyowner,twisting-nether,384,paladin,retribution,6,4,2
Gérin,blackmoore,384,paladin,retribution,6,4,2
Zhàø,ysondre,384,paladin,retribution,6,4,2
Missmyhoj,archimonde,384,paladin,retribution,6,4,2
Égi,azshara,384,paladin,retribution,6,4,2
Zeportpala,archimonde,384,paladin,retribution,6,4,2
Cake,alakir,384,paladin,retribution,6,4,2
Tyarel,aegwynn,384,paladin,retribution,6,4,2
Idin,nemesis,384,paladin,retribution,6,4,2
Grymä,archimonde,384,paladin,retribution,6,4,2
Nezgrôs,hyjal,384,paladin,retribution,6,4,2
Marmotaxx,dun-modr,384,paladin,retribution,6,4,2
Джиблэйд,gordunni,384,paladin,retribution,6,4,2
Кукусяшка,gordunni,384,paladin,retribution,6,4,2
Toratoratora,blackmoore,384,paladin,retribution,6,4,2
Lightmachine,kirin-tor,384,paladin,retribution,6,4,2
Yasuö,argent-dawn,384,paladin,retribution,6,4,2
Naizem,dun-modr,384,paladin,retribution,6,4,2
Naaruda,kazzak,384,paladin,retribution,6,4,2
Buffoon,twisting-nether,384,paladin,retribution,6,4,2
Keem,aszune,384,paladin,retribution,6,4,2
Dragongîrl,lothar,384,paladin,retribution,6,4,2
Doubleweed,blackmoore,384,paladin,retribution,6,4,2
Miskok,twisting-nether,384,paladin,retribution,6,4,2
Elwenepal,archimonde,384,paladin,retribution,6,4,2
Evilash,dun-modr,384,paladin,retribution,6,4,2
Zeggayoda,nemesis,384,paladin,retribution,6,4,2
Sukársugár,silvermoon,384,paladin,retribution,6,4,2
Malaquè,blackrock,384,paladin,retribution,6,4,2
Whiteflash,archimonde,384,paladin,retribution,6,4,2
Haudrupp,blackmoore,384,paladin,retribution,6,4,2
Virdis,tarren-mill,384,paladin,retribution,6,4,2
Bearwlkn,ravencrest,384,paladin,retribution,6,4,2
Referee,blackrock,384,paladin,retribution,6,4,2
Фоггихохо,gordunni,384,paladin,retribution,6,4,2
Соргосош,gordunni,384,paladin,retribution,6,4,2
Tritôn,draenor,384,paladin,retribution,6,4,2
Judercy,kaelthas,384,paladin,retribution,6,4,2
Raek,stormscale,384,paladin,retribution,6,4,2
Synnas,hyjal,384,paladin,retribution,6,4,2
Фаналайз,soulflayer,384,paladin,retribution,6,4,2
Léona,hyjal,384,paladin,retribution,6,4,2
Kzydi,zuljin,384,paladin,retribution,6,4,2
Malcolmx,sanguino,384,paladin,retribution,6,4,2
Sabriaña,silvermoon,384,paladin,retribution,6,4,2
Tauràdin,blackhand,384,paladin,retribution,6,4,2
Thrillhouse,dun-morogh,384,paladin,retribution,6,4,2
Baradus,ragnaros,384,paladin,retribution,6,4,2
Вечновтильте,howling-fjord,384,paladin,retribution,6,4,2
Windtwoo,tarren-mill,384,paladin,retribution,6,4,2
Shadoopala,silvermoon,384,paladin,retribution,6,4,2
Qouart,antonidas,384,paladin,retribution,6,4,2
Axpala,ragnaros,384,paladin,retribution,6,4,2
Peacekeep,stormscale,384,paladin,retribution,6,4,2
Morlune,kazzak,384,paladin,retribution,6,4,2
Támìndòr,alleria,384,paladin,retribution,6,4,2
Thøræ,dalaran,384,paladin,retribution,6,4,2
Kraco,tarren-mill,384,paladin,retribution,6,4,2
Colpadeltank,kazzak,384,paladin,retribution,6,4,2
Tigurius,zuljin,384,paladin,retribution,6,4,2
Wiither,argent-dawn,384,paladin,retribution,6,4,2
Sunstrider,quelthalas,384,paladin,retribution,6,4,2
Slowjob,eredar,384,paladin,retribution,6,4,2
Lightbreak,quelthalas,384,paladin,retribution,6,4,2
Diran,sanguino,384,paladin,retribution,6,4,2
Rölfchen,frostwolf,384,paladin,retribution,6,4,2
Gotrehk,nemesis,384,paladin,retribution,6,4,2
Akamis,drakthul,384,paladin,retribution,6,4,2
Knobgreaser,silvermoon,384,paladin,retribution,6,4,2
Tigér,ravencrest,384,paladin,retribution,6,4,2
Palatitude,archimonde,384,paladin,retribution,6,4,2
Mariahuana,sanguino,384,paladin,retribution,6,4,2
Zoddz,zuljin,384,paladin,retribution,6,4,2
Драгмитухел,gordunni,384,paladin,retribution,6,4,2
Ashengelm,silvermoon,384,paladin,retribution,9,5,4
Vondab,ravencrest,384,paladin,retribution,10,5,5
Slerick,silvermoon,384,paladin,retribution,10,5,5
Erebir,burning-blade,384,paladin,retribution,11,4,7
Palnox,blackrock,384,paladin,retribution,11,4,7
Хилвкд,blackscar,384,paladin,retribution,11,4,7
Athênâ,azjolnerub,384,paladin,retribution,15,5,10
Palapaye,archimonde,384,paladin,retribution,12,4,8
Isyllë,dalaran,384,paladin,retribution,12,4,8
Dishla,stormscale,384,paladin,retribution,12,4,8
Рокстум,gordunni,384,paladin,retribution,12,4,8
Decroma,dalaran,384,paladin,retribution,12,4,8
Эвирглайт,gordunni,384,paladin,retribution,12,4,8
Drugin,amanthul,384,paladin,retribution,12,4,8
Highcrown,argent-dawn,384,paladin,retribution,12,4,8
Nicolae,saurfang,384,paladin,retribution,12,4,8
Зираэлис,gordunni,384,paladin,retribution,12,4,8
Cartell,dun-morogh,384,paladin,retribution,12,4,8
Valanyr,kazzak,384,paladin,retribution,12,4,8
Розовыйбабл,gordunni,384,paladin,retribution,12,4,8
Cafa,turalyon,384,paladin,retribution,12,4,8
Héraclèss,marécage-de-zangar,384,paladin,retribution,12,4,8
Beefdaddykuu,ravencrest,384,paladin,retribution,12,4,8
Турбобит,gordunni,384,paladin,retribution,12,4,8
Arkkipiispa,outland,384,paladin,retribution,12,4,8
Elyeasia,silvermoon,384,paladin,retribution,12,4,8
Reedaa,shattered-hand,384,paladin,retribution,12,4,8
Brolaf,drakthul,384,paladin,retribution,12,4,8
Cørleena,eredar,384,paladin,retribution,12,4,8
Powerking,ragnaros,384,paladin,retribution,12,4,8
Øazimutø,archimonde,384,paladin,retribution,12,4,8
Flashycactús,azjolnerub,384,paladin,retribution,12,4,8
Thiccdeeps,aegwynn,384,paladin,retribution,12,4,8
Crowdev,zuljin,384,paladin,retribution,12,4,8
Bundagains,silvermoon,384,paladin,retribution,12,4,8
Tjú,mannoroth,384,paladin,retribution,12,4,8
Bubatzine,dun-morogh,384,paladin,retribution,12,4,8
Zarifence,ragnaros,384,paladin,retribution,12,4,8
Kielonpala,kazzak,384,paladin,retribution,12,4,8
Takopa,twisting-nether,384,paladin,retribution,12,4,8
Beefcake,bladefist,384,paladin,retribution,12,4,8
Stjusmussel,ragnaros,384,paladin,retribution,12,4,8
Stoneð,antonidas,384,paladin,retribution,12,4,8
Ambîorix,dun-modr,384,paladin,retribution,12,4,8
Скруддж,howling-fjord,384,paladin,retribution,12,4,8
Поддыхдам,gordunni,384,paladin,retribution,12,4,8
Ðrisk,defias-brotherhood,384,paladin,retribution,12,4,8
Rahhem,burning-legion,384,paladin,retribution,12,4,8
Ekber,ravencrest,384,paladin,retribution,12,4,8
Kyrín,onyxia,384,paladin,retribution,12,4,8
Felling,silvermoon,384,paladin,retribution,12,4,8
Cyban,twisting-nether,384,paladin,retribution,12,4,8
Kimozabie,ravencrest,384,paladin,retribution,12,4,8
Eddiefanboy,eredar,384,paladin,retribution,12,4,8
Эсмория,gordunni,384,paladin,retribution,12,4,8
Светиздырки,howling-fjord,384,paladin,retribution,12,4,8
Popelarr,burning-blade,384,paladin,retribution,12,4,8
Киилаа,gordunni,384,paladin,retribution,12,4,8
Oodödlig,twisting-nether,384,paladin,retribution,12,4,8
Justífiéd,kazzak,384,paladin,retribution,12,4,8
Lazorx,eredar,384,paladin,retribution,12,4,8
Бойкийкот,eversong,384,paladin,retribution,12,4,8
Trainer,madmortem,384,paladin,retribution,12,4,8
Yeetholy,ragnaros,384,paladin,retribution,12,4,8
Enkidu,guldan,384,paladin,retribution,12,4,8
Xerya,dun-modr,384,paladin,retribution,12,4,8
Lástchaos,madmortem,384,paladin,retribution,12,4,8
Pansarplåt,argent-dawn,384,paladin,retribution,12,4,8
Failhammer,tarren-mill,384,paladin,retribution,12,4,8
Катсес,eversong,384,paladin,retribution,12,4,8
Carelinus,tarren-mill,384,paladin,retribution,12,4,8
Xirôs,zirkel-des-cenarius,384,paladin,retribution,12,4,8
Chïefen,twisting-nether,384,paladin,retribution,12,4,8
Ivarlordbroc,hyjal,384,paladin,retribution,12,4,8
Mehighlaw,chamber-of-aspects,384,paladin,retribution,12,4,8
Dennyboy,sylvanas,384,paladin,retribution,12,4,8
Grymbol,boulderfist,384,paladin,retribution,12,4,8
Alawdi,ysondre,384,paladin,retribution,12,4,8
Somaxpala,burning-legion,384,paladin,retribution,12,4,8
Raudo,stormscale,384,paladin,retribution,12,4,8
Shealby,thrall,384,paladin,retribution,12,4,8
Lullabye,runetotem,384,paladin,retribution,12,4,8
Ревирант,howling-fjord,384,paladin,retribution,12,4,8
Encoreret,kilrogg,384,paladin,retribution,12,4,8
Astamye,ysondre,384,paladin,retribution,12,4,8
Celilinda,kiljaeden,384,paladin,retribution,12,4,8
ßellstarz,archimonde,384,paladin,retribution,12,4,8
Mjjolnir,doomhammer,384,paladin,retribution,12,4,8
Бронеаптечка,soulflayer,384,paladin,retribution,12,4,8
Cyborg,ysondre,384,paladin,retribution,12,4,8
Hasart,tarren-mill,384,paladin,retribution,12,4,8
Etzann,draenor,384,paladin,retribution,12,4,8
Lionknight,sylvanas,384,paladin,retribution,12,4,8
Varianwrinn,bloodhoof,384,paladin,retribution,12,4,8
Granberg,twisting-nether,384,paladin,retribution,12,4,8
Meatslice,boulderfist,384,paladin,retribution,12,4,8
Bugohoss,nathrezim,384,paladin,retribution,12,4,8
Дрейв,soulflayer,384,paladin,retribution,12,4,8
Blockitp,stormscale,384,paladin,retribution,12,4,8
Sgiach,draenor,384,paladin,retribution,12,4,8
Avengence,dragonblight,384,paladin,retribution,12,4,8
Mystràs,khaz-modan,384,paladin,retribution,12,4,8
Hgaming,kazzak,384,paladin,retribution,12,4,8
Æternal,arathor,384,paladin,retribution,12,4,8
Calarion,thrall,384,paladin,retribution,12,4,8
Lucretius,kilrogg,384,paladin,retribution,12,4,8
Ildarian,kazzak,384,paladin,retribution,12,4,8
Louxoxo,ravencrest,384,paladin,retribution,12,4,8
Jiby,twisting-nether,384,paladin,retribution,12,4,8
Djehuty,nemesis,384,paladin,retribution,12,4,8
Lopal,silvermoon,384,paladin,retribution,12,4,8
Karsini,arathor,384,paladin,retribution,12,4,8
Ríék,lightbringer,384,paladin,retribution,12,4,8
Komamrod,archimonde,384,paladin,retribution,12,4,8
Санзар,howling-fjord,384,paladin,retribution,12,4,8
Hyduriak,lightnings-blade,384,paladin,retribution,12,4,8
Heidfield,draenor,384,paladin,retribution,12,4,8
Prómetheus,malygos,384,paladin,retribution,12,4,8
Gellmar,the-maelstrom,384,paladin,retribution,12,4,8
Thaemónd,draenor,384,paladin,retribution,12,4,8
Димаходж,blackscar,384,paladin,retribution,12,4,8
Sorkara,argent-dawn,384,paladin,retribution,12,4,8
Douglazz,tarren-mill,384,paladin,retribution,13,4,9
Caedîs,antonidas,384,paladin,retribution,13,4,9
Kaitak,outland,384,paladin,retribution,20,5,15
Orbia,draenor,384,paladin,retribution,18,4,14
Retfull,sylvanas,384,paladin,retribution,18,4,14
Notnding,draenor,384,paladin,retribution,18,4,14
Forthy,drakthul,384,paladin,retribution,18,4,14
Franciscø,conseil-des-ombres,384,paladin,retribution,18,4,14
Kretheus,argent-dawn,384,paladin,retribution,18,4,14
Ciscó,ragnaros,384,paladin,retribution,18,4,14
Galaerøn,elune,384,paladin,retribution,18,4,14
Caribbean,outland,384,paladin,retribution,18,4,14
Garzad,ravencrest,384,paladin,retribution,18,4,14
Pepegasensei,ravencrest,384,paladin,retribution,18,4,14
Masuroc,antonidas,384,paladin,retribution,18,4,14
Отчо,gordunni,384,paladin,retribution,18,4,14
Thoryel,ravencrest,384,paladin,retribution,18,4,14
Vacalistarr,los-errantes,384,paladin,retribution,18,4,14
Trismegistos,bloodhoof,384,paladin,retribution,18,4,14
Sánexe,blackrock,384,paladin,retribution,18,4,14
Neyd,hyjal,384,paladin,retribution,18,4,14
Ruttodidio,outland,384,paladin,retribution,18,4,14
Minfa,argent-dawn,384,paladin,retribution,18,4,14
Synáx,blackhand,384,paladin,retribution,18,4,14
Erïn,rexxar,384,paladin,retribution,23,4,19
Elisun,twisting-nether,384,paladin,retribution,24,4,20
Hadok,uldaman,383,paladin,retribution,6,4,2
Рукаф,soulflayer,383,paladin,retribution,6,4,2
Микацури,howling-fjord,383,paladin,retribution,6,4,2
Toküt,elune,383,paladin,retribution,6,4,2
Одиннадцатый,ashenvale,383,paladin,retribution,6,4,2
Krögerelf,garrosh,383,paladin,retribution,6,4,2
Sphïnx,dun-modr,383,paladin,retribution,6,4,2
Purometa,silvermoon,383,paladin,retribution,6,4,2
Supersnubben,grim-batol,383,paladin,retribution,6,4,2
Lancelhot,archimonde,383,paladin,retribution,6,4,2
Haseldin,dun-modr,383,paladin,retribution,15,5,10
Giuliagirod,kazzak,383,paladin,retribution,12,4,8
Chunpala,silvermoon,383,paladin,retribution,12,4,8
Elvyri,silvermoon,383,paladin,retribution,12,4,8
Faragevult,defias-brotherhood,383,paladin,retribution,12,4,8
Hilkisen,ragnaros,383,paladin,retribution,12,4,8
Syrenia,die-silberne-hand,383,paladin,retribution,12,4,8
Hélls,sargeras,383,paladin,retribution,12,4,8
Haggís,blackrock,383,paladin,retribution,12,4,8
Xpurcica,twisting-nether,383,paladin,retribution,12,4,8
Ságé,thrall,383,paladin,retribution,16,4,12
Lavacalistar,turalyon,383,paladin,retribution,21,5,16
Vallys,runetotem,383,paladin,retribution,18,4,14
Arbuzno,draenor,1971,paladin,protection,120,95,25
Maximumtaste,ravencrest,1874,paladin,protection,42,33,9
Sonnywalkman,twisting-nether,1845,paladin,protection,54,42,12
Hoodnachoz,outland,1842,paladin,protection,36,30,6
Sterben,aegwynn,1805,paladin,protection,101,57,44
Sartshield,aerie-peak,1772,paladin,protection,102,57,45
Âmba,blackrock,1766,paladin,protection,143,99,44
Vivalabeef,stormscale,1723,paladin,protection,53,34,19
Гниленький,razuvious,1712,paladin,protection,29,20,9
Leotheron,boulderfist,1680,paladin,protection,1065,719,346
Zireth,silvermoon,1678,paladin,protection,42,26,16
Justífiéd,kazzak,1670,paladin,protection,53,27,26
Collinnawin,aegwynn,1656,paladin,protection,298,142,156
Mørfi,antonidas,1643,paladin,protection,82,41,41
Arkhàn,ravencrest,1634,paladin,protection,202,116,86
Statscowski,thrall,1624,paladin,protection,64,33,31
Фабийвальдор,soulflayer,1621,paladin,protection,72,48,24
Толинель,soulflayer,1610,paladin,protection,29,18,11
Timbadin,frostwolf,1608,paladin,protection,47,32,15
Eåsy,argent-dawn,1603,paladin,protection,175,96,79
Craft,frostwolf,1584,paladin,protection,148,65,83
Bariy,auchindoun,1579,paladin,protection,124,68,56
Tippressure,ravencrest,1572,paladin,protection,76,47,29
Neopronouns,minahonda,1559,paladin,protection,54,35,19
Elitest,hyjal,1550,paladin,protection,219,84,135
Phlakorn,blackhand,1542,paladin,protection,90,50,40
Schrikii,archimonde,1538,paladin,protection,84,49,35
Savión,silvermoon,1528,paladin,protection,53,32,21
Sutbeyaz,twisting-nether,1524,paladin,protection,31,21,10
Uswieconyra,silvermoon,1523,paladin,protection,83,42,41
Palan,cthun,1518,paladin,protection,83,33,50
Kurøneko,hyjal,1496,paladin,protection,41,19,22
Маиэр,gordunni,1494,paladin,protection,65,31,34
Broolaf,antonidas,1490,paladin,protection,196,103,93
Supremerage,silvermoon,1474,paladin,protection,86,46,40
Силугор,soulflayer,1470,paladin,protection,107,53,54
Whiteraven,rexxar,1467,paladin,protection,95,46,49
Galevar,argent-dawn,1464,paladin,protection,140,69,71
Sìlver,conseil-des-ombres,1461,paladin,protection,42,21,21
Haringoth,argent-dawn,1453,paladin,protection,78,42,36
Mocnyreka,silvermoon,1450,paladin,protection,89,48,41
Youness,ysondre,1440,paladin,protection,321,164,157
Ðizzmo,bloodfeather,1438,paladin,protection,238,120,118
Gabubex,tarren-mill,1435,paladin,protection,176,101,75
Leadfoot,argent-dawn,1430,paladin,protection,98,66,32
Oldsqlmofu,blackrock,1427,paladin,protection,45,25,20
Антоним,gordunni,1410,paladin,protection,35,19,16
Eriellè,kazzak,1403,paladin,protection,111,59,52
Бранв,gordunni,1401,paladin,protection,96,55,41
Шмыгапал,eversong,1389,paladin,protection,38,20,18
Dolff,argent-dawn,1379,paladin,protection,59,30,29
Баибар,soulflayer,1378,paladin,protection,162,89,73
Хэбит,soulflayer,1369,paladin,protection,142,67,75
Jûstice,kirin-tor,1368,paladin,protection,186,91,95
Swiatlomiecz,silvermoon,1366,paladin,protection,60,23,37
Flakkson,stormscale,1364,paladin,protection,334,144,190
Medium,frostwolf,1362,paladin,protection,29,15,14
Maeltesar,kult-der-verdammten,1361,paladin,protection,40,28,12
Krispce,bloodhoof,1360,paladin,protection,66,40,26
Ðivine,stormscale,1359,paladin,protection,130,60,70
Casstiel,anetheron,1356,paladin,protection,48,22,26
Helladin,haomarush,1346,paladin,protection,152,57,95
Ponce,los-errantes,1345,paladin,protection,48,20,28
Линвэль,gordunni,1342,paladin,protection,18,14,4
Lóu,hyjal,1340,paladin,protection,92,45,47
Unbesiegbar,malfurion,1340,paladin,protection,48,15,33
Vangorn,burning-legion,1334,paladin,protection,58,29,29
Shybia,kirin-tor,1327,paladin,protection,35,19,16
Trufetteuh,hyjal,1324,paladin,protection,207,104,103
Thrinea,blackrock,1324,paladin,protection,48,22,26
Galadrion,dun-modr,1321,paladin,protection,23,14,9
Ichbin,sanguino,1318,paladin,protection,308,123,185
Bobilous,twisting-nether,1310,paladin,protection,23,14,9
Velkar,frostmane,1310,paladin,protection,124,63,61
Hermodir,kargath,1303,paladin,protection,41,19,22
Zerhakz,ysondre,1302,paladin,protection,102,49,53
Gaffel,dethecus,1296,paladin,protection,64,28,36
Sikaniska,stormscale,1294,paladin,protection,108,45,63
Rudra,kiljaeden,1288,paladin,protection,87,35,52
Ragonas,mannoroth,1276,paladin,protection,48,20,28
Valeriu,stormreaver,1271,paladin,protection,42,17,25
Manupierre,ysondre,1270,paladin,protection,48,22,26
Yunalêsca,mugthol,1268,paladin,protection,137,59,78
Celyne,kirin-tor,1265,paladin,protection,54,21,33
Stahlkeule,antonidas,1264,paladin,protection,41,17,24
Milliemaître,elune,1253,paladin,protection,90,41,49
Elkka,azjolnerub,1235,paladin,protection,116,41,75
Augroni,antonidas,1227,paladin,protection,117,50,67
Lotheriem,argent-dawn,1203,paladin,protection,54,20,34
Xrules,blackhand,1201,paladin,protection,47,21,26
Butchertom,ravencrest,1184,paladin,protection,23,14,9
Проц,soulflayer,1178,paladin,protection,72,26,46
Quantox,frostwolf,1153,paladin,protection,40,14,26
Babaluga,blackrock,1151,paladin,protection,18,12,6
Vader,arygos,1151,paladin,protection,51,17,34
Derendil,ysondre,1143,paladin,protection,89,25,64
Kawakai,blackrock,1138,paladin,protection,76,28,48
Ciralia,chants-éternels,1137,paladin,protection,21,12,9
Arkera,blackrock,1134,paladin,protection,61,22,39
Tíríón,nethersturm,1124,paladin,protection,24,12,12
Furiosio,ysondre,1115,paladin,protection,27,13,14
Deathicâ,outland,1067,paladin,protection,28,12,16
Aarrb,sylvanas,1065,paladin,protection,51,15,36
Yruqrem,ravencrest,1055,paladin,protection,18,11,7
Fumbz,alakir,1050,paladin,protection,18,11,7
Vladium,argent-dawn,1046,paladin,protection,24,11,13
Такуан,fordragon,1035,paladin,protection,24,11,13
Faranume,sylvanas,1028,paladin,protection,35,18,17
Strahladin,blackhand,1013,paladin,protection,53,12,41
Emakk,darksorrow,958,paladin,protection,18,10,8
Divinebeans,kazzak,863,paladin,protection,12,9,3
Rushtank,dragonmaw,861,paladin,protection,36,9,27
Kîpôune,dalaran,860,paladin,protection,24,9,15
Ìu,draenor,809,paladin,protection,14,10,4
Thraliss,hyjal,767,paladin,protection,12,8,4
Dkfdevil,ravencrest,767,paladin,protection,18,8,10
Garjzla,chamber-of-aspects,727,paladin,protection,22,8,14
Testos,ulduar,712,paladin,protection,15,9,6
Lägolas,thrall,701,paladin,protection,17,8,9
Figustyle,archimonde,700,paladin,protection,22,8,14
Kraljevic,silvermoon,672,paladin,protection,12,7,5
Comic,frostwolf,672,paladin,protection,12,7,5
Ванябублгам,soulflayer,672,paladin,protection,18,7,11
Romfis,arathor,671,paladin,protection,18,7,11
Yanemba,zuljin,670,paladin,protection,18,7,11
Retríciusz,ragnaros,622,paladin,protection,15,8,7
Napooleon,archimonde,607,paladin,protection,11,7,4
Pingouin,hyjal,576,paladin,protection,10,7,3
Blechdøse,onyxia,576,paladin,protection,12,6,6
Dibzi,kazzak,576,paladin,protection,12,6,6
Uners,hyjal,576,paladin,protection,12,6,6
Marihuána,ragnaros,576,paladin,protection,18,6,12
Дадух,gordunni,575,paladin,protection,12,6,6
Thrormund,defias-brotherhood,575,paladin,protection,12,6,6
Ekenpala,kazzak,575,paladin,protection,12,6,6
Книгс,gordunni,575,paladin,protection,18,6,12
Exion,ravenholdt,543,paladin,protection,11,6,5
Кельдерик,howling-fjord,480,paladin,protection,6,5,1
Palmeretes,zuljin,480,paladin,protection,6,5,1
Moløk,ysondre,480,paladin,protection,6,5,1
Lightian,twisting-nether,480,paladin,protection,12,5,7
Jorrel,bladefist,480,paladin,protection,18,5,13
Кооениксз,blackscar,480,paladin,protection,18,5,13
Telninio,ravencrest,480,paladin,protection,18,5,13
Lithera,outland,480,paladin,protection,24,5,19
Onefrostyboi,defias-brotherhood,479,paladin,protection,12,5,7
Xairios,blackhand,479,paladin,protection,12,5,7
Duxbellorum,the-maelstrom,479,paladin,protection,18,5,13
Biffle,korgall,479,paladin,protection,30,5,25
Ilseparatzio,turalyon,477,paladin,protection,18,5,13
Hgaming,kazzak,384,paladin,protection,6,4,2
Brudiwinkler,blackrock,384,paladin,protection,6,4,2
Escort,frostwolf,384,paladin,protection,6,4,2
Akelad,arathor,384,paladin,protection,6,4,2
Fleshoflight,arathor,384,paladin,protection,6,4,2
Bbroblem,blackmoore,384,paladin,protection,6,4,2
Inqontrol,burning-legion,384,paladin,protection,12,4,8
Røse,argent-dawn,384,paladin,protection,12,4,8
Снайпик,azuregos,384,paladin,protection,12,4,8
Æåæxâëæ,dun-modr,384,paladin,protection,12,4,8
Slainer,zuljin,384,paladin,protection,18,4,14
Astragore,archimonde,384,paladin,protection,18,4,14
Дюве,blackscar,351,paladin,protection,11,4,7
Valädar,sanguino,351,paladin,protection,16,4,12
Swäagg,hyjal,288,paladin,protection,6,3,3
Estellar,bronze-dragonflight,288,paladin,protection,6,3,3
Æero,blackhand,288,paladin,protection,6,3,3
Zuplex,deathwing,288,paladin,protection,6,3,3
Aümagad,confrérie-du-thorium,288,paladin,protection,6,3,3
Palaplaya,zuljin,288,paladin,protection,6,3,3
Davykuro,medivh,288,paladin,protection,6,3,3
Рустиктоп,gordunni,288,paladin,protection,6,3,3
Bloodynox,dentarg,288,paladin,protection,6,3,3
Ламберинн,goldrinn,288,paladin,protection,12,3,9
Crimsons,draenor,288,paladin,protection,12,3,9
Meneth,elune,240,paladin,protection,9,3,6
Yourmomz,kazzak,239,paladin,protection,5,3,2
Zinetp,tarren-mill,192,paladin,protection,6,2,4
Gornim,die-nachtwache,192,paladin,protection,6,2,4
Djakninn,ragnaros,192,paladin,protection,6,2,4
Kryvex,nemesis,192,paladin,protection,6,2,4
Saró,ravencrest,192,paladin,protection,6,2,4
Синерина,blackscar,192,paladin,protection,6,2,4
Palarhym,thrall,192,paladin,protection,6,2,4
Mcprobieh,kazzak,192,paladin,protection,6,2,4
Paladuns,burning-legion,192,paladin,protection,6,2,4
Derina,silvermoon,192,paladin,protection,6,2,4
Khrak,conseil-des-ombres,192,paladin,protection,12,2,10
Palacaplaca,cthun,175,paladin,protection,11,2,9
Angeal,ysondre,175,paladin,protection,11,2,9
Soxsnort,twisting-nether,159,paladin,protection,5,2,3
Cutebabe,twisting-nether,159,paladin,protection,5,2,3
Olydig,argent-dawn,96,paladin,protection,6,1,5
Taptreus,antonidas,96,paladin,protection,6,1,5
Kathly,madmortem,96,paladin,protection,6,1,5
Лебоввски,blackscar,96,paladin,protection,6,1,5
Mattiesko,kazzak,96,paladin,protection,6,1,5
Чиксапомойка,gordunni,96,paladin,protection,6,1,5
Monkeyhoffi,blackrock,96,paladin,protection,6,1,5
Bugo,drakthul,96,paladin,protection,6,1,5
Dömötörp,ragnaros,96,paladin,protection,6,1,5
Barbarul,draenor,96,paladin,protection,6,1,5
Thôrwald,les-sentinelles,96,paladin,protection,12,1,11
Lokinder,pozzo-delleternità,96,paladin,protection,12,1,11
Blindfury,jaedenar,96,paladin,protection,12,1,11
Солошафл,howling-fjord,42,paladin,protection,12,4,8
Numberô,kazzak,42,paladin,protection,16,3,13
Candrä,archimonde,2213,priest,holy,96,52,44
Itsmeminglee,ravencrest,2213,priest,holy,216,116,100
Køzukï,ravencrest,2167,priest,holy,281,147,134
Leadeur,kazzak,2167,priest,holy,519,264,255
Servey,twisting-nether,2166,priest,holy,78,43,35
Peisetti,stormscale,2139,priest,holy,102,54,48
Tenpointone,kazzak,2127,priest,holy,171,90,81
Lmnsqzy,ravencrest,2107,priest,holy,148,79,69
Boonlai,ravencrest,2106,priest,holy,235,123,112
Tangent,ravencrest,2101,priest,holy,317,178,139
Yhoundey,blackrock,2098,priest,holy,141,73,68
Jtî,ravencrest,2096,priest,holy,54,36,18
Ladá,stormscale,2088,priest,holy,291,154,137
Yötönyö,ravencrest,2072,priest,holy,66,34,32
Carlitastock,eredar,2067,priest,holy,119,65,54
Feararenaone,outland,2055,priest,holy,128,70,58
Weezing,ysondre,2050,priest,holy,318,167,151
Lylska,stormreaver,2041,priest,holy,66,31,35
Møhammed,wrathbringer,2037,priest,holy,1224,621,603
Tmnstrtw,alakir,2026,priest,holy,155,83,72
Grafius,stormscale,2016,priest,holy,96,48,48
Còsmo,ravencrest,2010,priest,holy,60,34,26
Кальвейт,deathweaver,2006,priest,holy,251,128,123
Dotzey,outland,1996,priest,holy,60,32,28
Найтингеилл,gordunni,1990,priest,holy,174,96,78
Eriónd,ravencrest,1987,priest,holy,195,105,90
Bigwik,tarren-mill,1985,priest,holy,206,111,95
Rébörn,tarren-mill,1982,priest,holy,262,148,114
Cosines,ravencrest,1972,priest,holy,356,185,171
Tëst,ravencrest,1970,priest,holy,115,64,51
Лоаресс,gordunni,1969,priest,holy,280,145,135
Jaisuu,ravencrest,1967,priest,holy,60,31,29
Testdeath,ravencrest,1963,priest,holy,90,52,38
Finizkram,sylvanas,1959,priest,holy,64,34,30
Pandakhlys,ysondre,1950,priest,holy,100,54,46
Гопикзашквар,blackscar,1948,priest,holy,167,87,80
Tmnstr,alakir,1946,priest,holy,66,33,33
Jaytî,ravencrest,1944,priest,holy,48,33,15
Fleischesser,ravencrest,1941,priest,holy,110,59,51
Ltmp,ravencrest,1932,priest,holy,143,78,65
Zuniya,tarren-mill,1930,priest,holy,90,47,43
Rippertmepls,ravencrest,1924,priest,holy,166,97,69
Hélp,stormscale,1922,priest,holy,132,80,52
Wåtrux,alakir,1922,priest,holy,602,327,275
Шотыказау,blackscar,1921,priest,holy,317,162,155
Jiffie,twisting-nether,1920,priest,holy,137,72,65
Výra,der-rat-von-dalaran,1916,priest,holy,107,63,44
Lolylights,tarren-mill,1913,priest,holy,249,135,114
Pierrebourne,blackmoore,1911,priest,holy,78,42,36
Basilette,hyjal,1911,priest,holy,84,43,41
Разрухаз,gordunni,1899,priest,holy,66,40,26
Rehnstek,wildhammer,1898,priest,holy,167,89,78
Лайхтни,howling-fjord,1890,priest,holy,155,85,70
Lîrana,ravencrest,1889,priest,holy,160,98,62
Gokumødex,outland,1886,priest,holy,160,86,74
Nakkenils,tarren-mill,1886,priest,holy,64,30,34
Dmnz,blackrock,1885,priest,holy,117,56,61
Stanyú,tarren-mill,1880,priest,holy,90,43,47
Myste,nemesis,1875,priest,holy,238,129,109
Holyholy,stormscale,1871,priest,holy,210,101,109
Dmnz,antonidas,1870,priest,holy,58,33,25
Soyloverjuan,auchindoun,1865,priest,holy,54,38,16
Катккат,soulflayer,1864,priest,holy,53,30,23
Siign,ravencrest,1863,priest,holy,356,178,178
Piwi,blackrock,1854,priest,holy,120,67,53
Beatrixz,twisting-nether,1852,priest,holy,384,199,185
Muchos,blackrock,1852,priest,holy,415,205,210
Flongoletta,xavius,1850,priest,holy,189,102,87
Lenyp,sanguino,1850,priest,holy,300,151,149
Reflector,sunstrider,1847,priest,holy,48,27,21
Çhéåtçødé,ravencrest,1847,priest,holy,185,103,82
Qzrx,draenor,1847,priest,holy,72,38,34
Servêy,twisting-nether,1845,priest,holy,42,22,20
Ladderpolice,blackmoore,1844,priest,holy,36,21,15
Nxbo,kazzak,1841,priest,holy,154,80,74
Kaiikoo,ravencrest,1840,priest,holy,60,32,28
Друмги,gordunni,1839,priest,holy,244,117,127
Ryna,the-maelstrom,1838,priest,holy,58,37,21
Brigittë,ravencrest,1838,priest,holy,78,46,32
Thelunara,sanguino,1838,priest,holy,98,53,45
Jim,saurfang,1838,priest,holy,292,150,142
Charlotten,shattered-hand,1836,priest,holy,179,94,85
Гоплзнекст,gordunni,1835,priest,holy,502,254,248
Pharli,stormscale,1833,priest,holy,66,40,26
Gøkumodex,tarren-mill,1833,priest,holy,140,77,63
Kæzm,blackrock,1833,priest,holy,54,29,25
Gigamind,blackrock,1832,priest,holy,126,71,55
Obeng,tarren-mill,1829,priest,holy,48,23,25
Ysun,tarren-mill,1825,priest,holy,96,49,47
Wextroth,arathor,1824,priest,holy,42,28,14
Yateh,blackmoore,1824,priest,holy,62,32,30
Yugata,archimonde,1824,priest,holy,53,26,27
Pradrak,eredar,1823,priest,holy,40,23,17
Квваззар,gordunni,1822,priest,holy,72,34,38
Limeslayerx,veklor,1818,priest,holy,135,83,52
Dranbor,argent-dawn,1818,priest,holy,296,161,135
Syalis,kazzak,1817,priest,holy,255,133,122
Ancientalien,khadgar,1817,priest,holy,66,29,37
Celliapriest,antonidas,1816,priest,holy,74,40,34
Calithria,kazzak,1816,priest,holy,321,173,148
Jagardoden,stormscale,1816,priest,holy,36,19,17
Dogshtpriest,ravencrest,1815,priest,holy,126,74,52
Sayne,arathor,1815,priest,holy,168,91,77
Кодис,gordunni,1813,priest,holy,153,91,62
Yamai,thrall,1813,priest,holy,60,28,32
Maruh,malganis,1812,priest,holy,113,60,53
Infamoussftw,drakthul,1812,priest,holy,224,103,121
Kaalu,frostmane,1809,priest,holy,254,131,123
Deneris,ravencrest,1807,priest,holy,51,29,22
Drillin,ravencrest,1806,priest,holy,216,120,96
Jaywie,twisting-nether,1805,priest,holy,48,22,26
Vaerath,argent-dawn,1803,priest,holy,90,49,41
Разрухаовнз,gordunni,1803,priest,holy,155,81,74
Lupinx,terokkar,1802,priest,holy,177,105,72
Soulwordpain,ragnaros,1802,priest,holy,60,29,31
Verycute,argent-dawn,1801,priest,holy,36,24,12
Sausageboy,tarren-mill,1801,priest,holy,246,122,124
Teatime,aegwynn,1800,priest,holy,84,42,42
Troedelsuppe,destromath,1798,priest,holy,407,211,196
Zoophobîa,stormscale,1796,priest,holy,79,48,31
Ssjx,ravencrest,1791,priest,holy,96,58,38
Кэрия,blackscar,1791,priest,holy,263,140,123
Sehlia,kazzak,1790,priest,holy,418,223,195
Kunen,sanguino,1789,priest,holy,138,77,61
Psi,hakkar,1788,priest,holy,526,275,251
Fotmrerollrz,draenor,1787,priest,holy,48,34,14
Depridolens,argent-dawn,1783,priest,holy,66,39,27
Kirobreika,twisting-nether,1779,priest,holy,42,26,16
Seanoob,turalyon,1779,priest,holy,72,38,34
Sisko,stormscale,1778,priest,holy,168,89,79
Sod,dun-morogh,1776,priest,holy,66,39,27
Drunkshufler,stormscale,1775,priest,holy,231,128,103
Zêlestia,antonidas,1774,priest,holy,58,34,24
Alchemïst,ravencrest,1772,priest,holy,58,28,30
Эльдиремонт,gordunni,1771,priest,holy,419,209,210
Fízwow,stormscale,1771,priest,holy,117,57,60
Сказочки,gordunni,1770,priest,holy,111,55,56
Weezïng,ysondre,1765,priest,holy,114,64,50
Casic,lordaeron,1762,priest,holy,38,24,14
Gigotdagneau,dalaran,1753,priest,holy,71,35,36
Ivÿx,ravencrest,1749,priest,holy,101,57,44
Jukester,stormscale,1747,priest,holy,98,57,41
Canoftuna,outland,1746,priest,holy,250,149,101
Xnda,ravencrest,1742,priest,holy,283,146,137
Shmoly,stormscale,1741,priest,holy,101,52,49
Stickpas,ysondre,1739,priest,holy,47,22,25
Ðês,ravencrest,1735,priest,holy,76,37,39
Штанга,blackscar,1734,priest,holy,202,106,96
Pigdestroyin,frostmane,1730,priest,holy,77,45,32
Преттисмайл,gordunni,1730,priest,holy,283,139,144
Wèèzing,ysondre,1728,priest,holy,113,65,48
Angelsdust,stormscale,1728,priest,holy,58,33,25
Anníng,tarren-mill,1727,priest,holy,280,156,124
Zên,argent-dawn,1726,priest,holy,27,19,8
Applepiez,ravencrest,1726,priest,holy,58,30,28
Løøney,kazzak,1723,priest,holy,90,55,35
Scartay,outland,1723,priest,holy,53,24,29
Skyggedyret,tarren-mill,1721,priest,holy,59,31,28
Sàweetie,archimonde,1721,priest,holy,54,27,27
Makkesfil,stormscale,1720,priest,holy,52,34,18
Gloomkesh,draenor,1720,priest,holy,66,36,30
Fjonnski,blackmoore,1717,priest,holy,127,74,53
Zeflol,malganis,1717,priest,holy,185,101,84
Gnomemonk,stormscale,1716,priest,holy,217,113,104
Shizzlol,silvermoon,1716,priest,holy,614,304,310
Jinxa,draenor,1716,priest,holy,84,36,48
Affro,drakthul,1714,priest,holy,211,110,101
Marcopp,kazzak,1713,priest,holy,66,28,38
Alpháømegá,outland,1712,priest,holy,224,118,106
Tabaç,stormscale,1711,priest,holy,42,22,20
Stinkydog,kazzak,1711,priest,holy,406,205,201
Ksn,argent-dawn,1710,priest,holy,66,37,29
Tazn,thrall,1708,priest,holy,36,21,15
Duqes,stormreaver,1702,priest,holy,18,18,0
Asgà,stormscale,1702,priest,holy,41,25,16
Rafaled,ravencrest,1701,priest,holy,53,33,20
Malaki,ysondre,1700,priest,holy,209,110,99
Ålúñãh,azjolnerub,1699,priest,holy,42,27,15
Azulâ,eredar,1699,priest,holy,59,35,24
Eox,kazzak,1699,priest,holy,78,46,32
Dolens,argent-dawn,1699,priest,holy,112,55,57
Oide,area-52,1697,priest,holy,159,83,76
Rankonejames,silvermoon,1696,priest,holy,87,45,42
Xianxia,twisting-nether,1695,priest,holy,196,101,95
Anaqt,silvermoon,1694,priest,holy,673,347,326
Flyffi,tarren-mill,1693,priest,holy,34,22,12
Ilenna,dun-morogh,1692,priest,holy,135,75,60
Инзора,gordunni,1692,priest,holy,242,130,112
Câlyr,ragnaros,1692,priest,holy,54,24,30
Jâde,bloodhoof,1690,priest,holy,138,78,60
Макстин,howling-fjord,1690,priest,holy,48,27,21
Discomelk,stormscale,1690,priest,holy,48,23,25
Vui,kelthuzad,1689,priest,holy,72,46,26
Shanya,thrall,1688,priest,holy,285,144,141
Bzzdontplay,ravencrest,1687,priest,holy,225,116,109
Yzïam,ravencrest,1687,priest,holy,66,33,33
Maikzky,stormreaver,1686,priest,holy,42,26,16
Joeasaurs,ragnaros,1686,priest,holy,118,61,57
Notdan,stormscale,1685,priest,holy,404,214,190
Vitae,gorgonnash,1684,priest,holy,56,32,24
Meanbabe,argent-dawn,1683,priest,holy,48,22,26
Enoriya,blackrock,1682,priest,holy,252,141,111
Jeanlumina,stormscale,1680,priest,holy,48,25,23
Chechenkata,ravencrest,1678,priest,holy,54,29,25
Ghettothug,darksorrow,1677,priest,holy,120,58,62
Kahir,ravencrest,1676,priest,holy,54,28,26
Darkyos,azshara,1675,priest,holy,54,28,26
Каткааткат,soulflayer,1674,priest,holy,48,23,25
Katleiya,ysondre,1672,priest,holy,52,36,16
Zen,talnivarr,1672,priest,holy,42,19,23
Suili,twisting-nether,1669,priest,holy,30,19,11
Просодик,blackscar,1667,priest,holy,48,26,22
Highn,anetheron,1666,priest,holy,83,49,34
Djmeld,ravencrest,1664,priest,holy,107,56,51
Sehrhübsch,malygos,1661,priest,holy,66,35,31
Labuchette,archimonde,1660,priest,holy,42,23,19
Kÿokó,ravencrest,1659,priest,holy,84,46,38
Wraithtrippz,stormscale,1659,priest,holy,50,27,23
Womanwonderf,ravencrest,1658,priest,holy,143,76,67
Shanny,kazzak,1658,priest,holy,132,70,62
Æäõ,turalyon,1657,priest,holy,64,28,36
Кввазаар,gordunni,1656,priest,holy,66,30,36
Kolto,ravencrest,1655,priest,holy,64,36,28
Alizeé,nazjatar,1655,priest,holy,245,134,111
Sïxsïxsïx,ravencrest,1651,priest,holy,73,37,36
Ainadaxz,ravencrest,1650,priest,holy,42,26,16
Swd,burning-blade,1650,priest,holy,40,18,22
Heilop,kazzak,1650,priest,holy,53,23,30
Нубстрим,gordunni,1646,priest,holy,286,141,145
Iiamx,antonidas,1645,priest,holy,41,24,17
Lendoril,blackhand,1644,priest,holy,77,39,38
Adare,sanguino,1644,priest,holy,96,46,50
Vregoa,twisting-nether,1644,priest,holy,78,37,41
Mêmphìs,twisting-nether,1643,priest,holy,93,56,37
Мамкалол,soulflayer,1643,priest,holy,588,293,295
Arianaglandé,hyjal,1642,priest,holy,30,18,12
Ангеланика,gordunni,1640,priest,holy,113,75,38
Gladíator,blackhand,1639,priest,holy,126,68,58
Caihla,silvermoon,1639,priest,holy,42,22,20
Penvon,ravencrest,1638,priest,holy,207,101,106
Xïâ,hyjal,1638,priest,holy,176,83,93
Shinesomnya,aegwynn,1637,priest,holy,54,32,22
Jellypie,blackrock,1637,priest,holy,60,31,29
Seeyae,archimonde,1636,priest,holy,54,27,27
Wernou,archimonde,1635,priest,holy,44,25,19
Acronix,the-maelstrom,1635,priest,holy,54,28,26
Bilbobanging,aggramar,1635,priest,holy,108,53,55
Xzklolz,twisting-nether,1634,priest,holy,185,95,90
Massbimba,tarren-mill,1633,priest,holy,72,35,37
Ranevskiy,kazzak,1631,priest,holy,120,70,50
Scrxppe,twisting-nether,1630,priest,holy,283,155,128
Eliíah,outland,1629,priest,holy,54,31,23
Pasqualz,ravencrest,1629,priest,holy,204,112,92
Camina,shattered-hand,1629,priest,holy,279,146,133
Chrysos,argent-dawn,1629,priest,holy,102,47,55
Pøsæ,uldaman,1627,priest,holy,78,44,34
Kyokaze,silvermoon,1626,priest,holy,118,64,54
Ankî,aegwynn,1626,priest,holy,68,36,32
Fizzlesp,tarren-mill,1626,priest,holy,54,28,26
Boomixed,twisting-nether,1623,priest,holy,60,29,31
Simpadisco,ravencrest,1623,priest,holy,96,46,50
Jedimind,kazzak,1621,priest,holy,66,33,33
Elmaestrø,aegwynn,1620,priest,holy,96,52,44
Cølï,ravencrest,1620,priest,holy,96,48,48
Rankoneprazt,stormscale,1620,priest,holy,131,63,68
Melzas,the-shatar,1619,priest,holy,60,31,29
Wurstpriest,silvermoon,1619,priest,holy,52,25,27
Xxmybaxxo,archimonde,1617,priest,holy,30,21,9
Eddíémorphin,kazzak,1617,priest,holy,78,39,39
Smïlë,ravencrest,1616,priest,holy,210,105,105
Èlysium,grim-batol,1615,priest,holy,117,67,50
Grindgames,pozzo-delleternità,1615,priest,holy,44,22,22
Jawjie,tarren-mill,1615,priest,holy,86,36,50
Penitent,anachronos,1614,priest,holy,60,34,26
Coolwnbnamex,ravencrest,1614,priest,holy,36,19,17
Hwren,auchindoun,1612,priest,holy,430,229,201
Isadriel,madmortem,1610,priest,holy,64,40,24
Xzklol,twisting-nether,1610,priest,holy,92,48,44
Harmónia,outland,1610,priest,holy,283,140,143
Ysalute,sylvanas,1608,priest,holy,33,18,15
Adonallsium,sylvanas,1607,priest,holy,90,58,32
Vespîrâ,onyxia,1607,priest,holy,842,436,406
Alphacub,ragnaros,1607,priest,holy,149,76,73
Eleutheria,grim-batol,1607,priest,holy,228,113,115
Salvatíon,sanguino,1607,priest,holy,106,46,60
Usw,outland,1606,priest,holy,164,74,90
Gonker,malganis,1605,priest,holy,41,21,20
Slakkieslak,archimonde,1604,priest,holy,126,77,49
Anabananaa,ravencrest,1604,priest,holy,88,50,38
Avelynn,ravencrest,1603,priest,holy,231,119,112
Angelsdust,ravencrest,1603,priest,holy,60,26,34
Theythem,stormscale,1602,priest,holy,30,17,13
Росвэнд,gordunni,1601,priest,holy,89,51,38
Zxø,ravencrest,1601,priest,holy,160,88,72
Sak,uldaman,1601,priest,holy,315,161,154
Budgetdp,archimonde,1601,priest,holy,153,69,84
Imbitterx,stormscale,1600,priest,holy,41,26,15
Диматеу,galakrond,1600,priest,holy,144,71,73
Malphesto,sunstrider,1599,priest,holy,29,19,10
Pínacoladáqt,stormscale,1599,priest,holy,136,71,65
Vídel,cthun,1598,priest,holy,60,35,25
Flensu,stormscale,1597,priest,holy,36,24,12
Zds,ghostlands,1596,priest,holy,42,26,16
Rixis,la-croisade-écarlate,1596,priest,holy,124,70,54
Dazé,ravencrest,1596,priest,holy,141,76,65
Catstretch,ravencrest,1596,priest,holy,281,150,131
Ünique,alakir,1595,priest,holy,36,19,17
Ksn,silvermoon,1593,priest,holy,236,121,115
Striderz,outland,1592,priest,holy,38,21,17
Goytka,tarren-mill,1591,priest,holy,114,55,59
Karpiest,stormscale,1590,priest,holy,214,118,96
Priestxx,twilights-hammer,1588,priest,holy,47,22,25
Dìsclol,draenor,1586,priest,holy,247,125,122
Lanmarie,sylvanas,1585,priest,holy,84,46,38
Overdosedtw,die-aldor,1584,priest,holy,60,37,23
Dairox,blackrock,1584,priest,holy,143,77,66
Zelzeari,sylvanas,1583,priest,holy,36,22,14
Altarboy,dun-modr,1583,priest,holy,36,18,18
Tromah,archimonde,1580,priest,holy,147,83,64
Mewdi,outland,1579,priest,holy,146,78,68
Aethanira,ravencrest,1579,priest,holy,104,51,53
Poulet,sylvanas,1578,priest,holy,54,34,20
Senga,kazzak,1574,priest,holy,29,17,12
Свэпи,blackscar,1573,priest,holy,30,18,12
Icybae,archimonde,1572,priest,holy,48,34,14
Imaut,emerald-dream,1571,priest,holy,95,47,48
Велост,gordunni,1570,priest,holy,149,86,63
Wilby,archimonde,1570,priest,holy,78,39,39
Prëdz,stormscale,1569,priest,holy,280,149,131
Solacé,frostmourne,1566,priest,holy,182,95,87
Fakeshield,aegwynn,1565,priest,holy,137,70,67
Goofdookie,outland,1563,priest,holy,48,26,22
Fomstable,outland,1562,priest,holy,182,104,78
Kathja,outland,1561,priest,holy,46,26,20
Rozå,argent-dawn,1560,priest,holy,84,48,36
Hotforus,silvermoon,1560,priest,holy,51,26,25
Elëkträ,dalaran,1559,priest,holy,85,52,33
Nastylex,magtheridon,1559,priest,holy,36,21,15
Rägà,archimonde,1557,priest,holy,161,91,70
Immortalled,twisting-nether,1556,priest,holy,42,20,22
Døtgdx,archimonde,1555,priest,holy,88,51,37
Touddixz,blackrock,1555,priest,holy,44,18,26
Aykò,blackmoore,1554,priest,holy,204,98,106
Hadis,tarren-mill,1553,priest,holy,80,49,31
Dokkaebì,kazzak,1552,priest,holy,153,78,75
Marvellously,tarren-mill,1549,priest,holy,46,20,26
Неймхичгодх,gordunni,1548,priest,holy,88,46,42
Capslk,ravencrest,1547,priest,holy,78,43,35
Phobò,antonidas,1545,priest,holy,170,79,91
Trenenjoyer,stormscale,1544,priest,holy,30,17,13
Kubbarn,stormscale,1544,priest,holy,361,194,167
Åluneth,kazzak,1544,priest,holy,423,219,204
Tazlii,dalaran,1543,priest,holy,30,17,13
Dény,ravencrest,1539,priest,holy,156,83,73
Koíré,defias-brotherhood,1539,priest,holy,458,236,222
Смайткен,gordunni,1538,priest,holy,117,52,65
Sonyl,les-sentinelles,1537,priest,holy,48,27,21
Evabae,the-maelstrom,1537,priest,holy,54,29,25
Карпинчо,soulflayer,1537,priest,holy,36,19,17
Cleoana,blackhand,1537,priest,holy,66,31,35
Glaedahr,blackmoore,1536,priest,holy,42,21,21
Lisk,argent-dawn,1535,priest,holy,30,17,13
Vickepriest,stormreaver,1532,priest,holy,84,52,32
Yuhé,elune,1529,priest,holy,44,28,16
Zeitgeíst,archimonde,1529,priest,holy,122,50,72
Holzí,frostmourne,1528,priest,holy,50,24,26
Priewyn,ragnaros,1528,priest,holy,40,19,21
Omnimento,blackrock,1526,priest,holy,60,34,26
Fléxed,burning-legion,1526,priest,holy,30,17,13
Badguymike,ragnaros,1526,priest,holy,64,33,31
Mayalolz,chogall,1525,priest,holy,80,43,37
Astralscare,outland,1525,priest,holy,48,23,25
Saceerdot,sanguino,1522,priest,holy,132,78,54
Justheal,stormscale,1522,priest,holy,102,49,53
Çhåstîsëfèár,dun-modr,1521,priest,holy,18,16,2
Swdommeil,aegwynn,1521,priest,holy,42,18,24
Другподруг,soulflayer,1520,priest,holy,48,29,19
Gratcrug,stormrage,1520,priest,holy,77,38,39
Malkàv,hyjal,1519,priest,holy,90,47,43
Insaner,ahnqiraj,1519,priest,holy,83,42,41
Felaenna,argent-dawn,1518,priest,holy,24,20,4
Rines,thrall,1518,priest,holy,242,123,119
Dorisdiesel,ravencrest,1517,priest,holy,45,28,17
Exoduz,stormscale,1515,priest,holy,150,75,75
Alaelis,burning-legion,1513,priest,holy,209,105,104
Snåttabaias,stormscale,1510,priest,holy,74,41,33
Msmsmsm,frostwhisper,1508,priest,holy,95,51,44
Ptiteminette,archimonde,1504,priest,holy,68,38,30
Bougetonboul,archimonde,1504,priest,holy,123,65,58
Hyonra,kazzak,1504,priest,holy,78,39,39
Aïmée,ravencrest,1503,priest,holy,149,80,69
Cyabish,twisting-nether,1503,priest,holy,203,108,95
Géèk,alakir,1503,priest,holy,62,32,30
Маквиэлла,howling-fjord,1500,priest,holy,66,37,29
Dbp,tarren-mill,1500,priest,holy,126,63,63
Шанэкс,howling-fjord,1499,priest,holy,36,21,15
Geilerheiler,dalvengyr,1499,priest,holy,35,20,15
Ðrugslol,aegwynn,1498,priest,holy,30,17,13
Phobò,blackrock,1498,priest,holy,123,57,66
Hiimgreen,blackhand,1497,priest,holy,194,93,101
Tyrhaa,blackmoore,1496,priest,holy,631,329,302
Kotipope,silvermoon,1496,priest,holy,86,43,43
Dzoo,kazzak,1496,priest,holy,42,21,21
Hoeneygodx,antonidas,1495,priest,holy,42,21,21
Velence,ravencrest,1494,priest,holy,48,31,17
Заволончик,blackscar,1494,priest,holy,102,48,54
Fatherliam,emerald-dream,1492,priest,holy,72,34,38
Иннерон,soulflayer,1490,priest,holy,493,261,232
Draster,blackrock,1490,priest,holy,53,28,25
Boostpriest,archimonde,1490,priest,holy,42,19,23
Mctastý,outland,1488,priest,holy,42,29,13
Cartøøns,ravencrest,1488,priest,holy,84,47,37
Daftî,twisting-nether,1488,priest,holy,199,105,94
Meshia,antonidas,1488,priest,holy,42,19,23
Øtîs,aegwynn,1487,priest,holy,78,39,39
Reiko,ravencrest,1485,priest,holy,54,33,21
Ÿolo,nemesis,1485,priest,holy,38,18,20
Superdude,stormscale,1484,priest,holy,36,16,20
Пингзеро,soulflayer,1482,priest,holy,238,120,118
Ozmik,twisting-nether,1482,priest,holy,50,25,25
Эилинг,gordunni,1481,priest,holy,292,155,137
Nou,aegwynn,1481,priest,holy,147,76,71
Senkín,aegwynn,1479,priest,holy,221,107,114
Sebekklawl,wrathbringer,1478,priest,holy,96,48,48
Еврейк,soulflayer,1478,priest,holy,66,31,35
Mêduse,ravencrest,1476,priest,holy,81,39,42
Cøvu,draenor,1475,priest,holy,189,95,94
Spamplague,stormscale,1473,priest,holy,170,89,81
Tavra,stormscale,1473,priest,holy,238,115,123
Grandpatea,silvermoon,1472,priest,holy,23,16,7
Sïlvëräzz,drekthar,1472,priest,holy,53,25,28
Pprxd,ysondre,1472,priest,holy,54,25,29
Maah,defias-brotherhood,1471,priest,holy,80,46,34
Smoree,malganis,1471,priest,holy,382,200,182
Divinetouch,ravencrest,1471,priest,holy,96,42,54
Tripjob,hyjal,1470,priest,holy,76,38,38
Fabs,laughing-skull,1468,priest,holy,119,72,47
Ðoxy,frostmane,1468,priest,holy,36,19,17
Weedony,hyjal,1468,priest,holy,112,58,54
Целитель,gordunni,1467,priest,holy,148,76,72
Выдокбля,soulflayer,1465,priest,holy,167,92,75
Symbolofhope,ravencrest,1464,priest,holy,231,121,110
Sixtyseven,blackhand,1464,priest,holy,78,39,39
Faelvirin,aegwynn,1462,priest,holy,66,36,30
Angrk,kazzak,1461,priest,holy,120,70,50
Painlêss,eredar,1461,priest,holy,41,22,19
Isilros,dalaran,1460,priest,holy,52,28,24
Liquoriced,tarren-mill,1460,priest,holy,43,23,20
Delphina,archimonde,1459,priest,holy,311,166,145
Soloria,twisting-nether,1458,priest,holy,119,57,62
Motoripräst,stormreaver,1457,priest,holy,148,73,75
Бэнэльф,soulflayer,1457,priest,holy,55,25,30
Jappsolut,outland,1456,priest,holy,101,56,45
Sebbepriest,twisting-nether,1455,priest,holy,34,19,15
Zrada,dalaran,1455,priest,holy,66,36,30
Suxino,stormscale,1455,priest,holy,185,94,91
Рилия,howling-fjord,1455,priest,holy,70,34,36
Dãrkmedic,silvermoon,1454,priest,holy,83,42,41
Mcdeady,tarren-mill,1454,priest,holy,42,19,23
Dùsty,archimonde,1453,priest,holy,74,41,33
Ceraghk,tichondrius,1453,priest,holy,52,23,29
Chibrausorus,archimonde,1452,priest,holy,205,109,96
Алеброн,gordunni,1452,priest,holy,123,65,58
Køzøxîä,dalaran,1452,priest,holy,60,20,40
Momopriesto,draenor,1450,priest,holy,89,41,48
Taksus,alexstrasza,1450,priest,holy,42,19,23
Feelmypainn,kazzak,1449,priest,holy,125,71,54
Mezegis,draenor,1449,priest,holy,48,26,22
Learning,ysondre,1449,priest,holy,194,99,95
Stigmátá,ravencrest,1449,priest,holy,54,26,28
Húlda,auchindoun,1447,priest,holy,164,84,80
Djdesha,tarren-mill,1447,priest,holy,41,19,22
Onixa,tarren-mill,1447,priest,holy,60,22,38
Нейроблум,soulflayer,1446,priest,holy,42,24,18
Zlejkadlec,drakthul,1445,priest,holy,109,55,54
Discobrill,silvermoon,1444,priest,holy,78,49,29
Åzjol,magtheridon,1443,priest,holy,85,39,46
Exaneo,ragnaros,1442,priest,holy,38,22,16
Tiphereth,blackmoore,1442,priest,holy,32,17,15
Venomrush,ravencrest,1442,priest,holy,47,24,23
Voodoo,the-maelstrom,1441,priest,holy,129,55,74
Lirych,the-maelstrom,1440,priest,holy,48,29,19
Byzzi,draenor,1440,priest,holy,332,171,161
Discxqt,ysondre,1438,priest,holy,26,18,8
Бредяка,gordunni,1438,priest,holy,84,50,34
Juco,draenor,1438,priest,holy,342,175,167
Sqwabblepee,stormscale,1438,priest,holy,53,27,26
Ròka,ysondre,1438,priest,holy,72,34,38
Краббожий,greymane,1437,priest,holy,123,55,68
Thalane,das-konsortium,1437,priest,holy,66,29,37
Arianell,stormscale,1436,priest,holy,45,28,17
Sadgepriest,draenor,1435,priest,holy,132,68,64
Pleistex,sylvanas,1435,priest,holy,129,65,64
Maerlene,nemesis,1433,priest,holy,54,31,23
Novella,kult-der-verdammten,1432,priest,holy,88,55,33
Valío,stormreaver,1432,priest,holy,30,16,14
Bettinella,silvermoon,1431,priest,holy,42,15,27
Bobitä,ravencrest,1430,priest,holy,54,32,22
Mindconrol,twisting-nether,1430,priest,holy,64,36,28
Cellia,antonidas,1430,priest,holy,48,15,33
Lasuora,nemesis,1429,priest,holy,84,42,42
Chosayomoine,elune,1428,priest,holy,73,37,36
Bierbändiger,blackhand,1427,priest,holy,366,181,185
Battleground,defias-brotherhood,1427,priest,holy,36,17,19
Arithon,blackrock,1426,priest,holy,36,21,15
Dathanosx,outland,1426,priest,holy,34,17,17
Melodyn,silvermoon,1426,priest,holy,62,28,34
Jannolapin,ysondre,1425,priest,holy,48,25,23
Seladine,ravencrest,1423,priest,holy,212,109,103
Cånniekekw,tarren-mill,1422,priest,holy,45,21,24
Rezzurrectum,doomhammer,1421,priest,holy,81,47,34
Neverque,defias-brotherhood,1420,priest,holy,24,15,9
Ittei,stormscale,1420,priest,holy,34,16,18
Dogfacex,ravencrest,1419,priest,holy,142,70,72
Kbakå,kazzak,1419,priest,holy,78,37,41
Nýkah,antonidas,1418,priest,holy,66,31,35
Chrishyp,blackrock,1417,priest,holy,146,89,57
Dwoa,silvermoon,1417,priest,holy,191,106,85
Mylini,silvermoon,1417,priest,holy,371,197,174
Emipriest,tarren-mill,1417,priest,holy,269,136,133
Lómesilme,dun-modr,1416,priest,holy,235,122,113
Davìna,sunstrider,1416,priest,holy,127,65,62
Noxxill,eredar,1416,priest,holy,42,21,21
Góldfinger,norgannon,1416,priest,holy,426,209,217
Penitence,drekthar,1416,priest,holy,56,24,32
Virginmaris,sanguino,1415,priest,holy,113,64,49
Stranger,thunderhorn,1415,priest,holy,60,33,27
Filthyzx,argent-dawn,1415,priest,holy,30,15,15
Willxzz,silvermoon,1414,priest,holy,88,36,52
Eazzyy,kazzak,1413,priest,holy,116,60,56
Lilianboss,stormscale,1412,priest,holy,47,25,22
Markianos,silvermoon,1412,priest,holy,114,58,56
Xytael,burning-legion,1410,priest,holy,286,149,137
Zufâllig,blackhand,1409,priest,holy,36,17,19
Judâspriest,twisting-nether,1408,priest,holy,107,52,55
Najglavniji,tarren-mill,1407,priest,holy,92,49,43
Balin,veklor,1407,priest,holy,77,35,42
Bifs,blackmoore,1405,priest,holy,50,32,18
Eedazap,argent-dawn,1405,priest,holy,33,16,17
Gertie,blackhand,1404,priest,holy,94,49,45
Prinki,tarren-mill,1404,priest,holy,42,19,23
Kusé,anubarak,1404,priest,holy,36,15,21
Blacklemons,thrall,1403,priest,holy,48,26,22
Bochonok,stormrage,1402,priest,holy,45,18,27
Ezechiel,twisting-nether,1401,priest,holy,83,49,34
Adallon,blackmoore,1401,priest,holy,65,34,31
Dødy,hyjal,1400,priest,holy,24,15,9
Beecn,tarren-mill,1398,priest,holy,78,42,36
Stàrlîght,chants-éternels,1397,priest,holy,54,33,21
Casconero,nemesis,1397,priest,holy,119,56,63
Aráko,blackhand,1396,priest,holy,62,34,28
Mianxpriest,tarren-mill,1395,priest,holy,162,82,80
Iwl,sanguino,1394,priest,holy,159,81,78
Annebonny,lightnings-blade,1392,priest,holy,125,69,56
Sopsy,stormscale,1391,priest,holy,54,34,20
Pakmopriest,ragnaros,1391,priest,holy,36,19,17
Hara,elune,1391,priest,holy,112,52,60
Spikoui,uldaman,1391,priest,holy,72,31,41
Chaerii,blackmoore,1390,priest,holy,54,26,28
Бустержиесть,soulflayer,1390,priest,holy,60,27,33
Lenara,kult-der-verdammten,1389,priest,holy,42,24,18
Tyene,voljin,1389,priest,holy,182,101,81
Lädi,ravencrest,1388,priest,holy,108,58,50
Возхд,soulflayer,1387,priest,holy,84,44,40
Ørdø,antonidas,1387,priest,holy,88,43,45
Hydraximus,garrosh,1386,priest,holy,889,441,448
Szelén,ragnaros,1385,priest,holy,30,17,13
Sannti,twisting-nether,1384,priest,holy,66,33,33
Jaz,ysondre,1383,priest,holy,108,53,55
Nbeewwannabe,silvermoon,1382,priest,holy,179,99,80
Qzrx,outland,1382,priest,holy,30,15,15
Холихэйт,howling-fjord,1381,priest,holy,29,15,14
Adenisia,hyjal,1380,priest,holy,43,20,23
Piprikas,draenor,1380,priest,holy,72,33,39
Aleanna,dalaran,1379,priest,holy,50,24,26
Letmehêal,archimonde,1377,priest,holy,96,47,49
Ikaa,wrathbringer,1377,priest,holy,59,28,31
Иссатея,galakrond,1377,priest,holy,84,39,45
Neoark,archimonde,1376,priest,holy,176,88,88
Veurjin,uldaman,1376,priest,holy,95,46,49
Annise,kazzak,1373,priest,holy,49,26,23
Bubbleup,defias-brotherhood,1373,priest,holy,162,85,77
Åshlol,ravencrest,1373,priest,holy,39,19,20
Insicompany,antonidas,1371,priest,holy,110,60,50
Madcole,blackhand,1371,priest,holy,85,43,42
Demonhunt,stormscale,1370,priest,holy,88,48,40
Mydicine,ysondre,1370,priest,holy,48,23,25
Orcid,chogall,1369,priest,holy,169,88,81
Мектран,gordunni,1369,priest,holy,66,31,35
Konstigadan,twisting-nether,1369,priest,holy,56,26,30
Kiralinia,eredar,1368,priest,holy,180,94,86
Eurydike,blackrock,1367,priest,holy,152,84,68
Элдерле,gordunni,1367,priest,holy,71,38,33
Vibby,moonglade,1364,priest,holy,41,20,21
Elessee,the-maelstrom,1364,priest,holy,172,82,90
Meatyshaft,doomhammer,1363,priest,holy,69,34,35
Nomakprst,sanguino,1362,priest,holy,60,31,29
Midycine,ysondre,1360,priest,holy,322,164,158
Draconux,terenas,1359,priest,holy,105,51,54
Elunos,blackrock,1358,priest,holy,130,65,65
Rustyroll,stormscale,1358,priest,holy,72,36,36
Tëmärï,ravencrest,1356,priest,holy,72,46,26
Zorea,twisting-nether,1356,priest,holy,153,76,77
Маракеда,soulflayer,1356,priest,holy,65,32,33
Ábomínatíøn,ravencrest,1354,priest,holy,36,18,18
Zyrusen,sanguino,1354,priest,holy,48,21,27
Hyonzy,silvermoon,1353,priest,holy,339,170,169
Stk,outland,1353,priest,holy,47,17,30
Budgetinfa,draenor,1352,priest,holy,84,40,44
Justignoreme,tarren-mill,1349,priest,holy,59,31,28
Nino,gorgonnash,1349,priest,holy,114,55,59
Fjems,ravencrest,1348,priest,holy,60,33,27
Speltmor,stormscale,1347,priest,holy,95,47,48
Pridepriest,twisting-nether,1346,priest,holy,84,42,42
Írida,silvermoon,1346,priest,holy,40,20,20
Sugarush,ravencrest,1346,priest,holy,56,27,29
Prencø,sanguino,1345,priest,holy,34,16,18
Certe,twisting-nether,1344,priest,holy,139,67,72
Frednshield,tarren-mill,1343,priest,holy,45,29,16
Surge,drakthul,1343,priest,holy,39,22,17
Papadrak,kazzak,1343,priest,holy,101,55,46
Prîestitute,twisting-nether,1343,priest,holy,48,25,23
Pleadz,tarren-mill,1342,priest,holy,60,27,33
Azoran,dentarg,1341,priest,holy,24,14,10
Zellita,ravencrest,1340,priest,holy,114,45,69
Haineko,burning-legion,1339,priest,holy,135,65,70
Nykah,antonidas,1339,priest,holy,109,51,58
Аринэко,howling-fjord,1338,priest,holy,87,39,48
Баптисто,gordunni,1338,priest,holy,42,18,24
Calïxløve,der-rat-von-dalaran,1337,priest,holy,31,20,11
Xzarion,nozdormu,1336,priest,holy,41,19,22
Nálá,nethersturm,1335,priest,holy,115,59,56
Kolsäck,twilights-hammer,1334,priest,holy,30,14,16
Migam,kazzak,1331,priest,holy,285,142,143
Ayess,aegwynn,1330,priest,holy,65,37,28
Sücre,dalaran,1330,priest,holy,166,93,73
Fedorah,ragnaros,1330,priest,holy,114,63,51
Bigpinkballs,tarren-mill,1330,priest,holy,54,28,26
Avp,the-maelstrom,1329,priest,holy,66,36,30
Wedoburgers,ravencrest,1329,priest,holy,30,14,16
Alú,draenor,1327,priest,holy,153,73,80
Ageo,sanguino,1326,priest,holy,71,36,35
Luxtrii,blackrock,1326,priest,holy,48,20,28
Ebolaidman,ravencrest,1325,priest,holy,57,28,29
Natsuki,illidan,1325,priest,holy,55,24,31
Excó,burning-legion,1324,priest,holy,73,40,33
Talie,frostmourne,1323,priest,holy,36,21,15
Мефодийприст,howling-fjord,1322,priest,holy,36,14,22
Isalvation,stormscale,1321,priest,holy,30,14,16
Elynä,silvermoon,1318,priest,holy,78,50,28
Alros,elune,1318,priest,holy,84,40,44
Runbaberun,hyjal,1317,priest,holy,52,30,22
Tolteck,ravencrest,1317,priest,holy,144,77,67
Ниеса,lich-king,1317,priest,holy,152,78,74
Misscure,draenor,1317,priest,holy,159,76,83
Atiyesh,arthas,1315,priest,holy,285,149,136
Owait,tarren-mill,1312,priest,holy,60,27,33
Lazheal,khaz-modan,1311,priest,holy,186,104,82
Sepa,stormreaver,1311,priest,holy,30,14,16
Devot,outland,1311,priest,holy,30,14,16
Sickheals,doomhammer,1310,priest,holy,152,93,59
Bacardii,blackmoore,1308,priest,holy,24,14,10
Velenthan,ragnaros,1308,priest,holy,36,18,18
Navi,emerald-dream,1307,priest,holy,87,47,40
Mashimaro,blackhand,1307,priest,holy,198,102,96
Чёбушек,gordunni,1306,priest,holy,53,27,26
Hilerki,draenor,1305,priest,holy,36,16,20
Cherron,argent-dawn,1305,priest,holy,61,27,34
Tomassur,drakthul,1304,priest,holy,132,67,65
Brodoswaginz,the-maelstrom,1300,priest,holy,65,29,36
Асггард,borean-tundra,1299,priest,holy,91,57,34
Idisck,kazzak,1299,priest,holy,62,30,32
Ten,haomarush,1298,priest,holy,30,16,14
Makkalisser,kazzak,1298,priest,holy,41,20,21
Kasualoix,stormscale,1296,priest,holy,54,24,30
Lulubel,argent-dawn,1294,priest,holy,24,14,10
Hmanco,burning-legion,1293,priest,holy,466,236,230
Toastedbread,sylvanas,1293,priest,holy,78,34,44
Redpök,hyjal,1292,priest,holy,42,23,19
Soapie,defias-brotherhood,1291,priest,holy,78,42,36
Vrêth,blackmoore,1289,priest,holy,35,21,14
Brightharp,argent-dawn,1289,priest,holy,34,15,19
Maybelline,ravencrest,1285,priest,holy,54,28,26
Phénylanine,khaz-modan,1285,priest,holy,474,243,231
Nyygalease,burning-legion,1282,priest,holy,29,16,13
Rrpriest,silvermoon,1282,priest,holy,51,27,24
Josephr,blackmoore,1282,priest,holy,64,31,33
Vocolieth,argent-dawn,1281,priest,holy,214,103,111
Dètox,twisting-nether,1280,priest,holy,92,44,48
Evílz,tarren-mill,1280,priest,holy,39,14,25
Kayia,bloodfeather,1279,priest,holy,37,16,21
Вакидзачи,gordunni,1278,priest,holy,269,130,139
Síuu,kazzak,1277,priest,holy,72,35,37
Alloktonos,ravencrest,1276,priest,holy,122,60,62
Nemista,hyjal,1276,priest,holy,124,58,66
Nerfnerf,kazzak,1275,priest,holy,93,51,42
Qazar,draenor,1274,priest,holy,48,27,21
Lavidu,antonidas,1274,priest,holy,42,15,27
Skryllette,archimonde,1272,priest,holy,54,25,29
Wintercurse,twisting-nether,1272,priest,holy,52,24,28
Zakhun,stormrage,1271,priest,holy,82,42,40
Resuscitator,spinebreaker,1271,priest,holy,28,14,14
Neeyø,blackhand,1271,priest,holy,42,16,26
Mîssandé,blackhand,1270,priest,holy,94,42,52
Êfnân,twisting-nether,1269,priest,holy,30,18,12
Umayyaa,sylvanas,1268,priest,holy,86,35,51
Kardínal,darkspear,1267,priest,holy,67,29,38
Хасгерион,gordunni,1267,priest,holy,100,42,58
Sapphos,ravencrest,1266,priest,holy,71,37,34
Ethery,argent-dawn,1266,priest,holy,65,33,32
Selfcontrol,blackhand,1266,priest,holy,38,16,22
Yinyangyø,eredar,1266,priest,holy,42,16,26
Lianzo,kazzak,1265,priest,holy,36,16,20
Xxanthos,ysondre,1263,priest,holy,424,224,200
Twh,outland,1263,priest,holy,33,15,18
Tépinette,chogall,1262,priest,holy,36,19,17
Tudiiheals,frostwolf,1261,priest,holy,91,48,43
Köküshibö,draenor,1261,priest,holy,27,14,13
Elf,tarren-mill,1259,priest,holy,54,21,33
Piizzdiica,twisting-nether,1258,priest,holy,30,16,14
Blazekk,sylvanas,1258,priest,holy,62,25,37
Disturbdtwo,archimonde,1257,priest,holy,35,16,19
Dôppler,archimonde,1256,priest,holy,23,14,9
Rostá,drakthul,1256,priest,holy,53,27,26
Mikasaa,frostwolf,1256,priest,holy,53,20,33
Ludriel,turalyon,1254,priest,holy,78,40,38
Асах,gordunni,1254,priest,holy,144,71,73
Peg,talnivarr,1252,priest,holy,31,15,16
Rhaegalia,nemesis,1252,priest,holy,60,18,42
Antiexhile,kazzak,1251,priest,holy,35,21,14
Lhyria,baelgun,1251,priest,holy,67,33,34
Pryna,dunemaul,1250,priest,holy,84,43,41
Gloxina,argent-dawn,1250,priest,holy,114,56,58
Daubulaieipl,hellfire,1249,priest,holy,42,25,17
Gudóngmae,ravencrest,1248,priest,holy,24,13,11
Cemiing,drakthul,1248,priest,holy,36,18,18
Slimemarther,nordrassil,1248,priest,holy,141,65,76
Like,frostwolf,1247,priest,holy,30,15,15
Emilysister,kazzak,1247,priest,holy,201,98,103
Dathlight,argent-dawn,1246,priest,holy,125,65,60
Фирец,howling-fjord,1246,priest,holy,36,13,23
Sloee,kazzak,1245,priest,holy,18,13,5
Jingling,kazzak,1245,priest,holy,18,13,5
Ltr,tarren-mill,1245,priest,holy,24,13,11
Judgementdaý,kazzak,1245,priest,holy,24,13,11
Skíps,sylvanas,1242,priest,holy,103,48,55
Sodatsu,cthun,1242,priest,holy,60,26,34
Døgfîsh,stormscale,1241,priest,holy,18,13,5
Azeeza,stormscale,1240,priest,holy,18,13,5
Ashrod,stormscale,1240,priest,holy,67,34,33
Кинвартиль,gordunni,1240,priest,holy,30,14,16
Zerotalent,stormscale,1238,priest,holy,18,13,5
Голнар,deathguard,1238,priest,holy,70,33,37
Highgloss,ravencrest,1238,priest,holy,30,13,17
Danglar,defias-brotherhood,1237,priest,holy,18,13,5
Moirgana,minahonda,1235,priest,holy,87,39,48
Elián,silvermoon,1234,priest,holy,75,39,36
Vaporfly,deathwing,1234,priest,holy,36,13,23
Morrydin,stormreaver,1233,priest,holy,108,48,60
Amorune,twilights-hammer,1233,priest,holy,30,13,17
Enaches,twisting-nether,1231,priest,holy,92,53,39
Forsetî,archimonde,1230,priest,holy,48,25,23
Fuloo,stormscale,1230,priest,holy,197,96,101
Gummi,blackhand,1230,priest,holy,72,31,41
Senbønzakùra,khaz-modan,1229,priest,holy,120,63,57
Elvorfidia,silvermoon,1229,priest,holy,96,44,52
Çirelia,tarren-mill,1229,priest,holy,41,18,23
Mabz,defias-brotherhood,1229,priest,holy,36,13,23
Iljas,kelthuzad,1228,priest,holy,122,69,53
Tasarla,tarren-mill,1228,priest,holy,36,17,19
Ihavewings,kazzak,1228,priest,holy,30,13,17
Dwano,balnazzar,1227,priest,holy,51,30,21
Swdjack,blackrock,1225,priest,holy,36,13,23
Drdiscospec,tarren-mill,1222,priest,holy,36,20,16
Ashesnéy,thrall,1222,priest,holy,99,51,48
Ичисанчик,howling-fjord,1222,priest,holy,26,13,13
Lykarion,argent-dawn,1221,priest,holy,78,38,40
Delebyan,azjolnerub,1221,priest,holy,56,27,29
Madnasty,azshara,1220,priest,holy,36,20,16
Prästera,draenor,1216,priest,holy,88,42,46
Avtarra,ravencrest,1215,priest,holy,198,96,102
Hølýðéåthjçç,tarren-mill,1215,priest,holy,94,44,50
Neenä,ravencrest,1214,priest,holy,50,25,25
Dúréx,sanguino,1212,priest,holy,42,28,14
Lobogaust,kargath,1212,priest,holy,296,165,131
Gaijins,tyrande,1211,priest,holy,36,18,18
Libetha,ysondre,1211,priest,holy,95,46,49
Morîana,les-sentinelles,1209,priest,holy,89,44,45
Anateoris,turalyon,1208,priest,holy,269,121,148
Asare,outland,1207,priest,holy,383,192,191
Shannywen,nemesis,1207,priest,holy,60,18,42
Rhäenÿra,hyjal,1204,priest,holy,82,46,36
Shalalalalaè,outland,1204,priest,holy,76,40,36
Proteco,antonidas,1204,priest,holy,42,22,20
Sohryø,drekthar,1204,priest,holy,133,65,68
Crimatoriá,rajaxx,1203,priest,holy,114,64,50
Omnissiiah,silvermoon,1203,priest,holy,30,13,17
Скартэикс,howling-fjord,1202,priest,holy,72,33,39
Góli,argent-dawn,1200,priest,holy,30,13,17
Testdeex,ravencrest,1197,priest,holy,23,13,10
Retardé,tarren-mill,1197,priest,holy,38,14,24
Unchainedz,twisting-nether,1196,priest,holy,88,39,49
Nashidara,frostmane,1195,priest,holy,33,14,19
Холреин,gordunni,1195,priest,holy,72,25,47
Nathamo,archimonde,1194,priest,holy,30,15,15
Keskiyö,ravencrest,1193,priest,holy,27,14,13
Benificent,argent-dawn,1192,priest,holy,76,38,38
Sokolado,silvermoon,1187,priest,holy,54,28,26
Бенигана,soulflayer,1187,priest,holy,70,35,35
Nicksiz,silvermoon,1187,priest,holy,52,20,32
Ripjuice,sylvanas,1186,priest,holy,84,44,40
Gød,magtheridon,1186,priest,holy,46,14,32
Dotterin,draenor,1185,priest,holy,35,19,16
Zongiz,azjolnerub,1185,priest,holy,52,26,26
Holydolly,doomhammer,1184,priest,holy,108,55,53
Bowie,frostwhisper,1183,priest,holy,96,41,55
Холимыша,blackscar,1182,priest,holy,63,32,31
Карнотит,howling-fjord,1182,priest,holy,48,16,32
Chiccaii,draenor,1180,priest,holy,54,25,29
Berrylee,twisting-nether,1177,priest,holy,28,14,14
Zloop,tarren-mill,1175,priest,holy,36,17,19
Mandzukic,stormscale,1175,priest,holy,83,36,47
Jarnary,blackmoore,1171,priest,holy,75,33,42
Mårdelol,outland,1171,priest,holy,30,13,17
Fareeya,thrall,1171,priest,holy,48,20,28
Nosgot,earthen-ring,1169,priest,holy,78,34,44
Mugyu,antonidas,1169,priest,holy,47,19,28
Matdd,arthas,1168,priest,holy,60,29,31
Torcena,garrosh,1166,priest,holy,141,70,71
Killtrew,ravencrest,1165,priest,holy,39,13,26
Voidsoul,blackmoore,1163,priest,holy,23,15,8
Cóòkie,silvermoon,1163,priest,holy,36,16,20
Kbakå,stormscale,1162,priest,holy,71,29,42
Voreno,alonsus,1160,priest,holy,65,24,41
Drypri,twisting-nether,1158,priest,holy,26,13,13
Lyla,frostwolf,1156,priest,holy,100,52,48
Eîslotus,blackrock,1156,priest,holy,119,53,66
Kiånå,teldrassil,1152,priest,holy,257,119,138
Nenku,minahonda,1151,priest,holy,18,12,6
Jmp,tarren-mill,1151,priest,holy,18,12,6
Lúthien,outland,1150,priest,holy,18,12,6
Satins,silvermoon,1150,priest,holy,21,13,8
Swdömmel,aegwynn,1150,priest,holy,24,12,12
Seeyae,ravencrest,1149,priest,holy,24,12,12
Æbe,tarren-mill,1148,priest,holy,24,12,12
Tansk,stormscale,1147,priest,holy,24,12,12
Sambiel,antonidas,1147,priest,holy,42,13,29
Ertruski,exodar,1146,priest,holy,54,28,26
Wonderdispel,ragnaros,1146,priest,holy,24,12,12
Ilerya,hyjal,1145,priest,holy,70,35,35
Nancey,draenor,1145,priest,holy,24,12,12
Vaenor,durotan,1145,priest,holy,30,12,18
Raygone,kirin-tor,1144,priest,holy,30,12,18
Ломаюключики,gordunni,1143,priest,holy,96,50,46
Hepakko,stormscale,1143,priest,holy,24,12,12
Libido,outland,1142,priest,holy,36,17,19
Healthebeast,kazzak,1141,priest,holy,18,12,6
Ахмох,gordunni,1139,priest,holy,30,13,17
Leyrie,draenor,1138,priest,holy,69,25,44
Domerick,outland,1136,priest,holy,30,12,18
Kaleycuoco,blackhand,1133,priest,holy,24,12,12
Rastafaja,doomhammer,1133,priest,holy,83,34,49
Athissa,draenor,1133,priest,holy,36,14,22
Deltapriest,shadowsong,1132,priest,holy,24,12,12
Andreel,ravencrest,1131,priest,holy,24,12,12
Cisarpriest,silvermoon,1130,priest,holy,18,12,6
Morphuz,tarren-mill,1130,priest,holy,186,86,100
Cazzîe,eredar,1129,priest,holy,18,12,6
Deeforce,argent-dawn,1128,priest,holy,103,58,45
Хилтихон,howling-fjord,1128,priest,holy,48,26,22
Meowcakes,stormscale,1127,priest,holy,54,30,24
Krilight,sargeras,1126,priest,holy,36,13,23
Asraje,eredar,1121,priest,holy,68,39,29
Hampådenbååd,kazzak,1119,priest,holy,22,13,9
Brigied,turalyon,1118,priest,holy,363,172,191
Copperplume,ravenholdt,1116,priest,holy,264,124,140
Türapea,draenor,1114,priest,holy,66,37,29
Voelvah,ragnaros,1108,priest,holy,48,18,30
Mundwerk,malganis,1107,priest,holy,60,22,38
Mindgame,anachronos,1105,priest,holy,96,42,54
Каятль,gordunni,1105,priest,holy,53,21,32
Beatla,khaz-modan,1104,priest,holy,75,40,35
Pristerline,antonidas,1104,priest,holy,31,12,19
Elîsyø,blackmoore,1103,priest,holy,30,12,18
Anàriel,elune,1100,priest,holy,48,19,29
Thingsy,draenor,1099,priest,holy,104,54,50
Nakali,the-maelstrom,1095,priest,holy,79,38,41
Itstooney,doomhammer,1093,priest,holy,36,19,17
Shaniqua,saurfang,1093,priest,holy,104,53,51
Miniluk,zuljin,1092,priest,holy,116,62,54
Cheeséd,ravencrest,1090,priest,holy,28,13,15
Åme,kirin-tor,1089,priest,holy,54,19,35
Holypowér,twisting-nether,1088,priest,holy,30,17,13
Grausami,zuluhed,1083,priest,holy,35,12,23
Naieli,antonidas,1079,priest,holy,92,49,43
Киторик,blackscar,1078,priest,holy,77,37,40
Vouhza,turalyon,1077,priest,holy,96,48,48
Ulrach,hyjal,1077,priest,holy,27,13,14
Baabaak,frostmane,1074,priest,holy,99,57,42
Quatorze,voljin,1074,priest,holy,40,20,20
Sablo,blackrock,1073,priest,holy,30,12,18
Ankhepope,outland,1070,priest,holy,74,43,31
Larisä,uldum,1070,priest,holy,201,96,105
Pretzioso,nemesis,1069,priest,holy,142,69,73
Drràcø,hyjal,1068,priest,holy,39,17,22
Sáro,ravencrest,1066,priest,holy,50,21,29
Sucukpriest,blackrock,1065,priest,holy,38,22,16
Náshy,argent-dawn,1065,priest,holy,89,49,40
Kæos,blackrock,1065,priest,holy,129,58,71
Vampiro,blackhand,1062,priest,holy,20,12,8
Akwah,dalaran,1059,priest,holy,54,19,35
Nightwemet,kirin-tor,1058,priest,holy,48,23,25
Tezzi,azjolnerub,1058,priest,holy,97,46,51
Eile,doomhammer,1058,priest,holy,36,17,19
Sâtânica,kelthuzad,1057,priest,holy,175,81,94
Làñàt,kazzak,1056,priest,holy,12,11,1
Neems,twisting-nether,1056,priest,holy,24,11,13
Луилэнс,howling-fjord,1055,priest,holy,18,11,7
Миррен,gordunni,1055,priest,holy,18,11,7
Øbz,sylvanas,1055,priest,holy,24,11,13
Åçrû,dun-modr,1055,priest,holy,24,11,13
Cãlyr,ragnaros,1055,priest,holy,30,11,19
Swiftdemise,sylvanas,1054,priest,holy,18,11,7
Dreê,hyjal,1054,priest,holy,18,11,7
Тевтонка,goldrinn,1054,priest,holy,80,38,42
Сонлия,gordunni,1054,priest,holy,24,11,13
Duskojar,kazzak,1054,priest,holy,24,11,13
Рейеан,soulflayer,1054,priest,holy,24,11,13
Uro,tirion,1053,priest,holy,30,11,19
Арингол,howling-fjord,1052,priest,holy,58,27,31
Mgx,defias-brotherhood,1052,priest,holy,30,11,19
Tyog,khazgoroth,1051,priest,holy,18,11,7
Крайл,blackscar,1051,priest,holy,111,37,74
Leyea,kazzak,1050,priest,holy,55,28,27
Elinaa,die-aldor,1050,priest,holy,24,11,13
Saheila,defias-brotherhood,1050,priest,holy,30,11,19
Peelz,uldaman,1050,priest,holy,30,11,19
Syhndel,draenor,1049,priest,holy,24,11,13
Exola,outland,1049,priest,holy,36,11,25
Murmaiderrx,draenor,1048,priest,holy,24,11,13
Aureï,khaz-modan,1047,priest,holy,30,12,18
Overdøz,archimonde,1047,priest,holy,30,11,19
Bamboleon,blackrock,1046,priest,holy,24,11,13
Båbak,frostmane,1045,priest,holy,69,36,33
Tákú,blackmoore,1045,priest,holy,116,55,61
Lindp,stormreaver,1045,priest,holy,24,11,13
Harlemsfnest,blackrock,1042,priest,holy,24,13,11
Priincess,ragnaros,1039,priest,holy,94,38,56
Астит,soulflayer,1035,priest,holy,54,18,36
Orcü,tarren-mill,1033,priest,holy,78,36,42
Fratio,krasus,1033,priest,holy,42,18,24
Wildjaevel,grim-batol,1033,priest,holy,30,11,19
Laewen,die-aldor,1032,priest,holy,82,39,43
Priestyo,blackrock,1031,priest,holy,45,17,28
Juicedmaboi,tarren-mill,1028,priest,holy,24,11,13
Valdos,hyjal,1026,priest,holy,48,16,32
Salzholy,malygos,1021,priest,holy,23,11,12
Siarai,pozzo-delleternità,1020,priest,holy,94,48,46
Onnovq,ravencrest,1017,priest,holy,23,11,12
Epona,terrordar,1017,priest,holy,24,11,13
Haregnor,gorgonnash,1016,priest,holy,54,22,32
Moriou,dun-morogh,1015,priest,holy,24,13,11
Noroelle,drakthul,1015,priest,holy,24,12,12
Edvardy,stormreaver,1014,priest,holy,23,11,12
Tiphanie,kazzak,1014,priest,holy,101,45,56
Барух,blackscar,1010,priest,holy,35,18,17
Hegg,ghostlands,1010,priest,holy,60,17,43
Narwarion,die-aldor,1006,priest,holy,90,42,48
Monetaria,das-syndikat,1006,priest,holy,184,84,100
Docmercy,dun-morogh,1004,priest,holy,78,32,46
Valtessian,medivh,1000,priest,holy,75,37,38
Spoc,blackrock,1000,priest,holy,30,11,19
Hipnotika,nemesis,997,priest,holy,76,29,47
Ivaldur,antonidas,996,priest,holy,66,31,35
Kímbérléy,argent-dawn,995,priest,holy,207,102,105
Areonas,alleria,994,priest,holy,99,40,59
Diszi,norgannon,992,priest,holy,26,12,14
Loordïngue,eldrethalas,992,priest,holy,24,11,13
Zerula,outland,990,priest,holy,42,21,21
Covidios,twisting-nether,990,priest,holy,93,43,50
Zakkonnik,burning-legion,989,priest,holy,24,14,10
Applecrumßle,ragnaros,983,priest,holy,71,35,36
Phasmofobia,ragnaros,981,priest,holy,69,20,49
Рикимарочка,gordunni,977,priest,holy,54,20,34
Eowix,argent-dawn,975,priest,holy,46,14,32
Xver,dun-morogh,973,priest,holy,30,11,19
Maxý,ravencrest,971,priest,holy,66,30,36
Dampfwalze,nozdormu,969,priest,holy,67,33,34
Lixyrealeia,hellscream,963,priest,holy,30,19,11
Amemiya,ragnaros,961,priest,holy,28,12,16
Artístx,twisting-nether,960,priest,holy,24,10,14
Десемин,deathguard,960,priest,holy,47,18,29
Marôs,antonidas,959,priest,holy,12,10,2
Mcmuffin,runetotem,959,priest,holy,21,13,8
Dqt,ragnaros,959,priest,holy,18,10,8
Padisonpain,blackmoore,959,priest,holy,18,10,8
Рагзел,howling-fjord,959,priest,holy,18,10,8
Iirina,draenor,959,priest,holy,18,10,8
Maryjanè,twisting-nether,959,priest,holy,18,10,8
Zeratwo,eredar,959,priest,holy,21,11,10
Eilene,pozzo-delleternità,959,priest,holy,24,10,14
Nûtqt,archimonde,958,priest,holy,18,10,8
Lâughing,ravencrest,958,priest,holy,24,10,14
Lenneyqt,blackmoore,958,priest,holy,24,10,14
Bebwaz,kazzak,958,priest,holy,24,10,14
Vänskap,kazzak,958,priest,holy,24,10,14
Mesticore,nethersturm,958,priest,holy,24,10,14
Stinkynoob,kazzak,958,priest,holy,24,10,14
Azrella,ravencrest,957,priest,holy,18,10,8
Byebee,stormscale,956,priest,holy,12,10,2
Ilsebill,nerathor,956,priest,holy,47,26,21
Nøfear,tarren-mill,956,priest,holy,35,10,25
Rennic,stormscale,955,priest,holy,18,10,8
Нёрфмили,soulflayer,955,priest,holy,24,10,14
Akhi,dun-morogh,954,priest,holy,24,10,14
Arkkupiispa,stormreaver,954,priest,holy,24,10,14
Nannymcfee,stormscale,953,priest,holy,23,11,12
Vengigodxx,ravencrest,952,priest,holy,18,10,8
Melancholly,thunderhorn,951,priest,holy,41,19,22
Avïlia,dalaran,950,priest,holy,30,10,20
Smø,kazzak,949,priest,holy,30,10,20
Hegêan,argent-dawn,945,priest,holy,83,40,43
Popé,steamwheedle-cartel,943,priest,holy,27,15,12
Лалуса,gordunni,943,priest,holy,46,19,27
Hodza,frostmane,941,priest,holy,114,64,50
Meenaye,hyjal,940,priest,holy,18,10,8
Addison,die-aldor,933,priest,holy,24,10,14
Lunne,les-clairvoyants,931,priest,holy,30,17,13
Majdas,ravencrest,927,priest,holy,14,11,3
Noukeé,blackrock,927,priest,holy,29,10,19
Jitters,lightnings-blade,925,priest,holy,18,11,7
Isiriah,archimonde,925,priest,holy,24,10,14
Maphiko,blackhand,922,priest,holy,14,11,3
Xal,drekthar,917,priest,holy,324,144,180
Archangel,terokkar,916,priest,holy,60,30,30
Chaendral,darkmoon-faire,911,priest,holy,32,11,21
Kanki,haomarush,908,priest,holy,96,48,48
Ламедрис,gordunni,904,priest,holy,41,10,31
Infinitiy,sylvanas,900,priest,holy,53,25,28
Rahela,sanguino,897,priest,holy,23,11,12
Пристотян,gordunni,894,priest,holy,20,10,10
Xlhealscptn,arathor,889,priest,holy,66,19,47
Sîanah,archimonde,886,priest,holy,28,11,17
Fivequeens,tarren-mill,883,priest,holy,60,25,35
Protegee,draenor,879,priest,holy,87,30,57
Unborkenn,ragnaros,873,priest,holy,60,25,35
Авэнсис,howling-fjord,869,priest,holy,54,21,33
Lanat,ravencrest,864,priest,holy,12,9,3
Chimplordx,argent-dawn,864,priest,holy,12,9,3
Aeqüitas,tarren-mill,864,priest,holy,15,10,5
Crowny,ysondre,864,priest,holy,18,9,9
Verti,outland,864,priest,holy,18,9,9
Rhæveth,ravencrest,864,priest,holy,18,9,9
Zeraphïn,eredar,864,priest,holy,18,9,9
Mazeari,sylvanas,864,priest,holy,18,9,9
Ømegagødx,outland,864,priest,holy,30,9,21
Âlolexx,archimonde,863,priest,holy,12,9,3
Narinelepen,culte-de-la-rive-noire,863,priest,holy,24,9,15
Ashp,shattered-halls,863,priest,holy,24,9,15
Dorque,ravencrest,862,priest,holy,12,9,3
Kalkudis,blackmoore,862,priest,holy,18,9,9
Viroxian,outland,862,priest,holy,18,9,9
Oxiièmort,khaz-modan,862,priest,holy,24,9,15
Arezou,ravencrest,861,priest,holy,24,9,15
Didntlos,aegwynn,861,priest,holy,24,9,15
Hónòr,sylvanas,861,priest,holy,30,9,21
Durinsbane,silvermoon,860,priest,holy,18,9,9
Marey,blackmoore,860,priest,holy,24,9,15
Azaza,burning-legion,851,priest,holy,55,25,30
Barbiemeth,silvermoon,851,priest,holy,29,11,18
Centauria,burning-legion,851,priest,holy,60,17,43
Widok,kazzak,848,priest,holy,113,58,55
Ayahuascarli,ravencrest,847,priest,holy,17,9,8
Jbte,silvermoon,845,priest,holy,36,9,27
Sosûke,archimonde,830,priest,holy,23,9,14
Cherrih,argent-dawn,829,priest,holy,23,9,14
Eglantinna,ravencrest,809,priest,holy,14,10,4
Vyràn,onyxia,809,priest,holy,23,10,13
Blaulienchen,proudmoore,808,priest,holy,42,17,25
Пейлон,howling-fjord,807,priest,holy,43,14,29
Safiira,argent-dawn,798,priest,holy,132,64,68
Nokizzle,antonidas,795,priest,holy,14,9,5
Zargathx,kazzak,778,priest,holy,19,10,9
Egi,lothar,768,priest,holy,12,8,4
Zeruhphin,eredar,768,priest,holy,12,8,4
Whitemask,kazzak,768,priest,holy,12,8,4
Lloreen,ravencrest,768,priest,holy,12,8,4
Vyrá,der-rat-von-dalaran,768,priest,holy,12,8,4
Dès,ravencrest,768,priest,holy,12,8,4
Isweariheal,twisting-nether,768,priest,holy,12,8,4
Джулибуба,borean-tundra,768,priest,holy,18,8,10
Gimeurgold,destromath,768,priest,holy,18,8,10
Legitha,blackmoore,768,priest,holy,18,8,10
Randomxdisc,draenor,767,priest,holy,12,8,4
Experimentix,silvermoon,767,priest,holy,12,8,4
Shyoû,blackmoore,767,priest,holy,13,8,5
Racialkekl,hyjal,767,priest,holy,18,8,10
Lovely,silvermoon,767,priest,holy,18,8,10
Artés,suramar,767,priest,holy,18,8,10
Glyss,draenor,767,priest,holy,18,8,10
Neagica,kazzak,767,priest,holy,18,8,10
Arits,tarren-mill,767,priest,holy,18,8,10
Hannïri,archimonde,767,priest,holy,18,8,10
Lamáxima,dun-modr,767,priest,holy,24,8,16
Priesless,sylvanas,766,priest,holy,18,8,10
Malizia,ragnaros,766,priest,holy,18,8,10
Sayash,chamber-of-aspects,766,priest,holy,18,8,10
Quiwzx,blackrock,766,priest,holy,18,8,10
Knóld,draenor,766,priest,holy,24,8,16
Drêäms,archimonde,766,priest,holy,24,8,16
Helerys,archimonde,766,priest,holy,24,8,16
Elenie,frostwolf,766,priest,holy,30,8,22
Aladra,archimonde,765,priest,holy,30,8,22
Nargøff,tarren-mill,764,priest,holy,18,8,10
Anyea,dalaran,764,priest,holy,24,8,16
Элизабетшорт,soulflayer,763,priest,holy,18,8,10
Hellhámmer,azshara,763,priest,holy,18,8,10
Taint,khadgar,762,priest,holy,12,8,4
Lasanka,sylvanas,761,priest,holy,24,8,16
Melissasky,ragnaros,760,priest,holy,60,22,38
Chyen,kult-der-verdammten,758,priest,holy,18,8,10
Avinci,blackrock,757,priest,holy,18,8,10
Piddá,twisting-nether,755,priest,holy,18,8,10
Lockmold,tarren-mill,755,priest,holy,27,11,16
Nevermd,blackrock,755,priest,holy,43,11,32
Spàgno,nemesis,750,priest,holy,24,8,16
Phelesto,ysera,749,priest,holy,104,46,58
Besmrtna,saurfang,749,priest,holy,23,8,15
Waycrest,ravencrest,746,priest,holy,23,11,12
Eternitiy,auchindoun,744,priest,holy,18,8,10
Englishheart,auchindoun,734,priest,holy,17,8,9
Mønsterx,kazzak,732,priest,holy,16,9,7
Kirvane,outland,724,priest,holy,20,10,10
Popå,aerie-peak,724,priest,holy,36,8,28
Fatherted,nagrand,722,priest,holy,64,17,47
Emessary,scarshield-legion,715,priest,holy,24,10,14
Felvytwo,stormscale,714,priest,holy,24,9,15
Aspertina,outland,714,priest,holy,27,9,18
Iliridan,pozzo-delleternità,708,priest,holy,194,62,132
Valentinus,dragonmaw,702,priest,holy,26,8,18
Mélínâ,blackmoore,691,priest,holy,28,9,19
Yanclown,tarren-mill,672,priest,holy,12,7,5
Ibunnyqt,aegwynn,672,priest,holy,12,7,5
Artìst,ravencrest,672,priest,holy,12,7,5
Jaytï,ravencrest,672,priest,holy,12,7,5
Fxd,talnivarr,672,priest,holy,12,7,5
Môrtïciâ,tarren-mill,672,priest,holy,12,7,5
Raw,dragonblight,672,priest,holy,12,7,5
Arabpriest,draenor,672,priest,holy,12,7,5
Namîxoxo,ysondre,672,priest,holy,12,7,5
Willzah,outland,672,priest,holy,12,7,5
Nelakya,blackmoore,672,priest,holy,12,7,5
Гшд,gordunni,672,priest,holy,12,7,5
Lucksy,antonidas,672,priest,holy,12,7,5
Darkoul,conseil-des-ombres,672,priest,holy,12,7,5
Burnesenbois,chogall,672,priest,holy,12,7,5
Ботхесатва,deepholm,672,priest,holy,12,7,5
Mythasz,archimonde,672,priest,holy,16,8,8
Naïcos,dun-modr,672,priest,holy,18,7,11
Nooblygaming,nemesis,672,priest,holy,18,7,11
Westfalen,tichondrius,672,priest,holy,18,7,11
Valinoru,silvermoon,672,priest,holy,18,7,11
Russianpvp,outland,672,priest,holy,18,7,11
Fabulicious,blackrock,672,priest,holy,18,7,11
Missbarbados,blackmoore,672,priest,holy,18,7,11
Ticklypriest,outland,672,priest,holy,18,7,11
Synexia,sylvanas,671,priest,holy,12,7,5
Gujjax,doomhammer,671,priest,holy,12,7,5
Jajada,kazzak,671,priest,holy,18,7,11
Systerstål,twisting-nether,671,priest,holy,18,7,11
Egozyp,kazzak,671,priest,holy,20,7,13
Kineila,dun-morogh,671,priest,holy,24,7,17
Carðinal,dentarg,670,priest,holy,18,7,11
Smolbøi,tarren-mill,670,priest,holy,24,7,17
Luffly,draenor,669,priest,holy,12,7,5
Haileybailey,stormreaver,669,priest,holy,12,7,5
Asmila,die-nachtwache,669,priest,holy,18,7,11
Anòther,the-maelstrom,667,priest,holy,15,8,7
Zinary,silvermoon,667,priest,holy,18,7,11
Datek,silvermoon,667,priest,holy,18,7,11
Lovestruck,kazzak,665,priest,holy,18,7,11
Ларуса,gordunni,662,priest,holy,15,8,7
Yayaxoxo,archimonde,660,priest,holy,26,10,16
Ledarz,dun-morogh,658,priest,holy,18,7,11
Sarafîsthole,ysondre,655,priest,holy,18,7,11
Kaliboom,archimonde,654,priest,holy,23,7,16
Naid,exodar,654,priest,holy,24,7,17
Níghty,ravencrest,639,priest,holy,11,7,4
Killtrewerty,stormscale,638,priest,holy,17,7,10
Branmer,silvermoon,627,priest,holy,29,7,22
Sinetrax,tarren-mill,624,priest,holy,17,8,9
Winilo,ravencrest,622,priest,holy,17,7,10
Wixzyx,ravencrest,618,priest,holy,14,8,6
Svakkanxd,kazzak,618,priest,holy,19,8,11
Zauxx,blackhand,614,priest,holy,28,8,20
Fréecaster,ravencrest,607,priest,holy,11,7,4
Valves,saurfang,604,priest,holy,164,70,94
Blâdes,gorgonnash,589,priest,holy,17,7,10
Trollpriest,khadgar,576,priest,holy,6,6,0
Babá,argent-dawn,576,priest,holy,6,6,0
Ahilarry,tarren-mill,576,priest,holy,12,6,6
Xblanque,kazzak,576,priest,holy,12,6,6
Knobibobby,blackrock,576,priest,holy,12,6,6
Múixi,dun-modr,576,priest,holy,12,6,6
Redy,drakthul,576,priest,holy,12,6,6
Aevery,onyxia,576,priest,holy,12,6,6
Priestok,archimonde,576,priest,holy,12,6,6
Anthonyn,ravencrest,576,priest,holy,12,6,6
Schattenface,blackmoore,576,priest,holy,12,6,6
Brûshie,kazzak,576,priest,holy,12,6,6
Shadowkym,blackrock,576,priest,holy,12,6,6
Azymi,ravencrest,576,priest,holy,12,6,6
Tsuser,blackrock,576,priest,holy,12,6,6
Bij,outland,576,priest,holy,12,6,6
Ixxmp,blackrock,576,priest,holy,12,6,6
Shreedx,stormscale,576,priest,holy,12,6,6
Drée,hyjal,576,priest,holy,12,6,6
Crinji,blackmoore,576,priest,holy,12,6,6
Pwsx,draenor,576,priest,holy,12,6,6
Eoraoierai,ragnaros,576,priest,holy,12,6,6
Danina,outland,576,priest,holy,12,6,6
Darkoul,ravencrest,576,priest,holy,12,6,6
Reverend,azuremyst,576,priest,holy,12,6,6
Tribz,kargath,576,priest,holy,12,6,6
Emnm,shattered-hand,576,priest,holy,15,7,8
Jhaazx,nemesis,576,priest,holy,14,6,8
Ñya,sylvanas,576,priest,holy,14,6,8
Satora,arathor,576,priest,holy,18,6,12
Ckxd,ravencrest,576,priest,holy,18,6,12
Батлджес,gordunni,576,priest,holy,18,6,12
Мотд,gordunni,576,priest,holy,18,6,12
Patatå,sanguino,576,priest,holy,18,6,12
Sinf,sanguino,576,priest,holy,18,6,12
Baldracca,shendralar,576,priest,holy,18,6,12
Старлайтх,gordunni,576,priest,holy,18,6,12
Amambo,chamber-of-aspects,576,priest,holy,18,6,12
Джагонх,soulflayer,576,priest,holy,24,6,18
Lifeisgg,draenor,576,priest,holy,24,6,18
Guddie,saurfang,575,priest,holy,12,6,6
Injured,bronzebeard,575,priest,holy,12,6,6
Dusktildawn,ragnaros,575,priest,holy,12,6,6
Níbbz,twisting-nether,575,priest,holy,12,6,6
Бояка,soulflayer,575,priest,holy,12,6,6
Waters,lightbringer,575,priest,holy,12,6,6
Wasfürsaft,tarren-mill,575,priest,holy,12,6,6
Tikama,aegwynn,575,priest,holy,18,6,12
Wavelength,stormscale,575,priest,holy,18,6,12
Healiea,outland,575,priest,holy,18,6,12
Dokurochan,tarren-mill,575,priest,holy,24,6,18
Wortgottes,blackrock,574,priest,holy,12,6,6
Holybomba,blackmoore,574,priest,holy,12,6,6
Saara,daggerspine,574,priest,holy,18,6,12
Roberic,silvermoon,574,priest,holy,18,6,12
Mingyue,thrall,574,priest,holy,24,6,18
Skatman,aggramar,574,priest,holy,27,6,21
Cayden,bloodfeather,573,priest,holy,12,6,6
Dinma,argent-dawn,573,priest,holy,18,6,12
Люцифиэль,ashenvale,571,priest,holy,12,6,6
Satyâ,kult-der-verdammten,571,priest,holy,12,6,6
Meladorable,elune,571,priest,holy,18,6,12
Proxypriest,the-maelstrom,571,priest,holy,20,6,14
Drop,los-errantes,569,priest,holy,12,6,6
Aliyaah,conseil-des-ombres,568,priest,holy,12,6,6
Bloodelfoula,draenor,563,priest,holy,18,6,12
Sos,nethersturm,558,priest,holy,28,10,18
Eyrìon,kazzak,543,priest,holy,16,6,10
Kyderr,blackrock,543,priest,holy,17,6,11
Equitalia,pozzo-delleternità,543,priest,holy,20,7,13
Enviro,argent-dawn,542,priest,holy,20,7,13
Fuzzymerge,ravencrest,528,priest,holy,21,7,14
Сандейрейн,gordunni,527,priest,holy,11,6,5
Shadowsig,silvermoon,522,priest,holy,19,7,12
Psychoboris,outland,521,priest,holy,19,7,12
Dotreveal,ravencrest,521,priest,holy,20,7,13
Reallittle,kazzak,520,priest,holy,21,7,14
Dayno,draenor,512,priest,holy,10,6,4
Madvortexe,kazzak,496,priest,holy,25,6,19
Ralek,hyjal,495,priest,holy,17,6,11
Hÿliaa,twisting-nether,480,priest,holy,6,5,1
Эйттёрналинь,fordragon,480,priest,holy,6,5,1
Deliriumxd,ravencrest,480,priest,holy,6,5,1
Holdmyfear,proudmoore,480,priest,holy,6,5,1
Ceedra,ravencrest,480,priest,holy,6,5,1
Toasttrii,outland,480,priest,holy,6,5,1
Mariahcarry,rexxar,480,priest,holy,6,5,1
Priestazie,madmortem,480,priest,holy,7,5,2
Holymamba,silvermoon,480,priest,holy,12,5,7
Shaquíloheal,blackrock,480,priest,holy,12,5,7
Релакз,soulflayer,480,priest,holy,12,5,7
Jaykerlordx,kazzak,480,priest,holy,12,5,7
Shâru,frostmourne,480,priest,holy,12,5,7
Velfchurch,draenor,480,priest,holy,12,5,7
Razamdi,drakthul,480,priest,holy,12,5,7
Teengirl,ravencrest,480,priest,holy,12,5,7
Azsemtwo,arathor,480,priest,holy,12,5,7
Mikò,blackmoore,480,priest,holy,12,5,7
Krematorio,twisting-nether,480,priest,holy,12,5,7
Ogiez,sylvanas,480,priest,holy,12,5,7
Sjuksyster,silvermoon,480,priest,holy,12,5,7
Wíft,argent-dawn,480,priest,holy,12,5,7
Selëne,blackrock,480,priest,holy,12,5,7
Nicolovato,draenor,480,priest,holy,12,5,7
Rzkp,eredar,480,priest,holy,12,5,7
Caz,cthun,480,priest,holy,12,5,7
Enèr,hyjal,480,priest,holy,12,5,7
Эвмениды,gordunni,480,priest,holy,12,5,7
Tygstycke,tarren-mill,480,priest,holy,12,5,7
Königlich,kiljaeden,480,priest,holy,12,5,7
Hodnkobold,kazzak,480,priest,holy,12,5,7
Sayala,dalaran,480,priest,holy,12,5,7
Mneme,aggramar,480,priest,holy,12,5,7
Quica,antonidas,480,priest,holy,12,5,7
Purist,arthas,480,priest,holy,12,5,7
Sãnsa,blackmoore,480,priest,holy,12,5,7
Pirkkapriest,stormreaver,480,priest,holy,12,5,7
Darkoulito,dalaran,480,priest,holy,12,5,7
Insânity,kazzak,480,priest,holy,12,5,7
Mönster,cthun,480,priest,holy,13,5,8
Drmacmoo,kazzak,480,priest,holy,18,5,13
Hugerage,stormreaver,480,priest,holy,18,5,13
Minimalist,ravencrest,480,priest,holy,18,5,13
Felascious,draenor,480,priest,holy,18,5,13
Vannax,arygos,479,priest,holy,6,5,1
Двакамня,soulflayer,479,priest,holy,12,5,7
Chabbe,ragnaros,479,priest,holy,12,5,7
Árcadoom,quelthalas,479,priest,holy,12,5,7
Grøums,blackmoore,479,priest,holy,12,5,7
Cocolasticot,garona,479,priest,holy,12,5,7
Inzané,doomhammer,479,priest,holy,12,5,7
Гидранист,soulflayer,479,priest,holy,18,5,13
Blaumeaux,eredar,479,priest,holy,18,5,13
Cazuky,malganis,479,priest,holy,18,5,13
Alaeddin,kazzak,479,priest,holy,24,5,19
Ларуся,soulflayer,478,priest,holy,12,5,7
Laxara,arthas,478,priest,holy,12,5,7
Priestdahl,ravencrest,478,priest,holy,18,5,13
Xaeo,burning-legion,477,priest,holy,26,5,21
Mazeari,tarren-mill,448,priest,holy,10,6,4
Пристомал,howling-fjord,446,priest,holy,14,6,8
Karoopi,ysondre,430,priest,holy,11,5,6
Secundis,silvermoon,425,priest,holy,14,6,8
Кариелла,fordragon,425,priest,holy,17,7,10
Carbonic,khaz-modan,418,priest,holy,20,10,10
Tavaera,antonidas,400,priest,holy,13,5,8
Shnookfour,agamaggan,392,priest,holy,26,7,19
Ltrxo,twisting-nether,384,priest,holy,6,4,2
Abomïnàtîon,ysondre,384,priest,holy,6,4,2
Brobert,nerathor,384,priest,holy,6,4,2
Gepeitschter,frostwolf,384,priest,holy,6,4,2
Mvce,outland,384,priest,holy,6,4,2
Beyal,tarren-mill,384,priest,holy,6,4,2
Trankilisimo,sanguino,384,priest,holy,6,4,2
Råcòøñ,ravencrest,384,priest,holy,6,4,2
Cløwnn,tarren-mill,384,priest,holy,6,4,2
Êliten,tarren-mill,384,priest,holy,6,4,2
Yredias,dalaran,384,priest,holy,6,4,2
Zymai,ravencrest,384,priest,holy,6,4,2
Luthsha,sylvanas,384,priest,holy,6,4,2
Frenchpriest,archimonde,384,priest,holy,6,4,2
Lostmybibles,twisting-nether,384,priest,holy,6,4,2
Igonnagrabu,malfurion,384,priest,holy,6,4,2
Trowe,tarren-mill,384,priest,holy,6,4,2
Mainputa,pozzo-delleternità,384,priest,holy,6,4,2
Shadowlander,dun-modr,384,priest,holy,6,4,2
Stazia,ravencrest,384,priest,holy,6,4,2
Indrades,blackmoore,384,priest,holy,6,4,2
Remkojatwo,blackrock,384,priest,holy,6,4,2
Velluspriest,burning-legion,384,priest,holy,6,4,2
Æsthëtìçgødx,exodar,384,priest,holy,6,4,2
Mainhunter,aegwynn,384,priest,holy,6,4,2
Даймэн,gordunni,384,priest,holy,6,4,2
Nevx,blackmoore,384,priest,holy,6,4,2
Holypoppa,ravencrest,384,priest,holy,6,4,2
Doctis,hyjal,384,priest,holy,6,4,2
Shinjicum,kazzak,384,priest,holy,9,5,4
Clergy,hellfire,384,priest,holy,12,4,8
Aladriela,exodar,384,priest,holy,12,4,8
Psychout,ravencrest,384,priest,holy,12,4,8
Fabuliciøus,blackrock,384,priest,holy,12,4,8
Ivysaurus,ravencrest,384,priest,holy,12,4,8
Alshah,emerald-dream,384,priest,holy,12,4,8
Disillusíon,tarren-mill,384,priest,holy,12,4,8
Salzgehalt,antonidas,384,priest,holy,12,4,8
Verweven,twisting-nether,384,priest,holy,12,4,8
Príêstjklól,stormscale,384,priest,holy,12,4,8
Alterlight,twisting-nether,384,priest,holy,12,4,8
Flurri,tarren-mill,384,priest,holy,12,4,8
Menda,eredar,384,priest,holy,12,4,8
Ashuramaru,drakthul,384,priest,holy,12,4,8
Ripperdepip,magtheridon,384,priest,holy,12,4,8
Naomi,ragnaros,384,priest,holy,12,4,8
Инстенли,howling-fjord,384,priest,holy,12,4,8
Bloodie,drakthul,384,priest,holy,12,4,8
Aratorass,malganis,384,priest,holy,12,4,8
Zarez,stormscale,384,priest,holy,12,4,8
Massasax,kazzak,384,priest,holy,12,4,8
Adäm,grim-batol,384,priest,holy,12,4,8
Gehrke,silvermoon,384,priest,holy,12,4,8
Chrisdorner,archimonde,384,priest,holy,12,4,8
Skytheory,eredar,384,priest,holy,13,4,9
Ðlcz,blackrock,384,priest,holy,18,4,14
Missdemerè,nemesis,384,priest,holy,18,4,14
Virgosenpai,silvermoon,384,priest,holy,18,4,14
Eihran,stormscale,384,priest,holy,18,4,14
Кэндимен,gordunni,384,priest,holy,18,4,14
Kheenah,argent-dawn,383,priest,holy,6,4,2
Hemmiz,archimonde,383,priest,holy,6,4,2
Allwhitte,confrérie-du-thorium,383,priest,holy,6,4,2
Kasimette,garona,383,priest,holy,6,4,2
Danklindots,silvermoon,383,priest,holy,12,4,8
Ynnaria,blackmoore,383,priest,holy,12,4,8
Dîakon,antonidas,383,priest,holy,12,4,8
Ruebi,blackmoore,383,priest,holy,12,4,8
Blackwidow,chromaggus,383,priest,holy,12,4,8
Harukaa,aggra-português,383,priest,holy,12,4,8
Yasminelopez,tarren-mill,381,priest,holy,18,4,14
Silverfate,outland,367,priest,holy,11,4,7
Эгнерия,eversong,367,priest,holy,17,4,13
Nxtlvl,stormscale,352,priest,holy,10,5,5
Apuessii,dun-modr,351,priest,holy,11,4,7
Lyndorien,argent-dawn,336,priest,holy,9,4,5
Worgster,malganis,336,priest,holy,21,4,17
Buffholy,kazzak,330,priest,holy,17,6,11
Shrshbilah,kazzak,330,priest,holy,15,5,10
Shyvi,ravencrest,319,priest,holy,5,4,1
Ostrogami,silvermoon,319,priest,holy,8,4,4
Shadowdae,outland,319,priest,holy,8,4,4
Zahadoom,stormscale,319,priest,holy,12,5,7
Amanthus,draenor,308,priest,holy,35,12,23
Ariyia,argent-dawn,288,priest,holy,6,3,3
Heyská,eredar,288,priest,holy,6,3,3
Синед,soulflayer,288,priest,holy,6,3,3
Фионыч,blackscar,288,priest,holy,6,3,3
Аполонио,soulflayer,288,priest,holy,6,3,3
Seum,ravencrest,288,priest,holy,6,3,3
Jp,gorgonnash,288,priest,holy,6,3,3
Kevinsorbo,destromath,288,priest,holy,6,3,3
Хексорик,howling-fjord,288,priest,holy,6,3,3
Abusalt,stormscale,288,priest,holy,6,3,3
Inà,thrall,288,priest,holy,6,3,3
Aruna,ravencrest,288,priest,holy,6,3,3
Mcx,stormscale,288,priest,holy,6,3,3
Sneboldìs,sylvanas,288,priest,holy,6,3,3
Pulverpadder,stormscale,288,priest,holy,6,3,3
Аржан,soulflayer,288,priest,holy,6,3,3
Suzziee,silvermoon,288,priest,holy,6,3,3
Подчинись,ashenvale,288,priest,holy,6,3,3
Erzis,silvermoon,288,priest,holy,6,3,3
Fsnx,sylvanas,288,priest,holy,6,3,3
Ainsely,alakir,288,priest,holy,6,3,3
Voidtouched,drakthul,288,priest,holy,6,3,3
Thundertwo,ravencrest,288,priest,holy,6,3,3
Nimsi,ravencrest,288,priest,holy,6,3,3
Priesterious,blackrock,288,priest,holy,6,3,3
Ðøntßetøxic,kazzak,288,priest,holy,6,3,3
Shdetrzyx,outland,288,priest,holy,6,3,3
Pøcketsåge,blackrock,288,priest,holy,6,3,3
Bambus,shattered-hand,288,priest,holy,6,3,3
Prisht,ravencrest,288,priest,holy,6,3,3
Monataamis,kazzak,288,priest,holy,6,3,3
Гленнис,gordunni,288,priest,holy,6,3,3
Йефа,gordunni,288,priest,holy,6,3,3
Lynéssa,silvermoon,288,priest,holy,6,3,3
Scaryolol,blackmoore,288,priest,holy,6,3,3
Voidflash,blackmoore,288,priest,holy,6,3,3
Cilletbang,blackmoore,288,priest,holy,6,3,3
Rewinqt,blackmoore,288,priest,holy,6,3,3
Madsmadkas,kazzak,288,priest,holy,6,3,3
Xharyo,ravencrest,288,priest,holy,6,3,3
Noova,defias-brotherhood,288,priest,holy,6,3,3
Dathanosp,outland,288,priest,holy,6,3,3
Catrex,draenor,288,priest,holy,6,3,3
Kekkonh,sylvanas,288,priest,holy,6,3,3
Adssdfhjgh,outland,288,priest,holy,6,3,3
Runay,draenor,288,priest,holy,6,3,3
Jeboc,ravencrest,288,priest,holy,6,3,3
Yaiva,antonidas,288,priest,holy,6,3,3
ßestworld,draenor,288,priest,holy,6,3,3
Aiewn,elune,288,priest,holy,6,3,3
Atenuviel,norgannon,288,priest,holy,6,3,3
Burningheatx,kazzak,288,priest,holy,6,3,3
Psylurker,die-nachtwache,288,priest,holy,6,3,3
Holyheartx,argent-dawn,288,priest,holy,6,3,3
Äliénør,khaz-modan,288,priest,holy,6,3,3
Atremius,dragonmaw,288,priest,holy,6,3,3
Ejoz,khaz-modan,288,priest,holy,6,3,3
Pyropenance,twisting-nether,288,priest,holy,6,3,3
Inthemoöd,twisting-nether,288,priest,holy,6,3,3
Asolan,drakthul,288,priest,holy,6,3,3
Badhêalz,aegwynn,288,priest,holy,6,3,3
Smiteweaver,drakthul,288,priest,holy,6,3,3
ßabylexa,ravencrest,288,priest,holy,6,3,3
Carnacia,tarren-mill,288,priest,holy,6,3,3
Fadex,argent-dawn,288,priest,holy,6,3,3
Tebzy,ravencrest,288,priest,holy,6,3,3
Namsolo,kazzak,288,priest,holy,6,3,3
Tmnewho,outland,288,priest,holy,6,3,3
Vanadii,blackhand,288,priest,holy,6,3,3
Vitapriest,silvermoon,288,priest,holy,6,3,3
Liviúss,draenor,288,priest,holy,6,3,3
Menecare,blackhand,288,priest,holy,6,3,3
Páuse,nefarian,288,priest,holy,6,3,3
Egî,azshara,288,priest,holy,6,3,3
Perrý,archimonde,288,priest,holy,6,3,3
Kintsugí,ragnaros,288,priest,holy,6,3,3
Адария,booty-bay,288,priest,holy,6,3,3
Kimlie,baelgun,288,priest,holy,6,3,3
Xelivia,draenor,288,priest,holy,6,3,3
Nyxtovia,ravencrest,288,priest,holy,6,3,3
Discmachinex,stormscale,288,priest,holy,6,3,3
Skiplegday,blackrock,288,priest,holy,8,3,5
Cdïs,tyrande,288,priest,holy,11,3,8
Parzivál,argent-dawn,288,priest,holy,12,3,9
Lâñàt,ravencrest,288,priest,holy,12,3,9
Trashpriest,blackrock,288,priest,holy,12,3,9
Olereo,blackhand,288,priest,holy,12,3,9
Purplex,aggra-português,288,priest,holy,12,3,9
Ressucitor,kaelthas,288,priest,holy,12,3,9
Quami,dun-modr,288,priest,holy,12,3,9
Faol,the-venture-co,288,priest,holy,12,3,9
Singularity,ravencrest,288,priest,holy,12,3,9
Omegamegaman,blackrock,288,priest,holy,12,3,9
Мущмущ,howling-fjord,288,priest,holy,12,3,9
Javvi,sylvanas,288,priest,holy,12,3,9
Daenaerys,dun-morogh,288,priest,holy,12,3,9
Bzets,jaedenar,288,priest,holy,12,3,9
Alentissar,nemesis,288,priest,holy,12,3,9
Snooglefacé,grim-batol,288,priest,holy,12,3,9
Новокшан,soulflayer,288,priest,holy,12,3,9
Люблюкофе,deathguard,288,priest,holy,12,3,9
Tacochrist,kazzak,288,priest,holy,12,3,9
Drminduskâ,ysondre,288,priest,holy,12,3,9
Nswqt,kazzak,288,priest,holy,12,3,9
Shutyi,arathor,288,priest,holy,12,3,9
Royalty,aerie-peak,288,priest,holy,12,3,9
Míscode,twisting-nether,288,priest,holy,12,3,9
Westminster,tarren-mill,288,priest,holy,12,3,9
Lurri,tarren-mill,288,priest,holy,12,3,9
Madpad,tarren-mill,288,priest,holy,18,3,15
Farae,arathor,288,priest,holy,24,3,21
Ralaya,ravencrest,287,priest,holy,6,3,3
Ansaniâ,antonidas,287,priest,holy,12,3,9
Виатрикс,goldrinn,287,priest,holy,18,3,15
Spoggle,kazzak,256,priest,holy,4,4,0
Elýris,silvermoon,256,priest,holy,4,4,0
Clerìc,argent-dawn,255,priest,holy,11,3,8
Elthrone,kazzak,240,priest,holy,9,4,5
Lr,aszune,240,priest,holy,9,3,6
Azrpr,ravencrest,239,priest,holy,5,3,2
Danema,blackrock,239,priest,holy,9,4,5
ßest,archimonde,234,priest,holy,15,5,10
Azsem,arathor,234,priest,holy,18,4,14
Outcast,korgall,224,priest,holy,16,3,13
Rexxár,aszune,223,priest,holy,14,3,11
Sumiyaki,ravencrest,207,priest,holy,8,3,5
Nathyxqt,archimonde,192,priest,holy,6,2,4
Олегстразза,howling-fjord,192,priest,holy,6,2,4
Dertar,archimonde,192,priest,holy,6,2,4
Hunfall,stormscale,192,priest,holy,6,2,4
Thoryän,ragnaros,192,priest,holy,6,2,4
Marrisa,khaz-modan,192,priest,holy,6,2,4
Lusîa,echsenkessel,192,priest,holy,6,2,4
Fùkøff,stormscale,192,priest,holy,6,2,4
Gendzsó,ragnaros,192,priest,holy,6,2,4
Utsuro,stormscale,192,priest,holy,6,2,4
Frvrfridayy,stormscale,192,priest,holy,6,2,4
Pollution,ragnaros,192,priest,holy,6,2,4
Shkzz,hyjal,192,priest,holy,6,2,4
Breana,arathor,192,priest,holy,6,2,4
Eyllise,ragnaros,192,priest,holy,6,2,4
Effot,twisting-nether,192,priest,holy,6,2,4
Soül,sylvanas,192,priest,holy,6,2,4
Semagdnim,aggra-português,192,priest,holy,6,2,4
Dangerfred,stormscale,192,priest,holy,6,2,4
Plåtpriest,twisting-nether,192,priest,holy,6,2,4
Jinxies,twisting-nether,192,priest,holy,6,2,4
Кожетс,galakrond,192,priest,holy,6,2,4
Келебриана,deepholm,192,priest,holy,6,2,4
Priestmond,magtheridon,192,priest,holy,6,2,4
Absórb,quelthalas,192,priest,holy,6,2,4
Merkabah,azjolnerub,192,priest,holy,6,2,4
Korzec,dun-modr,192,priest,holy,6,2,4
Djingischan,twisting-nether,192,priest,holy,6,2,4
Kanketopries,korgall,192,priest,holy,6,2,4
Курчатовский,gordunni,192,priest,holy,6,2,4
Cidrea,saurfang,192,priest,holy,6,2,4
Ihefyehvjrm,ravencrest,192,priest,holy,6,2,4
Prästpojken,frostwhisper,192,priest,holy,6,2,4
Rngånxiety,ravencrest,192,priest,holy,6,2,4
Юлечка,blackscar,192,priest,holy,6,2,4
Buzzy,twisting-nether,192,priest,holy,6,2,4
Lutzki,the-maelstrom,192,priest,holy,6,2,4
Корбюратор,blackscar,192,priest,holy,6,2,4
Sathie,ravencrest,192,priest,holy,6,2,4
Secrethealer,frostmane,192,priest,holy,6,2,4
Halysion,ravencrest,192,priest,holy,6,2,4
Sigor,hellfire,192,priest,holy,6,2,4
Таяш,soulflayer,192,priest,holy,6,2,4
Raeratwo,archimonde,192,priest,holy,6,2,4
Nightstyle,nethersturm,192,priest,holy,6,2,4
Ammirrandus,aszune,192,priest,holy,6,2,4
Daria,teldrassil,192,priest,holy,6,2,4
Dotsin,kazzak,192,priest,holy,6,2,4
Fluxyqt,ravencrest,192,priest,holy,6,2,4
Redders,sylvanas,192,priest,holy,6,2,4
Solaclypsa,destromath,192,priest,holy,6,2,4
Apes,frostmourne,192,priest,holy,6,2,4
Асуартхас,gordunni,192,priest,holy,6,2,4
Bríta,veknilash,192,priest,holy,6,2,4
Egxo,blackrock,192,priest,holy,6,2,4
Ðøìßåx,silvermoon,192,priest,holy,6,2,4
Haxxøn,die-nachtwache,192,priest,holy,6,2,4
Scynthia,ravencrest,192,priest,holy,6,2,4
Kolinamenus,dun-morogh,192,priest,holy,6,2,4
Llounal,silvermoon,192,priest,holy,6,2,4
Burnex,thrall,192,priest,holy,6,2,4
Akhz,silvermoon,192,priest,holy,6,2,4
Sînálà,antonidas,192,priest,holy,6,2,4
Sáruky,blackrock,192,priest,holy,6,2,4
Crackbär,blackmoore,192,priest,holy,6,2,4
Shidolah,antonidas,192,priest,holy,6,2,4
Луножрец,gordunni,192,priest,holy,6,2,4
Wyez,blackmoore,192,priest,holy,6,2,4
Cheefto,blackmoore,192,priest,holy,6,2,4
Lovly,antonidas,192,priest,holy,6,2,4
Flexelzz,argent-dawn,192,priest,holy,6,2,4
Schnullehupê,blackmoore,192,priest,holy,6,2,4
Vandansk,kazzak,192,priest,holy,6,2,4
Tinypump,silvermoon,192,priest,holy,6,2,4
Zèl,blackmoore,192,priest,holy,6,2,4
Blazingad,kazzak,192,priest,holy,6,2,4
Dimentions,sylvanas,192,priest,holy,6,2,4
Niightstorm,silvermoon,192,priest,holy,6,2,4
Schizophrens,outland,192,priest,holy,6,2,4
Neverswap,blackmoore,192,priest,holy,6,2,4
Runkkar,defias-brotherhood,192,priest,holy,6,2,4
Dami,defias-brotherhood,192,priest,holy,6,2,4
Johen,terenas,192,priest,holy,6,2,4
Dehydratia,silvermoon,192,priest,holy,6,2,4
Micix,tarren-mill,192,priest,holy,6,2,4
Notatrap,outland,192,priest,holy,6,2,4
Tudp,tarren-mill,192,priest,holy,6,2,4
Yunico,kazzak,192,priest,holy,6,2,4
Supervillain,draenor,192,priest,holy,6,2,4
Buskisis,tarren-mill,192,priest,holy,6,2,4
Dameyo,argent-dawn,192,priest,holy,6,2,4
Ronk,outland,192,priest,holy,6,2,4
Meliodasa,outland,192,priest,holy,6,2,4
Moonmaster,tarren-mill,192,priest,holy,6,2,4
Strüss,draenor,192,priest,holy,6,2,4
Flào,draenor,192,priest,holy,6,2,4
Lahammy,kazzak,192,priest,holy,6,2,4
Yukirito,drakthul,192,priest,holy,6,2,4
Gullys,drakthul,192,priest,holy,6,2,4
Fogz,kazzak,192,priest,holy,6,2,4
Sová,drakthul,192,priest,holy,6,2,4
Lushlux,argent-dawn,192,priest,holy,6,2,4
Scooterkid,tarren-mill,192,priest,holy,6,2,4
Beliar,azshara,192,priest,holy,6,2,4
Katìe,anachronos,192,priest,holy,6,2,4
Zenholy,kazzak,192,priest,holy,6,2,4
Бранлор,howling-fjord,192,priest,holy,8,2,6
Yxazil,silvermoon,192,priest,holy,12,2,10
Джейтил,gordunni,192,priest,holy,12,2,10
Brøs,blackmoore,192,priest,holy,12,2,10
Злыденькая,gordunni,192,priest,holy,12,2,10
Authentic,dalaran,192,priest,holy,12,2,10
Daedarkis,twisting-nether,192,priest,holy,12,2,10
Prigart,sylvanas,192,priest,holy,12,2,10
Johnbâzz,tarren-mill,192,priest,holy,12,2,10
Crookiest,draenor,192,priest,holy,18,2,16
Bianchi,los-errantes,191,priest,holy,6,2,4
Caojialedebi,zuljin,191,priest,holy,6,2,4
Priestlords,doomhammer,191,priest,holy,6,2,4
Yacrablo,medivh,191,priest,holy,6,2,4
Meynola,ysondre,191,priest,holy,6,2,4
Riogas,khaz-modan,191,priest,holy,12,2,10
Fídme,ragnaros,160,priest,holy,10,2,8
Jénnó,runetotem,159,priest,holy,5,2,3
Shadowzrip,twilights-hammer,159,priest,holy,5,2,3
Beaukock,kazzak,159,priest,holy,5,2,3
Chrì,argent-dawn,159,priest,holy,5,2,3
Broksigar,the-maelstrom,159,priest,holy,5,2,3
Batschmoar,shattrath,144,priest,holy,3,3,0
Consümed,draenor,144,priest,holy,9,2,7
Dekarapriest,ravencrest,138,priest,holy,6,3,3
Xet,outland,138,priest,holy,6,3,3
Discisiipeli,sylvanas,138,priest,holy,11,5,6
Pristern,tarren-mill,138,priest,holy,9,4,5
Pinkfloydx,lightbringer,138,priest,holy,9,4,5
Spae,twisting-nether,138,priest,holy,11,4,7
Ambur,ravencrest,138,priest,holy,9,3,6
Alicewhydel,blackhand,138,priest,holy,9,3,6
Paterlurki,blackhand,138,priest,holy,10,3,7
Ûñrêpørtablë,outland,96,priest,holy,3,2,1
Cptmoigx,antonidas,96,priest,holy,3,2,1
Zeythz,ravencrest,96,priest,holy,10,2,8
Blúefox,malfurion,96,priest,holy,6,1,5
Healoisious,alonsus,96,priest,holy,6,1,5
Flokè,stormscale,96,priest,holy,6,1,5
Симпоз,howling-fjord,96,priest,holy,6,1,5
Kijul,ragnaros,96,priest,holy,6,1,5
Decimerad,kazzak,96,priest,holy,6,1,5
Rcxd,silvermoon,96,priest,holy,6,1,5
Lujka,outland,96,priest,holy,6,1,5
Bragokexx,tarren-mill,96,priest,holy,6,1,5
Enzyme,drakthul,96,priest,holy,6,1,5
Díp,ragnaros,96,priest,holy,6,1,5
Laadyybirkee,blackhand,96,priest,holy,6,1,5
Yaoshih,draenor,96,priest,holy,6,1,5
Ovrpwr,stormscale,96,priest,holy,6,1,5
Pappipappa,draenor,96,priest,holy,6,1,5
Galpriest,tarren-mill,96,priest,holy,6,1,5
Wísp,die-aldor,96,priest,holy,6,1,5
Helpmeheal,sylvanas,96,priest,holy,6,1,5
Нуннчи,howling-fjord,96,priest,holy,6,1,5
Cytheria,auchindoun,96,priest,holy,6,1,5
Eloundir,dalaran,96,priest,holy,6,1,5
Тоориал,howling-fjord,96,priest,holy,6,1,5
Ylenae,twisting-nether,96,priest,holy,6,1,5
Pattie,ragnaros,96,priest,holy,6,1,5
Flugame,ravencrest,96,priest,holy,6,1,5
Elfhelp,ravencrest,96,priest,holy,6,1,5
Hanniel,kazzak,96,priest,holy,6,1,5
Herwin,twisting-nether,96,priest,holy,6,1,5
Wrongwrong,draenor,96,priest,holy,6,1,5
Goupillou,hyjal,96,priest,holy,6,1,5
Jaesabøyx,twisting-nether,96,priest,holy,6,1,5
Myrrha,les-sentinelles,96,priest,holy,6,1,5
Morîdîn,kazzak,96,priest,holy,6,1,5
Эллвинг,howling-fjord,96,priest,holy,6,1,5
Nuriva,frostmane,96,priest,holy,6,1,5
Shadowgeek,sylvanas,96,priest,holy,6,1,5
Элунаир,gordunni,96,priest,holy,6,1,5
Robiee,twisting-nether,96,priest,holy,6,1,5
Fadchod,outland,96,priest,holy,6,1,5
Radiance,emeriss,96,priest,holy,6,1,5
Mauralin,zirkel-des-cenarius,96,priest,holy,6,1,5
Aviz,tarren-mill,96,priest,holy,6,1,5
Healpower,aggramar,96,priest,holy,6,1,5
Elya,hyjal,96,priest,holy,6,1,5
Chybrozzør,archimonde,96,priest,holy,6,1,5
Trickyteè,tarren-mill,96,priest,holy,6,1,5
Borá,twisting-nether,96,priest,holy,6,1,5
Øbserverx,stormscale,96,priest,holy,6,1,5
Elvedâ,blackhand,96,priest,holy,6,1,5
Ximenia,eredar,96,priest,holy,6,1,5
Zthul,draenor,96,priest,holy,6,1,5
Chê,sanguino,96,priest,holy,6,1,5
Goodsonja,sanguino,96,priest,holy,6,1,5
Healêl,sanguino,96,priest,holy,6,1,5
Vierfingerjo,eredar,96,priest,holy,6,1,5
Simbaone,scarshield-legion,96,priest,holy,6,1,5
Johnblack,dun-morogh,96,priest,holy,6,1,5
Kakuzuke,nemesis,96,priest,holy,6,1,5
Ramy,sporeggar,96,priest,holy,6,1,5
Isendriel,outland,96,priest,holy,6,1,5
Valyreon,outland,96,priest,holy,6,1,5
Ieav,frostwolf,96,priest,holy,6,1,5
Disz,zuljin,96,priest,holy,6,1,5
Snotknuckle,gorgonnash,96,priest,holy,6,1,5
Slêq,antonidas,96,priest,holy,6,1,5
Soonako,antonidas,96,priest,holy,6,1,5
Lyssa,saurfang,96,priest,holy,6,1,5
Drë,daggerspine,96,priest,holy,6,1,5
Nuph,ravencrest,96,priest,holy,6,1,5
Сакредлайв,gordunni,96,priest,holy,6,1,5
Nuraschka,antonidas,96,priest,holy,6,1,5
Чтоподелать,soulflayer,96,priest,holy,6,1,5
Xodze,outland,96,priest,holy,6,1,5
Shicu,blackmoore,96,priest,holy,6,1,5
Antibiotike,hyjal,96,priest,holy,6,1,5
Miralou,ravencrest,96,priest,holy,6,1,5
Соцке,eversong,96,priest,holy,6,1,5
Jaatjak,ravencrest,96,priest,holy,6,1,5
Sebiah,darksorrow,96,priest,holy,6,1,5
Angusbeêf,blackrock,96,priest,holy,6,1,5
Lãnat,ravencrest,96,priest,holy,6,1,5
Tigrok,burning-legion,96,priest,holy,6,1,5
Kipnuggetz,burning-legion,96,priest,holy,6,1,5
Яестькенни,soulflayer,96,priest,holy,6,1,5
Buan,outland,96,priest,holy,6,1,5
Тёмафиргвард,blackscar,96,priest,holy,6,1,5
Draobwýn,blackrock,96,priest,holy,6,1,5
Remkoja,blackrock,96,priest,holy,6,1,5
Мишатемный,gordunni,96,priest,holy,6,1,5
Tÿona,hyjal,96,priest,holy,6,1,5
Daskemaskinx,the-maelstrom,96,priest,holy,6,1,5
Blastor,ravencrest,96,priest,holy,6,1,5
Malzzara,outland,96,priest,holy,6,1,5
Kasáya,thrall,96,priest,holy,14,2,12
Quackies,ravencrest,96,priest,holy,7,1,6
Gisborn,laughing-skull,96,priest,holy,8,1,7
Downtrone,blackrock,96,priest,holy,9,1,8
Yuuvi,ravencrest,96,priest,holy,12,1,11
Plaguestrike,darkspear,96,priest,holy,12,1,11
Onlyfans,burning-steppes,96,priest,holy,12,1,11
Нитровина,howling-fjord,96,priest,holy,12,1,11
Quinlanx,quelthalas,96,priest,holy,12,1,11
Demora,ysondre,96,priest,holy,12,1,11
Lunabärchi,ravencrest,96,priest,holy,12,1,11
Doublehealix,argent-dawn,96,priest,holy,12,1,11
Takros,blackrock,96,priest,holy,18,1,17
Frékiatya,ravenholdt,95,priest,holy,6,1,5
Shikamarudmx,burning-legion,79,priest,holy,5,1,4
Looó,los-errantes,79,priest,holy,5,1,4
Mswagner,outland,79,priest,holy,5,1,4
Sdk,archimonde,79,priest,holy,5,1,4
Freshpope,ravencrest,48,priest,holy,3,1,2
Xaey,ravencrest,48,priest,holy,3,1,2
Maxyox,ragnaros,42,priest,holy,8,2,6
Tabítha,blackrock,42,priest,holy,9,2,7
Bøij,pozzo-delleternità,42,priest,holy,10,2,8
Hemmis,ravencrest,2279,priest,discipline,131,78,53
Keijuñâ,tarren-mill,2261,priest,discipline,102,59,43
Prêtresacré,archimonde,2244,priest,discipline,89,52,37
Gaalonikus,blackmoore,2235,priest,discipline,98,57,41
Vanostsp,kazzak,2231,priest,discipline,104,57,47
Døppëlápfèl,tarren-mill,2220,priest,discipline,108,59,49
Pheen,kazzak,2218,priest,discipline,547,289,258
Moonriver,archimonde,2210,priest,discipline,90,54,36
Jidammy,ravencrest,2207,priest,discipline,128,68,60
Jayti,ravencrest,2205,priest,discipline,115,65,50
Vengefulmaze,ravencrest,2205,priest,discipline,156,85,71
Hukkuvahirvi,ravencrest,2187,priest,discipline,123,66,57
Jaywie,twisting-nether,2186,priest,discipline,214,110,104
Primayodbain,archimonde,2184,priest,discipline,112,60,52
Chasx,ravencrest,2182,priest,discipline,201,101,100
Rlyeh,argent-dawn,2181,priest,discipline,89,49,40
Jackiqt,nemesis,2180,priest,discipline,125,81,44
Flao,ravencrest,2180,priest,discipline,88,47,41
Secø,sylvanas,2177,priest,discipline,78,43,35
Èfflux,ravencrest,2172,priest,discipline,86,54,32
Kêkwshádêzz,blackmoore,2165,priest,discipline,84,44,40
Saentainen,kazzak,2164,priest,discipline,113,78,35
Còsmo,ravencrest,2157,priest,discipline,137,69,68
Rñd,ravencrest,2155,priest,discipline,84,45,39
Jtî,ravencrest,2149,priest,discipline,120,74,46
Holypoppa,ravencrest,2145,priest,discipline,527,275,252
Gudóngmae,ravencrest,2144,priest,discipline,60,36,24
Villagebike,shadowsong,2142,priest,discipline,60,33,27
Rébörn,tarren-mill,2134,priest,discipline,77,47,30
Cylizx,stormscale,2133,priest,discipline,114,62,52
Ltr,tarren-mill,2132,priest,discipline,61,39,22
Thelïght,ravencrest,2132,priest,discipline,195,100,95
Aist,ragnaros,2132,priest,discipline,132,67,65
Artle,sanguino,2131,priest,discipline,83,44,39
Izzý,antonidas,2129,priest,discipline,90,57,33
Prådâshådëzz,blackmoore,2129,priest,discipline,95,51,44
Efflúx,ravencrest,2128,priest,discipline,124,71,53
Azrpr,ravencrest,2128,priest,discipline,82,45,37
Антошашвп,gordunni,2128,priest,discipline,98,51,47
Cringê,ravencrest,2124,priest,discipline,89,46,43
Asanti,die-aldor,2122,priest,discipline,252,145,107
Unréål,ravencrest,2122,priest,discipline,198,102,96
Kangaroogodx,ravencrest,2122,priest,discipline,149,75,74
Duckiethot,twisting-nether,2121,priest,discipline,226,115,111
Ilumiinatrix,dun-modr,2121,priest,discipline,797,400,397
Nasdaq,ravencrest,2120,priest,discipline,120,63,57
Tremrfinger,dun-modr,2119,priest,discipline,427,244,183
Bedfirez,ravencrest,2119,priest,discipline,235,134,101
Hampådenbååd,kazzak,2119,priest,discipline,147,81,66
Mond,eredar,2118,priest,discipline,171,84,87
Fatyoyo,frostwolf,2117,priest,discipline,89,56,33
Blessedmix,korgall,2117,priest,discipline,280,143,137
Lidlpriest,frostwolf,2114,priest,discipline,60,35,25
Ananous,hyjal,2114,priest,discipline,380,206,174
Mercilégion,sargeras,2113,priest,discipline,84,43,41
Деадхостх,soulflayer,2110,priest,discipline,90,53,37
Summerfinn,ravencrest,2110,priest,discipline,235,120,115
Råcòøñ,ravencrest,2110,priest,discipline,109,55,54
Dermaul,kazzak,2109,priest,discipline,144,76,68
Superbianka,stormscale,2109,priest,discipline,252,129,123
Flào,draenor,2108,priest,discipline,161,82,79
Фейнриприст,soulflayer,2107,priest,discipline,167,107,60
Coldyxz,blackrock,2107,priest,discipline,132,74,58
Klonyaryk,ravencrest,2107,priest,discipline,236,121,115
Nevercared,aegwynn,2106,priest,discipline,63,48,15
Swd,dun-morogh,2106,priest,discipline,72,43,29
Swdswdswdswd,blackmoore,2105,priest,discipline,106,58,48
Spìrít,ghostlands,2105,priest,discipline,192,93,99
Mshield,blackmoore,2103,priest,discipline,130,62,68
Shmoly,stormscale,2101,priest,discipline,169,88,81
Neverdome,ravencrest,2100,priest,discipline,405,218,187
Øbserverx,stormscale,2100,priest,discipline,114,61,53
Mshieldo,blackmoore,2100,priest,discipline,118,59,59
Гопикзашквар,blackscar,2100,priest,discipline,182,88,94
Fearxyz,aegwynn,2094,priest,discipline,96,51,45
Twinkboyx,ragnaros,2094,priest,discipline,187,98,89
Mentalboom,emerald-dream,2093,priest,discipline,238,123,115
Teengirl,ravencrest,2091,priest,discipline,562,312,250
Lunatique,shadowsong,2090,priest,discipline,92,45,47
Dripcheck,draenor,2087,priest,discipline,444,227,217
Voxtwo,blackrock,2083,priest,discipline,72,42,30
Prästpåven,stormscale,2078,priest,discipline,84,50,34
Jid,ravencrest,2078,priest,discipline,149,82,67
Luxurygirl,nemesis,2076,priest,discipline,54,35,19
Próxs,ravencrest,2074,priest,discipline,78,40,38
Sèco,sylvanas,2068,priest,discipline,156,77,79
Jawake,twisting-nether,2068,priest,discipline,126,61,65
Ðontargueok,blackmoore,2066,priest,discipline,138,76,62
Заак,howling-fjord,2062,priest,discipline,84,42,42
Фастэксп,razuvious,2059,priest,discipline,355,183,172
Crinji,blackmoore,2059,priest,discipline,424,212,212
Nicebeam,ravencrest,2058,priest,discipline,84,44,40
Buan,outland,2058,priest,discipline,78,39,39
Lloreen,ravencrest,2056,priest,discipline,221,121,100
Duckiethotx,ragnaros,2054,priest,discipline,202,100,102
Deadsloth,hyjal,2051,priest,discipline,203,106,97
Skyrojo,ravencrest,2050,priest,discipline,103,49,54
Светжрец,blackscar,2047,priest,discipline,84,52,32
Kâiøxx,outland,2046,priest,discipline,336,175,161
Looney,shadowsong,2045,priest,discipline,72,46,26
Sinfulmaze,outland,2043,priest,discipline,72,38,34
Dakystepmom,stormreaver,2043,priest,discipline,131,64,67
Plsdontnerf,onyxia,2039,priest,discipline,95,55,40
Imprøved,outland,2036,priest,discipline,102,70,32
Kekkons,sylvanas,2035,priest,discipline,149,80,69
Fleetways,draenor,2034,priest,discipline,93,61,32
Meganxx,ravencrest,2031,priest,discipline,78,47,31
Cluelesstwo,ravencrest,2030,priest,discipline,366,199,167
Reflector,sunstrider,2025,priest,discipline,99,47,52
Arthezz,ravencrest,2023,priest,discipline,282,148,134
Jagardoden,stormscale,2016,priest,discipline,141,80,61
Priestqtx,kelthuzad,2016,priest,discipline,60,34,26
Gerryqt,draenor,2016,priest,discipline,78,41,37
Sacerdotini,outland,2016,priest,discipline,49,23,26
Morphics,silvermoon,2013,priest,discipline,83,41,42
Loaffeh,ragnaros,2012,priest,discipline,100,56,44
Megxnx,ravencrest,2011,priest,discipline,125,74,51
Soloshuffle,draenor,2011,priest,discipline,184,99,85
Tacochrist,kazzak,2011,priest,discipline,385,206,179
Разрухаз,gordunni,2011,priest,discipline,95,48,47
Synxii,ravencrest,2010,priest,discipline,100,50,50
Donvyto,blackmoore,2010,priest,discipline,77,38,39
Trialight,ravencrest,2009,priest,discipline,89,57,32
Abdcefgihljk,tarren-mill,2008,priest,discipline,66,41,25
Brainbadly,aegwynn,2008,priest,discipline,72,34,38
Petitogré,silvermoon,2007,priest,discipline,236,124,112
Smiteweaver,drakthul,2006,priest,discipline,78,45,33
Youngfade,twisting-nether,2005,priest,discipline,117,57,60
Snuskong,kazzak,2005,priest,discipline,117,56,61
Фанпау,soulflayer,2005,priest,discipline,84,39,45
Azpr,ravencrest,2004,priest,discipline,54,32,22
Stavfel,stormscale,2004,priest,discipline,201,107,94
Kàrèm,blutkessel,2003,priest,discipline,78,43,35
Underdogx,eredar,2002,priest,discipline,551,282,269
Ashenflexj,draenor,2000,priest,discipline,280,149,131
Билетлолпро,borean-tundra,2000,priest,discipline,347,169,178
Donpedrila,kazzak,2000,priest,discipline,72,34,38
Vajadisc,twisting-nether,2000,priest,discipline,136,59,77
Tjackpanda,kazzak,1999,priest,discipline,66,38,28
Bonzuu,ravencrest,1999,priest,discipline,137,75,62
Чилюотферала,eversong,1996,priest,discipline,142,69,73
Ñya,sylvanas,1995,priest,discipline,288,152,136
Lyrvanax,ravencrest,1995,priest,discipline,324,162,162
Rhâpsødy,ravencrest,1994,priest,discipline,155,89,66
Pricemg,thrall,1994,priest,discipline,90,50,40
Shinjicum,kazzak,1994,priest,discipline,410,226,184
Elvibeast,twisting-nether,1993,priest,discipline,78,43,35
Wetnpuffy,ravencrest,1993,priest,discipline,292,149,143
Porkhunt,stormscale,1989,priest,discipline,96,57,39
Limerençe,ravencrest,1989,priest,discipline,98,50,48
Hamsicam,frostwolf,1989,priest,discipline,266,135,131
Rankonebabe,stormscale,1988,priest,discipline,118,65,53
Acondisc,ravencrest,1987,priest,discipline,257,133,124
Gerrylol,draenor,1987,priest,discipline,108,55,53
Shøy,nemesis,1986,priest,discipline,252,126,126
Dâhyun,ravencrest,1985,priest,discipline,305,180,125
Ävbmârsík,kazzak,1985,priest,discipline,149,82,67
Dabalthazar,ravencrest,1985,priest,discipline,163,83,80
Malfredx,draenor,1983,priest,discipline,51,31,20
Stormmyy,kazzak,1983,priest,discipline,118,56,62
Brainerror,outland,1982,priest,discipline,81,40,41
Tanlytwo,ravencrest,1982,priest,discipline,112,55,57
Kenzah,ysondre,1981,priest,discipline,60,34,26
Azoran,dentarg,1981,priest,discipline,96,47,49
Nolnilian,archimonde,1980,priest,discipline,84,46,38
Dpriesta,aegwynn,1979,priest,discipline,88,52,36
Sologrifer,sylvanas,1979,priest,discipline,94,50,44
Asyncx,ravencrest,1979,priest,discipline,116,60,56
Арейша,gordunni,1979,priest,discipline,77,39,38
Ðårkìnlol,ravencrest,1978,priest,discipline,65,42,23
Timbsheal,tarren-mill,1977,priest,discipline,162,81,81
Leahbtw,ravencrest,1975,priest,discipline,412,211,201
Dayno,draenor,1974,priest,discipline,127,67,60
ßlinkytwinky,outland,1974,priest,discipline,78,38,40
Tobadforglad,khaz-modan,1973,priest,discipline,41,26,15
Oioiio,kazzak,1973,priest,discipline,174,84,90
Artístx,twisting-nether,1973,priest,discipline,134,64,70
Boltygnome,blades-edge,1972,priest,discipline,123,66,57
Убикрофт,soulflayer,1971,priest,discipline,85,52,33
Релакз,soulflayer,1971,priest,discipline,150,75,75
Tazn,thrall,1971,priest,discipline,66,33,33
Flokè,stormscale,1970,priest,discipline,144,82,62
Sleepypriest,frostmane,1970,priest,discipline,60,34,26
Хомячпочка,gordunni,1970,priest,discipline,82,42,40
Trashedd,outland,1970,priest,discipline,206,105,101
Potatojuicer,argent-dawn,1968,priest,discipline,759,384,375
Infamoussftw,drakthul,1968,priest,discipline,450,221,229
Ziknait,sargeras,1967,priest,discipline,54,34,20
Comedii,blackmoore,1965,priest,discipline,477,247,230
Nalakis,archimonde,1964,priest,discipline,147,86,61
Eukmassus,archimonde,1964,priest,discipline,82,43,39
Tweely,drakthul,1964,priest,discipline,230,118,112
Mindblown,arthas,1964,priest,discipline,137,70,67
Bijaqt,blackmoore,1964,priest,discipline,84,39,45
Wernou,archimonde,1963,priest,discipline,60,36,24
Kripteksx,ravencrest,1963,priest,discipline,107,57,50
Psychout,ravencrest,1963,priest,discipline,141,71,70
Spinebuster,frostwolf,1963,priest,discipline,132,66,66
Sharkouly,blackmoore,1963,priest,discipline,66,33,33
Xians,alakir,1962,priest,discipline,53,30,23
Ayoutbt,ravencrest,1961,priest,discipline,114,63,51
Eestpr,tarren-mill,1961,priest,discipline,81,43,38
Líluqt,sanguino,1961,priest,discipline,102,50,52
Flongoletta,xavius,1960,priest,discipline,306,156,150
Uncreative,ravencrest,1958,priest,discipline,48,34,14
Donipriest,ravencrest,1958,priest,discipline,336,188,148
Райлоу,azuregos,1958,priest,discipline,162,87,75
Ifeared,stormscale,1958,priest,discipline,57,29,28
Refrenn,kazzak,1957,priest,discipline,203,115,88
Inhibitor,tarren-mill,1957,priest,discipline,215,117,98
Alexsmite,twisting-nether,1957,priest,discipline,59,29,30
Nêxt,ravencrest,1956,priest,discipline,114,71,43
Painchampion,draenor,1956,priest,discipline,94,45,49
Mazikeen,stormscale,1954,priest,discipline,54,32,22
Georgeshxx,ravencrest,1954,priest,discipline,406,210,196
Cener,ravencrest,1953,priest,discipline,146,90,56
Klered,ragnaros,1953,priest,discipline,94,57,37
Fsnx,sylvanas,1953,priest,discipline,180,103,77
Krawnz,dun-modr,1953,priest,discipline,54,29,25
Listrix,frostmane,1953,priest,discipline,430,220,210
Aiwass,twisting-nether,1952,priest,discipline,84,45,39
Finiskram,sylvanas,1952,priest,discipline,90,46,44
Sfÿ,ysondre,1952,priest,discipline,108,48,60
Холиэирлайнс,howling-fjord,1951,priest,discipline,39,22,17
Arendt,blackhand,1951,priest,discipline,174,90,84
Mainputa,pozzo-delleternità,1951,priest,discipline,119,57,62
Shadothat,turalyon,1950,priest,discipline,203,106,97
Bindw,tarren-mill,1949,priest,discipline,65,29,36
Sokratina,ragnaros,1948,priest,discipline,148,97,51
Ekman,twisting-nether,1948,priest,discipline,152,78,74
Factorywrkr,silvermoon,1946,priest,discipline,30,25,5
Stazqt,conseil-des-ombres,1946,priest,discipline,497,256,241
Çiione,archimonde,1946,priest,discipline,107,55,52
Artle,dun-modr,1945,priest,discipline,88,61,27
Karmev,twisting-nether,1944,priest,discipline,71,36,35
Бенджаминлол,deathguard,1944,priest,discipline,114,57,57
Elsuzette,hyjal,1943,priest,discipline,64,35,29
Kekkonh,sylvanas,1943,priest,discipline,315,159,156
Indrades,blackmoore,1942,priest,discipline,69,38,31
Loví,twisting-nether,1942,priest,discipline,155,71,84
Luphriest,ravencrest,1941,priest,discipline,60,35,25
Soziy,silvermoon,1941,priest,discipline,51,28,23
Галюхах,soulflayer,1941,priest,discipline,72,38,34
Мамкалол,soulflayer,1941,priest,discipline,546,276,270
Mentalist,dun-modr,1940,priest,discipline,273,130,143
Concetto,nazjatar,1939,priest,discipline,48,27,21
Oldnbad,archimonde,1939,priest,discipline,54,28,26
Puckhorde,outland,1938,priest,discipline,96,59,37
Lyrvatwo,ravencrest,1938,priest,discipline,55,33,22
Seankingkong,ravencrest,1938,priest,discipline,60,35,25
Scortie,blackrock,1938,priest,discipline,78,41,37
Notnøw,silvermoon,1937,priest,discipline,486,251,235
Yânux,aegwynn,1937,priest,discipline,276,140,136
Sheelah,ravencrest,1937,priest,discipline,154,78,76
Senga,kazzak,1937,priest,discipline,78,38,40
Павук,gordunni,1936,priest,discipline,113,67,46
Sdlman,nemesis,1936,priest,discipline,449,231,218
Mysterymucus,draenor,1934,priest,discipline,170,94,76
Eau,quelthalas,1934,priest,discipline,359,177,182
Вакариия,soulflayer,1934,priest,discipline,73,33,40
Scaryblapel,ravencrest,1933,priest,discipline,794,413,381
Soyloverjuan,auchindoun,1933,priest,discipline,64,33,31
Flugame,ravencrest,1933,priest,discipline,123,63,60
Zularia,rexxar,1932,priest,discipline,132,70,62
Faderfarbror,tarren-mill,1927,priest,discipline,147,89,58
Justyø,archimonde,1927,priest,discipline,345,196,149
Indulgence,eredar,1927,priest,discipline,427,215,212
Místerbiceps,outland,1927,priest,discipline,152,75,77
Mswagner,outland,1926,priest,discipline,65,36,29
Salvinia,kelthuzad,1926,priest,discipline,144,71,73
Лёнятреппер,blackscar,1925,priest,discipline,183,102,81
Traicklebron,antonidas,1924,priest,discipline,57,35,22
Xutira,silvermoon,1924,priest,discipline,228,131,97
Kavrack,sargeras,1923,priest,discipline,77,41,36
Artist,outland,1923,priest,discipline,96,46,50
Sûzy,ravencrest,1922,priest,discipline,48,27,21
Ebuglatatrov,ravencrest,1922,priest,discipline,174,83,91
Akaria,kelthuzad,1922,priest,discipline,66,30,36
Filthyzx,argent-dawn,1921,priest,discipline,114,58,56
Depridolens,argent-dawn,1920,priest,discipline,100,57,43
Aêalama,argent-dawn,1919,priest,discipline,90,45,45
Батлджес,gordunni,1918,priest,discipline,140,76,64
Semagdnim,aggra-português,1917,priest,discipline,198,99,99
Xraid,blackmoore,1916,priest,discipline,146,78,68
Nothappy,ragnaros,1915,priest,discipline,84,37,47
Делреона,blackscar,1914,priest,discipline,102,58,44
Nirvz,silvermoon,1913,priest,discipline,78,56,22
Feedergodx,dun-modr,1913,priest,discipline,60,34,26
Deneris,ravencrest,1912,priest,discipline,59,27,32
Lánî,blackmoore,1911,priest,discipline,56,30,26
Sinetrax,tarren-mill,1910,priest,discipline,114,63,51
Xghj,sylvanas,1910,priest,discipline,96,52,44
Ависи,soulflayer,1910,priest,discipline,54,27,27
ßrb,sylvanas,1909,priest,discipline,270,145,125
Rhauru,tyrande,1909,priest,discipline,331,159,172
Lovdisc,ysondre,1908,priest,discipline,148,84,64
Jâde,bloodhoof,1908,priest,discipline,588,300,288
Кв,blackscar,1908,priest,discipline,114,48,66
Priestdos,sanguino,1907,priest,discipline,61,39,22
Mend,tarren-mill,1906,priest,discipline,95,46,49
Scammers,argent-dawn,1905,priest,discipline,54,32,22
Nyàh,stormscale,1905,priest,discipline,89,47,42
Psyheea,stormscale,1905,priest,discipline,219,103,116
Ingelosi,eredar,1904,priest,discipline,262,142,120
Výra,der-rat-von-dalaran,1904,priest,discipline,80,41,39
Wangewover,ravencrest,1903,priest,discipline,177,98,79
Noserenity,outland,1902,priest,discipline,77,48,29
Nstp,zuljin,1902,priest,discipline,42,24,18
Savta,ravencrest,1901,priest,discipline,102,55,47
Georgesheenx,ravencrest,1901,priest,discipline,326,163,163
Sovereignp,aegwynn,1900,priest,discipline,66,33,33
Grouptrpy,draenor,1900,priest,discipline,60,30,30
Поднялбабки,deathguard,1900,priest,discipline,89,37,52
Парадайси,gordunni,1899,priest,discipline,101,61,40
Çhåosgòddess,kazzak,1899,priest,discipline,48,28,20
Alsalty,stormscale,1899,priest,discipline,113,52,61
Watchmedark,ravencrest,1898,priest,discipline,66,33,33
Vallstwo,zuljin,1897,priest,discipline,102,52,50
Evpisces,archimonde,1897,priest,discipline,631,315,316
Rîeka,antonidas,1897,priest,discipline,83,40,43
Faithz,ragnaros,1897,priest,discipline,120,51,69
Miraña,kazzak,1896,priest,discipline,30,24,6
Fabzen,grim-batol,1896,priest,discipline,123,61,62
Хомяктьмы,gordunni,1895,priest,discipline,144,71,73
Rxquiem,archimonde,1895,priest,discipline,150,69,81
Smallsmilesx,blackrock,1895,priest,discipline,96,44,52
Мефодийприст,howling-fjord,1894,priest,discipline,120,72,48
Citadelle,blackmoore,1894,priest,discipline,83,48,35
Shadiè,sylvanas,1894,priest,discipline,50,28,22
Аркада,blackscar,1894,priest,discipline,90,44,46
Wyroofear,ragnaros,1894,priest,discipline,77,37,40
Discishârd,ravencrest,1893,priest,discipline,117,60,57
Hélp,stormscale,1892,priest,discipline,114,75,39
Bigextendo,blackmoore,1892,priest,discipline,153,80,73
Flipflops,kirin-tor,1891,priest,discipline,60,36,24
Dendegodx,kazzak,1891,priest,discipline,150,82,68
Разорлайтх,gordunni,1890,priest,discipline,29,21,8
Jamienism,ravencrest,1890,priest,discipline,142,67,75
Poulet,sylvanas,1889,priest,discipline,244,127,117
Önnÿ,dun-modr,1889,priest,discipline,161,79,82
Jeanprêtre,ysondre,1889,priest,discipline,180,86,94
Unfaithful,twisting-nether,1888,priest,discipline,76,48,28
Grouptherpst,draenor,1888,priest,discipline,630,316,314
Yzïam,ravencrest,1887,priest,discipline,165,87,78
Uwuslayerx,stormscale,1887,priest,discipline,149,74,75
Dieterdose,tarren-mill,1886,priest,discipline,62,39,23
Brutalmaze,archimonde,1886,priest,discipline,54,29,25
Betatasty,dalaran,1886,priest,discipline,102,54,48
Wet,twisting-nether,1886,priest,discipline,194,85,109
Лайбаси,howling-fjord,1885,priest,discipline,272,136,136
Aprilfalls,blackmoore,1885,priest,discipline,72,34,38
Menarille,kazzak,1882,priest,discipline,48,37,11
Duelistfied,blackrock,1882,priest,discipline,110,53,57
Бенджаминлол,blackscar,1882,priest,discipline,120,52,68
Abomïnàtîon,ysondre,1881,priest,discipline,73,56,17
Voideffsucks,stormscale,1881,priest,discipline,60,32,28
Niniell,blackmoore,1880,priest,discipline,120,68,52
Нтти,soulflayer,1880,priest,discipline,152,81,71
Jconnelly,antonidas,1880,priest,discipline,86,44,42
Merylle,ragnaros,1880,priest,discipline,60,29,31
Spodermen,ravencrest,1879,priest,discipline,109,60,49
Eavy,argent-dawn,1879,priest,discipline,54,28,26
Ilovelily,antonidas,1879,priest,discipline,84,42,42
Wóllo,stormscale,1878,priest,discipline,78,45,33
Trevorlahey,draenor,1878,priest,discipline,416,220,196
Neffty,aegwynn,1878,priest,discipline,313,163,150
Пэрдёж,howling-fjord,1878,priest,discipline,41,21,20
Luvdisc,ysondre,1878,priest,discipline,74,37,37
Nedex,thrall,1877,priest,discipline,61,32,29
Fitu,drakthul,1877,priest,discipline,173,90,83
Фотосз,soulflayer,1876,priest,discipline,94,50,44
Смотривнебоь,soulflayer,1875,priest,discipline,224,119,105
Таравера,soulflayer,1875,priest,discipline,220,113,107
Laurens,tarren-mill,1875,priest,discipline,66,33,33
Свэпи,blackscar,1875,priest,discipline,77,38,39
Numa,stormscale,1875,priest,discipline,76,37,39
Alpháømegá,outland,1874,priest,discipline,166,85,81
Alèxy,tarren-mill,1874,priest,discipline,66,33,33
Тёмныйвид,soulflayer,1874,priest,discipline,520,259,261
Djsüssi,frostwolf,1873,priest,discipline,222,101,121
Падлез,howling-fjord,1873,priest,discipline,72,32,40
Artìst,ravencrest,1872,priest,discipline,48,30,18
Elethia,blackmoore,1872,priest,discipline,38,21,17
Луилэнс,howling-fjord,1872,priest,discipline,148,80,68
Menecare,blackhand,1871,priest,discipline,42,24,18
Поршкаенн,gordunni,1871,priest,discipline,66,37,29
Tingoess,silvermoon,1871,priest,discipline,195,101,94
Måzikeen,stormscale,1870,priest,discipline,42,29,13
Cdïs,tyrande,1870,priest,discipline,54,36,18
Rpriest,outland,1870,priest,discipline,60,34,26
Blâdéira,ravencrest,1870,priest,discipline,552,279,273
Egî,azshara,1870,priest,discipline,42,20,22
Bindww,tarren-mill,1869,priest,discipline,42,23,19
Nancey,draenor,1869,priest,discipline,86,47,39
Immortalled,twisting-nether,1869,priest,discipline,156,85,71
Интеллиджент,gordunni,1868,priest,discipline,42,24,18
Zhadow,outland,1868,priest,discipline,150,78,72
Саммерфинн,gordunni,1868,priest,discipline,110,54,56
Frikitouna,uldum,1868,priest,discipline,76,37,39
Двачх,soulflayer,1868,priest,discipline,72,35,37
Rezzdar,lightnings-blade,1867,priest,discipline,205,104,101
Wyrofear,ragnaros,1867,priest,discipline,75,34,41
Williamz,ravencrest,1866,priest,discipline,79,44,35
Zychopriest,antonidas,1866,priest,discipline,105,53,52
Karmasmom,kazzak,1866,priest,discipline,132,63,69
Saniqt,kazzak,1865,priest,discipline,57,35,22
Phosdia,festung-der-stürme,1864,priest,discipline,36,24,12
Ilovecala,ravencrest,1864,priest,discipline,54,31,23
Expert,blackrock,1864,priest,discipline,111,53,58
Negativeapm,archimonde,1863,priest,discipline,41,24,17
Yungmazikeen,archimonde,1863,priest,discipline,53,28,25
Ýbëzz,ravencrest,1862,priest,discipline,54,33,21
Sathie,ravencrest,1862,priest,discipline,156,77,79
Kaori,zenedar,1861,priest,discipline,71,38,33
Jimski,stormscale,1861,priest,discipline,87,39,48
Shínx,illidan,1860,priest,discipline,96,57,39
Кошечка,deathguard,1860,priest,discipline,41,21,20
Sakulus,malganis,1860,priest,discipline,72,34,38
Thalanas,ravencrest,1859,priest,discipline,158,90,68
Sublab,kazzak,1859,priest,discipline,60,33,27
Imahipstaqt,eredar,1859,priest,discipline,129,69,60
Furtnajebany,tarren-mill,1858,priest,discipline,93,47,46
Monopolygoat,arathor,1858,priest,discipline,181,84,97
Chochoo,argent-dawn,1858,priest,discipline,78,35,43
Фрайонель,gordunni,1857,priest,discipline,42,32,10
Iloveilka,madmortem,1857,priest,discipline,41,25,16
Cedifanboyx,archimonde,1857,priest,discipline,102,57,45
Frida,blackrock,1857,priest,discipline,119,57,62
Needmøremana,ragnaros,1856,priest,discipline,48,27,21
Ssjx,ravencrest,1856,priest,discipline,102,55,47
Imsaltyxd,tarren-mill,1855,priest,discipline,101,56,45
Гоплзнекст,gordunni,1855,priest,discipline,119,63,56
Micropenance,stormscale,1855,priest,discipline,80,38,42
Lîke,shattrath,1854,priest,discipline,60,31,29
Zyzx,blackrock,1854,priest,discipline,114,53,61
Bloodhealer,draenor,1853,priest,discipline,34,22,12
Krokkete,archimonde,1853,priest,discipline,54,31,23
Алинкалол,howling-fjord,1853,priest,discipline,198,111,87
Ranocchio,the-maelstrom,1853,priest,discipline,55,30,25
Vardogz,tirion,1853,priest,discipline,305,160,145
Healseri,defias-brotherhood,1853,priest,discipline,252,126,126
Crushmyballs,ravencrest,1852,priest,discipline,60,36,24
Chéry,archimonde,1852,priest,discipline,84,46,38
Джагонх,soulflayer,1852,priest,discipline,123,61,62
Кисашвд,gordunni,1851,priest,discipline,72,42,30
Yamai,thrall,1851,priest,discipline,48,26,22
Djswdgodx,twisting-nether,1851,priest,discipline,108,55,53
Ranchikswp,ravencrest,1850,priest,discipline,42,24,18
Anabølix,ravencrest,1850,priest,discipline,65,33,32
Enilion,draenor,1850,priest,discipline,71,34,37
Fandac,sylvanas,1849,priest,discipline,90,55,35
Rngånxiety,ravencrest,1849,priest,discipline,160,78,82
Bockx,ragnaros,1849,priest,discipline,134,65,69
Rynnegan,zuljin,1849,priest,discipline,72,31,41
Padisonfire,blackmoore,1849,priest,discipline,78,33,45
Cellia,antonidas,1848,priest,discipline,66,36,30
Asdfghqwezxc,twisting-nether,1848,priest,discipline,77,40,37
Shonsized,argent-dawn,1847,priest,discipline,154,88,66
Incaflamesex,sanguino,1847,priest,discipline,221,110,111
Kianprie,silvermoon,1847,priest,discipline,125,58,67
Aédeira,blackhand,1847,priest,discipline,83,34,49
Noukeé,blackrock,1847,priest,discipline,113,46,67
Assiduous,stormreaver,1846,priest,discipline,46,27,19
Cæsifer,blackrock,1846,priest,discipline,124,71,53
Akzar,blackrock,1846,priest,discipline,741,379,362
Аэтпио,soulflayer,1846,priest,discipline,156,79,77
Anheduanna,outland,1846,priest,discipline,2300,1160,1140
Judine,kazzak,1846,priest,discipline,70,35,35
Andrë,ragnaros,1845,priest,discipline,46,29,17
Chabi,stormscale,1845,priest,discipline,45,25,20
Waafa,kazzak,1845,priest,discipline,93,50,43
Pradrak,eredar,1845,priest,discipline,60,32,28
Skjelett,stormscale,1845,priest,discipline,68,36,32
Lorimac,dun-modr,1845,priest,discipline,273,142,131
Exola,outland,1845,priest,discipline,60,31,29
Bølzer,blackrock,1845,priest,discipline,479,239,240
Frenchpriest,archimonde,1845,priest,discipline,65,30,35
Sadsadsad,ravencrest,1845,priest,discipline,102,41,61
Gothicpriest,blackrock,1844,priest,discipline,65,41,24
Milderyp,kazzak,1844,priest,discipline,168,103,65
Lanata,blackrock,1844,priest,discipline,114,60,54
Tecc,draenor,1844,priest,discipline,142,72,70
Tanly,outland,1844,priest,discipline,220,109,111
Jimpah,outland,1844,priest,discipline,189,89,100
Møelester,antonidas,1843,priest,discipline,66,36,30
Nerfthat,thunderhorn,1843,priest,discipline,59,30,29
Onyoureyebal,vashj,1843,priest,discipline,255,122,133
Лэсивэснэс,soulflayer,1843,priest,discipline,227,107,120
Bæsts,ravencrest,1842,priest,discipline,47,35,12
Jellypie,blackrock,1842,priest,discipline,60,36,24
Vyrá,der-rat-von-dalaran,1842,priest,discipline,51,30,21
Maulerion,tarren-mill,1842,priest,discipline,92,53,39
Schattenface,blackmoore,1842,priest,discipline,374,192,182
Maxfly,archimonde,1842,priest,discipline,104,53,51
Trolldý,outland,1841,priest,discipline,54,33,21
Twinkerz,ravencrest,1841,priest,discipline,120,73,47
Discoqt,aegwynn,1841,priest,discipline,66,32,34
Дезминд,howling-fjord,1840,priest,discipline,41,23,18
Phyxiusx,stormscale,1840,priest,discipline,126,70,56
Såra,ravencrest,1840,priest,discipline,343,178,165
Rngamer,silvermoon,1839,priest,discipline,42,33,9
Shîn,zirkel-des-cenarius,1839,priest,discipline,72,32,40
Brigittë,ravencrest,1839,priest,discipline,78,31,47
Paterfisl,ragnaros,1838,priest,discipline,108,64,44
Goky,kazzak,1838,priest,discipline,108,50,58
Kolerps,ravencrest,1838,priest,discipline,54,25,29
Tia,mannoroth,1838,priest,discipline,70,31,39
Lunærÿ,hyjal,1838,priest,discipline,66,28,38
ßçøûzýìñ,ravencrest,1837,priest,discipline,40,29,11
Kappa,darksorrow,1837,priest,discipline,132,86,46
Xíøn,draenor,1837,priest,discipline,48,28,20
Src,ravencrest,1837,priest,discipline,155,84,71
Jp,gorgonnash,1837,priest,discipline,69,36,33
Rogeron,blackrock,1837,priest,discipline,118,57,61
Dogfx,blackhand,1837,priest,discipline,78,36,42
Mcpriestgodx,blackrock,1837,priest,discipline,108,48,60
Duqes,stormreaver,1836,priest,discipline,57,44,13
Cyabish,twisting-nether,1836,priest,discipline,293,157,136
Hyonra,kazzak,1836,priest,discipline,66,34,32
Aspertina,outland,1836,priest,discipline,48,22,26
Aeogon,kazzak,1836,priest,discipline,179,79,100
Некронево,howling-fjord,1835,priest,discipline,51,30,21
Helalolsun,archimonde,1835,priest,discipline,308,167,141
Kathigitis,stormscale,1835,priest,discipline,89,48,41
Lexìì,archimonde,1835,priest,discipline,66,35,31
Smilézz,eredar,1835,priest,discipline,272,140,132
Прощайдуде,gordunni,1835,priest,discipline,71,36,35
Yourholynes,nemesis,1835,priest,discipline,72,35,37
Видзар,blackscar,1834,priest,discipline,42,27,15
Анстахоуп,grom,1834,priest,discipline,210,131,79
Rêstlêss,blackrock,1834,priest,discipline,161,88,73
Eliana,blackrock,1834,priest,discipline,175,92,83
Ксенонх,gordunni,1834,priest,discipline,66,30,36
Шэлиэл,soulflayer,1833,priest,discipline,143,80,63
Scarylol,blackmoore,1833,priest,discipline,60,33,27
Vemix,ravencrest,1832,priest,discipline,126,85,41
Anabananaa,ravencrest,1832,priest,discipline,106,65,41
Azaciúx,sylvanas,1832,priest,discipline,48,29,19
Flensu,stormscale,1832,priest,discipline,112,63,49
Feeqamikka,ragnaros,1832,priest,discipline,61,32,29
Dqt,ragnaros,1832,priest,discipline,115,58,57
Reckxp,twisting-nether,1832,priest,discipline,192,93,99
Nakenhäst,ravencrest,1832,priest,discipline,84,39,45
Далайна,galakrond,1832,priest,discipline,48,21,27
Holytopp,aegwynn,1831,priest,discipline,60,36,24
Seherbazqt,twisting-nether,1831,priest,discipline,232,124,108
Jøjmenejøj,ravencrest,1831,priest,discipline,197,101,96
Ðènnis,argent-dawn,1831,priest,discipline,145,73,72
Krematorio,twisting-nether,1831,priest,discipline,101,46,55
Notnowelf,silvermoon,1831,priest,discipline,108,49,59
Sazuki,sylvanas,1830,priest,discipline,119,71,48
Discberg,kazzak,1830,priest,discipline,54,29,25
Лизагодх,howling-fjord,1830,priest,discipline,306,161,145
Monsterzx,outland,1830,priest,discipline,203,102,101
Soreboners,stormscale,1830,priest,discipline,42,21,21
Deadandugly,eredar,1830,priest,discipline,114,52,62
Deviön,blackrock,1829,priest,discipline,60,32,28
Женяшилд,howling-fjord,1829,priest,discipline,402,210,192
Aliciaiscute,ravencrest,1829,priest,discipline,52,27,25
Aridarpriest,silvermoon,1829,priest,discipline,182,87,95
Akeno,sylvanas,1829,priest,discipline,70,31,39
Discipleotl,stormscale,1828,priest,discipline,143,96,47
Zisch,silvermoon,1828,priest,discipline,184,109,75
Illuminarexo,sylvanas,1828,priest,discipline,145,82,63
Sosabgd,azjolnerub,1828,priest,discipline,211,117,94
Chivalryy,argent-dawn,1828,priest,discipline,119,64,55
Ayije,ravencrest,1828,priest,discipline,180,94,86
Itayyxd,doomhammer,1828,priest,discipline,66,34,32
Ostrogami,silvermoon,1828,priest,discipline,777,382,395
Асверай,howling-fjord,1827,priest,discipline,96,58,38
Tinypump,silvermoon,1827,priest,discipline,59,33,26
Feardotexe,frostwolf,1827,priest,discipline,275,146,129
Whýççpèrx,ravencrest,1827,priest,discipline,111,56,55
Noelretsof,jaedenar,1827,priest,discipline,68,34,34
Ltmp,ravencrest,1827,priest,discipline,48,24,24
Свдпро,soulflayer,1827,priest,discipline,192,90,102
Nakenhäst,stormscale,1827,priest,discipline,80,37,43
Mobcal,twisting-nether,1827,priest,discipline,108,48,60
Oesterput,stormscale,1827,priest,discipline,48,21,27
Talbyslegacý,blackmoore,1826,priest,discipline,126,70,56
Øxxgodx,blackrock,1826,priest,discipline,162,88,74
Holytop,aegwynn,1826,priest,discipline,60,31,29
Nadøney,hyjal,1826,priest,discipline,172,87,85
Snutz,draenor,1826,priest,discipline,94,46,48
Fønss,sanguino,1826,priest,discipline,89,41,48
Sinetrax,draenor,1825,priest,discipline,48,30,18
Theythem,stormscale,1825,priest,discipline,42,25,17
Hyw,hyjal,1825,priest,discipline,45,26,19
Manuelakanji,outland,1825,priest,discipline,98,56,42
Bebydaniwey,eredar,1825,priest,discipline,48,27,21
Moglimeister,blackrock,1825,priest,discipline,78,43,35
Nothic,blackmoore,1825,priest,discipline,196,105,91
Optiprime,ravencrest,1825,priest,discipline,60,30,30
Gimeurgold,destromath,1825,priest,discipline,66,32,34
Reign,ragnaros,1825,priest,discipline,64,31,33
Chechenkata,ravencrest,1825,priest,discipline,57,27,30
Deoxx,kazzak,1825,priest,discipline,150,71,79
Vespbruv,kazzak,1824,priest,discipline,42,28,14
Йефа,gordunni,1824,priest,discipline,124,71,53
Zarez,stormscale,1824,priest,discipline,95,47,48
Xoxogg,burning-blade,1823,priest,discipline,156,102,54
Rptr,ravencrest,1823,priest,discipline,52,30,22
Tjackmackann,kazzak,1823,priest,discipline,54,29,25
Ðiiez,ysondre,1823,priest,discipline,129,69,60
Кирюшасэмпай,gordunni,1823,priest,discipline,274,145,129
Virulence,twisting-nether,1823,priest,discipline,413,216,197
Мухаглот,soulflayer,1823,priest,discipline,71,37,34
Vicønia,tarren-mill,1823,priest,discipline,65,33,32
Krautfunding,blackrock,1823,priest,discipline,66,33,33
Mald,ravencrest,1822,priest,discipline,276,146,130
Keryin,draenor,1822,priest,discipline,303,149,154
Xandrial,blackmoore,1822,priest,discipline,66,30,36
Mèlindra,draenor,1821,priest,discipline,35,28,7
Estelle,silvermoon,1821,priest,discipline,151,95,56
Билет,borean-tundra,1821,priest,discipline,42,26,16
Aâraks,khaz-modan,1821,priest,discipline,134,82,52
Tribz,kargath,1821,priest,discipline,36,22,14
Roylian,ravencrest,1821,priest,discipline,51,28,23
Mautiya,blackrock,1821,priest,discipline,120,65,55
Felaenna,argent-dawn,1821,priest,discipline,151,81,70
Miklós,die-aldor,1821,priest,discipline,54,28,26
Samaya,blackrock,1821,priest,discipline,195,98,97
Ishkà,stormscale,1821,priest,discipline,141,69,72
Xianstwo,alakir,1821,priest,discipline,84,41,43
Neurozx,ravencrest,1821,priest,discipline,66,32,34
Moyoo,kazzak,1821,priest,discipline,188,88,100
Skyland,emeriss,1820,priest,discipline,36,20,16
Dotzey,outland,1820,priest,discipline,101,43,58
Rihx,ysondre,1819,priest,discipline,115,78,37
Yunusgødx,kazzak,1819,priest,discipline,102,65,37
Силесттиль,gordunni,1819,priest,discipline,77,49,28
Noskillx,burning-legion,1819,priest,discipline,106,66,40
Legitha,blackmoore,1819,priest,discipline,51,31,20
Dribbler,ragnaros,1819,priest,discipline,70,42,28
Striderz,outland,1819,priest,discipline,126,72,54
Омилая,gordunni,1819,priest,discipline,42,24,18
Изишвд,gordunni,1819,priest,discipline,59,33,26
Ayõu,ravencrest,1819,priest,discipline,114,63,51
Дорогасмеха,howling-fjord,1819,priest,discipline,72,39,33
Remkoja,blackrock,1819,priest,discipline,114,59,55
Kristianburn,arathi,1819,priest,discipline,60,31,29
Vibéz,outland,1819,priest,discipline,54,27,27
Lucyx,antonidas,1818,priest,discipline,36,25,11
Tylér,stormscale,1818,priest,discipline,144,88,56
Jaesabøyx,twisting-nether,1818,priest,discipline,168,100,68
Doublefreak,draenor,1818,priest,discipline,108,64,44
Smitemachine,ysondre,1818,priest,discipline,60,35,25
Kimspriest,ragnaros,1818,priest,discipline,42,24,18
Fems,tarren-mill,1818,priest,discipline,90,49,41
Egi,lothar,1818,priest,discipline,51,27,24
Cæsífer,senjin,1818,priest,discipline,78,41,37
Prayxlol,outland,1818,priest,discipline,42,22,20
Blerd,eredar,1818,priest,discipline,267,139,128
Bizqit,tarren-mill,1818,priest,discipline,677,352,325
Spiritina,darkmoon-faire,1817,priest,discipline,76,52,24
Holycuddles,ysondre,1817,priest,discipline,78,47,31
Hanniri,archimonde,1817,priest,discipline,54,31,23
Отклонен,soulflayer,1817,priest,discipline,84,43,41
Rexzuwe,eredar,1817,priest,discipline,60,30,30
Шатолюгран,soulflayer,1816,priest,discipline,166,105,61
Taslight,stormscale,1816,priest,discipline,341,190,151
Приствалера,howling-fjord,1816,priest,discipline,488,249,239
Andaar,ravencrest,1816,priest,discipline,75,38,37
Flowstate,sylvanas,1816,priest,discipline,52,26,26
Thaeres,stormscale,1816,priest,discipline,65,31,34
Ferpy,ragnaros,1816,priest,discipline,84,40,44
Оченьнеочень,howling-fjord,1816,priest,discipline,72,33,39
Невертрикахд,gordunni,1816,priest,discipline,173,78,95
Hængøver,blackmoore,1816,priest,discipline,78,33,45
Jowaba,ravencrest,1815,priest,discipline,60,38,22
Flanderspri,ravencrest,1815,priest,discipline,54,30,24
Апититька,soulflayer,1815,priest,discipline,365,197,168
Виллавелл,blackscar,1815,priest,discipline,48,24,24
Solerona,blackmoore,1815,priest,discipline,48,24,24
Løs,argent-dawn,1815,priest,discipline,108,53,55
Mgx,defias-brotherhood,1815,priest,discipline,105,49,56
Teyna,alakir,1815,priest,discipline,60,28,32
Flax,the-maelstrom,1814,priest,discipline,53,37,16
Jannejanne,ravencrest,1814,priest,discipline,30,19,11
Casic,blackhand,1814,priest,discipline,65,41,24
Alexpriest,twisting-nether,1814,priest,discipline,539,283,256
Spatzdom,malygos,1814,priest,discipline,332,169,163
Mafakor,ravencrest,1814,priest,discipline,699,348,351
Yeetedmycat,stormscale,1814,priest,discipline,90,44,46
Spaanseslof,silvermoon,1814,priest,discipline,240,117,123
Asdfgfhtjy,stormscale,1814,priest,discipline,148,72,76
Шкурюклады,gordunni,1814,priest,discipline,146,71,75
Уэйнестелл,booty-bay,1814,priest,discipline,72,35,37
Charlotten,shattered-hand,1814,priest,discipline,268,123,145
Самадхизх,gordunni,1814,priest,discipline,72,32,40
Daniweyy,eredar,1813,priest,discipline,30,19,11
Stargal,blackmoore,1813,priest,discipline,54,33,21
Джастха,soulflayer,1813,priest,discipline,42,24,18
Dzyxx,ravencrest,1813,priest,discipline,66,37,29
Brownhammer,ravencrest,1813,priest,discipline,100,56,44
Efeslol,dun-modr,1813,priest,discipline,255,133,122
Jesster,sylvanas,1813,priest,discipline,81,41,40
Architectx,ravencrest,1813,priest,discipline,131,66,65
Cæsifer,area-52,1813,priest,discipline,54,27,27
Dhassy,sanguino,1812,priest,discipline,71,44,27
Viiu,eredar,1812,priest,discipline,45,25,20
Eedazap,argent-dawn,1812,priest,discipline,58,32,26
Skynoxx,ragnaros,1812,priest,discipline,221,121,100
Leahx,dalvengyr,1812,priest,discipline,76,40,36
Isalvation,stormscale,1812,priest,discipline,78,38,40
Faenei,draenor,1812,priest,discipline,66,32,34
Mïserygødx,nemesis,1811,priest,discipline,84,57,27
Eyesønyou,nemesis,1811,priest,discipline,51,33,18
Антошашвп,azuregos,1811,priest,discipline,42,25,17
Tabaç,stormscale,1811,priest,discipline,83,49,34
Holysjodin,tarren-mill,1811,priest,discipline,42,23,19
Hellhammer,stormreaver,1811,priest,discipline,310,162,148
Фалд,gordunni,1811,priest,discipline,117,61,56
Scaday,sanguino,1811,priest,discipline,54,28,26
Arythc,ahnqiraj,1811,priest,discipline,101,52,49
Pâww,kazzak,1811,priest,discipline,84,43,41
Cnqx,archimonde,1811,priest,discipline,66,32,34
Neska,antonidas,1811,priest,discipline,53,23,30
Infamous,stormscale,1810,priest,discipline,51,36,15
Muncett,dun-modr,1810,priest,discipline,113,67,46
Türsteherxxl,mannoroth,1810,priest,discipline,126,74,52
Vinopure,turalyon,1810,priest,discipline,72,39,33
Gaussqt,ravencrest,1810,priest,discipline,120,62,58
Mythasz,archimonde,1810,priest,discipline,76,35,41
Undeathy,ravencrest,1810,priest,discipline,90,39,51
Xrq,stormscale,1809,priest,discipline,36,27,9
Delftware,tarren-mill,1809,priest,discipline,36,27,9
Thedisco,kazzak,1809,priest,discipline,84,56,28
Pny,outland,1809,priest,discipline,114,62,52
Danglar,defias-brotherhood,1809,priest,discipline,126,67,59
Qzrx,draenor,1809,priest,discipline,90,47,43
Røylian,ravencrest,1809,priest,discipline,54,28,26
Kuxk,stormscale,1809,priest,discipline,48,24,24
Незерхэвэн,soulflayer,1809,priest,discipline,59,29,30
Lakeworth,argent-dawn,1809,priest,discipline,170,79,91
Fearsleba,stormreaver,1809,priest,discipline,66,30,36
Ðøñtårmørýmë,der-abyssische-rat,1809,priest,discipline,92,35,57
Sikaanyo,blackhand,1808,priest,discipline,119,68,51
Niagarafalls,ragnaros,1808,priest,discipline,231,128,103
Tudp,tarren-mill,1808,priest,discipline,283,150,133
Lãnat,ravencrest,1808,priest,discipline,51,27,24
Prips,bladefist,1808,priest,discipline,223,117,106
Lethalhealz,outland,1808,priest,discipline,458,240,218
Lyllirock,varimathras,1808,priest,discipline,75,38,37
Blackbertha,ravencrest,1808,priest,discipline,162,81,81
Ÿolo,nemesis,1807,priest,discipline,80,47,33
Ronnyvandamm,destromath,1807,priest,discipline,366,195,171
Mamaa,stormscale,1807,priest,discipline,102,54,48
Cucurulla,sanguino,1807,priest,discipline,92,48,44
Emryth,blackhand,1807,priest,discipline,300,156,144
Mirupriest,sanguino,1807,priest,discipline,66,34,32
Seasonf,tarren-mill,1807,priest,discipline,60,28,32
Supervillain,draenor,1806,priest,discipline,407,224,183
Zarahard,draenor,1806,priest,discipline,120,65,55
Níghty,ravencrest,1806,priest,discipline,144,75,69
Zeruhphin,eredar,1806,priest,discipline,54,28,26
Vigoria,stormreaver,1806,priest,discipline,294,150,144
Svenmagnus,tarren-mill,1806,priest,discipline,101,49,52
Mïxa,eitrigg,1805,priest,discipline,42,28,14
Urizal,defias-brotherhood,1805,priest,discipline,54,31,23
Артфуул,howling-fjord,1805,priest,discipline,78,43,35
Satins,silvermoon,1805,priest,discipline,98,51,47
Unbangable,draenor,1805,priest,discipline,261,134,127
Milchzáhn,frostwolf,1805,priest,discipline,289,147,142
Сандейрейн,gordunni,1805,priest,discipline,71,36,35
Ipâ,hyjal,1805,priest,discipline,417,207,210
Свдпрох,soulflayer,1805,priest,discipline,101,50,51
Élsias,blackmoore,1805,priest,discipline,75,36,39
Neems,twisting-nether,1805,priest,discipline,42,19,23
Ïcön,ravencrest,1804,priest,discipline,60,43,17
Ljusmor,silvermoon,1804,priest,discipline,99,62,37
Bennyjamin,kazzak,1804,priest,discipline,74,45,29
Floyyd,kazzak,1804,priest,discipline,42,24,18
Tynsxd,silvermoon,1804,priest,discipline,481,267,214
Needsboorst,ravencrest,1804,priest,discipline,66,36,30
Nooxid,eredar,1804,priest,discipline,159,86,73
Krokkete,hyjal,1804,priest,discipline,54,29,25
Sebbi,ragnaros,1804,priest,discipline,96,46,50
Fogel,turalyon,1803,priest,discipline,96,82,14
Niíall,skullcrusher,1803,priest,discipline,42,27,15
Laonar,silvermoon,1803,priest,discipline,181,115,66
Holydreed,ragnaros,1803,priest,discipline,233,132,101
Psjk,blackrock,1803,priest,discipline,206,112,94
Ecrisis,twisting-nether,1803,priest,discipline,243,127,116
Gehrke,silvermoon,1803,priest,discipline,117,59,58
Uivi,azjolnerub,1803,priest,discipline,80,40,40
Chekkó,blackrock,1803,priest,discipline,128,61,67
Ebiso,ravencrest,1803,priest,discipline,90,41,49
Rainbowroll,kazzak,1803,priest,discipline,82,37,45
Priestiboi,eredar,1802,priest,discipline,30,19,11
Zsg,draenor,1802,priest,discipline,150,88,62
Ледикрис,blackscar,1802,priest,discipline,125,73,52
Jetlw,ravencrest,1802,priest,discipline,354,200,154
Zoophobîa,stormscale,1802,priest,discipline,96,54,42
Lekken,kazzak,1802,priest,discipline,123,69,54
Amysantiàgo,sylvanas,1802,priest,discipline,432,231,201
Xaey,ravencrest,1802,priest,discipline,335,177,158
Bassepriest,tarren-mill,1802,priest,discipline,101,53,48
Squishylol,tarren-mill,1802,priest,discipline,66,34,32
Montarone,archimonde,1802,priest,discipline,102,52,50
Splintplays,zuljin,1802,priest,discipline,533,270,263
Карбонит,fordragon,1802,priest,discipline,54,24,30
Stola,archimonde,1802,priest,discipline,143,62,81
Mythaaz,archimonde,1802,priest,discipline,57,23,34
Кошкаенот,blackscar,1802,priest,discipline,83,33,50
Cx,mazrigos,1801,priest,discipline,65,42,23
Aski,blackhand,1801,priest,discipline,30,19,11
Mopriest,eredar,1801,priest,discipline,110,68,42
Aelisendi,draenor,1801,priest,discipline,89,51,38
Nintendó,sylvanas,1801,priest,discipline,120,68,52
Reclue,silvermoon,1801,priest,discipline,48,27,21
Rabbai,twisting-nether,1801,priest,discipline,66,37,29
Holyshiiet,stormscale,1801,priest,discipline,275,151,124
Raesd,argent-dawn,1801,priest,discipline,148,80,68
Naivah,dun-modr,1801,priest,discipline,229,122,107
Echonic,aegwynn,1801,priest,discipline,881,445,436
Bekznfiend,ragnaros,1801,priest,discipline,71,33,38
Melphixia,stormscale,1801,priest,discipline,112,50,62
Yameru,stormreaver,1801,priest,discipline,78,34,44
Зулфар,razuvious,1800,priest,discipline,48,36,12
Wardshield,ravencrest,1800,priest,discipline,29,20,9
Felwy,stormscale,1800,priest,discipline,48,31,17
Hasnoaim,dun-morogh,1800,priest,discipline,72,44,28
Nazzghul,silvermoon,1800,priest,discipline,188,105,83
Умом,gordunni,1800,priest,discipline,66,36,30
Twizl,hyjal,1800,priest,discipline,227,118,109
Mantra,blackmoore,1800,priest,discipline,351,179,172
Zuniqa,die-aldor,1800,priest,discipline,221,112,109
Некрогуро,gordunni,1800,priest,discipline,54,27,27
Lazyx,tarren-mill,1800,priest,discipline,59,29,30
Шэвэпэ,deathguard,1800,priest,discipline,69,32,37
Ilovebenji,antonidas,1800,priest,discipline,54,25,29
Opprist,ragnaros,1800,priest,discipline,102,47,55
Dimsim,kazzak,1799,priest,discipline,60,34,26
Dumbasf,sporeggar,1798,priest,discipline,102,59,43
Дефаенс,soulflayer,1798,priest,discipline,82,45,37
Debeo,ragnaros,1798,priest,discipline,169,91,78
Azymi,ravencrest,1798,priest,discipline,53,27,26
Skitspill,ravencrest,1798,priest,discipline,228,109,119
Фенджидисплх,blackscar,1798,priest,discipline,114,54,60
Cestrial,sylvanas,1797,priest,discipline,233,125,108
Kirtarah,aegwynn,1797,priest,discipline,244,126,118
Dokwhite,blackrock,1797,priest,discipline,41,20,21
Sùzy,ravencrest,1797,priest,discipline,72,30,42
Reticlel,kazzak,1796,priest,discipline,206,118,88
Collinna,aegwynn,1796,priest,discipline,153,81,72
Nàlak,archimonde,1796,priest,discipline,140,69,71
Tmnetwo,ravencrest,1796,priest,discipline,82,39,43
Siezlababo,blackrock,1795,priest,discipline,35,21,14
Эмжи,howling-fjord,1795,priest,discipline,78,44,34
Abømination,hyjal,1795,priest,discipline,200,110,90
Bigballer,stormscale,1795,priest,discipline,51,26,25
Kevinsorbo,destromath,1795,priest,discipline,90,42,48
Kèvin,das-syndikat,1794,priest,discipline,130,77,53
Пристижнаяя,gordunni,1794,priest,discipline,116,65,51
Shuya,archimonde,1794,priest,discipline,64,34,30
Cdplz,archimonde,1794,priest,discipline,143,68,75
Наглыйприст,gordunni,1793,priest,discipline,336,180,156
Ohlinsqt,outland,1793,priest,discipline,90,47,43
Entenpanda,kazzak,1793,priest,discipline,138,72,66
Saygg,ysondre,1793,priest,discipline,126,65,61
Ssjfoxyo,sylvanas,1793,priest,discipline,469,234,235
Lolylights,tarren-mill,1793,priest,discipline,270,131,139
Fainttnt,stormscale,1793,priest,discipline,102,49,53
Cnqz,archimonde,1793,priest,discipline,126,60,66
Strahle,frostwolf,1793,priest,discipline,56,25,31
Cpzach,tarren-mill,1792,priest,discipline,312,163,149
Сайдвиндер,blackscar,1792,priest,discipline,115,59,56
Racecar,executus,1792,priest,discipline,144,71,73
Maxmoto,blackrock,1791,priest,discipline,104,61,43
Milamati,kazzak,1791,priest,discipline,108,58,50
Sekker,silvermoon,1791,priest,discipline,339,180,159
Demora,ysondre,1791,priest,discipline,428,213,215
Jempi,argent-dawn,1790,priest,discipline,180,106,74
Discusting,anachronos,1790,priest,discipline,84,42,42
Yllaenia,twisting-nether,1788,priest,discipline,62,35,27
Ðézø,twisting-nether,1787,priest,discipline,114,73,41
Dîàna,archimonde,1787,priest,discipline,59,35,24
Пусясвета,gordunni,1787,priest,discipline,42,23,19
Chnechnechne,outland,1787,priest,discipline,82,44,38
Nwo,twisting-nether,1786,priest,discipline,66,43,23
Elataqt,silvermoon,1786,priest,discipline,97,53,44
Altruistx,ravencrest,1786,priest,discipline,84,41,43
Iwariel,blackmoore,1785,priest,discipline,138,72,66
Deluxgodx,kazzak,1785,priest,discipline,87,45,42
Dès,ravencrest,1785,priest,discipline,182,90,92
Svakkanxd,kazzak,1785,priest,discipline,147,68,79
Øk,draenor,1783,priest,discipline,143,81,62
Pentøs,archimonde,1783,priest,discipline,66,33,33
Iòól,veknilash,1783,priest,discipline,89,41,48
Wérrýxs,kazzak,1782,priest,discipline,184,105,79
Gajos,frostwolf,1782,priest,discipline,185,103,82
Tricavla,frostmane,1782,priest,discipline,138,76,62
Minipõppy,ravencrest,1782,priest,discipline,262,136,126
Slovak,stormscale,1782,priest,discipline,54,26,28
Wodpriest,ravencrest,1781,priest,discipline,106,59,47
Mqsx,stormscale,1781,priest,discipline,48,23,25
Swallowship,twisting-nether,1781,priest,discipline,60,28,32
Втильте,blackscar,1780,priest,discipline,191,101,90
Maikzky,stormreaver,1780,priest,discipline,36,19,17
Drlovke,stormscale,1780,priest,discipline,207,98,109
Drillinx,tarren-mill,1779,priest,discipline,113,54,59
Keypo,khaz-modan,1779,priest,discipline,125,58,67
Bubblebuddy,draenor,1779,priest,discipline,84,30,54
Leahuwu,ravencrest,1778,priest,discipline,132,65,67
Lasêr,kazzak,1777,priest,discipline,183,95,88
Ilovepmr,outland,1777,priest,discipline,44,21,23
Ballepresten,outland,1776,priest,discipline,54,27,27
Zêxy,stormscale,1776,priest,discipline,155,77,78
Rafaled,ravencrest,1776,priest,discipline,48,23,25
Søb,silvermoon,1776,priest,discipline,53,25,28
Gødsfåvørite,blackrock,1775,priest,discipline,327,168,159
Mndvx,sylvanas,1775,priest,discipline,140,70,70
Prsx,ravencrest,1775,priest,discipline,132,65,67
Lifebygunzz,archimonde,1775,priest,discipline,42,20,22
Bonzu,ravencrest,1775,priest,discipline,102,46,56
Migaz,runetotem,1774,priest,discipline,239,139,100
Zanshin,ravencrest,1773,priest,discipline,47,25,22
Sláin,outland,1773,priest,discipline,419,211,208
Jpucciù,ysondre,1773,priest,discipline,78,36,42
Djplay,aegwynn,1772,priest,discipline,66,31,35
Yroe,gorgonnash,1772,priest,discipline,60,28,32
Ohiofromntty,ravencrest,1770,priest,discipline,30,23,7
Kavrack,dalaran,1770,priest,discipline,65,34,31
Obito,outland,1770,priest,discipline,53,26,27
Mcdodgens,auchindoun,1770,priest,discipline,257,123,134
Sørcedote,dun-modr,1770,priest,discipline,72,30,42
Holyblóod,kazzak,1769,priest,discipline,110,62,48
Леддигага,gordunni,1769,priest,discipline,48,27,21
Enzysama,sanguino,1769,priest,discipline,127,68,59
Qhub,sylvanas,1769,priest,discipline,249,132,117
Неприст,ashenvale,1769,priest,discipline,72,33,39
Ðæððysgïrl,ravencrest,1768,priest,discipline,96,61,35
Hopesallgone,stormscale,1768,priest,discipline,140,80,60
Ðàx,stormscale,1768,priest,discipline,58,26,32
Teatime,aegwynn,1767,priest,discipline,45,26,19
Jaytï,ravencrest,1766,priest,discipline,42,26,16
Øxx,blackrock,1766,priest,discipline,92,51,41
Sheeash,kazzak,1766,priest,discipline,126,65,61
Verti,outland,1766,priest,discipline,232,109,123
Kovexpulthul,sunstrider,1765,priest,discipline,47,34,13
Sosûke,archimonde,1765,priest,discipline,66,38,28
Kuusistöö,kazzak,1765,priest,discipline,182,92,90
Luvdeluxe,kazzak,1764,priest,discipline,145,87,58
Yro,gorgonnash,1764,priest,discipline,125,62,63
Nadoreille,hyjal,1763,priest,discipline,570,293,277
Justdänce,hyjal,1763,priest,discipline,79,38,41
Miyà,sylvanas,1762,priest,discipline,66,38,28
Tyreha,ravencrest,1762,priest,discipline,135,74,61
Нз,soulflayer,1762,priest,discipline,83,42,41
Cätälin,twisting-nether,1762,priest,discipline,452,226,226
Bengtas,ravencrest,1762,priest,discipline,316,157,159
Wiguwigu,blackrock,1762,priest,discipline,114,51,63
Needskîll,drakthul,1762,priest,discipline,84,37,47
Destinychild,norgannon,1761,priest,discipline,94,48,46
Zeröone,silvermoon,1761,priest,discipline,251,123,128
Ladderpolice,blackmoore,1761,priest,discipline,54,26,28
Gailiugà,kazzak,1760,priest,discipline,52,33,19
Alicanx,silvermoon,1760,priest,discipline,135,80,55
Manäka,hyjal,1760,priest,discipline,42,22,20
Loarderonx,stormscale,1760,priest,discipline,59,28,31
Imnoukee,blackrock,1760,priest,discipline,42,19,23
Старлайтх,gordunni,1759,priest,discipline,59,34,25
Sonics,antonidas,1759,priest,discipline,216,120,96
Bursthilda,blackmoore,1759,priest,discipline,251,138,113
Skelica,ragnaros,1758,priest,discipline,48,27,21
Legiondisc,blackmoore,1758,priest,discipline,163,74,89
Rmpriest,blackhand,1757,priest,discipline,54,23,31
Swdommeil,blackrock,1756,priest,discipline,48,27,21
Pilgram,twilights-hammer,1756,priest,discipline,244,127,117
Raw,dragonblight,1756,priest,discipline,108,52,56
Декорий,soulflayer,1756,priest,discipline,78,36,42
Drillin,ravencrest,1756,priest,discipline,177,80,97
Abusalt,stormscale,1756,priest,discipline,84,36,48
Шайтсунг,soulflayer,1755,priest,discipline,99,55,44
Waina,defias-brotherhood,1755,priest,discipline,764,397,367
Roshmanoff,stormscale,1755,priest,discipline,54,27,27
Capslk,ravencrest,1755,priest,discipline,54,27,27
Ytsal,stormscale,1755,priest,discipline,102,46,56
Flaynbones,tarren-mill,1754,priest,discipline,47,28,19
Pureàngel,ravencrest,1754,priest,discipline,53,26,27
Lowery,argent-dawn,1754,priest,discipline,66,28,38
Waaqa,outland,1752,priest,discipline,206,105,101
Luxør,blackrock,1752,priest,discipline,54,22,32
Merylle,outland,1751,priest,discipline,41,27,14
Nätrix,tarren-mill,1751,priest,discipline,42,26,16
Devotedape,draenor,1751,priest,discipline,101,57,44
Idisck,kazzak,1751,priest,discipline,247,130,117
Уровеньб,soulflayer,1751,priest,discipline,295,151,144
Brutapriestx,stormscale,1751,priest,discipline,53,23,30
Pandalulz,turalyon,1750,priest,discipline,347,193,154
Ödriaell,the-venture-co,1750,priest,discipline,228,117,111
Kîlo,sylvanas,1750,priest,discipline,42,19,23
Isuckmattsd,aggramar,1749,priest,discipline,30,21,9
Enzineum,twisting-nether,1749,priest,discipline,84,39,45
Goldensp,sanguino,1748,priest,discipline,117,60,57
Amtoxic,stormscale,1748,priest,discipline,515,262,253
Аскеронх,howling-fjord,1748,priest,discipline,99,48,51
Pikaboom,the-maelstrom,1747,priest,discipline,48,27,21
Pb,stormscale,1747,priest,discipline,244,124,120
Дъикиймвп,deepholm,1747,priest,discipline,48,24,24
Ruñaa,argent-dawn,1747,priest,discipline,171,77,94
Krolox,blackhand,1746,priest,discipline,252,125,127
Lucksy,antonidas,1746,priest,discipline,72,34,38
Aphroditê,blackrock,1745,priest,discipline,88,49,39
Sdn,twisting-nether,1745,priest,discipline,322,161,161
Candrä,archimonde,1745,priest,discipline,47,22,25
Twirlylocks,emerald-dream,1745,priest,discipline,71,29,42
Rippertmepls,ravencrest,1744,priest,discipline,101,52,49
Susaj,tarren-mill,1744,priest,discipline,98,50,48
Preme,blackhand,1744,priest,discipline,84,41,43
Theblank,pozzo-delleternità,1743,priest,discipline,48,21,27
Nitroze,stormscale,1742,priest,discipline,100,50,50
Hugokatt,silvermoon,1742,priest,discipline,61,30,31
Cvp,twisting-nether,1742,priest,discipline,90,37,53
Sloee,kazzak,1741,priest,discipline,48,28,20
Areyqt,ravencrest,1741,priest,discipline,60,34,26
Богколтрэйн,fordragon,1741,priest,discipline,116,64,52
Emopunkgodx,draenor,1739,priest,discipline,190,115,75
Xeldrania,azshara,1739,priest,discipline,41,22,19
Trixtrex,aegwynn,1739,priest,discipline,84,39,45
Pinipom,kazzak,1738,priest,discipline,93,54,39
Frëija,ravencrest,1738,priest,discipline,95,52,43
Lyrina,twisting-nether,1738,priest,discipline,364,199,165
Waffur,twisting-nether,1738,priest,discipline,119,63,56
Lobbygriefer,ravencrest,1738,priest,discipline,1118,569,549
Kuraimb,the-maelstrom,1738,priest,discipline,117,58,59
Goldeagle,archimonde,1738,priest,discipline,72,34,38
Kirà,nemesis,1738,priest,discipline,89,41,48
Seemedotin,aegwynn,1737,priest,discipline,77,44,33
Discisiipeli,sylvanas,1737,priest,discipline,108,59,49
Skyfish,archimonde,1737,priest,discipline,62,32,30
Вашачесть,gordunni,1737,priest,discipline,231,118,113
Rqx,stormscale,1736,priest,discipline,35,23,12
Holyholy,stormscale,1736,priest,discipline,66,41,25
Traxtoor,tarren-mill,1736,priest,discipline,389,206,183
Lauriinda,culte-de-la-rive-noire,1736,priest,discipline,365,191,174
Андерприст,soulflayer,1736,priest,discipline,198,100,98
Bride,burning-legion,1735,priest,discipline,66,38,28
Judgementdaý,kazzak,1735,priest,discipline,47,27,20
Sickboy,nordrassil,1735,priest,discipline,127,70,57
Gepeitschter,frostwolf,1735,priest,discipline,462,241,221
Aruna,ravencrest,1735,priest,discipline,120,60,60
Heavensfire,twisting-nether,1735,priest,discipline,100,49,51
Sydnex,blackmoore,1734,priest,discipline,77,45,32
Títarie,aegwynn,1734,priest,discipline,62,34,28
Shdwxy,blackrock,1734,priest,discipline,243,129,114
Kaizza,burning-legion,1734,priest,discipline,105,54,51
Leffie,outland,1734,priest,discipline,102,49,53
Lasyran,outland,1734,priest,discipline,59,25,34
Goodra,sylvanas,1733,priest,discipline,42,28,14
Tmnewho,outland,1733,priest,discipline,190,102,88
Blazingad,kazzak,1733,priest,discipline,283,143,140
Enteja,outland,1733,priest,discipline,1287,645,642
Aetas,hyjal,1732,priest,discipline,72,41,31
Denunciation,argent-dawn,1732,priest,discipline,257,135,122
Hoses,twisting-nether,1732,priest,discipline,290,146,144
Shieldyman,silvermoon,1732,priest,discipline,54,27,27
Holymoly,talnivarr,1732,priest,discipline,234,114,120
Голубчикпро,lich-king,1732,priest,discipline,42,20,22
Skaliq,tarren-mill,1731,priest,discipline,390,209,181
Lavendertown,tarren-mill,1731,priest,discipline,192,101,91
Карпинчо,soulflayer,1731,priest,discipline,438,212,226
Teradros,blackhand,1731,priest,discipline,71,33,38
Tÿona,hyjal,1730,priest,discipline,182,104,78
Tallyby,blackmoore,1730,priest,discipline,58,33,25
Pflanzenmann,nozdormu,1730,priest,discipline,137,73,64
Wasnezov,blackhand,1730,priest,discipline,108,55,53
Йеэгер,soulflayer,1730,priest,discipline,213,94,119
Dimsan,aegwynn,1730,priest,discipline,127,55,72
Sîena,ravencrest,1729,priest,discipline,135,73,62
Kaksel,blackrock,1729,priest,discipline,144,77,67
Lexojam,ravencrest,1729,priest,discipline,41,21,20
Ðeep,archimonde,1729,priest,discipline,90,45,45
Ihefyehvjrm,ravencrest,1729,priest,discipline,143,67,76
Stahpit,twisting-nether,1729,priest,discipline,83,37,46
Nyù,kazzak,1728,priest,discipline,203,115,88
Obnoxious,sunstrider,1728,priest,discipline,202,101,101
Veethene,kazzak,1728,priest,discipline,242,118,124
Midzoado,ragnaros,1728,priest,discipline,111,52,59
Indîcâ,outland,1728,priest,discipline,186,82,104
Mamabeer,draenor,1727,priest,discipline,150,91,59
Westfalen,tichondrius,1727,priest,discipline,91,50,41
Sausageboy,tarren-mill,1727,priest,discipline,90,47,43
Deliriumxd,ravencrest,1727,priest,discipline,68,33,35
Bunnydisc,outland,1727,priest,discipline,116,55,61
Obeng,tarren-mill,1726,priest,discipline,41,25,16
Kaldhor,ysondre,1726,priest,discipline,119,54,65
Kirobreika,twisting-nether,1725,priest,discipline,36,25,11
Savagex,dun-modr,1725,priest,discipline,256,136,120
Aenon,argent-dawn,1725,priest,discipline,141,74,67
Felvytwo,stormscale,1725,priest,discipline,48,24,24
Bandulskii,twisting-nether,1725,priest,discipline,487,240,247
Klugzy,silvermoon,1725,priest,discipline,179,81,98
Khristo,illidan,1725,priest,discipline,96,41,55
Eladri,silvermoon,1724,priest,discipline,30,19,11
Yadif,tarren-mill,1724,priest,discipline,42,24,18
Qpapi,quelthalas,1724,priest,discipline,48,24,24
Ellinha,tarren-mill,1724,priest,discipline,124,59,65
Nazhara,hyjal,1724,priest,discipline,78,37,41
Holó,stormscale,1724,priest,discipline,174,76,98
Lucìanà,blackmoore,1723,priest,discipline,30,18,12
Beabanane,aegwynn,1723,priest,discipline,287,149,138
Anabølixx,ravencrest,1722,priest,discipline,60,37,23
Ynys,dentarg,1722,priest,discipline,48,27,21
Angemir,nemesis,1722,priest,discipline,133,71,62
Sjhzzkl,blackrock,1722,priest,discipline,411,219,192
Plsdontcry,blackrock,1722,priest,discipline,54,27,27
Gurgaue,argent-dawn,1722,priest,discipline,182,89,93
Galpriest,tarren-mill,1722,priest,discipline,68,32,36
Chrïskz,archimonde,1722,priest,discipline,84,35,49
Splf,blackrock,1721,priest,discipline,96,60,36
Irefutåbil,stormscale,1721,priest,discipline,162,91,71
Skevitche,hyjal,1721,priest,discipline,208,108,100
Øbz,sylvanas,1721,priest,discipline,124,62,62
Chaxxpriest,blackrock,1721,priest,discipline,161,73,88
Tori,marécage-de-zangar,1720,priest,discipline,56,35,21
Gwinzy,blackmoore,1720,priest,discipline,36,22,14
Syntaria,pozzo-delleternità,1720,priest,discipline,84,44,40
Folelli,ysondre,1720,priest,discipline,113,58,55
Cáss,archimonde,1720,priest,discipline,36,18,18
Жентельмен,deathguard,1720,priest,discipline,135,62,73
Рувид,gordunni,1719,priest,discipline,118,63,55
Lesse,ravencrest,1719,priest,discipline,72,38,34
Bonsoin,kirin-tor,1719,priest,discipline,36,19,17
Scurrp,aegwynn,1719,priest,discipline,96,50,46
Abudhabi,blackhand,1719,priest,discipline,489,248,241
Schwypsvnr,garona,1719,priest,discipline,42,21,21
Haveboorst,twisting-nether,1719,priest,discipline,42,21,21
Swiftdemise,sylvanas,1719,priest,discipline,250,116,134
Tsipaz,outland,1719,priest,discipline,71,30,41
Trashpriest,blackrock,1719,priest,discipline,65,27,38
Magetrainer,tarren-mill,1718,priest,discipline,78,50,28
Unstopp,blackhand,1718,priest,discipline,41,25,16
Danina,outland,1718,priest,discipline,87,52,35
Babadriver,kazzak,1718,priest,discipline,147,84,63
Jarvinia,blackmoore,1718,priest,discipline,187,93,94
Jämar,archimonde,1718,priest,discipline,89,44,45
Yungblessing,stormscale,1718,priest,discipline,77,38,39
Déàthtuna,kazzak,1718,priest,discipline,96,46,50
Baptized,baelgun,1718,priest,discipline,150,71,79
Разрухаовнз,gordunni,1717,priest,discipline,42,24,18
Roxxes,kazzak,1717,priest,discipline,68,38,30
Найтингеилл,gordunni,1717,priest,discipline,48,24,24
Awön,stormscale,1717,priest,discipline,106,51,55
Tsumu,archimonde,1716,priest,discipline,69,40,29
Windywendy,blackrock,1716,priest,discipline,147,79,68
Naphell,outland,1716,priest,discipline,247,128,119
Parzivál,argent-dawn,1716,priest,discipline,265,134,131
Smiteyoudown,blackrock,1716,priest,discipline,42,21,21
Бонзайка,blackscar,1716,priest,discipline,100,49,51
Trickyteè,tarren-mill,1716,priest,discipline,66,26,40
Tridus,eitrigg,1715,priest,discipline,30,19,11
Verjin,kazzak,1715,priest,discipline,138,61,77
Fåye,ravencrest,1714,priest,discipline,82,43,39
Iyannà,blackrock,1713,priest,discipline,89,53,36
Ascendedpwnz,silvermoon,1713,priest,discipline,167,86,81
Хербоб,howling-fjord,1713,priest,discipline,345,177,168
Brilho,frostmane,1713,priest,discipline,679,340,339
Mpßx,tarren-mill,1713,priest,discipline,93,45,48
Hadis,tarren-mill,1713,priest,discipline,174,83,91
Lótus,outland,1713,priest,discipline,134,63,71
Céira,malganis,1712,priest,discipline,102,54,48
Sinnestrike,tarren-mill,1712,priest,discipline,64,33,31
Gòldfinger,norgannon,1712,priest,discipline,210,101,109
Premierex,stormscale,1711,priest,discipline,66,38,28
Mautijr,blackrock,1711,priest,discipline,343,186,157
Decimerad,kazzak,1711,priest,discipline,42,22,20
Drë,daggerspine,1711,priest,discipline,165,85,80
Scaryolol,blackmoore,1711,priest,discipline,191,94,97
Aelíth,archimonde,1711,priest,discipline,120,58,62
Priestqt,kelthuzad,1710,priest,discipline,99,58,41
Ðarkan,kaelthas,1710,priest,discipline,162,92,70
Purplex,aggra-português,1710,priest,discipline,105,55,50
Prc,stormscale,1709,priest,discipline,72,48,24
Lowhealing,kazzak,1709,priest,discipline,78,45,33
Eliriya,thrall,1709,priest,discipline,344,170,174
Assacine,aegwynn,1708,priest,discipline,146,77,69
Remlos,der-rat-von-dalaran,1708,priest,discipline,244,128,116
Pshan,blackmoore,1708,priest,discipline,346,180,166
Kàalyx,archimonde,1708,priest,discipline,174,85,89
Utrd,kazzak,1708,priest,discipline,399,192,207
Dorkama,silvermoon,1707,priest,discipline,119,60,59
Obie,exodar,1707,priest,discipline,46,19,27
Nyxoqtxd,ravencrest,1706,priest,discipline,100,57,43
Gød,magtheridon,1706,priest,discipline,347,172,175
Nameit,eredar,1706,priest,discipline,224,104,120
Alexuwu,kazzak,1705,priest,discipline,24,18,6
Baksa,das-konsortium,1705,priest,discipline,78,48,30
Gladíator,blackhand,1705,priest,discipline,54,33,21
Kæzm,blackrock,1705,priest,discipline,131,70,61
Wraithtrippz,stormscale,1705,priest,discipline,320,164,156
Hurtless,ravencrest,1705,priest,discipline,71,34,37
Yukasa,silvermoon,1705,priest,discipline,78,34,44
Smitelay,alleria,1704,priest,discipline,42,27,15
Morgíon,azshara,1704,priest,discipline,101,63,38
Drée,hyjal,1704,priest,discipline,54,28,26
Splís,ravencrest,1704,priest,discipline,81,33,48
Rivíía,drakthul,1703,priest,discipline,112,63,49
Zthul,draenor,1703,priest,discipline,104,58,46
Файкахохо,soulflayer,1703,priest,discipline,109,49,60
Aureliones,drakthul,1702,priest,discipline,84,55,29
Meganx,ravencrest,1702,priest,discipline,60,34,26
Gladiav,hyjal,1702,priest,discipline,72,39,33
Virdeo,aegwynn,1702,priest,discipline,66,34,32
Ninxy,sylvanas,1702,priest,discipline,166,80,86
Прристуха,gordunni,1702,priest,discipline,132,58,74
Lmnsqzy,ravencrest,1701,priest,discipline,36,24,12
Xulgarath,silvermoon,1701,priest,discipline,95,58,37
Darkshdwbrst,malorne,1701,priest,discipline,295,159,136
Ruckusxz,ravencrest,1701,priest,discipline,53,28,25
Noxr,ravencrest,1701,priest,discipline,68,28,40
Yânùx,aegwynn,1700,priest,discipline,36,24,12
Kapts,twisting-nether,1700,priest,discipline,30,18,12
Healbotmvp,ravencrest,1700,priest,discipline,42,24,18
Leckpriest,sanguino,1700,priest,discipline,286,161,125
Saniss,tarren-mill,1700,priest,discipline,90,48,42
Nomakprst,sanguino,1700,priest,discipline,327,173,154
Cctw,archimonde,1700,priest,discipline,344,172,172
Nightsøul,ragnaros,1699,priest,discipline,417,222,195
Yore,ravencrest,1699,priest,discipline,48,24,24
Ampara,thrall,1699,priest,discipline,120,59,61
Matmonp,hyjal,1699,priest,discipline,107,50,57
Presspainsup,tarren-mill,1699,priest,discipline,66,26,40
Waramoly,eredar,1698,priest,discipline,189,110,79
Holycrapx,chromaggus,1698,priest,discipline,237,127,110
Закс,blackscar,1698,priest,discipline,48,22,26
Kevokko,silvermoon,1698,priest,discipline,60,25,35
Yuukiilove,kult-der-verdammten,1697,priest,discipline,35,25,10
Painxd,stormscale,1697,priest,discipline,93,54,39
Fkitweball,argent-dawn,1697,priest,discipline,36,20,16
Healurnanny,aegwynn,1697,priest,discipline,215,116,99
Plåtpriest,twisting-nether,1697,priest,discipline,348,185,163
Jumby,outland,1697,priest,discipline,46,24,22
Justys,twisting-nether,1697,priest,discipline,72,37,35
Deathblind,blackmoore,1697,priest,discipline,42,21,21
Notpetya,kazzak,1697,priest,discipline,70,30,40
Neverlandx,bladefist,1696,priest,discipline,100,57,43
Kahir,ravencrest,1696,priest,discipline,98,52,46
Mitas,ravencrest,1696,priest,discipline,59,29,30
Sikola,ragnaros,1696,priest,discipline,90,40,50
Cptisus,draenor,1696,priest,discipline,72,31,41
Mixoo,throkferoth,1696,priest,discipline,95,40,55
Оналкин,gordunni,1695,priest,discipline,54,28,26
Fizzy,arthas,1695,priest,discipline,82,42,40
Walkmydome,twisting-nether,1695,priest,discipline,399,203,196
Swdommeil,aegwynn,1695,priest,discipline,48,24,24
Kenobai,kazzak,1695,priest,discipline,89,41,48
Эвэргарден,eversong,1695,priest,discipline,108,45,63
Jumpaxx,archimonde,1695,priest,discipline,53,20,33
Glyss,draenor,1694,priest,discipline,97,53,44
Gehrketwo,silvermoon,1694,priest,discipline,48,26,22
Yö,stormscale,1694,priest,discipline,42,22,20
Йуп,ashenvale,1694,priest,discipline,118,59,59
Tassivemits,sylvanas,1694,priest,discipline,60,28,32
Angrypiex,stormscale,1694,priest,discipline,83,38,45
Fiskpung,draenor,1693,priest,discipline,72,49,23
Arlekin,ravencrest,1693,priest,discipline,114,70,44
Sponpriest,ravencrest,1693,priest,discipline,271,156,115
Dreifearfünf,arygos,1693,priest,discipline,114,63,51
Deki,outland,1693,priest,discipline,120,66,54
Doyun,kazzak,1693,priest,discipline,95,50,45
Rixfoulah,ysondre,1693,priest,discipline,36,18,18
Missright,ragnaros,1693,priest,discipline,36,18,18
Saturno,chogall,1693,priest,discipline,90,44,46
Awien,kazzak,1693,priest,discipline,111,47,64
Diszis,blackhand,1692,priest,discipline,78,43,35
Ggbenis,ragnaros,1692,priest,discipline,83,44,39
Naomirussell,sylvanas,1692,priest,discipline,66,34,32
Csúforck,ragnaros,1692,priest,discipline,128,65,63
Pierrebourne,blackmoore,1692,priest,discipline,48,23,25
Tarellia,argent-dawn,1691,priest,discipline,323,187,136
Valnor,pozzo-delleternità,1691,priest,discipline,152,81,71
Coqa,blackrock,1691,priest,discipline,72,37,35
Owrly,bladefist,1691,priest,discipline,196,94,102
ßøunty,dun-modr,1691,priest,discipline,48,23,25
Nidetha,draenor,1691,priest,discipline,42,18,24
Hannirï,archimonde,1690,priest,discipline,112,72,40
Dealtime,ysondre,1690,priest,discipline,49,27,22
Zzbleh,stormscale,1690,priest,discipline,108,59,49
Djleffe,stormscale,1689,priest,discipline,45,27,18
Шестьнадцать,gordunni,1689,priest,discipline,107,60,47
Аая,blackscar,1689,priest,discipline,144,76,68
Yörüichi,kazzak,1689,priest,discipline,42,22,20
Chîllipriest,draenor,1689,priest,discipline,196,102,94
Zèl,blackmoore,1689,priest,discipline,61,29,32
Zelyxoxo,blackrock,1689,priest,discipline,96,45,51
Pixe,argent-dawn,1689,priest,discipline,66,27,39
Pouffi,garona,1688,priest,discipline,36,21,15
Alesthion,silvermoon,1688,priest,discipline,194,106,88
Дцевгений,gordunni,1688,priest,discipline,54,25,29
Wonderdispel,ragnaros,1688,priest,discipline,95,41,54
Icepoint,aggra-português,1688,priest,discipline,78,30,48
Voidbone,stormscale,1687,priest,discipline,42,22,20
Rickerstrike,stormscale,1687,priest,discipline,161,79,82
Berseenreikä,the-venture-co,1687,priest,discipline,60,29,31
Шаастраха,gordunni,1687,priest,discipline,121,56,65
Suxino,stormscale,1686,priest,discipline,316,178,138
Unsüllied,kazzak,1686,priest,discipline,48,25,23
Dispelgodxx,eredar,1686,priest,discipline,60,27,33
Fractu,tarren-mill,1686,priest,discipline,94,42,52
Pstech,ravencrest,1685,priest,discipline,69,38,31
Dállas,ravencrest,1685,priest,discipline,92,50,42
Yugemilkers,kazzak,1685,priest,discipline,233,119,114
Dollyboo,tarren-mill,1685,priest,discipline,54,24,30
Sfantul,darkspear,1685,priest,discipline,48,20,28
Isuckpriest,aegwynn,1684,priest,discipline,168,87,81
Джеиня,goldrinn,1684,priest,discipline,53,25,28
Neliica,silvermoon,1684,priest,discipline,138,59,79
Pieceoftrash,stormscale,1683,priest,discipline,191,97,94
Papoopepoo,sanguino,1683,priest,discipline,150,73,77
Carë,anubarak,1683,priest,discipline,125,59,66
Barackomana,blackrock,1683,priest,discipline,120,56,64
Ârth,kirin-tor,1683,priest,discipline,48,22,26
Goodheall,outland,1682,priest,discipline,35,21,14
Yassjr,archimonde,1682,priest,discipline,62,35,27
Kleot,ragnaros,1682,priest,discipline,844,428,416
Shììnx,hyjal,1682,priest,discipline,48,24,24
Jeanshield,varimathras,1681,priest,discipline,226,112,114
Skinandbones,sylvanas,1681,priest,discipline,209,101,108
Kaleycuoco,blackrock,1681,priest,discipline,114,55,59
Рнкх,lich-king,1681,priest,discipline,58,27,31
Mojoo,aggramar,1681,priest,discipline,48,22,26
Deathgodx,archimonde,1680,priest,discipline,154,85,69
Артжрец,soulflayer,1680,priest,discipline,82,45,37
Zingeling,ravencrest,1680,priest,discipline,60,31,29
Соникида,gordunni,1680,priest,discipline,130,61,69
Aestina,silvermoon,1679,priest,discipline,323,167,156
ßrûm,archimonde,1679,priest,discipline,48,23,25
Анклфрост,gordunni,1679,priest,discipline,72,34,38
Garbins,stormscale,1678,priest,discipline,59,35,24
Swkunz,dun-modr,1678,priest,discipline,465,227,238
Eolîn,draenor,1678,priest,discipline,96,46,50
Alwaysøøm,kazzak,1677,priest,discipline,204,113,91
Randmbare,nemesis,1677,priest,discipline,42,23,19
Jallahrud,stormscale,1677,priest,discipline,103,54,49
Verweven,twisting-nether,1677,priest,discipline,137,71,66
Bibilamuerte,archimonde,1677,priest,discipline,36,18,18
Iløvelena,ravencrest,1676,priest,discipline,98,55,43
Leåh,ravencrest,1676,priest,discipline,114,60,54
Clownspec,twisting-nether,1676,priest,discipline,54,26,28
Sighs,khaz-modan,1676,priest,discipline,55,26,29
Dankopriest,drakthul,1675,priest,discipline,155,92,63
Flurri,tarren-mill,1675,priest,discipline,195,111,84
Senkín,aegwynn,1675,priest,discipline,255,138,117
Iirina,draenor,1675,priest,discipline,42,22,20
Eliverax,outland,1675,priest,discipline,169,83,86
Hôt,archimonde,1675,priest,discipline,47,23,24
Apuessii,dun-modr,1675,priest,discipline,83,36,47
Flickos,twisting-nether,1674,priest,discipline,36,22,14
Tattum,ragnaros,1674,priest,discipline,130,77,53
Nyxém,blackmoore,1674,priest,discipline,72,36,36
Meltmvp,thrall,1674,priest,discipline,66,33,33
Zýgzäg,hyjal,1674,priest,discipline,226,111,115
Rytmusqt,outland,1674,priest,discipline,162,78,84
Geforcès,archimonde,1674,priest,discipline,113,45,68
Ticklypriest,outland,1673,priest,discipline,64,39,25
Forcedtoheal,sylvanas,1673,priest,discipline,85,51,34
Insânity,kazzak,1673,priest,discipline,36,20,16
Шэдоура,gordunni,1673,priest,discipline,327,169,158
Возрождающее,soulflayer,1673,priest,discipline,541,279,262
Dreythan,alakir,1673,priest,discipline,96,48,48
Hodscha,aegwynn,1673,priest,discipline,267,124,143
Alyzzé,blackhand,1672,priest,discipline,42,26,16
Onaltnoqs,silvermoon,1672,priest,discipline,76,39,37
Flygar,outland,1672,priest,discipline,120,61,59
Bawsy,blackrock,1671,priest,discipline,226,134,92
Byef,kazzak,1671,priest,discipline,56,31,25
Voided,nemesis,1671,priest,discipline,186,95,91
Rankoneprazt,stormscale,1671,priest,discipline,251,127,124
Acarru,stormscale,1671,priest,discipline,42,19,23
Owpex,outland,1670,priest,discipline,36,22,14
Qtdorr,ravencrest,1670,priest,discipline,178,103,75
Dêrbómbêr,guldan,1670,priest,discipline,96,54,42
Babybelle,arakarahm,1670,priest,discipline,88,49,39
Санггвиний,soulflayer,1670,priest,discipline,258,138,120
Swoptoplong,blackhand,1670,priest,discipline,503,263,240
Xzep,archimonde,1670,priest,discipline,482,239,243
Сосиска,deathguard,1670,priest,discipline,41,20,21
Wikpriest,ravencrest,1670,priest,discipline,88,41,47
Apeminister,nemesis,1670,priest,discipline,42,19,23
Pristel,twisting-nether,1669,priest,discipline,42,23,19
Littlehelper,shendralar,1669,priest,discipline,81,41,40
Mcdeady,tarren-mill,1669,priest,discipline,86,41,45
Namîxoxo,ysondre,1669,priest,discipline,106,49,57
Mástermínd,kazzak,1668,priest,discipline,99,64,35
Corrâ,aegwynn,1668,priest,discipline,42,24,18
Malapriest,dalaran,1668,priest,discipline,108,60,48
Шмэтар,gordunni,1668,priest,discipline,96,53,43
Skycity,silvermoon,1668,priest,discipline,69,35,34
Bilbobanging,aggramar,1668,priest,discipline,60,30,30
Myggsparv,stormscale,1668,priest,discipline,161,77,84
Машура,grom,1668,priest,discipline,48,22,26
Devastris,ravencrest,1668,priest,discipline,102,43,59
Cosmicfaith,kazzak,1667,priest,discipline,76,44,32
Jesslol,archimonde,1667,priest,discipline,40,23,17
Calling,nozdormu,1667,priest,discipline,125,66,59
Kygodisc,ravencrest,1667,priest,discipline,219,114,105
Ronlimonkek,dun-modr,1667,priest,discipline,246,123,123
Daskemaskinx,the-maelstrom,1667,priest,discipline,42,20,22
Aòo,twisting-nether,1667,priest,discipline,103,49,54
Romei,tarren-mill,1667,priest,discipline,42,18,24
Velyrium,tarren-mill,1666,priest,discipline,30,22,8
Tygstycke,tarren-mill,1666,priest,discipline,50,30,20
Vregoa,twisting-nether,1666,priest,discipline,113,63,50
Solaçe,antonidas,1666,priest,discipline,120,64,56
Thanatae,kazzak,1666,priest,discipline,54,26,28
Touchmypink,ragnaros,1666,priest,discipline,519,248,271
Doorix,nethersturm,1666,priest,discipline,80,36,44
Jasty,nemesis,1666,priest,discipline,88,35,53
Fortítude,draenor,1665,priest,discipline,30,20,10
Bestinuk,kazzak,1665,priest,discipline,100,63,37
Trntypr,senjin,1665,priest,discipline,84,48,36
Mentaldeadp,draenor,1665,priest,discipline,183,103,80
Зетш,soulflayer,1665,priest,discipline,41,22,19
Giggí,malganis,1665,priest,discipline,213,109,104
Pehmoinen,korgall,1665,priest,discipline,201,99,102
Hialdo,bladefist,1665,priest,discipline,102,47,55
Jezaja,sylvanas,1665,priest,discipline,84,37,47
Frígídhealz,outland,1665,priest,discipline,48,20,28
Yeatsnu,blackmoore,1664,priest,discipline,29,19,10
Kintsugí,ragnaros,1664,priest,discipline,60,39,21
Deadthicc,hyjal,1664,priest,discipline,104,67,37
Дардж,blackscar,1664,priest,discipline,102,54,48
Anotu,tarren-mill,1664,priest,discipline,102,53,49
Botstyleswdx,ravencrest,1664,priest,discipline,312,153,159
Märlborö,aggra-português,1664,priest,discipline,197,94,103
Alessana,antonidas,1663,priest,discipline,53,31,22
Fricia,zuljin,1663,priest,discipline,100,57,43
Stepsisterr,ravencrest,1663,priest,discipline,287,158,129
Luckystar,grim-batol,1663,priest,discipline,153,78,75
Афганский,gordunni,1663,priest,discipline,88,44,44
Nimb,blackrock,1663,priest,discipline,78,37,41
Elsieexø,ravencrest,1663,priest,discipline,102,47,55
Alahkazam,alakir,1663,priest,discipline,56,24,32
Caramello,stormscale,1662,priest,discipline,240,125,115
Quïzzler,ragnaros,1662,priest,discipline,77,40,37
Liviúss,draenor,1662,priest,discipline,487,252,235
Cizer,kazzak,1662,priest,discipline,182,92,90
Ew,shattered-halls,1662,priest,discipline,82,38,44
Ислейн,howling-fjord,1662,priest,discipline,59,24,35
Лилтёрти,soulflayer,1661,priest,discipline,52,31,21
Thiela,ravencrest,1661,priest,discipline,94,48,46
Moonsaint,stormscale,1661,priest,discipline,61,31,30
Сонясоукьют,gordunni,1661,priest,discipline,60,28,32
Estuary,turalyon,1660,priest,discipline,48,28,20
Неох,gordunni,1660,priest,discipline,58,32,26
Jesper,outland,1660,priest,discipline,34,18,16
Фокусшвд,soulflayer,1660,priest,discipline,180,90,90
Alicewhydel,blackhand,1660,priest,discipline,52,25,27
Ahun,taerar,1660,priest,discipline,54,25,29
Stórmén,kazzak,1660,priest,discipline,52,19,33
Grandpatea,silvermoon,1659,priest,discipline,30,21,9
Galadríel,malganis,1659,priest,discipline,71,43,28
Boogereater,kazzak,1659,priest,discipline,30,18,12
Ripperdepip,magtheridon,1659,priest,discipline,510,272,238
Zíria,outland,1659,priest,discipline,343,175,168
Faintly,emeriss,1659,priest,discipline,66,33,33
Shaneya,silvermoon,1659,priest,discipline,70,33,37
Lilypalmer,stormscale,1659,priest,discipline,102,48,54
Sills,twisting-nether,1659,priest,discipline,82,38,44
Babydark,ravencrest,1658,priest,discipline,32,19,13
Touddixz,blackrock,1658,priest,discipline,59,35,24
Finalprayer,silvermoon,1658,priest,discipline,149,87,62
Изилол,soulflayer,1658,priest,discipline,88,51,37
Valfore,eldrethalas,1658,priest,discipline,175,94,81
Pristern,tarren-mill,1658,priest,discipline,144,74,70
Veryfine,draenor,1658,priest,discipline,154,77,77
Thaykza,blackmoore,1658,priest,discipline,69,33,36
Undeadpriest,aegwynn,1658,priest,discipline,54,21,33
Floorpovx,blackmoore,1657,priest,discipline,42,25,17
Myrmz,archimonde,1657,priest,discipline,123,71,52
Stepmama,kazzak,1657,priest,discipline,42,23,19
Mystz,dun-modr,1657,priest,discipline,81,39,42
Djokui,uldum,1657,priest,discipline,54,22,32
Nyrziâ,archimonde,1656,priest,discipline,36,23,13
Atothéèx,outland,1656,priest,discipline,95,51,44
Feniyxa,die-aldor,1656,priest,discipline,42,22,20
Violentha,kazzak,1656,priest,discipline,244,126,118
Dreê,hyjal,1656,priest,discipline,114,53,61
Эсминза,gordunni,1656,priest,discipline,54,23,31
Devoura,sylvanas,1656,priest,discipline,87,37,50
Seeyae,ravencrest,1655,priest,discipline,28,19,9
Gnzysan,blackrock,1655,priest,discipline,114,66,48
Aéríthx,ravencrest,1655,priest,discipline,285,151,134
Healêl,sanguino,1655,priest,discipline,105,48,57
Bromine,twisting-nether,1654,priest,discipline,75,53,22
Gumer,antonidas,1654,priest,discipline,36,21,15
Xaeroow,archimonde,1654,priest,discipline,79,43,36
Syreet,silvermoon,1654,priest,discipline,484,244,240
Prästmåns,tarren-mill,1654,priest,discipline,102,48,54
Zërøx,ysondre,1654,priest,discipline,271,123,148
Xarac,eredar,1654,priest,discipline,60,27,33
Bammerr,stormscale,1653,priest,discipline,28,19,9
Mawok,blackmoore,1653,priest,discipline,53,26,27
Aloegarten,ravencrest,1653,priest,discipline,145,70,75
Redempt,nemesis,1653,priest,discipline,47,21,26
Sutenör,kazzak,1653,priest,discipline,162,69,93
Alusiepriest,ravencrest,1652,priest,discipline,175,106,69
Saturnqt,archimonde,1652,priest,discipline,48,28,20
Шпангл,gordunni,1652,priest,discipline,334,176,158
Азмоддан,azuregos,1652,priest,discipline,215,103,112
Rylpriest,blackmoore,1651,priest,discipline,61,36,25
Daddydisc,tarren-mill,1651,priest,discipline,58,34,24
Drmwow,kazzak,1651,priest,discipline,159,89,70
Zoe,aegwynn,1651,priest,discipline,300,161,139
Kyderr,blackrock,1651,priest,discipline,120,63,57
Mythrixia,draenor,1651,priest,discipline,193,100,93
Тоориал,howling-fjord,1651,priest,discipline,386,195,191
Gødsmack,blackhand,1651,priest,discipline,131,65,66
Nelakya,blackmoore,1651,priest,discipline,48,23,25
Yeahr,kazzak,1651,priest,discipline,214,97,117
Chabih,ravencrest,1651,priest,discipline,120,54,66
Covidisc,outland,1651,priest,discipline,78,33,45
Danucd,ragnaros,1650,priest,discipline,206,124,82
Melord,thunderhorn,1650,priest,discipline,102,57,45
Oxiièmort,khaz-modan,1650,priest,discipline,42,23,19
Notpoulet,sylvanas,1650,priest,discipline,89,45,44
Voleck,aegwynn,1650,priest,discipline,54,25,29
Bochonok,stormrage,1650,priest,discipline,54,23,31
Krecik,deathwing,1650,priest,discipline,59,25,34
Kâîri,ragnaros,1649,priest,discipline,39,26,13
Jeez,twilights-hammer,1649,priest,discipline,283,151,132
Dathanosp,outland,1649,priest,discipline,48,25,23
Blindmymind,malganis,1649,priest,discipline,153,79,74
Nocdsusage,draenor,1649,priest,discipline,294,148,146
Rhæveth,ravencrest,1648,priest,discipline,48,31,17
Reäzx,archimonde,1648,priest,discipline,126,78,48
Loreleì,sylvanas,1648,priest,discipline,78,48,30
Chèéks,kazzak,1648,priest,discipline,72,43,29
Drlight,stormscale,1648,priest,discipline,170,91,79
Могулас,soulflayer,1648,priest,discipline,792,406,386
Aviex,twisting-nether,1648,priest,discipline,96,43,53
Jumpàxx,archimonde,1648,priest,discipline,60,26,34
Joeelz,blackmoore,1647,priest,discipline,36,25,11
Athelsta,alleria,1647,priest,discipline,135,72,63
Ðæððÿsgïrl,ravencrest,1647,priest,discipline,171,89,82
Healdeal,stormscale,1647,priest,discipline,518,259,259
Алеброн,gordunni,1647,priest,discipline,66,32,34
Madev,thrall,1647,priest,discipline,144,69,75
Anvena,elune,1647,priest,discipline,60,26,34
Выдокбля,soulflayer,1646,priest,discipline,58,41,17
Appraiser,draenor,1646,priest,discipline,44,27,17
Tøxicboy,ravencrest,1646,priest,discipline,89,48,41
Blasterno,twisting-nether,1646,priest,discipline,51,27,24
Erfofthesop,chants-éternels,1646,priest,discipline,40,21,19
Auroree,stormscale,1646,priest,discipline,54,23,31
Discxqt,ysondre,1645,priest,discipline,92,56,36
Мастди,ashenvale,1645,priest,discipline,47,23,24
Pestmorran,sylvanas,1645,priest,discipline,515,249,266
Shdetrzyx,outland,1645,priest,discipline,56,21,35
Gødisc,blackrock,1644,priest,discipline,36,23,13
Árî,dun-modr,1644,priest,discipline,174,99,75
Layster,chants-éternels,1644,priest,discipline,42,23,19
Darkprofit,aegwynn,1644,priest,discipline,221,117,104
Scràppy,malganis,1644,priest,discipline,48,23,25
Scarified,aggramar,1644,priest,discipline,131,62,69
Monataamis,kazzak,1644,priest,discipline,117,53,64
Patriamore,jaedenar,1644,priest,discipline,106,46,60
Japral,blackhand,1643,priest,discipline,66,40,26
Zeiphe,kargath,1643,priest,discipline,69,40,29
Uo,kilrogg,1643,priest,discipline,195,104,91
Phorno,ragnaros,1643,priest,discipline,80,39,41
Mêduse,ravencrest,1643,priest,discipline,147,68,79
Kolinamenuss,dun-morogh,1643,priest,discipline,107,47,60
Discmoo,kazzak,1642,priest,discipline,32,22,10
Xtracheesy,ragnaros,1642,priest,discipline,90,54,36
Нед,greymane,1642,priest,discipline,297,160,137
Wawreks,drakthul,1642,priest,discipline,47,25,22
Babambaba,sylvanas,1642,priest,discipline,51,27,24
Tashziehn,blackrock,1642,priest,discipline,348,182,166
Cinnamoroll,ravencrest,1642,priest,discipline,60,29,31
Slemso,stormscale,1641,priest,discipline,30,20,10
Kuqezi,archimonde,1641,priest,discipline,96,53,43
Интенси,gordunni,1641,priest,discipline,278,141,137
Репабликуес,gordunni,1641,priest,discipline,36,18,18
Fluvnidi,ravencrest,1640,priest,discipline,66,38,28
Priéstitude,kazzak,1640,priest,discipline,42,24,18
Prästbaazil,ragnaros,1640,priest,discipline,72,40,32
Mysticmäc,aegwynn,1640,priest,discipline,96,47,49
Gobblestick,draenor,1640,priest,discipline,191,93,98
Eitukaeitai,outland,1640,priest,discipline,72,28,44
Slowinmotion,twisting-nether,1639,priest,discipline,42,25,17
Сенсис,gordunni,1639,priest,discipline,362,192,170
Shadowburst,archimonde,1639,priest,discipline,60,31,29
Sicknp,sylvanas,1639,priest,discipline,90,46,44
Îwi,archimonde,1639,priest,discipline,78,35,43
Xaerroow,archimonde,1638,priest,discipline,70,42,28
Hrtbrxkn,ravencrest,1638,priest,discipline,82,47,35
Vigodis,alleria,1638,priest,discipline,150,83,67
Äliénør,khaz-modan,1638,priest,discipline,165,89,76
Slimcharles,ravencrest,1638,priest,discipline,219,116,103
Nuriva,frostmane,1638,priest,discipline,72,26,46
Ltrxo,twisting-nether,1637,priest,discipline,59,40,19
Shalvy,aegwynn,1637,priest,discipline,242,123,119
Toxp,kazzak,1637,priest,discipline,244,119,125
Ðês,ravencrest,1637,priest,discipline,196,93,103
Schlämpie,blackmoore,1637,priest,discipline,73,32,41
Pewpewpew,krasus,1636,priest,discipline,127,73,54
Limeslayerx,veklor,1636,priest,discipline,111,62,49
Aerael,auchindoun,1636,priest,discipline,42,23,19
Cylantharia,eredar,1636,priest,discipline,189,98,91
Hodgins,bloodscalp,1636,priest,discipline,88,45,43
Animalrescue,draenor,1636,priest,discipline,78,39,39
Ванальная,soulflayer,1636,priest,discipline,42,21,21
Nooblygaming,nemesis,1636,priest,discipline,250,124,126
Milania,ravencrest,1636,priest,discipline,118,57,61
Remøørsêlês,outland,1635,priest,discipline,135,85,50
Izanamì,ragnaros,1635,priest,discipline,47,23,24
Shadowzrip,twilights-hammer,1635,priest,discipline,90,42,48
Tiphereth,blackmoore,1635,priest,discipline,119,52,67
Zéntius,twisting-nether,1635,priest,discipline,83,36,47
Лютаяшиза,gordunni,1634,priest,discipline,95,57,38
Balboa,archimonde,1634,priest,discipline,30,18,12
Eördög,ragnaros,1634,priest,discipline,240,132,108
Bigpinkballs,tarren-mill,1634,priest,discipline,93,51,42
Noodlesoup,daggerspine,1634,priest,discipline,343,187,156
Xxoo,antonidas,1634,priest,discipline,41,22,19
Hamati,blackhand,1634,priest,discipline,246,131,115
Twosugars,sylvanas,1634,priest,discipline,186,97,89
Máia,twisting-nether,1634,priest,discipline,121,62,59
Nihpolz,ragnaros,1634,priest,discipline,176,90,86
Byebee,stormscale,1633,priest,discipline,90,56,34
Mydianá,aegwynn,1633,priest,discipline,44,27,17
Fløkï,stormscale,1633,priest,discipline,36,22,14
Freezeage,stormscale,1633,priest,discipline,90,50,40
Jhaazx,nemesis,1633,priest,discipline,272,144,128
Eyecry,sylvanas,1633,priest,discipline,93,49,44
Raerâ,archimonde,1633,priest,discipline,40,21,19
Boukàry,illidan,1633,priest,discipline,42,22,20
Anotherdisc,aegwynn,1633,priest,discipline,518,260,258
Anzee,tarren-mill,1633,priest,discipline,72,35,37
Mindx,sylvanas,1633,priest,discipline,227,110,117
Yzina,archimonde,1633,priest,discipline,114,51,63
Misántropo,dun-modr,1632,priest,discipline,59,38,21
Psyhov,ragnaros,1632,priest,discipline,93,54,39
Sebikpri,ravencrest,1632,priest,discipline,90,51,39
Иоона,gordunni,1632,priest,discipline,36,20,16
Eagrh,ravencrest,1632,priest,discipline,450,244,206
Lilyrosemary,arathor,1632,priest,discipline,55,29,26
Hydroxizine,ragnaros,1632,priest,discipline,66,34,32
Runay,draenor,1632,priest,discipline,58,27,31
Jezuz,blackhand,1632,priest,discipline,66,28,38
Oldkaiz,shattered-hand,1631,priest,discipline,141,87,54
Supfamskrrt,stormscale,1631,priest,discipline,84,43,41
Sneboldìs,sylvanas,1630,priest,discipline,48,30,18
Angelofdeàth,kazzak,1630,priest,discipline,180,105,75
Severalx,ravencrest,1630,priest,discipline,48,24,24
Kaelena,steamwheedle-cartel,1630,priest,discipline,42,21,21
Zyrean,bronzebeard,1630,priest,discipline,76,36,40
Oscoolytb,archimonde,1630,priest,discipline,154,69,85
Biscuits,ravencrest,1630,priest,discipline,132,54,78
Thielaxx,ravencrest,1630,priest,discipline,51,20,31
Симпоз,howling-fjord,1629,priest,discipline,110,53,57
Pyion,antonidas,1629,priest,discipline,108,51,57
Olurin,rajaxx,1629,priest,discipline,108,48,60
Superdude,stormscale,1629,priest,discipline,59,26,33
Abcdefghijk,sanguino,1628,priest,discipline,24,17,7
Shadowkym,blackrock,1628,priest,discipline,84,53,31
Satzuki,sylvanas,1628,priest,discipline,39,24,15
Antainis,silvermoon,1628,priest,discipline,239,133,106
Pokahonta,silvermoon,1628,priest,discipline,363,186,177
Obbdasknob,ravencrest,1628,priest,discipline,141,71,70
Эридия,soulflayer,1628,priest,discipline,132,65,67
Ømñyx,outland,1628,priest,discipline,54,26,28
Sadoxy,kult-der-verdammten,1628,priest,discipline,48,22,26
Leviakerman,blackrock,1628,priest,discipline,42,18,24
Prezica,stormscale,1627,priest,discipline,258,140,118
Nilera,frostwolf,1627,priest,discipline,116,61,55
Kaiikoo,ravencrest,1627,priest,discipline,36,17,19
Xsydepriest,archimonde,1627,priest,discipline,54,22,32
Kizmy,archimonde,1627,priest,discipline,54,22,32
Dush,draenor,1626,priest,discipline,68,39,29
Lïnkz,kazzak,1626,priest,discipline,150,83,67
Fendoly,thrall,1626,priest,discipline,71,39,32
Lerdameur,arakarahm,1626,priest,discipline,302,146,156
Seanoob,turalyon,1626,priest,discipline,43,18,25
Marôs,antonidas,1626,priest,discipline,96,40,56
Asgà,stormscale,1625,priest,discipline,30,17,13
Belkanf,draenor,1625,priest,discipline,72,40,32
Ñíò,archimonde,1625,priest,discipline,72,39,33
Tifa,ravencrest,1625,priest,discipline,193,103,90
Roxeal,archimonde,1625,priest,discipline,228,121,107
Narinelepen,culte-de-la-rive-noire,1625,priest,discipline,54,26,28
Nissha,stormscale,1625,priest,discipline,123,54,69
Jeboc,ravencrest,1625,priest,discipline,95,40,55
Fearadelia,thrall,1624,priest,discipline,48,31,17
Labadudala,aegwynn,1624,priest,discipline,84,54,30
Артекриожрец,gordunni,1624,priest,discipline,36,21,15
Garsdal,tarren-mill,1624,priest,discipline,78,43,35
Verminous,ravencrest,1624,priest,discipline,93,51,42
Фастдед,howling-fjord,1624,priest,discipline,215,114,101
Syntara,twisting-nether,1624,priest,discipline,466,242,224
Darktheu,sanguino,1624,priest,discipline,39,20,19
Dnsxx,thrall,1624,priest,discipline,1117,568,549
Пальтишко,howling-fjord,1624,priest,discipline,102,51,51
Remkojatwo,blackrock,1624,priest,discipline,42,21,21
Lindvorm,tarren-mill,1624,priest,discipline,180,89,91
Farae,arathor,1624,priest,discipline,44,19,25
Elfarity,tarren-mill,1623,priest,discipline,69,44,25
Seeyae,archimonde,1623,priest,discipline,30,17,13
Menda,eredar,1623,priest,discipline,309,167,142
Grautesk,chogall,1623,priest,discipline,72,38,34
Kedrack,draenor,1623,priest,discipline,78,41,37
Péntagón,festung-der-stürme,1623,priest,discipline,78,40,38
Carnegi,burning-legion,1623,priest,discipline,314,158,156
Yîrâ,antonidas,1623,priest,discipline,227,114,113
Riptile,outland,1623,priest,discipline,100,50,50
Nelielto,stormscale,1622,priest,discipline,28,21,7
Nelyø,destromath,1622,priest,discipline,30,21,9
Mnu,blackrock,1622,priest,discipline,52,30,22
Lerión,ravencrest,1622,priest,discipline,108,62,46
Двелегитоп,howling-fjord,1622,priest,discipline,62,35,27
Feed,burning-legion,1622,priest,discipline,84,45,39
Nooway,kazzak,1622,priest,discipline,205,103,102
Vhim,hyjal,1622,priest,discipline,64,31,33
Pmake,ravencrest,1621,priest,discipline,42,24,18
Mønsterx,kazzak,1621,priest,discipline,76,43,33
Фыбра,soulflayer,1621,priest,discipline,36,20,16
Sicarium,aegwynn,1621,priest,discipline,102,56,46
Farnese,archimonde,1621,priest,discipline,497,265,232
Babywayn,onyxia,1621,priest,discipline,242,129,113
Wiwzi,outland,1621,priest,discipline,136,68,68
Elswêyr,blackmoore,1621,priest,discipline,54,27,27
Sotriggered,sylvanas,1621,priest,discipline,36,17,19
Mainhunter,aegwynn,1621,priest,discipline,36,17,19
Mindfiend,stormscale,1621,priest,discipline,81,37,44
Burnesenbois,chogall,1621,priest,discipline,119,48,71
Dêmôn,stormscale,1620,priest,discipline,24,17,7
Iiamx,antonidas,1620,priest,discipline,90,55,35
Incorporeal,eredar,1620,priest,discipline,62,33,29
Hónòr,sylvanas,1620,priest,discipline,101,51,50
Holyblóod,ravencrest,1620,priest,discipline,128,61,67
Dìsclol,draenor,1620,priest,discipline,61,29,32
Soloqbob,kazzak,1620,priest,discipline,48,22,26
Jesuispasbon,hyjal,1620,priest,discipline,48,22,26
Denarne,blackrock,1620,priest,discipline,48,21,27
Wifta,ravencrest,1619,priest,discipline,54,30,24
Chimara,eredar,1619,priest,discipline,254,139,115
Szelén,ragnaros,1619,priest,discipline,54,29,25
Jerzay,hyjal,1619,priest,discipline,200,105,95
Olio,outland,1619,priest,discipline,124,65,59
Maryjanè,twisting-nether,1619,priest,discipline,59,29,30
Naripriest,eredar,1619,priest,discipline,48,22,26
Fatalx,grim-batol,1619,priest,discipline,142,64,78
Yoii,nemesis,1618,priest,discipline,64,38,26
Zehakky,tarren-mill,1618,priest,discipline,157,90,67
Caboon,silvermoon,1618,priest,discipline,132,74,58
Fixelfax,defias-brotherhood,1618,priest,discipline,60,33,27
Sweetxq,tarren-mill,1618,priest,discipline,364,196,168
Fatishcribe,twisting-nether,1618,priest,discipline,368,196,172
Шадия,ashenvale,1618,priest,discipline,49,26,23
Soraal,argent-dawn,1618,priest,discipline,109,57,52
Fatherlou,outland,1618,priest,discipline,60,31,29
Lankydoc,blackmoore,1618,priest,discipline,52,23,29
Obifearnooby,blackhand,1618,priest,discipline,65,27,38
Фриерли,howling-fjord,1617,priest,discipline,54,38,16
Prost,aerie-peak,1617,priest,discipline,71,47,24
Fartsponge,ragnaros,1617,priest,discipline,67,38,29
Joojee,tarren-mill,1617,priest,discipline,231,129,102
Fabuliciøus,blackrock,1617,priest,discipline,42,23,19
Пустотность,gordunni,1617,priest,discipline,489,239,250
Alexsmite,tarren-mill,1617,priest,discipline,42,20,22
Lizka,kazzak,1617,priest,discipline,146,69,77
Ankus,tarren-mill,1617,priest,discipline,90,42,48
Ритуалист,deepholm,1617,priest,discipline,102,47,55
Mikeypi,laughing-skull,1616,priest,discipline,36,25,11
Følísh,hyjal,1616,priest,discipline,66,43,23
Bleedingeyes,tarren-mill,1616,priest,discipline,110,62,48
Eowins,blackmoore,1616,priest,discipline,297,163,134
Lianny,sylvanas,1616,priest,discipline,141,77,64
Chimpanzoo,kazzak,1616,priest,discipline,48,26,22
Holyasprin,sylvanas,1616,priest,discipline,102,54,48
Bercxu,ragnaros,1616,priest,discipline,131,68,63
Eluveitieq,kazzak,1616,priest,discipline,238,123,115
Wynda,outland,1616,priest,discipline,76,38,38
Mindgames,the-maelstrom,1616,priest,discipline,54,26,28
Lymhk,blackrock,1616,priest,discipline,60,28,32
Binder,tarren-mill,1616,priest,discipline,60,26,34
Illiest,ravencrest,1615,priest,discipline,48,34,14
Funkátiko,cthun,1615,priest,discipline,85,56,29
Rher,blackmoore,1615,priest,discipline,139,81,58
Mtbalt,tarren-mill,1615,priest,discipline,180,103,77
Epa,zuljin,1615,priest,discipline,66,37,29
Èightsix,draenor,1615,priest,discipline,161,88,73
Pxescalol,aegwynn,1615,priest,discipline,70,37,33
Cleancf,blackhand,1615,priest,discipline,450,227,223
Zackher,dun-modr,1615,priest,discipline,59,23,36
Craquylx,hyjal,1615,priest,discipline,53,20,33
Вилайф,galakrond,1614,priest,discipline,94,51,43
Jmp,tarren-mill,1614,priest,discipline,40,21,19
Clergin,argent-dawn,1614,priest,discipline,147,75,72
Mitha,tarren-mill,1614,priest,discipline,110,55,55
Sebiarchie,lightnings-blade,1614,priest,discipline,74,36,38
Cøvu,draenor,1613,priest,discipline,39,25,14
Aêbi,dalaran,1613,priest,discipline,78,45,33
Микаса,howling-fjord,1613,priest,discipline,30,17,13
Appuesi,dun-modr,1613,priest,discipline,30,17,13
Zlejkadlec,drakthul,1613,priest,discipline,238,129,109
Crowdd,turalyon,1613,priest,discipline,342,183,159
Freddyprinze,ravencrest,1613,priest,discipline,119,63,56
Dîablø,eredar,1613,priest,discipline,147,74,73
Giesix,frostwolf,1613,priest,discipline,42,21,21
Безрассудица,howling-fjord,1612,priest,discipline,24,17,7
Zenfangirlx,kazzak,1612,priest,discipline,24,17,7
Pankp,kazzak,1612,priest,discipline,28,18,10
Tifrahat,the-maelstrom,1612,priest,discipline,64,39,25
Lyndorien,argent-dawn,1612,priest,discipline,120,73,47
Massasax,kazzak,1612,priest,discipline,144,83,61
Smellypotato,kazzak,1612,priest,discipline,153,85,68
Nerul,twisting-nether,1612,priest,discipline,357,191,166
Ryuuzaki,stormscale,1612,priest,discipline,101,53,48
Achardia,argent-dawn,1612,priest,discipline,35,18,17
Seranà,hyjal,1612,priest,discipline,108,55,53
Badorange,kazzak,1612,priest,discipline,65,33,32
Znàdix,silvermoon,1612,priest,discipline,276,140,136
Raawri,blackmoore,1612,priest,discipline,101,50,51
Kaltasar,guldan,1612,priest,discipline,105,48,57
Aviken,outland,1612,priest,discipline,66,30,36
Deazypriest,blackrock,1612,priest,discipline,66,28,38
Carolyna,ravencrest,1612,priest,discipline,42,17,25
Matwucss,outland,1611,priest,discipline,48,28,20
Lanfear,shadowsong,1611,priest,discipline,72,40,32
ßênnyßoy,stormscale,1611,priest,discipline,67,36,31
Диспайзх,gordunni,1611,priest,discipline,204,97,107
Acidrops,hyjal,1611,priest,discipline,66,30,36
Pøcketsåge,blackrock,1610,priest,discipline,24,17,7
Sméctà,marécage-de-zangar,1610,priest,discipline,55,32,23
Anarame,silvermoon,1610,priest,discipline,75,42,33
Steelbird,ravencrest,1610,priest,discipline,36,20,16
Réquell,twisting-nether,1610,priest,discipline,72,39,33
Melisoula,stormscale,1610,priest,discipline,66,34,32
Terno,sylvanas,1610,priest,discipline,1026,516,510
Jibrael,draenor,1610,priest,discipline,84,40,44
Ivÿx,ravencrest,1610,priest,discipline,113,52,61
Zaak,kazzak,1610,priest,discipline,117,52,65
Viu,eredar,1610,priest,discipline,51,22,29
Ptipotam,archimonde,1610,priest,discipline,96,37,59
Holyshiz,stormrage,1609,priest,discipline,42,24,18
Kdot,drakthul,1609,priest,discipline,86,48,38
Fazzy,nagrand,1609,priest,discipline,76,41,35
Alinone,uldum,1609,priest,discipline,141,76,65
Майти,gordunni,1609,priest,discipline,321,168,153
Gulch,blackmoore,1609,priest,discipline,114,59,55
Egî,lothar,1609,priest,discipline,42,21,21
Fishler,tarren-mill,1609,priest,discipline,58,28,30
Santyel,blackrock,1609,priest,discipline,60,27,33
Patoon,ravencrest,1608,priest,discipline,24,18,6
Anticorona,twisting-nether,1608,priest,discipline,42,22,20
Dotreveal,ravencrest,1608,priest,discipline,113,58,55
Kuki,tarren-mill,1608,priest,discipline,240,122,118
Avenara,blackrock,1608,priest,discipline,123,60,63
Fakecats,sargeras,1608,priest,discipline,51,22,29
Rmp,stormscale,1608,priest,discipline,75,30,45
Zymai,ravencrest,1608,priest,discipline,54,21,33
Pohja,veknilash,1607,priest,discipline,30,20,10
Мачя,gordunni,1607,priest,discipline,255,152,103
Pipperxp,ravencrest,1607,priest,discipline,91,54,37
Mightnáre,tarren-mill,1607,priest,discipline,36,21,15
Absôlutvôdka,twisting-nether,1607,priest,discipline,96,53,43
Otuschpriest,blackmoore,1607,priest,discipline,170,93,77
Phøènix,twisting-nether,1607,priest,discipline,46,24,22
Evõmax,sylvanas,1607,priest,discipline,533,276,257
Æbe,tarren-mill,1607,priest,discipline,94,48,46
Krazuk,theradras,1607,priest,discipline,60,29,31
Ridskeyx,archimonde,1607,priest,discipline,90,43,47
Zloyvrach,ravencrest,1607,priest,discipline,126,60,66
Киллус,ashenvale,1607,priest,discipline,155,70,85
Dxî,ysondre,1607,priest,discipline,102,46,56
Salvatíon,sanguino,1607,priest,discipline,284,127,157
Omahelga,blackrock,1606,priest,discipline,196,110,86
Fäke,dunemaul,1606,priest,discipline,493,263,230
Towelie,stormscale,1606,priest,discipline,96,48,48
Kolinamenus,dun-morogh,1606,priest,discipline,299,149,150
Nzothapostle,baelgun,1606,priest,discipline,566,277,289
Óói,outland,1606,priest,discipline,61,29,32
Laceylol,anubarak,1606,priest,discipline,36,17,19
Fästrak,dalaran,1606,priest,discipline,78,34,44
Babibayle,arakarahm,1606,priest,discipline,123,51,72
Dtpe,kazzak,1605,priest,discipline,93,59,34
Hoppa,stormscale,1605,priest,discipline,138,86,52
Halysis,chamber-of-aspects,1605,priest,discipline,52,28,24
Бониклайтх,gordunni,1605,priest,discipline,72,38,34
Jupiter,silvermoon,1605,priest,discipline,340,179,161
Mèix,ysondre,1605,priest,discipline,120,63,57
Pollution,ragnaros,1605,priest,discipline,60,30,30
Mjamc,stormscale,1605,priest,discipline,157,78,79
Krottus,antonidas,1605,priest,discipline,89,44,45
Nidrana,drakthul,1605,priest,discipline,84,41,43
Drwlad,archimonde,1605,priest,discipline,126,61,65
Tárget,frostwolf,1605,priest,discipline,48,22,26
Polymonkey,stormscale,1605,priest,discipline,47,18,29
Troedel,destromath,1604,priest,discipline,103,62,41
Thylstra,ravencrest,1604,priest,discipline,88,51,37
Tritíana,blackrock,1604,priest,discipline,192,110,82
Whipped,ravencrest,1604,priest,discipline,62,34,28
Horrðr,kazzak,1604,priest,discipline,114,61,53
Dameyo,argent-dawn,1604,priest,discipline,77,41,36
Loldisc,arthas,1604,priest,discipline,120,63,57
Leictreach,draenor,1604,priest,discipline,42,22,20
Maquivel,aggra-português,1604,priest,discipline,96,50,46
Няжик,azuregos,1604,priest,discipline,136,68,68
Erdine,ravencrest,1604,priest,discipline,52,26,26
Azrella,ravencrest,1604,priest,discipline,84,40,44
Ostberger,twisting-nether,1603,priest,discipline,227,130,97
Acidpills,hyjal,1603,priest,discipline,124,67,57
Inoru,stormreaver,1603,priest,discipline,204,106,98
Lendoril,blackhand,1603,priest,discipline,118,59,59
Sacerdosan,quelthalas,1603,priest,discipline,66,32,34
Góldfinger,norgannon,1603,priest,discipline,39,18,21
Хилботгодикс,borean-tundra,1602,priest,discipline,42,32,10
Syniixp,aegwynn,1602,priest,discipline,30,20,10
Misspingle,sunstrider,1602,priest,discipline,60,36,24
Gamebredx,silvermoon,1602,priest,discipline,42,25,17
Iljvjll,blackrock,1602,priest,discipline,37,22,15
Gladrielia,eldrethalas,1602,priest,discipline,42,23,19
Хеликси,gordunni,1602,priest,discipline,235,127,108
Tansk,stormscale,1602,priest,discipline,270,144,126
Cultaken,kazzak,1602,priest,discipline,94,48,46
Krystynal,archimonde,1602,priest,discipline,113,54,59
Asherá,kazzak,1602,priest,discipline,160,74,86
Kathja,outland,1602,priest,discipline,48,22,26
Aldebrand,dun-modr,1602,priest,discipline,72,29,43
Hannïri,archimonde,1601,priest,discipline,78,48,30
Jpjp,gorgonnash,1601,priest,discipline,108,66,42
Bigbootyheal,silvermoon,1601,priest,discipline,198,117,81
Pumpinghard,twisting-nether,1601,priest,discipline,68,39,29
Sanuki,stormscale,1601,priest,discipline,41,23,18
Kamiyasa,blackmoore,1601,priest,discipline,247,128,119
Shadowboness,twisting-nether,1601,priest,discipline,115,59,56
Амберис,gordunni,1601,priest,discipline,90,46,44
Makkesfil,stormscale,1601,priest,discipline,60,29,31
Smitebone,tarren-mill,1601,priest,discipline,90,40,50
Ironqt,malfurion,1601,priest,discipline,139,61,78
Lgbtgodx,archimonde,1600,priest,discipline,61,45,16
Kitågåwå,ravencrest,1600,priest,discipline,24,17,7
Romero,sylvanas,1600,priest,discipline,30,19,11
Девственен,soulflayer,1600,priest,discipline,131,78,53
Trì,thrall,1600,priest,discipline,35,20,15
Elosen,darkspear,1600,priest,discipline,216,122,94
Blaelel,dun-modr,1600,priest,discipline,90,49,41
Praywingsebb,nazjatar,1600,priest,discipline,54,29,25
Sinîra,frostwolf,1600,priest,discipline,110,59,51
Valossa,ravencrest,1600,priest,discipline,53,28,25
Jumperlawl,khaz-modan,1600,priest,discipline,366,191,175
Neverswap,blackmoore,1600,priest,discipline,97,50,47
Ojh,defias-brotherhood,1600,priest,discipline,100,51,49
Xangha,burning-legion,1600,priest,discipline,264,133,131
Foh,antonidas,1600,priest,discipline,36,17,19
Stvilde,ragnaros,1600,priest,discipline,42,19,23
Stepsisstuck,ragnaros,1600,priest,discipline,80,36,44
Еврейк,soulflayer,1600,priest,discipline,117,52,65
Shento,blackhand,1600,priest,discipline,48,21,27
Andhoras,dalaran,1600,priest,discipline,53,22,31
Marícanqt,tarren-mill,1599,priest,discipline,30,23,7
Пеппаслав,soulflayer,1599,priest,discipline,252,135,117
Wencis,kazzak,1599,priest,discipline,132,67,65
Shallteár,doomhammer,1599,priest,discipline,274,136,138
Ahpøual,archimonde,1599,priest,discipline,186,90,96
Stampo,draenor,1599,priest,discipline,77,35,42
Magicdisco,nemesis,1598,priest,discipline,41,27,14
Freeguzmán,ragnaros,1598,priest,discipline,70,43,27
Norganp,die-aldor,1598,priest,discipline,124,64,60
Bebwaz,kazzak,1598,priest,discipline,183,94,89
Euthenia,twilights-hammer,1598,priest,discipline,54,27,27
Ptrspriest,twisting-nether,1598,priest,discipline,393,194,199
Zwu,antonidas,1598,priest,discipline,106,51,55
Jackyl,kazzak,1598,priest,discipline,73,35,38
Légít,argent-dawn,1598,priest,discipline,144,64,80
Chalecø,dun-modr,1597,priest,discipline,30,17,13
Эски,howling-fjord,1597,priest,discipline,257,137,120
Massbimba,tarren-mill,1597,priest,discipline,427,224,203
Noobpriest,blackrock,1597,priest,discipline,226,116,110
Blackbox,burning-legion,1597,priest,discipline,268,134,134
Fulgus,sanguino,1597,priest,discipline,424,208,216
Mohammedx,tarren-mill,1597,priest,discipline,131,59,72
Padregianni,nemesis,1597,priest,discipline,107,46,61
Phucme,deathwing,1597,priest,discipline,60,24,36
Holineß,burning-blade,1596,priest,discipline,114,66,48
Баблби,soulflayer,1596,priest,discipline,169,73,96
Ache,defias-brotherhood,1595,priest,discipline,36,23,13
Yaoz,sanguino,1595,priest,discipline,30,17,13
Systerstål,twisting-nether,1595,priest,discipline,154,86,68
Hentaigirls,ravencrest,1595,priest,discipline,36,20,16
Toiga,lightnings-blade,1595,priest,discipline,136,74,62
Arjak,stormscale,1595,priest,discipline,81,41,40
Lqd,blackrock,1595,priest,discipline,42,21,21
Hinorist,kazzak,1595,priest,discipline,232,109,123
Gannendor,blackhand,1595,priest,discipline,51,23,28
Шимату,howling-fjord,1595,priest,discipline,101,44,57
Drïxit,illidan,1595,priest,discipline,97,37,60
Эскирия,gordunni,1595,priest,discipline,48,17,31
Spbosse,aszune,1594,priest,discipline,60,35,25
Axla,stormscale,1594,priest,discipline,107,56,51
Chigreru,uldum,1594,priest,discipline,88,45,43
Maâti,kazzak,1594,priest,discipline,223,114,109
Ровк,soulflayer,1594,priest,discipline,52,20,32
Flowén,twisting-nether,1593,priest,discipline,92,56,36
Haakon,tarren-mill,1593,priest,discipline,30,17,13
Goosebot,stormscale,1593,priest,discipline,90,49,41
Атэистотбога,gordunni,1593,priest,discipline,182,96,86
Nevor,nemesis,1593,priest,discipline,266,134,132
Exoduz,stormscale,1593,priest,discipline,419,211,208
Kijhun,uldaman,1593,priest,discipline,96,47,49
Swdjack,blackrock,1593,priest,discipline,232,110,122
Greenlizzard,emerald-dream,1593,priest,discipline,53,19,34
Серью,booty-bay,1592,priest,discipline,47,28,19
Whopzi,blackmoore,1592,priest,discipline,48,28,20
Zhenni,ravencrest,1592,priest,discipline,69,32,37
Сашадвасм,gordunni,1591,priest,discipline,171,96,75
Djariisimp,tarren-mill,1591,priest,discipline,36,20,16
Piperxp,ravencrest,1591,priest,discipline,96,49,47
Träskfarfar,tarren-mill,1591,priest,discipline,60,30,30
Мэдмод,gordunni,1591,priest,discipline,319,159,160
Voidtouched,drakthul,1591,priest,discipline,53,25,28
Peign,eredar,1590,priest,discipline,48,29,19
Itsdiscobaby,auchindoun,1590,priest,discipline,112,51,61
Cadierna,argent-dawn,1590,priest,discipline,75,34,41
Jàckîe,aegwynn,1590,priest,discipline,52,22,30
Burningheatx,kazzak,1589,priest,discipline,89,56,33
Chîlliz,draenor,1589,priest,discipline,82,51,31
Nomorelight,stormscale,1589,priest,discipline,205,116,89
Rizzlerx,blackmoore,1589,priest,discipline,162,90,72
Vulreth,culte-de-la-rive-noire,1589,priest,discipline,36,20,16
Oecgreg,ysondre,1589,priest,discipline,82,44,38
Shadowbread,tarren-mill,1589,priest,discipline,192,96,96
Dexodus,sylvanas,1589,priest,discipline,52,26,26
Purip,stormscale,1589,priest,discipline,73,36,37
Biggestpass,kazzak,1588,priest,discipline,24,19,5
Shikibu,sylvanas,1588,priest,discipline,29,22,7
Dashxzz,silvermoon,1588,priest,discipline,42,23,19
Hélgå,kazzak,1588,priest,discipline,66,33,33
Yacine,blackrock,1588,priest,discipline,138,67,71
Esqimax,argent-dawn,1587,priest,discipline,30,19,11
Данягантеля,gordunni,1587,priest,discipline,90,48,42
Alz,rashgarroth,1587,priest,discipline,231,119,112
Zurlyne,ravencrest,1587,priest,discipline,141,72,69
Aurosa,argent-dawn,1587,priest,discipline,141,72,69
Radiancekey,sanguino,1587,priest,discipline,72,36,36
Vänskap,kazzak,1587,priest,discipline,132,65,67
Imdeadxd,twisting-nether,1586,priest,discipline,63,36,27
Менестрели,gordunni,1586,priest,discipline,369,204,165
Grêy,dun-modr,1586,priest,discipline,140,74,66
Shyria,argent-dawn,1586,priest,discipline,103,52,51
Nexìan,ravencrest,1586,priest,discipline,78,37,41
Teedye,ravencrest,1585,priest,discipline,41,26,15
Toba,hellscream,1585,priest,discipline,113,65,48
Ishande,los-errantes,1585,priest,discipline,507,273,234
Sølvfox,stormscale,1585,priest,discipline,66,35,31
Senpumara,malganis,1585,priest,discipline,408,211,197
Impecabllo,outland,1585,priest,discipline,66,34,32
Muradawg,nemesis,1585,priest,discipline,71,30,41
Nhaisu,silvermoon,1584,priest,discipline,54,31,23
Beatzeps,tarren-mill,1584,priest,discipline,56,32,24
Arvonpenaali,defias-brotherhood,1584,priest,discipline,95,51,44
Copperpriest,draenor,1584,priest,discipline,80,41,39
Necronidas,burning-legion,1584,priest,discipline,171,86,85
Scarletstory,ravencrest,1584,priest,discipline,199,92,107
Bumfunk,twisting-nether,1584,priest,discipline,47,17,30
Zooster,pozzo-delleternità,1583,priest,discipline,84,54,30
Softie,zuljin,1583,priest,discipline,329,171,158
Kanî,eredar,1583,priest,discipline,123,62,61
Gravebrain,draenor,1583,priest,discipline,441,220,221
Mommymilkrx,argent-dawn,1583,priest,discipline,906,446,460
Shadowlander,dun-modr,1583,priest,discipline,159,78,81
Frojka,outland,1583,priest,discipline,78,36,42
Wolferr,outland,1583,priest,discipline,42,19,23
Whattson,colinas-pardas,1583,priest,discipline,41,18,23
Tomb,alonsus,1582,priest,discipline,30,17,13
Mazzekeen,burning-legion,1582,priest,discipline,146,79,67
Anaqt,silvermoon,1582,priest,discipline,447,228,219
Psíquica,sanguino,1582,priest,discipline,143,71,72
Chizu,alakir,1582,priest,discipline,208,99,109
Elwing,darkmoon-faire,1582,priest,discipline,78,36,42
Anyndra,twisting-nether,1581,priest,discipline,217,115,102
Boostpriest,archimonde,1581,priest,discipline,306,161,145
Chafrufru,kazzak,1581,priest,discipline,60,31,29
Alterlight,twisting-nether,1581,priest,discipline,869,431,438
Lythi,eredar,1581,priest,discipline,144,67,77
Holyarnold,silvermoon,1581,priest,discipline,224,100,124
Чилюнахиле,gordunni,1581,priest,discipline,71,23,48
Mindfreakxx,twisting-nether,1580,priest,discipline,72,44,28
Dunderprälle,outland,1580,priest,discipline,91,47,44
Niketn,aegwynn,1580,priest,discipline,70,36,34
Insekta,ragnaros,1580,priest,discipline,457,232,225
Целитель,gordunni,1580,priest,discipline,304,151,153
Acrio,die-ewige-wacht,1580,priest,discipline,120,59,61
Slikjar,stormscale,1580,priest,discipline,58,24,34
Djchinoix,archimonde,1579,priest,discipline,201,110,91
Colèy,blackhand,1579,priest,discipline,204,111,93
Велост,gordunni,1579,priest,discipline,140,76,64
Linqx,ravencrest,1579,priest,discipline,48,25,23
Xanthe,ravencrest,1579,priest,discipline,35,18,17
Uppiediscyo,ravencrest,1579,priest,discipline,664,337,327
Missandeí,frostmane,1579,priest,discipline,42,21,21
Кхарли,howling-fjord,1579,priest,discipline,122,56,66
Vate,aszune,1579,priest,discipline,66,29,37
Hölykiwi,silvermoon,1578,priest,discipline,35,21,14
Bambus,shattered-hand,1578,priest,discipline,54,29,25
Mutterteresa,frostwolf,1578,priest,discipline,36,19,17
Nêlumar,aegwynn,1578,priest,discipline,105,54,51
Deadlyhealer,draenor,1578,priest,discipline,60,30,30
Интердиктх,gordunni,1577,priest,discipline,42,26,16
Флафика,deathguard,1577,priest,discipline,84,48,36
Шарадин,gordunni,1577,priest,discipline,181,101,80
Jóhnnybravó,kazzak,1577,priest,discipline,102,54,48
Acosp,sylvanas,1577,priest,discipline,36,19,17
Winnever,dun-modr,1577,priest,discipline,513,270,243
Johen,terenas,1577,priest,discipline,224,116,108
Phamy,antonidas,1577,priest,discipline,76,38,38
Bloodanglee,outland,1577,priest,discipline,66,33,33
Tâmshi,dun-modr,1577,priest,discipline,54,26,28
Maccz,hyjal,1577,priest,discipline,68,32,36
Dazzlee,rajaxx,1577,priest,discipline,198,93,105
Jackboss,draenor,1577,priest,discipline,140,63,77
Discomacka,twisting-nether,1576,priest,discipline,83,46,37
Макимасама,gordunni,1576,priest,discipline,49,26,23
Pjuww,outland,1576,priest,discipline,57,30,27
Luziaa,outland,1576,priest,discipline,101,48,53
Ecg,silvermoon,1576,priest,discipline,144,68,76
Maise,stormreaver,1575,priest,discipline,46,29,17
Floodey,defias-brotherhood,1575,priest,discipline,90,45,45
Laceylee,anubarak,1575,priest,discipline,42,20,22
Bænzoni,pozzo-delleternità,1575,priest,discipline,110,52,58
Skyløl,dun-modr,1575,priest,discipline,42,19,23
Eustâche,suramar,1574,priest,discipline,24,17,7
Vqny,archimonde,1574,priest,discipline,177,98,79
Babloche,archimonde,1574,priest,discipline,125,68,57
Sbeecha,argent-dawn,1574,priest,discipline,192,96,96
Айрогуэл,grom,1574,priest,discipline,42,21,21
Aleluia,alonsus,1574,priest,discipline,153,68,85
Юлечка,blackscar,1573,priest,discipline,165,90,75
Gbpjr,xavius,1573,priest,discipline,278,142,136
Grzmocillaa,burning-legion,1573,priest,discipline,108,55,53
Yhraeliaegh,defias-brotherhood,1573,priest,discipline,344,169,175
Aia,tyrande,1573,priest,discipline,88,41,47
Эззи,soulflayer,1573,priest,discipline,66,29,37
Biophyzix,aegwynn,1573,priest,discipline,41,18,23
Bloodie,drakthul,1572,priest,discipline,48,30,18
Ellfle,kazzak,1572,priest,discipline,48,28,20
Acik,bladefist,1572,priest,discipline,101,53,48
Meanazer,antonidas,1572,priest,discipline,145,76,69
Hérune,outland,1572,priest,discipline,146,76,70
Nyarlatothep,boulderfist,1572,priest,discipline,148,77,71
Мплехибои,gordunni,1572,priest,discipline,66,34,32
Scréam,eredar,1572,priest,discipline,114,58,56
Shadowmend,aegwynn,1571,priest,discipline,65,34,31
Pvpalt,argent-dawn,1571,priest,discipline,152,75,77
Goodgirl,frostmane,1570,priest,discipline,70,46,24
Nyroq,blackrock,1570,priest,discipline,48,29,19
Eshania,frostwolf,1570,priest,discipline,102,60,42
Zinzor,archimonde,1570,priest,discipline,118,62,56
Люблюкофе,deathguard,1570,priest,discipline,112,56,56
Invexx,tarren-mill,1570,priest,discipline,540,268,272
Intentoso,nemesis,1570,priest,discipline,66,32,34
Miikkap,blackhand,1570,priest,discipline,60,29,31
Mysticforces,silvermoon,1570,priest,discipline,114,54,60
Bubbelchên,blackhand,1570,priest,discipline,72,32,40
Sebbepriest,twisting-nether,1569,priest,discipline,96,61,35
Amun,blackmoore,1569,priest,discipline,113,53,60
Nercøtic,antonidas,1569,priest,discipline,94,44,50
Хэвидрим,soulflayer,1569,priest,discipline,66,28,38
Vrêth,blackmoore,1569,priest,discipline,51,21,30
Isendth,archimonde,1569,priest,discipline,78,27,51
Hèmera,tichondrius,1568,priest,discipline,55,41,14
Bicepvein,sylvanas,1568,priest,discipline,33,19,14
Paìnz,blackhand,1568,priest,discipline,146,82,64
Nightreaver,argent-dawn,1568,priest,discipline,105,57,48
Heilerharry,blackmoore,1568,priest,discipline,87,47,40
Ledxpri,twisting-nether,1568,priest,discipline,114,61,53
Holynelph,kazzak,1568,priest,discipline,56,28,28
Valyreon,outland,1568,priest,discipline,72,25,47
Mercîlezz,eredar,1567,priest,discipline,59,39,20
Licktheheal,outland,1567,priest,discipline,422,212,210
Черныйсписок,gordunni,1566,priest,discipline,454,236,218
Телоури,galakrond,1566,priest,discipline,309,157,152
Loliheal,blackmoore,1566,priest,discipline,93,47,46
Discih,ragnaros,1566,priest,discipline,87,40,47
Raphyx,blackhand,1566,priest,discipline,76,29,47
Svistis,ravencrest,1565,priest,discipline,58,39,19
Caliadan,kazzak,1565,priest,discipline,54,30,24
Aternia,draenor,1565,priest,discipline,89,48,41
Soupriest,ysondre,1565,priest,discipline,217,115,102
Holygustavo,blackmoore,1565,priest,discipline,48,25,23
Loonytoo,ravencrest,1565,priest,discipline,36,18,18
Cajolîne,archimonde,1565,priest,discipline,222,109,113
Ftiersp,ravencrest,1565,priest,discipline,60,27,33
Rukiä,chogall,1564,priest,discipline,32,18,14
Мидэрка,howling-fjord,1564,priest,discipline,417,224,193
Крэкслингер,howling-fjord,1564,priest,discipline,142,71,71
Простосори,gordunni,1564,priest,discipline,616,302,314
Gojó,outland,1564,priest,discipline,117,57,60
Cringelørd,alakir,1564,priest,discipline,42,17,25
Yënâs,hyjal,1563,priest,discipline,114,65,49
Orophar,antonidas,1563,priest,discipline,481,246,235
Boostedidot,tarren-mill,1563,priest,discipline,58,29,29
Alicanx,twisting-nether,1563,priest,discipline,90,40,50
Tobijara,proudmoore,1563,priest,discipline,42,18,24
Unfaker,drakthul,1562,priest,discipline,36,23,13
Talbädar,draenor,1562,priest,discipline,54,32,22
Ypsi,defias-brotherhood,1562,priest,discipline,48,27,21
Надийя,gordunni,1562,priest,discipline,150,84,66
Raeratwo,archimonde,1562,priest,discipline,36,18,18
Louiepr,outland,1562,priest,discipline,92,38,54
Shieldop,eredar,1561,priest,discipline,30,18,12
Okeymokey,malganis,1561,priest,discipline,267,140,127
Frednshield,tarren-mill,1561,priest,discipline,162,82,80
Mindgamez,tarren-mill,1561,priest,discipline,66,33,33
Dangerfred,stormscale,1561,priest,discipline,36,18,18
Shrshbilah,kazzak,1561,priest,discipline,180,86,94
Макстин,howling-fjord,1561,priest,discipline,201,96,105
Soloqhero,chamber-of-aspects,1561,priest,discipline,60,25,35
Saintpri,twisting-nether,1560,priest,discipline,123,67,56
Raezi,defias-brotherhood,1560,priest,discipline,196,105,91
Lyim,stormscale,1560,priest,discipline,47,25,22
Maerlene,nemesis,1560,priest,discipline,122,50,72
Shafela,sanguino,1559,priest,discipline,36,21,15
Ðæthshaðow,dalaran,1559,priest,discipline,59,32,27
Enimao,tarren-mill,1559,priest,discipline,117,61,56
Føxy,emerald-dream,1559,priest,discipline,53,27,26
Ичисанчик,howling-fjord,1559,priest,discipline,91,45,46
Schmetter,tarren-mill,1559,priest,discipline,37,18,19
Toxicx,aegwynn,1559,priest,discipline,48,19,29
Khomic,archimonde,1558,priest,discipline,59,35,24
Shedzinty,tarren-mill,1558,priest,discipline,153,87,66
Fuzzybae,ravencrest,1558,priest,discipline,120,59,61
Ectria,ravencrest,1558,priest,discipline,149,71,78
Touchmé,blackmoore,1558,priest,discipline,47,18,29
Fapfapjohn,sylvanas,1558,priest,discipline,71,27,44
Аркприст,gordunni,1557,priest,discipline,48,32,16
Лин,howling-fjord,1557,priest,discipline,34,21,13
Morerespect,lothar,1557,priest,discipline,50,29,21
Strawhât,eredar,1557,priest,discipline,77,40,37
Lishado,twisting-nether,1557,priest,discipline,108,55,53
Олдмэнсэйд,soulflayer,1557,priest,discipline,134,68,66
Ashuramaru,drakthul,1557,priest,discipline,71,34,37
Shielddanke,blackmoore,1557,priest,discipline,84,40,44
Dreythan,stormrage,1557,priest,discipline,120,55,65
Lanthypriest,hyjal,1557,priest,discipline,60,25,35
Alwiel,kazzak,1557,priest,discipline,66,27,39
Lucîd,ravencrest,1556,priest,discipline,201,111,90
Giggidee,tarren-mill,1556,priest,discipline,220,115,105
Darkprist,sanguino,1556,priest,discipline,124,64,60
Chuckline,eredar,1556,priest,discipline,138,71,67
Hexonite,burning-legion,1556,priest,discipline,94,47,47
Lerissea,argent-dawn,1556,priest,discipline,40,17,23
Heílsuse,antonidas,1556,priest,discipline,48,18,30
Blkp,archimonde,1555,priest,discipline,132,82,50
Woid,aegwynn,1555,priest,discipline,48,28,20
Блексебет,soulflayer,1555,priest,discipline,172,92,80
Treen,silvermoon,1555,priest,discipline,177,94,83
Laërhia,archimonde,1555,priest,discipline,391,196,195
Skallya,ysondre,1555,priest,discipline,36,17,19
Кролс,gordunni,1555,priest,discipline,54,25,29
Shockpriest,grim-batol,1555,priest,discipline,72,27,45
Mvce,outland,1554,priest,discipline,54,37,17
Cathocrasty,draenor,1554,priest,discipline,123,69,54
Pubis,silvermoon,1554,priest,discipline,66,35,31
Eßola,silvermoon,1554,priest,discipline,88,44,44
Cresellia,twisting-nether,1554,priest,discipline,182,87,95
Troedelsuppe,destromath,1554,priest,discipline,347,162,185
Mustatomi,stormreaver,1554,priest,discipline,39,17,22
Labopriest,blackmoore,1554,priest,discipline,48,20,28
Алуан,blackscar,1554,priest,discipline,90,36,54
Donvasco,kazzak,1554,priest,discipline,83,33,50
Walúpe,draenor,1553,priest,discipline,70,45,25
Psnextxp,eredar,1553,priest,discipline,135,76,59
Хахеха,gordunni,1553,priest,discipline,66,37,29
Kaliboom,archimonde,1553,priest,discipline,232,126,106
Sháady,ravencrest,1553,priest,discipline,78,41,37
Рэйкар,razuvious,1553,priest,discipline,65,33,32
Pøwêr,hyjal,1553,priest,discipline,90,45,45
Niøssxx,blackrock,1553,priest,discipline,54,27,27
Gooflord,ravencrest,1553,priest,discipline,132,64,68
Mêmphìs,twisting-nether,1553,priest,discipline,149,72,77
Khâléd,kazzak,1553,priest,discipline,36,17,19
Рейсина,gordunni,1553,priest,discipline,79,35,44
Нукафирни,soulflayer,1553,priest,discipline,42,17,25
Armward,twisting-nether,1552,priest,discipline,58,35,23
Valadaris,outland,1552,priest,discipline,222,109,113
Yøløswagg,silvermoon,1552,priest,discipline,157,75,82
Deathspren,stormscale,1552,priest,discipline,42,19,23
Shacoat,draenor,1552,priest,discipline,78,29,49
Wedoburgers,ravencrest,1551,priest,discipline,24,17,7
Outtloor,twisting-nether,1551,priest,discipline,86,46,40
Rtang,outland,1551,priest,discipline,104,55,49
Srakabot,burning-legion,1551,priest,discipline,275,137,138
Расспутана,howling-fjord,1551,priest,discipline,326,161,165
Ronk,outland,1551,priest,discipline,39,19,20
Tryhàrdx,stormscale,1551,priest,discipline,84,33,51
Afrøjack,tarren-mill,1550,priest,discipline,61,35,26
Furosam,eredar,1550,priest,discipline,66,37,29
Zìzz,hyjal,1550,priest,discipline,42,23,19
Vexadow,kazzak,1550,priest,discipline,90,49,41
Sinnzz,ysondre,1550,priest,discipline,126,68,58
Makesnosense,kilrogg,1550,priest,discipline,78,42,36
Zône,hyjal,1550,priest,discipline,75,40,35
Arya,dunemaul,1550,priest,discipline,54,25,29
Selfcontrol,blackhand,1550,priest,discipline,66,25,41
Dùsty,archimonde,1549,priest,discipline,135,79,56
Jcnun,xavius,1549,priest,discipline,180,94,86
Xaerah,blackmoore,1549,priest,discipline,98,51,47
Soraløl,stormscale,1549,priest,discipline,130,66,64
Prayforme,lightbringer,1549,priest,discipline,71,36,35
Priewyn,ragnaros,1549,priest,discipline,357,180,177
Chenandler,aggra-português,1549,priest,discipline,53,26,27
Alysial,silvermoon,1549,priest,discipline,42,20,22
Arkkinunna,outland,1549,priest,discipline,124,59,65
Faouzia,argent-dawn,1549,priest,discipline,59,27,32
Denyz,blackrock,1549,priest,discipline,66,26,40
Sahorie,archimonde,1548,priest,discipline,171,95,76
Cainactor,drakthul,1548,priest,discipline,119,64,55
Марабудх,soulflayer,1548,priest,discipline,123,66,57
Marymisery,blackhand,1548,priest,discipline,190,101,89
Foobi,the-maelstrom,1548,priest,discipline,704,362,342
Twisty,malganis,1548,priest,discipline,174,88,86
Sctheal,outland,1548,priest,discipline,75,37,38
Shadowfishey,grim-batol,1548,priest,discipline,176,81,95
Usee,kazzak,1547,priest,discipline,72,45,27
Poxqt,thrall,1547,priest,discipline,208,120,88
Säeneris,hyjal,1547,priest,discipline,127,69,58
Avaichquirit,tarren-mill,1547,priest,discipline,142,75,67
Zennen,ragnaros,1547,priest,discipline,88,46,42
Sundæ,antonidas,1547,priest,discipline,95,46,49
Bejud,tarren-mill,1547,priest,discipline,54,26,28
Nielar,onyxia,1546,priest,discipline,92,50,42
Pøsæ,uldaman,1546,priest,discipline,89,46,43
Èzì,burning-legion,1546,priest,discipline,173,89,84
Priestin,dun-modr,1546,priest,discipline,194,98,96
Poonies,silvermoon,1546,priest,discipline,124,61,63
Mandipriest,aggra-português,1546,priest,discipline,129,62,67
Wìklüñd,ravencrest,1546,priest,discipline,170,72,98
Hanrej,ravencrest,1546,priest,discipline,42,17,25
Элхолейн,gordunni,1545,priest,discipline,41,28,13
Этотьмадетка,howling-fjord,1545,priest,discipline,72,40,32
Sapholie,kirin-tor,1545,priest,discipline,36,20,16
Murmaiderrx,draenor,1545,priest,discipline,218,118,100
Аидкабтв,gordunni,1545,priest,discipline,85,45,40
Kiropap,silvermoon,1545,priest,discipline,470,245,225
Themistia,kazzak,1545,priest,discipline,253,126,127
Хомие,soulflayer,1545,priest,discipline,121,58,63
Heindl,ravencrest,1545,priest,discipline,72,34,38
Twh,outland,1544,priest,discipline,77,45,32
Zaluri,blackrock,1544,priest,discipline,53,30,23
Toratorap,burning-legion,1544,priest,discipline,186,94,92
Geesuz,outland,1544,priest,discipline,151,76,75
Mæzen,sylvanas,1544,priest,discipline,60,29,31
Sethp,hyjal,1543,priest,discipline,33,24,9
Prencø,sanguino,1543,priest,discipline,36,23,13
Spiochpr,burning-legion,1543,priest,discipline,224,123,101
Mapples,antonidas,1543,priest,discipline,320,172,148
Tjat,silvermoon,1543,priest,discipline,114,58,56
Beocca,sanguino,1543,priest,discipline,53,21,32
Burtarul,argent-dawn,1542,priest,discipline,74,44,30
Cursedme,blackrock,1542,priest,discipline,55,32,23
Spirítbox,argent-dawn,1542,priest,discipline,315,164,151
Vicwix,draenor,1542,priest,discipline,71,36,35
Nithraw,kazzak,1542,priest,discipline,291,143,148
Admiration,eredar,1542,priest,discipline,47,23,24
Hopepriest,magtheridon,1542,priest,discipline,96,46,50
Tyraedrel,nemesis,1542,priest,discipline,104,45,59
Jamii,kazzak,1541,priest,discipline,137,85,52
Батямелднул,blackscar,1541,priest,discipline,60,36,24
Buan,blackmoore,1541,priest,discipline,104,59,45
Deadwen,stormscale,1541,priest,discipline,290,157,133
Bublelicious,silvermoon,1541,priest,discipline,90,48,42
Tazting,stormscale,1541,priest,discipline,139,74,65
Chocoly,tarren-mill,1541,priest,discipline,143,75,68
Runekpriest,tarren-mill,1541,priest,discipline,93,47,46
Dadheal,dalaran,1541,priest,discipline,66,32,34
Yonkerz,frostmane,1541,priest,discipline,269,128,141
Loverxz,dun-modr,1540,priest,discipline,90,46,44
Khazidhea,frostwolf,1540,priest,discipline,135,68,67
Whiskie,twisting-nether,1540,priest,discipline,60,30,30
Psi,hakkar,1540,priest,discipline,36,18,18
Dapope,drakthul,1540,priest,discipline,131,57,74
Nnaoy,ysondre,1539,priest,discipline,44,26,18
Xayrin,thrall,1539,priest,discipline,162,91,71
Lahammy,kazzak,1539,priest,discipline,68,36,32
Ranevskiy,kazzak,1539,priest,discipline,305,153,152
Джулибуба,borean-tundra,1539,priest,discipline,93,46,47
Wurstpriest,silvermoon,1539,priest,discipline,84,41,43
Ijzerehenk,outland,1539,priest,discipline,476,228,248
Estrecho,sanguino,1539,priest,discipline,93,44,49
Léandrä,magtheridon,1538,priest,discipline,36,18,18
Tepevelf,dun-modr,1538,priest,discipline,565,271,294
Effectx,ravencrest,1538,priest,discipline,138,66,72
Zastyx,drakthul,1538,priest,discipline,62,28,34
Disconight,kazzak,1538,priest,discipline,60,24,36
Szycho,burning-legion,1538,priest,discipline,60,20,40
Subha,drakthul,1537,priest,discipline,83,54,29
Chokmâh,sanguino,1537,priest,discipline,30,19,11
Mòly,archimonde,1537,priest,discipline,33,20,13
Géorge,blackmoore,1537,priest,discipline,30,18,12
Happyprocs,dun-modr,1537,priest,discipline,107,58,49
Priestadorie,ravencrest,1537,priest,discipline,37,20,17
Holykebab,defias-brotherhood,1537,priest,discipline,72,37,35
Tgz,ravencrest,1537,priest,discipline,241,123,118
Pleadz,tarren-mill,1537,priest,discipline,137,61,76
Redpriestess,kazzak,1536,priest,discipline,77,43,34
Natapriest,antonidas,1536,priest,discipline,266,145,121
Géèk,alakir,1536,priest,discipline,337,170,167
Styilepriest,twisting-nether,1536,priest,discipline,36,18,18
Arctoczax,ravencrest,1536,priest,discipline,126,59,67
Interrupted,kazzak,1536,priest,discipline,132,61,71
Shellpop,stormscale,1535,priest,discipline,47,25,22
Åzjol,magtheridon,1535,priest,discipline,36,19,17
Yûnalescá,blackmoore,1535,priest,discipline,147,74,73
Sonyl,les-sentinelles,1535,priest,discipline,54,27,27
Wreniwreni,stormscale,1535,priest,discipline,36,18,18
Yuukii,kult-der-verdammten,1535,priest,discipline,36,17,19
Berstkraft,blackmoore,1535,priest,discipline,155,73,82
Goblex,hyjal,1535,priest,discipline,63,28,35
Luuniisboost,blackmoore,1535,priest,discipline,54,23,31
Tyrial,outland,1534,priest,discipline,86,47,39
Logath,archimonde,1534,priest,discipline,79,41,38
Partyanimal,blackrock,1534,priest,discipline,95,49,46
Makemyday,dun-modr,1534,priest,discipline,125,64,61
Pmh,kazzak,1534,priest,discipline,120,60,60
Truthspeaker,outland,1534,priest,discipline,44,22,22
Pakmopriest,ragnaros,1534,priest,discipline,84,39,45
Fuzzymerge,ravencrest,1534,priest,discipline,100,46,54
Kineo,frostwolf,1534,priest,discipline,60,27,33
Buchânân,archimonde,1534,priest,discipline,48,17,31
Джоега,grom,1534,priest,discipline,65,21,44
Affro,drakthul,1533,priest,discipline,72,40,32
Shizai,hyjal,1533,priest,discipline,125,65,60
Kotipope,silvermoon,1532,priest,discipline,175,103,72
Mahraxyr,hyjal,1532,priest,discipline,43,22,21
Sxl,ysondre,1532,priest,discipline,54,27,27
Baloopriest,grim-batol,1532,priest,discipline,71,35,36
Blutleid,malfurion,1532,priest,discipline,78,36,42
Mvuu,kazzak,1531,priest,discipline,71,45,26
Володябигуди,howling-fjord,1531,priest,discipline,64,36,28
Хилкорлеоне,soulflayer,1531,priest,discipline,126,65,61
Mandarinee,blackmoore,1531,priest,discipline,456,233,223
Hâlez,antonidas,1531,priest,discipline,490,249,241
Trénboloné,tarren-mill,1531,priest,discipline,120,58,62
Darktemplarx,magtheridon,1531,priest,discipline,375,179,196
Glaedahr,blackmoore,1531,priest,discipline,66,26,40
Asmodeux,alakir,1530,priest,discipline,24,19,5
Ríeka,proudmoore,1530,priest,discipline,24,16,8
Ønliie,ravencrest,1530,priest,discipline,48,29,19
Xvpr,trollbane,1530,priest,discipline,77,43,34
Zordochpräst,ravencrest,1530,priest,discipline,72,39,33
Swdömmel,aegwynn,1530,priest,discipline,30,16,14
Jakeow,auchindoun,1530,priest,discipline,129,68,61
Gûardianwisp,ravencrest,1530,priest,discipline,271,137,134
Prinyatel,tarren-mill,1530,priest,discipline,86,40,46
Taanu,quelthalas,1529,priest,discipline,157,89,68
Skylar,xavius,1529,priest,discipline,84,47,37
Kakuzuke,nemesis,1529,priest,discipline,52,29,23
ßlinkywinky,outland,1529,priest,discipline,30,16,14
Gingerflexay,archimonde,1529,priest,discipline,72,38,34
Wortmonster,malganis,1529,priest,discipline,54,28,26
Fancytrash,ravencrest,1529,priest,discipline,169,83,86
Mojmir,drakthul,1529,priest,discipline,120,58,62
Manethø,twisting-nether,1529,priest,discipline,48,23,25
Onelovexx,thrall,1529,priest,discipline,60,28,32
Joshpr,stormscale,1528,priest,discipline,27,20,7
Mírá,burning-blade,1528,priest,discipline,108,66,42
Akingodxz,twisting-nether,1528,priest,discipline,48,27,21
Undeabniss,nathrezim,1528,priest,discipline,54,29,25
Jagersmite,twisting-nether,1528,priest,discipline,504,267,237
Grishnat,ragnaros,1528,priest,discipline,54,28,26
Avgenjoyer,kazzak,1528,priest,discipline,310,152,158
Franciscus,bladefist,1528,priest,discipline,109,53,56
Sentryward,silvermoon,1528,priest,discipline,66,27,39
Zackshock,sanguino,1528,priest,discipline,102,39,63
Delarus,perenolde,1527,priest,discipline,96,58,38
Squidlicker,twisting-nether,1527,priest,discipline,148,79,69
Leleg,blackhand,1527,priest,discipline,36,19,17
Vdwayne,argent-dawn,1527,priest,discipline,167,87,80
Preachyjeg,ravencrest,1527,priest,discipline,291,142,149
Papynou,garona,1526,priest,discipline,37,23,14
Chujzvychodu,drakthul,1526,priest,discipline,48,28,20
Diva,malfurion,1526,priest,discipline,96,51,45
Phasmöphobia,zuljin,1526,priest,discipline,261,130,131
Tanjaspano,twisting-nether,1526,priest,discipline,66,32,34
Budwéisér,ravencrest,1526,priest,discipline,122,58,64
Ivysaurus,ravencrest,1525,priest,discipline,168,94,74
Cinri,argent-dawn,1525,priest,discipline,322,156,166
Вайфими,gordunni,1525,priest,discipline,148,71,77
Лилатэль,blackscar,1525,priest,discipline,203,94,109
Syrell,sanguino,1525,priest,discipline,83,37,46
Hellmipriest,antonidas,1525,priest,discipline,72,28,44
Crimsõn,kazzak,1524,priest,discipline,78,45,33
Валифа,gordunni,1524,priest,discipline,116,63,53
Экспл,lich-king,1524,priest,discipline,82,41,41
Nøitra,blackrock,1524,priest,discipline,59,28,31
Szentpap,ravencrest,1524,priest,discipline,82,38,44
Vendorqt,twisting-nether,1524,priest,discipline,36,16,20
Fearmongerer,tarren-mill,1523,priest,discipline,35,25,10
Vanillahaze,sylvanas,1523,priest,discipline,91,59,32
Argaar,burning-legion,1523,priest,discipline,191,107,84
Madkes,ravencrest,1523,priest,discipline,389,202,187
Utsuro,stormscale,1523,priest,discipline,96,49,47
Kyseki,ravencrest,1523,priest,discipline,514,262,252
Phobica,frostmane,1523,priest,discipline,52,26,26
Laurent,sanguino,1523,priest,discipline,47,22,25
Wiildsy,tarren-mill,1523,priest,discipline,77,36,41
Виспх,eversong,1523,priest,discipline,269,120,149
Бархомелфой,gordunni,1522,priest,discipline,113,61,52
Pricé,blackmoore,1522,priest,discipline,102,55,47
Burnex,thrall,1522,priest,discipline,165,83,82
Averagenoob,ragnaros,1522,priest,discipline,335,168,167
Тыкофка,gordunni,1522,priest,discipline,504,242,262
Cptatonement,draenor,1522,priest,discipline,142,68,74
Hìld,blackmoore,1522,priest,discipline,78,35,43
Josva,sanguino,1522,priest,discipline,54,24,30
Карбираторх,gordunni,1522,priest,discipline,54,23,31
Kaazaam,eredar,1522,priest,discipline,66,21,45
Justrebeccap,kazzak,1521,priest,discipline,56,35,21
Ruhe,silvermoon,1521,priest,discipline,48,29,19
Rasha,kazzak,1521,priest,discipline,129,71,58
Badballs,doomhammer,1521,priest,discipline,65,29,36
Mezan,tarren-mill,1521,priest,discipline,113,50,63
Бэнжэминг,gordunni,1521,priest,discipline,179,79,100
Соулвардинг,soulflayer,1521,priest,discipline,66,27,39
Localmadlad,draenor,1520,priest,discipline,91,57,34
Yesdaddypls,draenor,1520,priest,discipline,54,33,21
Voidwaffel,blackmoore,1520,priest,discipline,144,79,65
Rennic,stormscale,1520,priest,discipline,102,54,48
Øtîs,aegwynn,1520,priest,discipline,86,44,42
Discgodx,ravencrest,1520,priest,discipline,186,94,92
Pepeflex,draenor,1520,priest,discipline,293,140,153
Babybeyle,arakarahm,1520,priest,discipline,322,151,171
Benau,aegwynn,1519,priest,discipline,60,38,22
Calyah,kazzak,1519,priest,discipline,35,20,15
Sorrybowtdat,tarren-mill,1519,priest,discipline,144,70,74
Awcute,kazzak,1519,priest,discipline,623,301,322
Castpenance,blackrock,1519,priest,discipline,342,165,177
Noviriel,argent-dawn,1519,priest,discipline,264,123,141
Sixeus,outland,1519,priest,discipline,45,19,26
Ínsäníty,outland,1518,priest,discipline,48,30,18
Весёлыйкоил,gordunni,1518,priest,discipline,69,40,29
Miileys,arthas,1518,priest,discipline,163,90,73
Mmh,haomarush,1518,priest,discipline,51,20,31
Verxalas,stormscale,1517,priest,discipline,40,29,11
Sensor,kazzak,1517,priest,discipline,147,78,69
Viroz,blackmoore,1517,priest,discipline,82,41,41
Grimdream,ragnaros,1517,priest,discipline,573,284,289
Øpra,nemesis,1517,priest,discipline,246,111,135
Synnestra,antonidas,1516,priest,discipline,59,34,25
Sadkitten,sylvanas,1516,priest,discipline,373,203,170
Хальтэнис,gordunni,1516,priest,discipline,83,45,38
Shymouni,norgannon,1516,priest,discipline,65,35,30
Arkkupiispa,stormreaver,1516,priest,discipline,740,372,368
Mikò,blackmoore,1516,priest,discipline,90,43,47
Bornxgood,kazzak,1516,priest,discipline,78,36,42
Dench,azjolnerub,1516,priest,discipline,84,38,46
Arashana,hyjal,1515,priest,discipline,99,59,40
Makrophage,mannoroth,1515,priest,discipline,34,18,16
Ocepriest,twisting-nether,1515,priest,discipline,170,87,83
Nastynina,frostwhisper,1515,priest,discipline,116,57,59
Hateyeleison,burning-legion,1515,priest,discipline,108,52,56
Элишана,deathguard,1515,priest,discipline,230,108,122
Valmar,twisting-nether,1514,priest,discipline,102,60,42
Elyra,the-shatar,1514,priest,discipline,146,84,62
Mercies,kazzak,1514,priest,discipline,81,46,35
Amnesztia,ragnaros,1514,priest,discipline,141,77,64
Atax,kazzak,1514,priest,discipline,543,275,268
Lukéy,silvermoon,1514,priest,discipline,66,33,33
Boysa,earthen-ring,1514,priest,discipline,150,72,78
Hiddenhealz,blackrock,1514,priest,discipline,60,25,35
Ayumcd,ravencrest,1513,priest,discipline,109,63,46
Ssol,tarren-mill,1513,priest,discipline,126,68,58
Mâdowk,los-errantes,1513,priest,discipline,570,293,277
Lurri,tarren-mill,1513,priest,discipline,228,116,112
Bottemg,defias-brotherhood,1513,priest,discipline,66,33,33
Mactub,frostwolf,1513,priest,discipline,88,37,51
Лэрикус,howling-fjord,1513,priest,discipline,60,25,35
Ðøìßåx,silvermoon,1512,priest,discipline,96,53,43
Dabzp,twisting-nether,1512,priest,discipline,47,25,22
Göblinpriest,the-maelstrom,1512,priest,discipline,87,45,42
Вутитути,howling-fjord,1512,priest,discipline,132,62,70
Babyx,stormscale,1512,priest,discipline,98,45,53
Bärgarn,tarren-mill,1512,priest,discipline,48,22,26
Warm,auchindoun,1511,priest,discipline,51,37,14
Büssi,blackrock,1511,priest,discipline,30,19,11
Ciri,die-aldor,1511,priest,discipline,31,18,13
Astralscare,outland,1511,priest,discipline,163,90,73
Zxèlá,tarren-mill,1511,priest,discipline,149,82,67
Lirou,archimonde,1511,priest,discipline,53,29,24
Kuivatmaat,ravencrest,1511,priest,discipline,30,16,14
Rmt,darksorrow,1511,priest,discipline,75,38,37
Priestlol,outland,1511,priest,discipline,217,107,110
Worldgamer,blackrock,1511,priest,discipline,310,150,160
Khrtp,silvermoon,1511,priest,discipline,84,38,46
Blazekk,sylvanas,1511,priest,discipline,127,56,71
Chrisdorner,archimonde,1511,priest,discipline,39,16,23
Zeroskillz,outland,1510,priest,discipline,89,56,33
Rúbý,tarren-mill,1510,priest,discipline,442,240,202
Tebzy,ravencrest,1510,priest,discipline,30,16,14
Kirchhoffina,die-nachtwache,1510,priest,discipline,49,26,23
Voidwalkz,kazzak,1510,priest,discipline,41,20,21
Alliora,dalaran,1510,priest,discipline,236,115,121
Исусиприст,deepholm,1510,priest,discipline,54,26,28
Aurorä,burning-legion,1510,priest,discipline,69,33,36
Колдрексх,deathguard,1510,priest,discipline,120,55,65
Alros,elune,1510,priest,discipline,42,18,24
Pumpkin,aggramar,1509,priest,discipline,30,19,11
Discomarcel,burning-legion,1509,priest,discipline,48,27,21
Nûttz,stormscale,1509,priest,discipline,126,69,57
Zïn,silvermoon,1509,priest,discipline,103,55,48
Ghoul,destromath,1509,priest,discipline,30,16,14
Dusktide,ravencrest,1509,priest,discipline,30,16,14
Майндоф,howling-fjord,1509,priest,discipline,108,57,51
Lilpi,rexxar,1509,priest,discipline,129,67,62
Ilostmybible,runetotem,1509,priest,discipline,204,105,99
Дармирэль,gordunni,1509,priest,discipline,105,53,52
Naberus,ragnaros,1509,priest,discipline,399,198,201
Kryzenn,hyjal,1509,priest,discipline,165,73,92
Yummelol,dun-modr,1509,priest,discipline,52,20,32
Nimbtwink,silvermoon,1508,priest,discipline,83,50,33
Seinaruki,emerald-dream,1508,priest,discipline,109,64,45
Healinrbglol,blackmoore,1508,priest,discipline,77,43,34
Knazh,twisting-nether,1508,priest,discipline,38,21,17
Arkatina,outland,1508,priest,discipline,70,38,32
Ethaz,twisting-nether,1508,priest,discipline,30,16,14
Xaeron,eredar,1508,priest,discipline,84,44,40
Isweariheal,twisting-nether,1508,priest,discipline,154,80,74
Watchmedeath,sargeras,1508,priest,discipline,73,36,37
Mcdced,archimonde,1508,priest,discipline,141,67,74
Zzoska,burning-legion,1508,priest,discipline,118,51,67
Dotingshadow,tarren-mill,1507,priest,discipline,65,44,21
Peersh,ahnqiraj,1507,priest,discipline,30,19,11
Аришвд,gordunni,1507,priest,discipline,110,65,45
Ledania,aegwynn,1507,priest,discipline,91,52,39
Healicious,teldrassil,1507,priest,discipline,30,16,14
Champp,drakthul,1507,priest,discipline,275,145,130
Ggsus,outland,1507,priest,discipline,160,83,77
Goldgot,tarren-mill,1507,priest,discipline,54,28,26
Shînnøk,silvermoon,1507,priest,discipline,289,148,141
Slasherh,ravencrest,1507,priest,discipline,294,150,144
Scade,kazzak,1507,priest,discipline,104,52,52
Aguerran,spinebreaker,1507,priest,discipline,132,63,69
Voidsnitch,antonidas,1507,priest,discipline,144,67,77
Hwren,auchindoun,1507,priest,discipline,242,108,134
Mindhøven,veklor,1507,priest,discipline,42,16,26
Enoriya,blackrock,1506,priest,discipline,268,143,125
Floory,twisting-nether,1506,priest,discipline,383,203,180
Edoran,ragnaros,1506,priest,discipline,115,59,56
Æxø,draenor,1506,priest,discipline,83,42,41
Rtfmx,outland,1506,priest,discipline,46,23,23
Jandice,blackrock,1506,priest,discipline,71,31,40
Stiflersmum,doomhammer,1505,priest,discipline,30,18,12
Клаидх,gordunni,1505,priest,discipline,55,32,23
Lasebeak,ravencrest,1505,priest,discipline,115,66,49
Imoz,antonidas,1505,priest,discipline,30,17,13
Ylivoima,stormscale,1505,priest,discipline,188,104,84
Пристяо,howling-fjord,1505,priest,discipline,321,177,144
Yvaini,xavius,1505,priest,discipline,132,72,60
Tutoress,stormscale,1505,priest,discipline,54,25,29
Xîz,silvermoon,1505,priest,discipline,96,43,53
Aexlius,silvermoon,1504,priest,discipline,29,20,9
Ixdeadxl,stormscale,1504,priest,discipline,99,58,41
Ghostroller,pozzo-delleternità,1504,priest,discipline,126,68,58
Staj,blackrock,1504,priest,discipline,30,16,14
Dartheon,twisting-nether,1504,priest,discipline,360,183,177
Elämäntypy,stormscale,1504,priest,discipline,144,70,74
Supernal,twisting-nether,1504,priest,discipline,72,34,38
Banshzz,ragnaros,1504,priest,discipline,143,67,76
Вишнях,soulflayer,1503,priest,discipline,60,32,28
Рвотка,gordunni,1503,priest,discipline,184,96,88
Anetalol,zuluhed,1503,priest,discipline,72,36,36
Eîkro,blackmoore,1503,priest,discipline,96,47,49
Jacksonz,blackmoore,1503,priest,discipline,42,17,25
Deicidex,blackrock,1503,priest,discipline,78,28,50
Icutebiker,nagrand,1502,priest,discipline,101,61,40
Diskogoblin,drakthul,1502,priest,discipline,52,29,23
Thejambura,ragnaros,1502,priest,discipline,157,87,70
Ximya,kazzak,1502,priest,discipline,139,75,64
Sebekklawl,wrathbringer,1502,priest,discipline,103,54,49
Spoggle,kazzak,1502,priest,discipline,131,67,64
Ckxd,ravencrest,1502,priest,discipline,51,25,26
Lipoatrofia,sanguino,1502,priest,discipline,214,104,110
Tiragosaure,arakarahm,1502,priest,discipline,105,51,54
Artì,kazzak,1502,priest,discipline,326,155,171
Chamelthoe,the-maelstrom,1502,priest,discipline,126,59,67
Saénna,burning-legion,1502,priest,discipline,62,26,36
Maskinjundre,bronzebeard,1502,priest,discipline,51,21,30
Verzeichnis,thrall,1501,priest,discipline,188,104,84
Dreadx,antonidas,1501,priest,discipline,157,83,74
Alphabreyf,tarren-mill,1501,priest,discipline,161,82,79
Greyanna,twisting-nether,1501,priest,discipline,231,112,119
Redøm,stormreaver,1501,priest,discipline,69,33,36
Nometalol,drakthul,1501,priest,discipline,36,16,20
Aeritha,blackmoore,1500,priest,discipline,65,39,26
Дюшапинанс,soulflayer,1500,priest,discipline,92,54,38
Malyzion,draenor,1500,priest,discipline,253,142,111
Мьюсх,deathguard,1500,priest,discipline,77,42,35
Priesticchi,stormscale,1500,priest,discipline,222,119,103
Alakkiria,ravencrest,1500,priest,discipline,135,71,64
Selenee,scarshield-legion,1500,priest,discipline,236,119,117
Ohbenji,ravencrest,1500,priest,discipline,200,95,105
Proteinsnack,auchindoun,1500,priest,discipline,36,16,20
Dreamhatcher,deathwing,1500,priest,discipline,42,18,24
Selëne,blackrock,1499,priest,discipline,51,29,22
Mzpriest,dalaran,1499,priest,discipline,106,57,49
Tintapri,aszune,1499,priest,discipline,152,81,71
Nandezpriest,blackrock,1499,priest,discipline,214,111,103
Byzzi,draenor,1499,priest,discipline,221,107,114
Merkabrah,sylvanas,1499,priest,discipline,98,47,51
Disillusíon,tarren-mill,1499,priest,discipline,156,74,82
Raffá,blackhand,1499,priest,discipline,136,58,78
Holyxqt,blackrock,1498,priest,discipline,114,68,46
Sîarra,eredar,1498,priest,discipline,156,89,67
Cydira,eredar,1498,priest,discipline,96,54,42
Holywann,argent-dawn,1498,priest,discipline,89,50,39
Crims,twisting-nether,1498,priest,discipline,150,83,67
Safemode,ravencrest,1498,priest,discipline,83,45,38
Shagan,archimonde,1498,priest,discipline,72,39,33
Shenkt,ravenholdt,1498,priest,discipline,30,16,14
Eyllise,ragnaros,1498,priest,discipline,646,334,312
Boarheals,blackmoore,1498,priest,discipline,107,54,53
Ascindra,ravencrest,1498,priest,discipline,36,18,18
Tuitio,blackmoore,1498,priest,discipline,132,65,67
Húlda,auchindoun,1498,priest,discipline,208,100,108
Darknun,aggra-português,1498,priest,discipline,195,90,105
Klemi,dun-modr,1497,priest,discipline,72,42,30
Diarolz,sanguino,1497,priest,discipline,81,46,35
Holysheett,magtheridon,1497,priest,discipline,156,82,74
Mukake,burning-legion,1497,priest,discipline,503,263,240
Viì,ravencrest,1497,priest,discipline,69,35,34
Prästpojken,frostwhisper,1497,priest,discipline,222,107,115
Cbsad,madmortem,1496,priest,discipline,135,72,63
Juco,draenor,1496,priest,discipline,153,80,73
Huffinctus,tarren-mill,1496,priest,discipline,118,61,57
Saitani,stormscale,1496,priest,discipline,59,28,31
Lokíe,ragnaros,1496,priest,discipline,48,19,29
Ashérs,ravencrest,1495,priest,discipline,219,122,97
Creigmorg,sanguino,1495,priest,discipline,96,50,46
Rightx,outland,1495,priest,discipline,419,218,201
Badhêalz,aegwynn,1495,priest,discipline,181,92,89
Chôrdi,aegwynn,1495,priest,discipline,249,125,124
Døgfîsh,stormscale,1495,priest,discipline,148,72,76
Ihaveibs,doomhammer,1495,priest,discipline,163,79,84
Jijin,stormscale,1495,priest,discipline,54,26,28
Panoio,aggra-português,1495,priest,discipline,147,69,78
Rezzurrectum,doomhammer,1495,priest,discipline,111,52,59
Skarnir,uldaman,1495,priest,discipline,165,75,90
Aïezn,culte-de-la-rive-noire,1495,priest,discipline,206,93,113
Zealtron,darksorrow,1495,priest,discipline,98,44,54
Рмпим,howling-fjord,1495,priest,discipline,63,23,40
Onetwo,silvermoon,1494,priest,discipline,30,18,12
Drawun,burning-legion,1494,priest,discipline,116,67,49
Enzyme,drakthul,1494,priest,discipline,84,48,36
Ballsbrawlz,sylvanas,1494,priest,discipline,48,27,21
Dairox,blackrock,1494,priest,discipline,175,94,81
Lolipopheal,blackmoore,1494,priest,discipline,60,32,28
Huzlin,kazzak,1494,priest,discipline,268,137,131
Juggster,bloodhoof,1494,priest,discipline,186,95,91
Hexenmeister,laughing-skull,1493,priest,discipline,69,36,33
Levimm,turalyon,1493,priest,discipline,604,315,289
Spánkproof,kazzak,1493,priest,discipline,66,34,32
Keimohansío,draenor,1493,priest,discipline,117,60,57
Nubso,aegwynn,1493,priest,discipline,66,31,35
Phipham,frostwolf,1493,priest,discipline,42,19,23
Chrispriest,argent-dawn,1493,priest,discipline,62,28,34
Myrann,ravencrest,1492,priest,discipline,36,21,15
Shadowsig,silvermoon,1492,priest,discipline,317,166,151
Nerfpriest,tarren-mill,1492,priest,discipline,406,200,206
Zofiiee,tarren-mill,1492,priest,discipline,167,78,89
Tinpr,sanguino,1492,priest,discipline,111,50,61
Dezó,stormscale,1491,priest,discipline,23,16,7
Ursela,tarren-mill,1491,priest,discipline,66,41,25
Чтоподелать,soulflayer,1491,priest,discipline,107,57,50
Holyfussell,antonidas,1491,priest,discipline,119,63,56
Остроухх,howling-fjord,1491,priest,discipline,180,93,87
Wâneis,stormscale,1491,priest,discipline,285,146,139
Khaag,korgall,1491,priest,discipline,102,52,50
Zuigen,lightbringer,1491,priest,discipline,122,60,62
Мерзавчикх,soulflayer,1491,priest,discipline,45,22,23
Nimsi,ravencrest,1491,priest,discipline,36,16,20
Quintanaro,thrall,1491,priest,discipline,51,19,32
Asdecoeur,tarren-mill,1490,priest,discipline,63,40,23
Shwadopreist,aegwynn,1490,priest,discipline,51,29,22
Enigam,alakir,1490,priest,discipline,125,68,57
Ysharrj,hyjal,1490,priest,discipline,105,57,48
Sílvana,nordrassil,1490,priest,discipline,355,190,165
Quencher,outland,1490,priest,discipline,30,16,14
Aasgard,frostwolf,1490,priest,discipline,134,67,67
Hunfall,stormscale,1490,priest,discipline,148,73,75
Keyfear,kazzak,1490,priest,discipline,99,48,51
Kurt,blackrock,1490,priest,discipline,154,74,80
Broer,twisting-nether,1489,priest,discipline,48,31,17
Holydisease,tarren-mill,1489,priest,discipline,36,21,15
Jaatjak,ravencrest,1489,priest,discipline,114,61,53
Meiyah,draenor,1489,priest,discipline,95,49,46
Олегстразза,howling-fjord,1489,priest,discipline,426,216,210
Leyasu,eredar,1489,priest,discipline,81,40,41
Lâughing,ravencrest,1488,priest,discipline,129,72,57
Ceraghk,tichondrius,1488,priest,discipline,144,76,68
Kinkykaren,kazzak,1488,priest,discipline,139,72,67
Auntbessy,outland,1488,priest,discipline,91,47,44
Targolina,argent-dawn,1488,priest,discipline,796,399,397
ßøpe,khaz-modan,1488,priest,discipline,42,21,21
Priszt,arathor,1488,priest,discipline,85,42,43
Disturbdtwo,archimonde,1488,priest,discipline,72,35,37
Cav,archimonde,1488,priest,discipline,194,94,100
Mamis,anetheron,1488,priest,discipline,84,39,45
Rîhanna,sanguino,1487,priest,discipline,51,31,20
Jodge,ravencrest,1487,priest,discipline,102,59,43
Bøts,ravencrest,1487,priest,discipline,841,424,417
Marryisme,twisting-nether,1487,priest,discipline,271,135,136
Hötchick,outland,1487,priest,discipline,228,112,116
Ptsd,argent-dawn,1487,priest,discipline,120,56,64
Çelph,silvermoon,1487,priest,discipline,80,35,45
Elleine,aggra-português,1486,priest,discipline,57,30,27
Wakeybakey,tarren-mill,1486,priest,discipline,338,173,165
Triuna,sylvanas,1486,priest,discipline,41,20,21
Yugata,archimonde,1486,priest,discipline,121,53,68
Merrysmiting,ravencrest,1486,priest,discipline,42,16,26
Eotlin,shattered-hand,1485,priest,discipline,60,34,26
Ðiscobiscuit,argent-dawn,1485,priest,discipline,116,62,54
Saintsense,outland,1485,priest,discipline,120,64,56
Elegosht,sanguino,1485,priest,discipline,143,75,68
Senosaurus,tarren-mill,1485,priest,discipline,147,71,76
Äkvä,ragnaros,1485,priest,discipline,78,32,46
Erikssan,stormscale,1485,priest,discipline,55,22,33
Sàvia,pozzo-delleternità,1485,priest,discipline,54,18,36
Sickwill,blackrock,1484,priest,discipline,62,34,28
Nightfearqt,outland,1484,priest,discipline,134,72,62
Diszi,norgannon,1484,priest,discipline,78,35,43
Лоео,ashenvale,1484,priest,discipline,114,51,63
Aurunea,blackrock,1483,priest,discipline,75,44,31
Dunkelseele,ahnqiraj,1483,priest,discipline,48,26,22
Nerfy,tarren-mill,1483,priest,discipline,384,199,185
Cäandy,dalaran,1482,priest,discipline,70,39,31
Dalylla,aggra-português,1482,priest,discipline,123,65,58
Jackyz,tarren-mill,1482,priest,discipline,108,43,65
Mamoltte,draenor,1481,priest,discipline,60,39,21
Eagleess,silvermoon,1481,priest,discipline,78,45,33
Snoopqt,dalaran,1481,priest,discipline,325,166,159
Vaßpera,tarren-mill,1481,priest,discipline,39,19,20
Unheal,thrall,1481,priest,discipline,69,33,36
Laxímink,sylvanas,1481,priest,discipline,119,51,68
Deadmous,sanguino,1480,priest,discipline,60,43,17
Êvîlêvê,blackmoore,1480,priest,discipline,100,57,43
Холишитс,gordunni,1480,priest,discipline,190,107,83
Derylium,kazzak,1480,priest,discipline,152,84,68
Wwpriest,thrall,1480,priest,discipline,129,69,60
Southyz,stormscale,1480,priest,discipline,129,67,62
Spiriman,zuljin,1480,priest,discipline,132,67,65
Гизамуррис,howling-fjord,1480,priest,discipline,99,50,49
Nemrtvaa,draenor,1480,priest,discipline,78,38,40
Healiröva,stormscale,1480,priest,discipline,44,21,23
Mortarz,ragnaros,1480,priest,discipline,101,45,56
Noxth,blackmoore,1480,priest,discipline,42,18,24
Lapinvicieux,archimonde,1479,priest,discipline,90,51,39
Оуджис,soulflayer,1479,priest,discipline,40,21,19
Mylox,blackrock,1479,priest,discipline,93,48,45
Blackheall,nemesis,1479,priest,discipline,46,23,23
Джелесана,gordunni,1479,priest,discipline,99,45,54
Tech,shattered-hand,1479,priest,discipline,59,24,35
Snylia,blackrock,1479,priest,discipline,66,25,41
Rwaphouu,ysondre,1478,priest,discipline,99,59,40
Cidrea,saurfang,1478,priest,discipline,30,17,13
Annisa,kazzak,1478,priest,discipline,201,112,89
Sangububblu,silvermoon,1478,priest,discipline,118,65,53
Thaiboimby,veknilash,1478,priest,discipline,487,254,233
Zøid,ysondre,1478,priest,discipline,58,30,28
Ihealzem,tarren-mill,1478,priest,discipline,48,23,25
Barnicha,grim-batol,1477,priest,discipline,48,29,19
Shkzz,hyjal,1477,priest,discipline,217,124,93
Carnacia,tarren-mill,1477,priest,discipline,154,88,66
Kollis,twilights-hammer,1477,priest,discipline,251,125,126
Pretee,nemesis,1477,priest,discipline,54,25,29
Moarein,twisting-nether,1477,priest,discipline,101,46,55
Deesy,aegwynn,1476,priest,discipline,30,22,8
Letmehêal,archimonde,1476,priest,discipline,114,63,51
Rikipope,ravencrest,1476,priest,discipline,89,48,41
Prioheal,hyjal,1476,priest,discipline,132,70,62
Vogelfrau,ravencrest,1476,priest,discipline,143,74,69
Mahalik,blackhand,1476,priest,discipline,53,27,26
Lhh,blackmoore,1476,priest,discipline,127,64,63
Kopperuud,stormscale,1476,priest,discipline,78,38,40
Фруктовыйса,gordunni,1476,priest,discipline,134,63,71
Xytael,burning-legion,1476,priest,discipline,66,31,35
Бичиотаке,azuregos,1476,priest,discipline,42,16,26
Pöppers,ysondre,1476,priest,discipline,127,44,83
Gorti,ravencrest,1475,priest,discipline,30,16,14
Крутосанка,blackscar,1475,priest,discipline,72,38,34
Keewix,ysondre,1475,priest,discipline,95,46,49
Lydîâ,blackhand,1475,priest,discipline,35,16,19
Isadian,kazzak,1475,priest,discipline,57,24,33
Ninetzz,tarren-mill,1474,priest,discipline,48,34,14
Hailor,blackmoore,1474,priest,discipline,54,32,22
Bubidiblumpr,twisting-nether,1474,priest,discipline,126,72,54
Kratzîgel,blackmoore,1474,priest,discipline,137,76,61
Numi,blackmoore,1474,priest,discipline,221,121,100
Battra,argent-dawn,1474,priest,discipline,84,45,39
Buzzy,twisting-nether,1474,priest,discipline,144,75,69
Zoose,silvermoon,1474,priest,discipline,78,36,42
Jána,argent-dawn,1473,priest,discipline,96,57,39
Adonallsium,sylvanas,1473,priest,discipline,75,44,31
Decísíon,aegwynn,1473,priest,discipline,150,85,65
Luuña,ravencrest,1473,priest,discipline,214,112,102
Soulreapper,blackhand,1473,priest,discipline,323,169,154
Vilanae,hyjal,1473,priest,discipline,361,188,173
Bonzux,dethecus,1473,priest,discipline,42,19,23
Sànká,ysondre,1472,priest,discipline,48,27,21
Гшд,gordunni,1472,priest,discipline,128,71,57
Жариха,gordunni,1472,priest,discipline,132,72,60
Chooser,stormscale,1472,priest,discipline,44,21,23
Волия,gordunni,1472,priest,discipline,50,20,30
Спсчтоживой,blackscar,1471,priest,discipline,189,93,96
Purebollox,twisting-nether,1471,priest,discipline,78,35,43
Omgitshuux,blackmoore,1471,priest,discipline,126,56,70
Вичкрафт,howling-fjord,1471,priest,discipline,60,23,37
Porklifer,tarren-mill,1470,priest,discipline,54,32,22
Tekrs,tarren-mill,1470,priest,discipline,48,28,20
Xeay,blackrock,1470,priest,discipline,42,24,18
Maneipriest,drakthul,1470,priest,discipline,65,35,30
Dêxter,hyjal,1470,priest,discipline,144,72,72
Ruly,ragnaros,1470,priest,discipline,69,33,36
Axxul,blackrock,1470,priest,discipline,97,46,51
Кхайла,blackscar,1470,priest,discipline,34,16,18
Vorynax,silvermoon,1470,priest,discipline,92,42,50
Virulent,nemesis,1470,priest,discipline,60,27,33
Mewpew,azjolnerub,1470,priest,discipline,66,28,38
Woukitos,drekthar,1470,priest,discipline,90,38,52
Hypernym,eredar,1469,priest,discipline,38,25,13
Housty,chamber-of-aspects,1469,priest,discipline,42,22,20
Bløøððåñçé,ragnaros,1469,priest,discipline,42,22,20
Влажныйшп,soulflayer,1469,priest,discipline,78,40,38
Openyoureyes,blackrock,1469,priest,discipline,66,33,33
Leerzeichen,aegwynn,1469,priest,discipline,95,47,48
Madrobert,outland,1469,priest,discipline,65,32,33
Abdibio,twisting-nether,1469,priest,discipline,48,23,25
Архиэрей,soulflayer,1469,priest,discipline,80,37,43
Okfartpå,ravencrest,1468,priest,discipline,30,22,8
Атинка,gordunni,1468,priest,discipline,60,35,25
Koíré,defias-brotherhood,1468,priest,discipline,195,109,86
Têhïcâ,dun-modr,1468,priest,discipline,203,107,96
Jazzmind,stormscale,1468,priest,discipline,180,93,87
Klituriis,twisting-nether,1468,priest,discipline,113,58,55
Pewkz,draenor,1468,priest,discipline,164,83,81
Unholyfield,draenor,1468,priest,discipline,215,108,107
Marllen,twisting-nether,1468,priest,discipline,443,220,223
Nàvy,archimonde,1468,priest,discipline,39,19,20
Lucidluke,blackmoore,1468,priest,discipline,103,49,54
Tsunê,ysondre,1468,priest,discipline,40,19,21
Cptmoigx,antonidas,1468,priest,discipline,69,27,42
Kalisya,ravencrest,1468,priest,discipline,63,24,39
Eros,illidan,1467,priest,discipline,132,71,61
Фикспрайз,gordunni,1467,priest,discipline,30,16,14
Sadgepriest,draenor,1467,priest,discipline,36,18,18
Jimmymcgill,ravencrest,1467,priest,discipline,34,16,18
Fluba,thrall,1466,priest,discipline,89,50,39
Hellsaya,ysondre,1466,priest,discipline,126,69,57
Txz,kazzak,1466,priest,discipline,120,65,55
Overtimedmg,kazzak,1466,priest,discipline,35,18,17
Sâtânica,kelthuzad,1466,priest,discipline,380,190,190
Sameec,drakthul,1466,priest,discipline,147,72,75
Gobie,sunstrider,1466,priest,discipline,92,44,48
Yákizå,darksorrow,1466,priest,discipline,72,30,42
Бленди,howling-fjord,1466,priest,discipline,65,27,38
Myxeh,ravencrest,1465,priest,discipline,73,39,34
Morenetä,dun-modr,1465,priest,discipline,72,38,34
Тэтэшник,ashenvale,1465,priest,discipline,230,117,113
Willenskraft,outland,1465,priest,discipline,54,26,28
Zatón,dun-modr,1465,priest,discipline,66,31,35
Sherbanger,argent-dawn,1465,priest,discipline,48,22,26
Kroa,ragnaros,1464,priest,discipline,54,31,23
Cezzar,kazzak,1464,priest,discipline,95,54,41
Jeuhy,talnivarr,1464,priest,discipline,198,107,91
Chénony,ravencrest,1464,priest,discipline,274,139,135
Coldsigil,argent-dawn,1464,priest,discipline,87,43,44
Viagrà,outland,1464,priest,discipline,138,63,75
Injured,bronzebeard,1464,priest,discipline,42,19,23
Ragelogoouut,draenor,1464,priest,discipline,84,37,47
Geierlol,blackrock,1464,priest,discipline,42,17,25
Viroxian,outland,1463,priest,discipline,199,112,87
Getötet,blackrock,1463,priest,discipline,138,76,62
Arrlina,magtheridon,1463,priest,discipline,131,64,67
Hombre,anetheron,1463,priest,discipline,39,19,20
Ецци,howling-fjord,1462,priest,discipline,68,37,31
Anniegelic,ravencrest,1462,priest,discipline,184,91,93
Ботхесатва,deepholm,1462,priest,discipline,77,35,42
Amoxkys,nemesis,1462,priest,discipline,86,39,47
Avázàr,stormscale,1462,priest,discipline,60,27,33
Eompriest,magtheridon,1462,priest,discipline,48,21,27
Dubai,silvermoon,1462,priest,discipline,52,17,35
Yomominmedm,draenor,1461,priest,discipline,72,41,31
Zoose,defias-brotherhood,1461,priest,discipline,44,25,19
Tallzoné,ravencrest,1461,priest,discipline,213,113,100
Celiara,argent-dawn,1461,priest,discipline,183,95,88
Taiyöshin,silvermoon,1461,priest,discipline,118,61,57
Suaakypriest,tyrande,1461,priest,discipline,48,24,24
Нэстикус,gordunni,1461,priest,discipline,78,38,40
Sodomizing,kazzak,1461,priest,discipline,104,48,56
Tarîs,archimonde,1461,priest,discipline,144,66,78
Painkillrz,twisting-nether,1461,priest,discipline,60,25,35
Elizabéth,blackrock,1460,priest,discipline,43,26,17
Nurbanu,ravencrest,1460,priest,discipline,83,50,33
Вайтбласт,howling-fjord,1460,priest,discipline,36,21,15
Ehther,dun-modr,1460,priest,discipline,82,47,35
Evilangèl,ravenholdt,1460,priest,discipline,139,76,63
Алуриэлия,gordunni,1460,priest,discipline,135,67,68
Урголиафа,howling-fjord,1460,priest,discipline,111,54,57
Akeejprix,ravencrest,1460,priest,discipline,126,60,66
Трихоманиаз,ashenvale,1460,priest,discipline,96,45,51
Пнух,soulflayer,1460,priest,discipline,150,70,80
Cúrt,sanguino,1460,priest,discipline,78,36,42
Rzkp,eredar,1460,priest,discipline,39,17,22
Deadonmyscrn,ravencrest,1459,priest,discipline,60,46,14
Drusila,drakthul,1459,priest,discipline,30,23,7
Luhmann,thrall,1459,priest,discipline,29,17,12
Joseantuan,sanguino,1459,priest,discipline,72,41,31
Kijul,ragnaros,1459,priest,discipline,154,85,69
Yukíø,antonidas,1459,priest,discipline,305,158,147
Zenholy,kazzak,1459,priest,discipline,114,59,55
Nÿpô,hyjal,1459,priest,discipline,89,40,49
Stàrlîght,chants-éternels,1458,priest,discipline,30,19,11
Damnatíon,ravencrest,1458,priest,discipline,46,29,17
Dømini,tarren-mill,1458,priest,discipline,88,52,36
Justkorèan,stormscale,1458,priest,discipline,54,29,25
Marylin,senjin,1458,priest,discipline,725,373,352
Wizmek,silvermoon,1458,priest,discipline,161,82,79
Hanniel,kazzak,1458,priest,discipline,108,55,53
Doktoritca,kazzak,1458,priest,discipline,90,38,52
Hardcode,twisting-nether,1457,priest,discipline,156,78,78
Jesuita,dun-modr,1457,priest,discipline,143,70,73
Faíht,blackrock,1457,priest,discipline,78,36,42
Jetlìfe,ysondre,1457,priest,discipline,48,20,28
Holymöly,archimonde,1457,priest,discipline,61,25,36
Dwel,bloodfeather,1457,priest,discipline,59,22,37
Amanojakü,ravencrest,1456,priest,discipline,78,50,28
Deadpxlz,ravencrest,1456,priest,discipline,42,25,17
Ysaril,archimonde,1456,priest,discipline,36,20,16
Sambiel,antonidas,1456,priest,discipline,60,33,27
Carzn,blackmoore,1456,priest,discipline,102,55,47
Retardé,tarren-mill,1456,priest,discipline,222,118,104
Yuuvi,ravencrest,1456,priest,discipline,335,173,162
Sedu,draenor,1456,priest,discipline,66,32,34
Рокрон,galakrond,1456,priest,discipline,114,53,61
Марина,howling-fjord,1456,priest,discipline,143,65,78
Лизота,gordunni,1456,priest,discipline,93,42,51
Sémi,twisting-nether,1455,priest,discipline,60,34,26
Vhis,ragnaros,1455,priest,discipline,30,17,13
Kåstå,archimonde,1455,priest,discipline,92,51,41
Nestiah,hyjal,1455,priest,discipline,42,22,20
Papkalácss,hellfire,1455,priest,discipline,110,54,56
Teladorne,ravencrest,1455,priest,discipline,36,17,19
Clapclap,frostmourne,1455,priest,discipline,99,46,53
Dènna,eldrethalas,1455,priest,discipline,66,30,36
Oneheal,rexxar,1455,priest,discipline,61,27,34
Xaizn,arthas,1454,priest,discipline,116,66,50
Helikipope,kazzak,1454,priest,discipline,48,25,23
Докторпэйн,howling-fjord,1454,priest,discipline,257,133,124
Moustafaz,archimonde,1454,priest,discipline,45,22,23
Holyshart,magtheridon,1454,priest,discipline,119,58,61
Ralph,kazzak,1454,priest,discipline,78,29,49
Burka,aegwynn,1453,priest,discipline,27,20,7
Yusepmikel,cthun,1453,priest,discipline,62,40,22
Diddlefiddle,stormscale,1453,priest,discipline,100,55,45
Noany,ravencrest,1453,priest,discipline,140,73,67
Джахия,soulflayer,1453,priest,discipline,331,169,162
Pedopräst,stormscale,1453,priest,discipline,83,42,41
Sînálà,antonidas,1453,priest,discipline,86,43,43
ßabylexa,ravencrest,1453,priest,discipline,224,107,117
Xerxsiss,frostwolf,1453,priest,discipline,96,45,51
Healmebaby,kiljaeden,1452,priest,discipline,36,22,14
Doomey,ravencrest,1452,priest,discipline,59,33,26
Ræpriestx,ragnaros,1452,priest,discipline,167,90,77
Syro,defias-brotherhood,1452,priest,discipline,162,83,79
Synoé,la-croisade-écarlate,1452,priest,discipline,125,63,62
Xepetas,tarren-mill,1452,priest,discipline,69,31,38
Strikérlayá,aegwynn,1451,priest,discipline,107,52,55
Aviz,tarren-mill,1451,priest,discipline,36,17,19
Eleatros,blackrock,1451,priest,discipline,130,61,69
Dotdotggwp,stormscale,1451,priest,discipline,124,58,66
Netherp,twisting-nether,1450,priest,discipline,42,26,16
Halastrâ,tarren-mill,1450,priest,discipline,86,53,33
Alianza,hellfire,1450,priest,discipline,84,50,34
Krayziest,tarren-mill,1450,priest,discipline,51,30,21
Thorhammer,turalyon,1450,priest,discipline,72,42,30
Maidie,stormscale,1450,priest,discipline,107,62,45
Jimmbosmite,stormscale,1450,priest,discipline,95,52,43
Joyfu,archimonde,1450,priest,discipline,113,61,52
Rustyroll,stormscale,1450,priest,discipline,135,72,63
Reól,blackmoore,1450,priest,discipline,54,28,26
Skuhlx,blackrock,1450,priest,discipline,175,89,86
Relaxmom,bloodhoof,1450,priest,discipline,60,30,30
Холиблэк,blackscar,1450,priest,discipline,96,40,56
Kozmopi,blackhand,1449,priest,discipline,35,24,11
Exorcizamus,khaz-modan,1449,priest,discipline,30,18,12
Disc,argent-dawn,1449,priest,discipline,138,80,58
Holybunny,blackrock,1449,priest,discipline,146,82,64
Sheshan,destromath,1449,priest,discipline,111,57,54
Cyliaa,aegwynn,1449,priest,discipline,42,21,21
Akemmì,sylvanas,1449,priest,discipline,180,89,91
Сатанчикгод,howling-fjord,1449,priest,discipline,256,121,135
Zhacha,stormscale,1449,priest,discipline,36,16,20
Ebolaidman,ravencrest,1448,priest,discipline,156,87,69
Vanadii,blackhand,1448,priest,discipline,96,51,45
Flaylol,stormscale,1448,priest,discipline,53,26,27
Шруня,howling-fjord,1448,priest,discipline,345,169,176
Vanillå,silvermoon,1448,priest,discipline,84,41,43
Deepsea,kazzak,1448,priest,discipline,583,284,299
Inzàné,kazzak,1448,priest,discipline,112,51,61
ßøjèñkâ,ravencrest,1447,priest,discipline,32,21,11
Cring,kirin-tor,1447,priest,discipline,150,85,65
Massdispell,silvermoon,1447,priest,discipline,80,44,36
Palaniax,outland,1447,priest,discipline,48,26,22
Minsie,silvermoon,1447,priest,discipline,104,52,52
Djvoodoo,ahnqiraj,1447,priest,discipline,60,23,37
Ingvár,blackrock,1446,priest,discipline,24,16,8
Sevika,twisting-nether,1446,priest,discipline,25,16,9
Daddyfinger,argent-dawn,1446,priest,discipline,139,76,63
Aesyla,drakthul,1446,priest,discipline,69,37,32
Starnote,auchindoun,1446,priest,discipline,151,80,71
Тенсаи,howling-fjord,1446,priest,discipline,92,48,44
Friskï,silvermoon,1446,priest,discipline,60,31,29
Kobri,gilneas,1446,priest,discipline,263,135,128
Karoopi,ysondre,1446,priest,discipline,257,131,126
Cé,magtheridon,1446,priest,discipline,137,69,68
Ilovedisc,kazzak,1446,priest,discipline,62,31,31
Berrylee,twisting-nether,1446,priest,discipline,107,52,55
Меинбиг,gordunni,1446,priest,discipline,70,34,36
Аматури,soulflayer,1446,priest,discipline,54,26,28
Líín,hyjal,1446,priest,discipline,97,46,51
Niholie,sinstralis,1446,priest,discipline,132,60,72
Absinthamos,eredar,1446,priest,discipline,70,30,40
Flaskandeux,tarren-mill,1446,priest,discipline,248,104,144
Gâmeøvr,sanguino,1445,priest,discipline,93,53,40
ßlowska,hyjal,1445,priest,discipline,91,50,41
Greedyaf,stormscale,1445,priest,discipline,295,154,141
Chrì,argent-dawn,1445,priest,discipline,84,43,41
Kimozabi,ravencrest,1445,priest,discipline,74,37,37
Dreamscapez,tarren-mill,1445,priest,discipline,127,61,66
Reivno,ravencrest,1444,priest,discipline,54,33,21
Radulfus,stormrage,1444,priest,discipline,42,25,17
Deluuxelawl,ysondre,1444,priest,discipline,64,38,26
Bynd,blackrock,1444,priest,discipline,62,36,26
Серыйлог,galakrond,1444,priest,discipline,90,49,41
Sarrâh,ysondre,1444,priest,discipline,35,19,16
Toorree,stormscale,1444,priest,discipline,161,82,79
Comple,kazzak,1444,priest,discipline,54,27,27
Пэйтен,deathguard,1444,priest,discipline,42,21,21
Luziz,blackmoore,1444,priest,discipline,69,34,35
Fåtkidx,ravencrest,1444,priest,discipline,126,62,64
Antibiotike,hyjal,1443,priest,discipline,46,27,19
Fakebob,draenor,1443,priest,discipline,72,42,30
Grausami,zuluhed,1443,priest,discipline,102,55,47
Tamy,draenor,1443,priest,discipline,122,59,63
Hellmione,blackmoore,1443,priest,discipline,112,44,68
Cinjá,thrall,1443,priest,discipline,67,26,41
Sombralúz,sanguino,1442,priest,discipline,36,20,16
Kangkong,ravencrest,1442,priest,discipline,57,31,26
Aizakku,frostmane,1442,priest,discipline,36,19,17
Fericul,argent-dawn,1442,priest,discipline,280,147,133
Xet,outland,1442,priest,discipline,165,81,84
Shanny,kazzak,1442,priest,discipline,89,43,46
Ёджих,blackscar,1442,priest,discipline,145,70,75
Krasawìtch,onyxia,1442,priest,discipline,117,54,63
Chibrausorus,archimonde,1442,priest,discipline,66,30,36
Ereebus,ragnaros,1442,priest,discipline,42,19,23
Randomm,shadowsong,1442,priest,discipline,78,33,45
Щявыхилим,howling-fjord,1441,priest,discipline,139,82,57
Endlin,silvermoon,1441,priest,discipline,78,46,32
Hyggêê,sanguino,1441,priest,discipline,53,31,22
Ðotgød,nemesis,1441,priest,discipline,42,24,18
Ciqua,frostmane,1441,priest,discipline,72,40,32
Troublemaker,durotan,1441,priest,discipline,126,68,58
Arize,dun-modr,1441,priest,discipline,440,221,219
Mindrouf,burning-legion,1441,priest,discipline,283,140,143
Fxd,talnivarr,1441,priest,discipline,98,48,50
Arima,kargath,1441,priest,discipline,186,91,95
Käji,silvermoon,1441,priest,discipline,93,44,49
Írelia,amanthul,1441,priest,discipline,100,46,54
Stk,outland,1441,priest,discipline,91,41,50
Søkariss,elune,1440,priest,discipline,48,28,20
Garfriest,aggra-português,1440,priest,discipline,117,67,50
Mørphè,hyjal,1440,priest,discipline,115,63,52
Mylini,silvermoon,1440,priest,discipline,201,104,97
Смегмачет,soulflayer,1440,priest,discipline,122,63,59
Sordag,lordaeron,1440,priest,discipline,108,48,60
Lyés,uldaman,1439,priest,discipline,247,141,106
Fathermaxii,stormrage,1439,priest,discipline,182,102,80
Гачибунта,blackscar,1439,priest,discipline,213,117,96
Bedkara,ravencrest,1439,priest,discipline,30,15,15
Voxqt,blackrock,1439,priest,discipline,30,15,15
Zeraphïn,eredar,1439,priest,discipline,30,15,15
Мненосина,goldrinn,1439,priest,discipline,186,88,98
Ведёрководки,ashenvale,1439,priest,discipline,36,17,19
Zeslash,suramar,1439,priest,discipline,99,45,54
Fakéy,draenor,1438,priest,discipline,47,32,15
Binkx,tarren-mill,1438,priest,discipline,24,15,9
Blackchrist,uldum,1438,priest,discipline,159,85,74
Roskva,archimonde,1438,priest,discipline,33,17,16
Bandgap,antonidas,1438,priest,discipline,235,118,117
Miraev,argent-dawn,1438,priest,discipline,60,29,31
Ascendare,tarren-mill,1438,priest,discipline,149,69,80
Lastchance,ravencrest,1438,priest,discipline,36,15,21
Shakalol,kazzak,1438,priest,discipline,39,16,23
Åshbé,archimonde,1437,priest,discipline,18,15,3
Hopeso,silvermoon,1437,priest,discipline,18,15,3
Cazã,archimonde,1437,priest,discipline,24,15,9
Causa,blackhand,1437,priest,discipline,85,51,34
Priztar,nazjatar,1437,priest,discipline,153,90,63
Thanil,bloodfeather,1437,priest,discipline,148,78,70
Zulcas,outland,1437,priest,discipline,48,25,23
Трезида,gordunni,1437,priest,discipline,102,53,49
Властьтени,gordunni,1437,priest,discipline,274,136,138
Тодохил,gordunni,1437,priest,discipline,244,119,125
Yaaoz,dun-modr,1437,priest,discipline,36,15,21
Fotmape,stormscale,1437,priest,discipline,36,15,21
Shavog,stormscale,1436,priest,discipline,42,22,20
Klosso,anachronos,1436,priest,discipline,102,53,49
Prisell,die-aldor,1436,priest,discipline,162,81,81
Фейкай,blackscar,1436,priest,discipline,66,33,33
Oxborn,thrall,1436,priest,discipline,167,83,84
Kbakå,stormscale,1436,priest,discipline,84,37,47
Fraydo,argent-dawn,1436,priest,discipline,48,21,27
Schockerjr,blackmoore,1436,priest,discipline,80,34,46
Voldream,ravencrest,1436,priest,discipline,73,29,44
Divinekat,tarren-mill,1435,priest,discipline,76,48,28
Domspitz,malygos,1435,priest,discipline,95,57,38
Декстерадей,howling-fjord,1435,priest,discipline,90,51,39
Lushipri,blackhand,1435,priest,discipline,113,63,50
Швдвшип,deathweaver,1435,priest,discipline,51,26,25
Anbish,burning-legion,1435,priest,discipline,401,204,197
Malisè,ravencrest,1435,priest,discipline,30,15,15
Nahni,teldrassil,1435,priest,discipline,307,142,165
Tinre,ravenholdt,1435,priest,discipline,96,43,53
Orkanwal,ravencrest,1434,priest,discipline,24,15,9
Бэнэльф,soulflayer,1434,priest,discipline,69,36,33
Kæyc,blackmoore,1434,priest,discipline,71,35,36
Zarozina,pozzo-delleternità,1434,priest,discipline,102,48,54
Nuraschka,antonidas,1434,priest,discipline,42,19,23
Rhäenÿra,hyjal,1433,priest,discipline,30,18,12
Negmatoda,ravencrest,1433,priest,discipline,27,16,11
Galadrielkä,drakthul,1433,priest,discipline,166,89,77
Simplesam,ravencrest,1433,priest,discipline,94,49,45
Onicolla,terokkar,1433,priest,discipline,192,99,93
Schmatzy,blackmoore,1433,priest,discipline,78,40,38
Баптисто,gordunni,1433,priest,discipline,59,26,33
Bigwik,tarren-mill,1433,priest,discipline,42,15,27
Ghostee,twisting-nether,1432,priest,discipline,35,24,11
Zazeriño,dun-modr,1432,priest,discipline,43,28,15
Junglepls,burning-blade,1432,priest,discipline,24,15,9
Brênos,blackmoore,1432,priest,discipline,47,29,18
Мэдсанван,howling-fjord,1432,priest,discipline,364,194,170
Healysith,archimonde,1432,priest,discipline,36,15,21
Muant,twisting-nether,1432,priest,discipline,36,15,21
Altargirl,defias-brotherhood,1432,priest,discipline,78,32,46
Lèss,ysondre,1432,priest,discipline,42,16,26
Swera,twisting-nether,1431,priest,discipline,24,15,9
Mcgodx,argent-dawn,1431,priest,discipline,48,28,20
Ilovechildrn,silvermoon,1431,priest,discipline,36,21,15
Fluffymuh,blackrock,1431,priest,discipline,87,47,40
Myrmeen,silvermoon,1431,priest,discipline,223,120,103
Phreyst,draenor,1431,priest,discipline,189,97,92
Shttygame,nazjatar,1431,priest,discipline,30,15,15
Sáshagrey,arathor,1431,priest,discipline,79,38,41
Cartøøns,ravencrest,1431,priest,discipline,100,47,53
Choron,kult-der-verdammten,1431,priest,discipline,127,58,69
Cherrih,argent-dawn,1431,priest,discipline,96,39,57
Marilya,dalvengyr,1431,priest,discipline,48,19,29
Micoup,ysondre,1431,priest,discipline,78,29,49
Agorasii,frostwolf,1430,priest,discipline,72,43,29
Unckus,defias-brotherhood,1430,priest,discipline,54,30,24
Mediumheals,tarren-mill,1430,priest,discipline,214,113,101
Golletz,twisting-nether,1430,priest,discipline,120,63,57
Metadot,ravencrest,1430,priest,discipline,53,24,29
Clæude,tarren-mill,1430,priest,discipline,90,39,51
Lanaineuwu,archimonde,1429,priest,discipline,32,22,10
Willzah,outland,1429,priest,discipline,24,15,9
Hlyhoe,silvermoon,1429,priest,discipline,84,48,36
Chilie,ravencrest,1429,priest,discipline,56,30,26
Shæzè,antonidas,1429,priest,discipline,180,94,86
Pennywïse,kargath,1429,priest,discipline,159,83,76
Lokö,kazzak,1429,priest,discipline,30,15,15
ßrain,garona,1429,priest,discipline,30,15,15
Khâlîa,archimonde,1429,priest,discipline,180,88,92
Vornexp,sporeggar,1429,priest,discipline,92,44,48
Leykop,ravencrest,1429,priest,discipline,48,15,33
Yurrij,thrall,1428,priest,discipline,39,23,16
Navis,burning-blade,1428,priest,discipline,76,43,33
Sunfire,twisting-nether,1428,priest,discipline,53,29,24
Whiskeyhaze,burning-legion,1428,priest,discipline,90,48,42
Æsia,archimonde,1428,priest,discipline,75,39,36
Svevo,ravencrest,1428,priest,discipline,190,96,94
Xypri,nordrassil,1428,priest,discipline,173,87,86
Alshah,emerald-dream,1428,priest,discipline,108,48,60
Artymox,sylvanas,1428,priest,discipline,78,33,45
Nèvertrust,ragnaros,1427,priest,discipline,77,43,34
Amelìa,doomhammer,1427,priest,discipline,112,61,51
Деривация,grom,1427,priest,discipline,218,117,101
Энвиньяттар,howling-fjord,1427,priest,discipline,132,66,66
Azarseth,exodar,1427,priest,discipline,48,24,24
Nietzsche,area-52,1427,priest,discipline,146,72,74
Ylenae,twisting-nether,1427,priest,discipline,42,15,27
Whîs,stormscale,1426,priest,discipline,72,44,28
Joeasaurs,ragnaros,1426,priest,discipline,33,16,17
Angelic,ragnaros,1426,priest,discipline,225,109,116
Ìstarï,sylvanas,1426,priest,discipline,137,66,71
Косн,razuvious,1426,priest,discipline,40,19,21
Mackópriest,ragnaros,1426,priest,discipline,217,101,116
Emala,hyjal,1426,priest,discipline,35,15,20
Luciferase,sylvanas,1425,priest,discipline,24,22,2
Heylmßad,stormscale,1425,priest,discipline,24,17,7
Zickzak,destromath,1425,priest,discipline,70,40,30
Tntbigheal,silvermoon,1425,priest,discipline,91,51,40
Морикаа,lich-king,1425,priest,discipline,42,23,19
Carlye,stormreaver,1425,priest,discipline,120,62,58
Zedrus,azshara,1425,priest,discipline,159,77,82
Jael,frostmane,1425,priest,discipline,62,30,32
Awalneczarem,magtheridon,1425,priest,discipline,36,16,20
Дыффян,gordunni,1424,priest,discipline,54,30,24
Fiilaaja,stormreaver,1424,priest,discipline,132,72,60
Кэндимен,gordunni,1424,priest,discipline,351,180,171
Pumpmenow,drakthul,1424,priest,discipline,102,47,55
Anadyia,aegwynn,1424,priest,discipline,36,16,20
Affalterbach,blackrock,1424,priest,discipline,36,15,21
Extralite,stormscale,1423,priest,discipline,281,148,133
Motoripräst,stormreaver,1423,priest,discipline,50,26,24
Выхилютебя,galakrond,1423,priest,discipline,141,73,68
Aevery,onyxia,1423,priest,discipline,105,51,54
Dizpel,stormscale,1423,priest,discipline,59,24,35
Nswqt,kazzak,1422,priest,discipline,110,68,42
Tech,draenor,1422,priest,discipline,60,35,25
Noreal,twisting-nether,1422,priest,discipline,72,41,31
Хаварь,gordunni,1422,priest,discipline,180,97,83
Nyxalia,silvermoon,1422,priest,discipline,36,19,17
Spèrman,frostwolf,1422,priest,discipline,117,58,59
Adolin,onyxia,1422,priest,discipline,59,29,30
Stevep,tarren-mill,1422,priest,discipline,84,40,44
Pìkachù,stormscale,1422,priest,discipline,60,28,32
Slight,aggra-português,1421,priest,discipline,36,24,12
Ximenia,eredar,1421,priest,discipline,55,35,20
Freeve,outland,1421,priest,discipline,120,69,51
Гомотряс,howling-fjord,1421,priest,discipline,287,161,126
Arlic,silvermoon,1421,priest,discipline,155,85,70
Nattramnone,blackmoore,1421,priest,discipline,156,82,74
Xubeqi,kazzak,1421,priest,discipline,258,135,123
Морисгринх,gordunni,1421,priest,discipline,75,39,36
Ebashuvkashu,stormscale,1421,priest,discipline,116,60,56
Kemari,aegwynn,1421,priest,discipline,30,15,15
Prellish,draenor,1421,priest,discipline,119,59,60
Snuffanious,ragnaros,1421,priest,discipline,131,63,68
Discobrill,silvermoon,1421,priest,discipline,96,43,53
Nudavbrne,drakthul,1420,priest,discipline,53,33,20
Simza,azuremyst,1420,priest,discipline,30,18,12
Зиибак,soulflayer,1420,priest,discipline,80,47,33
Sciophobia,defias-brotherhood,1420,priest,discipline,82,48,34
Vynie,antonidas,1420,priest,discipline,73,38,35
Buerak,tarren-mill,1420,priest,discipline,80,40,40
Rafikii,eredar,1420,priest,discipline,36,17,19
Elnîa,conseil-des-ombres,1420,priest,discipline,110,51,59
Baristolth,archimonde,1420,priest,discipline,108,47,61
Hardbowl,teldrassil,1419,priest,discipline,42,27,15
Agatioxd,dun-modr,1419,priest,discipline,102,57,45
Aiewn,elune,1419,priest,discipline,170,92,78
Хидека,howling-fjord,1419,priest,discipline,101,52,49
Сафири,blackscar,1419,priest,discipline,30,15,15
Joex,arathor,1419,priest,discipline,54,24,30
Holybeef,kirin-tor,1419,priest,discipline,66,24,42
Cooriolis,sylvanas,1418,priest,discipline,41,27,14
Ezcobar,twilights-hammer,1418,priest,discipline,24,15,9
Sphero,kazzak,1418,priest,discipline,106,59,47
Bublies,silvermoon,1418,priest,discipline,85,47,38
Bandäid,ravencrest,1418,priest,discipline,118,64,54
Kayeen,tarren-mill,1418,priest,discipline,273,141,132
Wynkx,zuljin,1418,priest,discipline,170,86,84
Apostas,ragnaros,1418,priest,discipline,30,15,15
Aisha,rajaxx,1418,priest,discipline,135,67,68
Lemontea,frostwolf,1418,priest,discipline,60,29,31
Эйвиг,blackscar,1418,priest,discipline,128,60,68
Arasos,drakthul,1417,priest,discipline,107,72,35
Janclod,pozzo-delleternità,1417,priest,discipline,66,42,24
Rosalina,ravencrest,1417,priest,discipline,371,194,177
Тучанх,greymane,1417,priest,discipline,49,24,25
Dotdeath,ravencrest,1417,priest,discipline,236,115,121
Щещенская,gordunni,1417,priest,discipline,60,29,31
Ovrpwr,stormscale,1417,priest,discipline,46,22,24
Варинган,howling-fjord,1416,priest,discipline,64,37,27
Shilôz,hyjal,1416,priest,discipline,237,123,114
Tellmestory,outland,1416,priest,discipline,66,34,32
Mysticks,kirin-tor,1416,priest,discipline,119,57,62
Luxumbra,quelthalas,1416,priest,discipline,68,31,37
Hazedoktor,twisting-nether,1416,priest,discipline,42,18,24
Zivy,silvermoon,1415,priest,discipline,122,67,55
Mertérésa,hyjal,1415,priest,discipline,67,36,31
Smilyface,sylvanas,1415,priest,discipline,115,57,58
Xdthe,tarren-mill,1415,priest,discipline,234,115,119
Bakony,ravencrest,1414,priest,discipline,60,41,19
Lucéa,antonidas,1414,priest,discipline,44,29,15
Praybro,blackmoore,1414,priest,discipline,41,24,17
Крелмо,gordunni,1414,priest,discipline,73,41,32
Cottyx,outland,1414,priest,discipline,196,109,87
Doctep,sargeras,1414,priest,discipline,100,54,46
Kiieevv,blackrock,1414,priest,discipline,427,219,208
Rachelsz,ravencrest,1414,priest,discipline,78,36,42
Ohnedich,zuljin,1414,priest,discipline,59,27,32
Dragthal,malganis,1414,priest,discipline,86,37,49
Îlkari,hyjal,1413,priest,discipline,35,22,13
Kaeldara,ysondre,1413,priest,discipline,24,15,9
Cöpahue,sanguino,1413,priest,discipline,60,35,25
Symeria,sylvanas,1413,priest,discipline,102,57,45
Priesturz,aggramar,1413,priest,discipline,72,38,34
Apøcalypso,antonidas,1413,priest,discipline,216,108,108
Gabu,dalaran,1413,priest,discipline,161,79,82
Nirsis,dun-modr,1413,priest,discipline,289,141,148
Indicta,darksorrow,1413,priest,discipline,33,16,17
Gæxelademad,draenor,1412,priest,discipline,48,27,21
Maistuu,tarren-mill,1412,priest,discipline,49,27,22
Потёртый,borean-tundra,1412,priest,discipline,48,26,22
Filtro,eredar,1412,priest,discipline,723,364,359
Terstyana,hyjal,1412,priest,discipline,30,15,15
Sarkamer,auchindoun,1412,priest,discipline,69,33,36
Castalia,ravencrest,1412,priest,discipline,101,48,53
Rollpaper,ragnaros,1412,priest,discipline,66,29,37
Hashoko,draenor,1411,priest,discipline,42,29,13
Lúlù,outland,1411,priest,discipline,24,15,9
Slitenprest,kazzak,1411,priest,discipline,89,54,35
Мерседулька,howling-fjord,1411,priest,discipline,76,40,36
Ruderali,blackmoore,1411,priest,discipline,440,225,215
Jandria,sylvanas,1411,priest,discipline,54,27,27
Healywealy,stormrage,1411,priest,discipline,30,15,15
Thesunbeam,silvermoon,1411,priest,discipline,139,67,72
Sannti,twisting-nether,1411,priest,discipline,66,31,35
Aienes,ragnaros,1411,priest,discipline,49,23,26
Vynivan,korgall,1411,priest,discipline,66,30,36
Ziemkentiss,kazzak,1411,priest,discipline,111,50,61
Aliciakeys,twilights-hammer,1411,priest,discipline,58,25,33
Psêro,blackrock,1411,priest,discipline,50,21,29
Sebatröz,ravencrest,1410,priest,discipline,54,30,24
Villagegirlx,stormscale,1410,priest,discipline,42,23,19
Bomzhik,silvermoon,1410,priest,discipline,301,164,137
Faelvirin,aegwynn,1410,priest,discipline,41,21,20
Shanya,thrall,1410,priest,discipline,42,20,22
Undertaken,arathi,1410,priest,discipline,81,37,44
Miliane,twisting-nether,1410,priest,discipline,37,16,21
Гленнис,gordunni,1410,priest,discipline,36,15,21
Èlysium,grim-batol,1410,priest,discipline,60,24,36
Talonjean,conseil-des-ombres,1409,priest,discipline,50,29,21
Бомжскадилом,gordunni,1409,priest,discipline,237,125,112
Юлих,booty-bay,1409,priest,discipline,430,212,218
Vadhänder,the-maelstrom,1409,priest,discipline,66,32,34
Cyran,stormscale,1409,priest,discipline,54,26,28
Sazo,drakthul,1409,priest,discipline,68,32,36
Nordrenalin,tarren-mill,1409,priest,discipline,36,15,21
Пакетикдот,gordunni,1408,priest,discipline,297,163,134
Асади,gordunni,1408,priest,discipline,160,87,73
Tony,agamaggan,1408,priest,discipline,107,55,52
Æisa,blackmoore,1408,priest,discipline,361,185,176
Illüminaty,sylvanas,1408,priest,discipline,135,69,66
Ashbee,drakthul,1408,priest,discipline,30,15,15
Knøw,ravencrest,1408,priest,discipline,141,69,72
Давалкасвета,gordunni,1408,priest,discipline,92,44,48
Nextvbestapp,ravencrest,1408,priest,discipline,142,62,80
Xyal,outland,1407,priest,discipline,36,20,16
Korzec,dun-modr,1407,priest,discipline,114,60,54
Baybe,ravencrest,1407,priest,discipline,272,139,133
Дядяврач,howling-fjord,1407,priest,discipline,224,112,112
Nyah,dun-modr,1407,priest,discipline,48,22,26
Solaqt,tarren-mill,1407,priest,discipline,60,23,37
Gidy,blackmoore,1406,priest,discipline,25,17,8
Outcast,korgall,1406,priest,discipline,107,59,48
Diszis,antonidas,1406,priest,discipline,42,23,19
Valythria,blackhand,1406,priest,discipline,201,103,98
Drumont,kelthuzad,1406,priest,discipline,48,24,24
Imda,ravencrest,1406,priest,discipline,188,93,95
Miris,ysondre,1406,priest,discipline,72,32,40
Saucebauss,ravencrest,1406,priest,discipline,48,20,28
Henaë,archimonde,1405,priest,discipline,48,27,21
Фионыч,blackscar,1405,priest,discipline,36,20,16
Perdítá,thrall,1405,priest,discipline,473,247,226
Menjo,silvermoon,1405,priest,discipline,72,37,35
Нэилшери,gordunni,1405,priest,discipline,132,67,65
Grezzy,eredar,1405,priest,discipline,36,16,20
Holysquirt,twisting-nether,1405,priest,discipline,42,18,24
Strygah,die-nachtwache,1405,priest,discipline,59,25,34
Snusprällen,sylvanas,1405,priest,discipline,89,36,53
Ремкомплект,soulflayer,1404,priest,discipline,90,54,36
Discönnect,kazzak,1404,priest,discipline,30,18,12
Medivs,blackmoore,1404,priest,discipline,42,22,20
Holymøly,earthen-ring,1404,priest,discipline,93,46,47
Adägïo,dun-modr,1404,priest,discipline,105,51,54
Giily,archimonde,1404,priest,discipline,103,45,58
Yuki,trollbane,1403,priest,discipline,49,28,21
Злюкыч,gordunni,1403,priest,discipline,147,82,65
Veltrag,sanguino,1403,priest,discipline,68,37,31
Vaewyn,ravencrest,1403,priest,discipline,85,46,39
Kenzaiq,aegwynn,1403,priest,discipline,94,50,44
Nikotyna,doomhammer,1403,priest,discipline,191,97,94
Änf,silvermoon,1403,priest,discipline,144,71,73
Ylvanna,arthas,1403,priest,discipline,306,148,158
Аферона,soulflayer,1403,priest,discipline,111,50,61
Derathon,eredar,1402,priest,discipline,48,31,17
Feriant,argent-dawn,1402,priest,discipline,71,45,26
Eileengu,silvermoon,1402,priest,discipline,70,42,28
Amambo,chamber-of-aspects,1402,priest,discipline,96,56,40
Vaetrilla,doomhammer,1402,priest,discipline,79,40,39
Laadyybirkee,blackhand,1402,priest,discipline,182,91,91
Элизабетшорт,soulflayer,1402,priest,discipline,201,100,101
Kbakå,kazzak,1402,priest,discipline,32,15,17
Kätsulol,ysondre,1402,priest,discipline,77,36,41
Johnblack,dun-morogh,1402,priest,discipline,54,25,29
Immutable,twisting-nether,1402,priest,discipline,55,24,31
Kildöre,hyjal,1401,priest,discipline,24,16,8
Shoker,ravencrest,1401,priest,discipline,24,15,9
Chuckbarry,kazzak,1401,priest,discipline,42,24,18
Paine,pozzo-delleternità,1401,priest,discipline,104,58,46
Earnzy,outland,1401,priest,discipline,101,56,45
Ciordel,draenor,1401,priest,discipline,101,53,48
Lunegrise,archimonde,1401,priest,discipline,88,44,44
Miabelle,argent-dawn,1401,priest,discipline,64,32,32
Dysko,alakir,1401,priest,discipline,30,15,15
Idontknow,sanguino,1401,priest,discipline,61,28,33
Glärë,burning-legion,1400,priest,discipline,123,76,47
Phèbz,archimonde,1400,priest,discipline,60,36,24
Táliss,arthas,1400,priest,discipline,30,17,13
Ichpvpeuch,eredar,1400,priest,discipline,79,42,37
Veecna,the-maelstrom,1400,priest,discipline,192,102,90
Epifis,silvermoon,1400,priest,discipline,480,250,230
Lalgorithme,hyjal,1400,priest,discipline,54,28,26
Maeline,archimonde,1400,priest,discipline,252,127,125
Flyingdutch,tarren-mill,1400,priest,discipline,320,161,159
Xyfas,azshara,1400,priest,discipline,96,48,48
Healvendor,darkmoon-faire,1400,priest,discipline,52,24,28
Darkest,ysondre,1400,priest,discipline,95,43,52
Вурти,howling-fjord,1400,priest,discipline,65,28,37
Freshpope,ravencrest,1399,priest,discipline,113,66,47
Mindcrackr,stormscale,1399,priest,discipline,54,30,24
Pestaso,shendralar,1399,priest,discipline,102,56,46
Barracuda,burning-legion,1399,priest,discipline,197,103,94
Vocolieth,argent-dawn,1399,priest,discipline,105,53,52
Забейка,howling-fjord,1399,priest,discipline,60,30,30
Werita,frostmane,1399,priest,discipline,269,134,135
Сайларс,howling-fjord,1399,priest,discipline,126,61,65
Labella,tarren-mill,1398,priest,discipline,28,16,12
Fimor,die-nachtwache,1398,priest,discipline,207,115,92
Gothixs,draenor,1398,priest,discipline,100,55,45
Ahree,sargeras,1398,priest,discipline,363,183,180
Stilnðx,nemesis,1398,priest,discipline,161,80,81
Hidary,ysondre,1398,priest,discipline,85,40,45
Hiereia,khadgar,1398,priest,discipline,211,99,112
Llamamepadre,dun-modr,1398,priest,discipline,95,44,51
Guerilagusto,draenor,1398,priest,discipline,72,33,39
Veilon,defias-brotherhood,1398,priest,discipline,165,74,91
Azèm,archimonde,1398,priest,discipline,63,20,43
Tyrhaa,blackmoore,1397,priest,discipline,42,22,20
Gotikaa,blackrock,1397,priest,discipline,174,85,89
Yunggoth,eredar,1397,priest,discipline,50,24,26
Killerkende,ragnaros,1396,priest,discipline,122,66,56
Vrynna,kazzak,1396,priest,discipline,156,83,73
Hellscon,kazzak,1396,priest,discipline,48,24,24
Зонкк,thermaplugg,1396,priest,discipline,284,136,148
Rixis,la-croisade-écarlate,1396,priest,discipline,72,32,40
Rokocrazy,aggra-português,1396,priest,discipline,41,18,23
Nayro,blackrock,1396,priest,discipline,48,19,29
Dionegativ,draenor,1396,priest,discipline,66,24,42
Calisé,argent-dawn,1395,priest,discipline,24,15,9
Sâmba,pozzo-delleternità,1395,priest,discipline,24,15,9
Германий,deathguard,1395,priest,discipline,59,36,23
Sytrix,frostwolf,1395,priest,discipline,139,79,60
Iluras,thunderhorn,1395,priest,discipline,55,29,26
Reeta,stormscale,1395,priest,discipline,79,40,39
Jaheim,tarren-mill,1395,priest,discipline,170,85,85
Celestias,sanguino,1395,priest,discipline,39,16,23
Plsenjoygame,kazzak,1394,priest,discipline,56,31,25
Pixr,defias-brotherhood,1394,priest,discipline,30,15,15
Taxprayer,blackmoore,1393,priest,discipline,24,15,9
Drxz,twilights-hammer,1393,priest,discipline,58,30,28
Emon,nemesis,1393,priest,discipline,96,49,47
Littleheal,ghostlands,1393,priest,discipline,49,24,25
Chankilolx,dun-modr,1393,priest,discipline,205,94,111
Сегуната,howling-fjord,1393,priest,discipline,48,19,29
Borrex,sanguino,1392,priest,discipline,61,38,23
Bolflo,khaz-modan,1392,priest,discipline,147,79,68
Холигард,grom,1392,priest,discipline,78,40,38
Adev,drakthul,1392,priest,discipline,83,42,41
Codeincindy,blackhand,1392,priest,discipline,206,102,104
Redlight,ysondre,1392,priest,discipline,36,15,21
Neftul,blackrock,1392,priest,discipline,89,33,56
Salyisra,draenor,1391,priest,discipline,137,71,66
Exila,rashgarroth,1391,priest,discipline,37,18,19
Evolís,blackmoore,1391,priest,discipline,102,49,53
Animepfp,stormreaver,1391,priest,discipline,140,67,73
Trasslarn,tarren-mill,1391,priest,discipline,107,51,56
Vierforvier,aegwynn,1391,priest,discipline,132,61,71
Смайтвайфу,howling-fjord,1391,priest,discipline,90,41,49
Иннрей,soulflayer,1391,priest,discipline,42,19,23
Celina,quelthalas,1391,priest,discipline,60,25,35
Штецель,howling-fjord,1391,priest,discipline,44,17,27
Voltáren,blackmoore,1390,priest,discipline,56,35,21
Kojee,blackrock,1390,priest,discipline,96,44,52
Tirendor,burning-legion,1390,priest,discipline,60,27,33
Blagovesta,ravencrest,1390,priest,discipline,75,32,43
Zombîe,draenor,1390,priest,discipline,42,16,26
Salzgehalt,antonidas,1389,priest,discipline,176,98,78
Dreampriest,frostmane,1389,priest,discipline,31,17,14
Pàndoràh,nemesis,1389,priest,discipline,78,38,40
Tarana,mannoroth,1389,priest,discipline,38,18,20
Vexxdd,outland,1389,priest,discipline,78,36,42
Hôlyharald,blackrock,1389,priest,discipline,44,19,25
Clodet,dun-modr,1389,priest,discipline,67,26,41
Aaron,aegwynn,1388,priest,discipline,31,20,11
Kâmy,archimonde,1388,priest,discipline,120,65,55
Hidr,nemesis,1387,priest,discipline,108,58,50
Scodây,blackmoore,1387,priest,discipline,331,171,160
Rahan,stormscale,1387,priest,discipline,149,73,76
Anzil,dun-modr,1387,priest,discipline,176,82,94
Eviscerätor,draenor,1387,priest,discipline,33,15,18
Xarxis,twisting-nether,1387,priest,discipline,76,30,46
Captnawesome,blackrock,1386,priest,discipline,60,34,26
Lothyf,archimonde,1386,priest,discipline,87,48,39
Gothandor,der-rat-von-dalaran,1386,priest,discipline,90,48,42
Cheja,ravencrest,1386,priest,discipline,198,103,95
Альфреска,gordunni,1386,priest,discipline,94,48,46
Созвонимся,gordunni,1386,priest,discipline,121,61,60
Kalestharia,blackmoore,1386,priest,discipline,305,146,159
Pyropenance,twisting-nether,1386,priest,discipline,83,35,48
Kyri,stormscale,1385,priest,discipline,258,140,118
Matsipri,sylvanas,1385,priest,discipline,155,82,73
Dooga,draenor,1385,priest,discipline,48,25,23
Munchies,scarshield-legion,1385,priest,discipline,54,28,26
Stambuff,ragnaros,1385,priest,discipline,36,18,18
Lighttorch,burning-legion,1385,priest,discipline,52,24,28
Tosspot,ragnaros,1385,priest,discipline,37,17,20
Pinkyladdy,argent-dawn,1385,priest,discipline,95,42,53
Physical,jaedenar,1385,priest,discipline,71,31,40
Céph,sylvanas,1385,priest,discipline,66,28,38
Sehek,sanguino,1385,priest,discipline,96,39,57
Barcodes,kazzak,1384,priest,discipline,175,91,84
Köftemcc,blackrock,1384,priest,discipline,47,24,23
Luznywiesiek,burning-legion,1384,priest,discipline,134,67,67
Æøí,blackmoore,1384,priest,discipline,55,26,29
Nakrga,twisting-nether,1384,priest,discipline,53,25,28
Dragovic,chogall,1384,priest,discipline,86,40,46
Gegzlol,twisting-nether,1384,priest,discipline,41,17,24
Ромиопвп,gordunni,1384,priest,discipline,75,28,47
Pristerline,antonidas,1383,priest,discipline,67,35,32
Cutename,burning-blade,1383,priest,discipline,54,28,26
Rodshun,dun-modr,1383,priest,discipline,164,81,83
Benificent,argent-dawn,1383,priest,discipline,267,131,136
Fetmeister,drakthul,1383,priest,discipline,90,42,48
Synteria,gilneas,1383,priest,discipline,163,73,90
Ykiotonegawa,twisting-nether,1383,priest,discipline,189,79,110
Docpower,twisting-nether,1383,priest,discipline,66,27,39
Predpriest,twisting-nether,1383,priest,discipline,43,16,27
Cupola,ravencrest,1383,priest,discipline,42,15,27
Juuco,draenor,1382,priest,discipline,31,18,13
Froboz,the-venture-co,1382,priest,discipline,31,17,14
Voidtrix,blackrock,1382,priest,discipline,274,149,125
Батлграунтт,soulflayer,1382,priest,discipline,288,150,138
Manuba,antonidas,1382,priest,discipline,63,32,31
Dyliz,stormscale,1382,priest,discipline,491,248,243
Radizzel,tichondrius,1382,priest,discipline,46,20,26
Tinteolo,blackrock,1382,priest,discipline,81,35,46
Talyie,argent-dawn,1381,priest,discipline,27,18,9
Nicetomeatu,darksorrow,1381,priest,discipline,66,40,26
Oikus,minahonda,1381,priest,discipline,66,36,30
Lekadolplusc,doomhammer,1381,priest,discipline,420,222,198
Некроликон,grom,1381,priest,discipline,145,75,70
Cryksî,blackhand,1381,priest,discipline,126,61,65
Dejica,kult-der-verdammten,1381,priest,discipline,108,48,60
Dibelo,eredar,1381,priest,discipline,47,20,27
Dosentti,ragnaros,1380,priest,discipline,54,33,21
Keppas,doomhammer,1380,priest,discipline,103,57,46
Bekareth,archimonde,1380,priest,discipline,139,74,65
Psyfir,outland,1380,priest,discipline,260,135,125
Летиин,gordunni,1380,priest,discipline,123,59,64
Priesterious,blackrock,1380,priest,discipline,36,16,20
Эстрогенс,gordunni,1380,priest,discipline,66,25,41
Evølét,kazzak,1379,priest,discipline,45,26,19
Deathchicka,draenor,1379,priest,discipline,94,50,44
Shãdowlãght,antonidas,1379,priest,discipline,113,60,53
Sneed,moonglade,1379,priest,discipline,102,47,55
Paulinka,auchindoun,1379,priest,discipline,114,51,63
Птист,azuregos,1379,priest,discipline,54,20,34
Tripsdrill,blackmoore,1378,priest,discipline,57,40,17
Ehrmantràut,draenor,1378,priest,discipline,71,42,29
Apeist,outland,1378,priest,discipline,146,77,69
Амбракадабра,blackscar,1378,priest,discipline,102,53,49
Медиив,deepholm,1378,priest,discipline,180,88,92
Scarecrøw,frostwolf,1378,priest,discipline,96,46,50
Imhotép,anubarak,1378,priest,discipline,94,45,49
Убийцаорчат,lich-king,1378,priest,discipline,36,16,20
Теньраа,soulflayer,1378,priest,discipline,84,34,50
Resheff,thrall,1377,priest,discipline,85,52,33
Pwjetlifelol,grim-batol,1377,priest,discipline,179,94,85
Chocopríest,blackmoore,1377,priest,discipline,129,67,62
Гандболист,soulflayer,1377,priest,discipline,66,33,33
Haffination,frostmane,1377,priest,discipline,33,16,17
Vædan,drakthul,1376,priest,discipline,36,20,16
Азотод,gordunni,1376,priest,discipline,187,100,87
Eksel,silvermoon,1376,priest,discipline,155,80,75
Litera,silvermoon,1376,priest,discipline,104,48,56
Höfi,ragnaros,1376,priest,discipline,146,66,80
Brobert,nerathor,1376,priest,discipline,54,22,32
Ryzaria,thrall,1376,priest,discipline,66,26,40
Jerichó,blackmoore,1375,priest,discipline,76,48,28
Dolifrius,dalaran,1375,priest,discipline,50,30,20
Zzero,kazzak,1375,priest,discipline,73,40,33
Ompala,shattered-hand,1375,priest,discipline,43,23,20
Devot,outland,1375,priest,discipline,156,79,77
Skardumi,blackmoore,1375,priest,discipline,100,50,50
Wish,blackmoore,1375,priest,discipline,212,104,108
Thehealer,twisting-nether,1375,priest,discipline,84,40,44
Aperture,kelthuzad,1375,priest,discipline,54,23,31
Ментэс,gordunni,1374,priest,discipline,66,41,25
Ùçù,dalaran,1374,priest,discipline,94,51,43
Таяш,soulflayer,1374,priest,discipline,249,134,115
Qïx,ravencrest,1374,priest,discipline,45,24,21
Challengepro,burning-legion,1374,priest,discipline,30,16,14
Летириен,gordunni,1374,priest,discipline,54,28,26
Absórb,quelthalas,1374,priest,discipline,66,31,35
Otheym,the-maelstrom,1374,priest,discipline,39,18,21
Rhin,zuljin,1374,priest,discipline,42,16,26
Санёквиртуоз,soulflayer,1374,priest,discipline,42,16,26
Pocketissue,ravencrest,1373,priest,discipline,32,21,11
Wortgottes,blackrock,1373,priest,discipline,70,41,29
Трэй,deathguard,1373,priest,discipline,223,112,111
Calani,zirkel-des-cenarius,1373,priest,discipline,36,17,19
Valforexd,ravencrest,1373,priest,discipline,82,35,47
Iqr,blackmoore,1373,priest,discipline,72,30,42
Knikkerbaas,outland,1372,priest,discipline,30,26,4
Infínite,emeriss,1372,priest,discipline,154,82,72
Peacke,ravencrest,1372,priest,discipline,72,38,34
Majinme,kazzak,1372,priest,discipline,60,31,29
Rabbît,stormscale,1372,priest,discipline,82,42,40
Brickles,thrall,1372,priest,discipline,98,50,48
Alexnator,malganis,1372,priest,discipline,96,48,48
Ahbe,stormscale,1372,priest,discipline,87,43,44
Híppokrates,dethecus,1372,priest,discipline,119,55,64
Aytem,blackhand,1371,priest,discipline,29,20,9
Bilgecan,silvermoon,1371,priest,discipline,61,39,22
Xodze,outland,1371,priest,discipline,72,45,27
Qulpri,blackmoore,1371,priest,discipline,49,25,24
Jenelle,thrall,1371,priest,discipline,48,21,27
Skarn,blackmoore,1370,priest,discipline,77,51,26
Darkheall,sanguino,1370,priest,discipline,125,63,62
Ventorina,die-aldor,1370,priest,discipline,80,40,40
Mamaoh,ravencrest,1370,priest,discipline,81,40,41
Cronershadow,stormscale,1370,priest,discipline,63,31,32
Grímes,draenor,1370,priest,discipline,123,60,63
Fireflowers,silvermoon,1370,priest,discipline,132,64,68
Glimpseofus,ragnaros,1370,priest,discipline,84,35,49
Nûwa,draenor,1369,priest,discipline,83,48,35
Svartylol,outland,1369,priest,discipline,112,64,48
Sayek,shendralar,1369,priest,discipline,48,27,21
Yukîna,eredar,1369,priest,discipline,103,53,50
Micobra,dalaran,1369,priest,discipline,76,39,37
Aroghul,eredar,1369,priest,discipline,186,92,94
Ikaa,wrathbringer,1369,priest,discipline,51,25,26
Скумизарг,gordunni,1369,priest,discipline,42,20,22
Psychîc,twisting-nether,1368,priest,discipline,52,33,19
Csimpacsento,ragnaros,1368,priest,discipline,42,24,18
Tigrok,burning-legion,1368,priest,discipline,166,88,78
Tylorswift,ravencrest,1368,priest,discipline,54,27,27
Hugerage,stormreaver,1368,priest,discipline,166,76,90
Elyradp,dun-modr,1367,priest,discipline,132,75,57
Lunatrix,sanguino,1367,priest,discipline,48,24,24
Nirvs,kazzak,1367,priest,discipline,42,21,21
Freaki,blackrock,1367,priest,discipline,78,37,41
Speltmor,stormscale,1367,priest,discipline,42,18,24
Høiy,antonidas,1366,priest,discipline,26,16,10
Nashára,defias-brotherhood,1366,priest,discipline,232,119,113
Violentha,silvermoon,1366,priest,discipline,42,21,21
Sprutch,kazzak,1366,priest,discipline,93,46,47
Compact,blackrock,1366,priest,discipline,102,48,54
Valtalor,ragnaros,1366,priest,discipline,41,18,23
Erupyks,archimonde,1366,priest,discipline,103,45,58
Unerfedsp,archimonde,1366,priest,discipline,77,32,45
Gibbons,chogall,1366,priest,discipline,78,32,46
Saikoo,stormscale,1365,priest,discipline,48,27,21
Yinyangyø,eredar,1365,priest,discipline,72,37,35
Vipimp,blackrock,1365,priest,discipline,429,215,214
Shadowgeek,sylvanas,1365,priest,discipline,58,29,29
Kaémon,twisting-nether,1365,priest,discipline,298,144,154
Siliçia,aegwynn,1365,priest,discipline,54,25,29
Calah,frostwhisper,1365,priest,discipline,48,20,28
Pl,sunstrider,1364,priest,discipline,84,46,38
Джиннекс,gordunni,1364,priest,discipline,212,112,100
Elûnä,ysondre,1364,priest,discipline,340,179,161
Carcaz,blackmoore,1364,priest,discipline,59,27,32
Nejgr,tarren-mill,1364,priest,discipline,116,53,63
Vatizinium,veklor,1364,priest,discipline,34,15,19
Lysium,sylvanas,1364,priest,discipline,48,20,28
Dtgs,grim-batol,1364,priest,discipline,56,21,35
Deshaz,tarren-mill,1363,priest,discipline,153,78,75
Durness,argent-dawn,1363,priest,discipline,84,42,42
Joxdox,archimonde,1363,priest,discipline,96,46,50
Trekztwo,archimonde,1363,priest,discipline,84,39,45
Lezz,ragnaros,1363,priest,discipline,54,24,30
Momomomomomo,blackrock,1363,priest,discipline,74,32,42
Drêäms,archimonde,1362,priest,discipline,46,27,19
ßowforme,aegwynn,1362,priest,discipline,96,50,46
Lehava,archimonde,1362,priest,discipline,50,26,24
Hekro,thrall,1362,priest,discipline,118,61,57
Pvpriestess,silvermoon,1362,priest,discipline,322,162,160
Elreâ,blackrock,1362,priest,discipline,36,18,18
Jordí,darkspear,1362,priest,discipline,245,120,125
Sppid,sanguino,1362,priest,discipline,356,171,185
Joniop,stormreaver,1362,priest,discipline,72,33,39
Dzoo,kazzak,1362,priest,discipline,70,30,40
Bjornqt,ragnaros,1362,priest,discipline,86,35,51
Creepa,area-52,1361,priest,discipline,30,18,12
Лифик,blackscar,1361,priest,discipline,53,30,23
Уноханагодх,howling-fjord,1361,priest,discipline,98,48,50
Dstars,archimonde,1361,priest,discipline,88,40,48
Подорваный,gordunni,1361,priest,discipline,60,26,34
Imbadancer,turalyon,1360,priest,discipline,137,78,59
Aeternethy,ravencrest,1360,priest,discipline,209,104,105
Thrakoun,twilights-hammer,1360,priest,discipline,356,176,180
Celrin,chamber-of-aspects,1359,priest,discipline,24,17,7
Naïlu,hyjal,1359,priest,discipline,72,40,32
Pètunia,ravencrest,1359,priest,discipline,409,211,198
Paars,outland,1359,priest,discipline,36,16,20
Mxcey,ravencrest,1359,priest,discipline,36,15,21
Ÿë,stormreaver,1359,priest,discipline,37,15,22
Aykò,blackmoore,1359,priest,discipline,56,20,36
Várósh,blackmoore,1358,priest,discipline,93,50,43
Valeriana,stormreaver,1358,priest,discipline,239,123,116
Shidori,dalaran,1358,priest,discipline,96,49,47
Olereo,blackhand,1358,priest,discipline,228,115,113
Ryazz,blackrock,1358,priest,discipline,78,33,45
Priesless,sylvanas,1357,priest,discipline,34,20,14
Sasabsi,malorne,1357,priest,discipline,60,33,27
Bösenboris,aegwynn,1357,priest,discipline,119,63,56
Вегельдэрс,gordunni,1357,priest,discipline,66,30,36
Esüna,ysondre,1356,priest,discipline,48,26,22
Healeurway,dalaran,1356,priest,discipline,373,196,177
Assyrïa,ravencrest,1356,priest,discipline,48,25,23
Sabaxdxd,dun-modr,1356,priest,discipline,254,126,128
Byxoph,sanguino,1356,priest,discipline,113,56,57
Весенняя,gordunni,1356,priest,discipline,117,57,60
Dànè,defias-brotherhood,1355,priest,discipline,30,21,9
Cntrl,frostmane,1355,priest,discipline,179,95,84
Aquillon,outland,1355,priest,discipline,36,17,19
Tryingtomc,archimonde,1355,priest,discipline,46,21,25
Goodwin,draenor,1355,priest,discipline,125,57,68
Dìsc,ravencrest,1355,priest,discipline,107,48,59
Juliane,trollbane,1355,priest,discipline,147,63,84
Paterpaisios,kazzak,1355,priest,discipline,54,20,34
Shawfour,ravencrest,1354,priest,discipline,24,15,9
Akadras,blackmoore,1354,priest,discipline,51,31,20
Aemi,draenor,1354,priest,discipline,30,18,12
Makariotatos,xavius,1354,priest,discipline,76,42,34
Lèviåthån,stormscale,1354,priest,discipline,94,32,62
Hydrôlic,blackrock,1353,priest,discipline,48,31,17
Shadowzen,darkspear,1353,priest,discipline,79,45,34
Therezzer,burning-legion,1353,priest,discipline,66,36,30
Lévention,stormscale,1353,priest,discipline,46,24,22
Teyranamin,defias-brotherhood,1353,priest,discipline,67,34,33
Radegast,jaedenar,1353,priest,discipline,312,149,163
Nøheall,ysondre,1353,priest,discipline,174,79,95
Solarïah,garona,1352,priest,discipline,32,19,13
Noibe,chogall,1352,priest,discipline,30,16,14
Chaosweavèr,outland,1352,priest,discipline,60,28,32
Allotment,silvermoon,1351,priest,discipline,90,50,40
Мариона,gordunni,1351,priest,discipline,48,26,22
Darkweed,twilights-hammer,1351,priest,discipline,195,104,91
Widöw,cthun,1351,priest,discipline,126,62,64
Shîn,aegwynn,1351,priest,discipline,90,44,46
Cyberlunatic,antonidas,1351,priest,discipline,256,115,141
Frekio,eitrigg,1350,priest,discipline,248,123,125
Рискаль,borean-tundra,1350,priest,discipline,218,108,110
Орбит,blackscar,1350,priest,discipline,251,118,133
Nyxara,outland,1350,priest,discipline,69,31,38
Sytawa,blackmoore,1349,priest,discipline,104,55,49
Иварэкзарх,gordunni,1349,priest,discipline,82,41,41
Anubisones,uldum,1349,priest,discipline,89,43,46
Noncuro,tarren-mill,1349,priest,discipline,42,20,22
Khalphus,argent-dawn,1349,priest,discipline,70,32,38
Farleys,draenor,1349,priest,discipline,59,26,33
Nogsn,kazzak,1349,priest,discipline,42,16,26
Roqueforty,draenor,1348,priest,discipline,72,38,34
Obeliskprist,kazzak,1348,priest,discipline,212,111,101
Conzequ,kazzak,1348,priest,discipline,62,29,33
Крашдайс,soulflayer,1348,priest,discipline,115,53,62
Jazty,sanguino,1348,priest,discipline,42,19,23
Nerre,ravencrest,1348,priest,discipline,41,15,26
Ezpritt,burning-legion,1347,priest,discipline,22,15,7
Anotherlife,stormscale,1347,priest,discipline,24,15,9
Nabira,pozzo-delleternità,1347,priest,discipline,67,40,27
Holyguys,twisting-nether,1347,priest,discipline,190,97,93
Dirtydoc,area-52,1347,priest,discipline,138,70,68
Adrodda,kazzak,1347,priest,discipline,89,42,47
Yazh,argent-dawn,1347,priest,discipline,77,32,45
Blasfemo,nemesis,1346,priest,discipline,87,43,44
Enduring,darksorrow,1346,priest,discipline,138,65,73
Тлэц,gordunni,1346,priest,discipline,164,75,89
Bogiunia,burning-legion,1346,priest,discipline,60,24,36
Waru,argent-dawn,1346,priest,discipline,88,35,53
Bacberon,skullcrusher,1345,priest,discipline,102,56,46
Söultaker,ravencrest,1345,priest,discipline,75,41,34
Nynren,doomhammer,1345,priest,discipline,369,197,172
Spoc,blackrock,1345,priest,discipline,155,82,73
Gøðlìke,aegwynn,1345,priest,discipline,299,149,150
Senorvåc,ravencrest,1345,priest,discipline,388,193,195
Hauntzer,veknilash,1345,priest,discipline,101,44,57
Ratapain,argent-dawn,1344,priest,discipline,18,14,4
Hugeaf,antonidas,1344,priest,discipline,43,27,16
Rzpa,blackhand,1344,priest,discipline,142,72,70
Carrhyks,archimonde,1344,priest,discipline,174,87,87
Soed,defias-brotherhood,1344,priest,discipline,36,17,19
Putinkuilo,outland,1344,priest,discipline,65,30,35
Удзумукец,howling-fjord,1344,priest,discipline,124,57,67
Monstretpr,dragonblight,1344,priest,discipline,104,43,61
Чупатаявошь,soulflayer,1343,priest,discipline,120,70,50
Nëw,los-errantes,1343,priest,discipline,24,14,10
Asýnc,ravencrest,1343,priest,discipline,24,14,10
Freepriest,darksorrow,1343,priest,discipline,69,33,36
Ранзерот,soulflayer,1343,priest,discipline,30,14,16
Capheny,ravencrest,1343,priest,discipline,68,29,39
Swpain,argent-dawn,1342,priest,discipline,18,14,4
Capricê,aegwynn,1342,priest,discipline,18,14,4
Лайхтни,howling-fjord,1342,priest,discipline,24,14,10
Adeeva,ravencrest,1342,priest,discipline,105,60,45
Dtqs,grim-batol,1342,priest,discipline,42,24,18
Ultimécya,eldrethalas,1342,priest,discipline,30,17,13
Mädmän,draenor,1342,priest,discipline,219,121,98
Xyrël,blackrock,1342,priest,discipline,36,19,17
Amanojaku,archimonde,1342,priest,discipline,70,36,34
Holydörte,aegwynn,1342,priest,discipline,558,283,275
Amädeuss,tarren-mill,1342,priest,discipline,84,42,42
Holypepper,outland,1342,priest,discipline,173,85,88
Bakër,dalaran,1342,priest,discipline,75,36,39
Keltalador,zuljin,1342,priest,discipline,65,31,34
Карбонит,gordunni,1342,priest,discipline,30,14,16
Terakes,kiljaeden,1342,priest,discipline,30,14,16
Hans,thrall,1342,priest,discipline,66,30,36
Disconsick,vashj,1342,priest,discipline,239,106,133
Aeternuz,tarren-mill,1342,priest,discipline,91,39,52
Svetozarov,wildhammer,1341,priest,discipline,24,14,10
Fùkøff,stormscale,1341,priest,discipline,62,36,26
Manî,quelthalas,1341,priest,discipline,54,28,26
Faol,the-venture-co,1341,priest,discipline,54,27,27
Arthyria,archimonde,1341,priest,discipline,90,44,46
Spankulere,stormscale,1341,priest,discipline,54,26,28
Maiel,die-aldor,1341,priest,discipline,50,24,26
Сендрагон,blackscar,1340,priest,discipline,72,41,31
Nirvánabang,sylvanas,1340,priest,discipline,60,30,30
Neoni,blackmoore,1340,priest,discipline,381,187,194
Flagman,silvermoon,1340,priest,discipline,52,25,27
Vírtue,draenor,1339,priest,discipline,42,25,17
Moisboi,blackrock,1339,priest,discipline,24,14,10
Nuloa,ravencrest,1339,priest,discipline,78,45,33
Drioz,ysondre,1339,priest,discipline,183,102,81
Darkoze,kazzak,1339,priest,discipline,84,41,43
Tabbed,kazzak,1338,priest,discipline,24,16,8
Nuvie,ravencrest,1338,priest,discipline,96,51,45
Cárith,nemesis,1338,priest,discipline,82,43,39
Reynze,silvermoon,1338,priest,discipline,48,25,23
Zellia,frostmane,1338,priest,discipline,155,74,81
Râây,blackrock,1338,priest,discipline,30,14,16
Mungam,draenor,1338,priest,discipline,128,57,71
Torî,blackrock,1338,priest,discipline,102,43,59
Næsty,haomarush,1338,priest,discipline,36,15,21
Меесть,soulflayer,1338,priest,discipline,77,30,47
Têmplârx,stormscale,1338,priest,discipline,36,14,22
Lucidz,ravencrest,1338,priest,discipline,40,15,25
Дошутилась,gordunni,1338,priest,discipline,42,14,28
Parishealtón,ragnaros,1337,priest,discipline,54,32,22
Døtgdx,archimonde,1337,priest,discipline,24,14,10
Tumlaa,ravencrest,1337,priest,discipline,56,31,25
Mércíless,ravencrest,1337,priest,discipline,112,58,54
Akril,silvermoon,1337,priest,discipline,222,113,109
Taksí,tarren-mill,1337,priest,discipline,127,64,63
Stolpiller,lightbringer,1337,priest,discipline,30,15,15
Vendormeq,darkspear,1337,priest,discipline,133,64,69
Kitanai,silvermoon,1337,priest,discipline,73,35,38
Vrazorth,archimonde,1337,priest,discipline,60,28,32
Monin,kazzak,1337,priest,discipline,30,14,16
Varrês,kazzak,1337,priest,discipline,160,72,88
Dfourc,blackhand,1337,priest,discipline,42,18,24
Tezqt,ravencrest,1336,priest,discipline,24,14,10
Sariss,ravencrest,1336,priest,discipline,24,14,10
Nylee,stormscale,1336,priest,discipline,65,33,32
Ufos,stormscale,1336,priest,discipline,110,52,58
Mewdi,outland,1336,priest,discipline,30,14,16
Junglepriest,ravencrest,1336,priest,discipline,36,15,21
Lish,dun-modr,1335,priest,discipline,24,15,9
Sophoula,silvermoon,1335,priest,discipline,70,36,34
Quetraxz,chogall,1335,priest,discipline,66,31,35
Fótmheroqtx,ravencrest,1335,priest,discipline,30,14,16
Héinékén,ravencrest,1335,priest,discipline,216,96,120
Luthsha,sylvanas,1334,priest,discipline,32,17,15
Phoskitos,sanguino,1334,priest,discipline,52,27,25
Мегакастиэль,gordunni,1334,priest,discipline,136,68,68
Convulsiveq,silvermoon,1334,priest,discipline,317,156,161
Streety,nethersturm,1334,priest,discipline,185,90,95
Proféssor,ravencrest,1334,priest,discipline,98,47,51
Exorcitador,shendralar,1334,priest,discipline,88,37,51
Samerika,tarren-mill,1334,priest,discipline,72,28,44
Felanris,blackmoore,1333,priest,discipline,60,40,20
Ремидемс,howling-fjord,1333,priest,discipline,24,15,9
Xyret,blackmoore,1333,priest,discipline,37,23,14
Курумничек,gordunni,1333,priest,discipline,65,40,25
Noneedpriest,stormscale,1333,priest,discipline,24,14,10
Memoniia,ravencrest,1333,priest,discipline,48,27,21
Råin,draenor,1333,priest,discipline,33,18,15
Psychoboris,outland,1333,priest,discipline,169,91,78
Makimaqt,ravencrest,1333,priest,discipline,108,52,56
Tgarden,frostwhisper,1333,priest,discipline,109,52,57
Yorap,blackrock,1333,priest,discipline,86,39,47
Atremius,dragonmaw,1333,priest,discipline,84,37,47
Sardine,ravencrest,1333,priest,discipline,36,14,22
Radiance,emeriss,1333,priest,discipline,40,15,25
Fabs,laughing-skull,1332,priest,discipline,28,17,11
Buszeekk,outland,1332,priest,discipline,52,28,24
Орклекарь,soulflayer,1332,priest,discipline,96,49,47
Марджелла,howling-fjord,1332,priest,discipline,70,34,36
Defat,ravencrest,1331,priest,discipline,44,31,13
Florey,ragnaros,1331,priest,discipline,24,14,10
Velenthan,stormrage,1331,priest,discipline,105,58,47
Doncamïllo,blackrock,1331,priest,discipline,119,61,58
Siemenspvp,drakthul,1331,priest,discipline,63,32,31
Vzã,krasus,1331,priest,discipline,646,325,321
Holycrit,aszune,1331,priest,discipline,95,40,55
Washinomiya,ravencrest,1330,priest,discipline,43,27,16
Rûbyien,drakthul,1330,priest,discipline,24,14,10
Dshara,the-maelstrom,1330,priest,discipline,24,14,10
Jessrabbit,drakthul,1330,priest,discipline,118,66,52
Valaç,turalyon,1330,priest,discipline,149,76,73
Hòllymèdx,blackmoore,1330,priest,discipline,30,14,16
Baldracca,shendralar,1330,priest,discipline,90,35,55
Osteograhm,eldrethalas,1330,priest,discipline,42,16,26
Jezlung,frostmane,1329,priest,discipline,117,67,50
Herapeutic,argent-dawn,1329,priest,discipline,102,57,45
Priesong,blackrock,1329,priest,discipline,65,36,29
Altar,grim-batol,1329,priest,discipline,167,89,78
Tyog,khazgoroth,1329,priest,discipline,31,16,15
Curanders,sanguino,1329,priest,discipline,113,57,56
Woodiee,draenor,1329,priest,discipline,36,17,19
Marypops,outland,1329,priest,discipline,30,14,16
Svartochelak,stormscale,1329,priest,discipline,54,24,30
Trolar,zuljin,1329,priest,discipline,60,26,34
Freyalas,dun-morogh,1328,priest,discipline,18,14,4
Elfdarkholme,stormscale,1328,priest,discipline,97,55,42
Скизма,gordunni,1328,priest,discipline,92,50,42
Ginebra,archimonde,1328,priest,discipline,180,96,84
Clua,draenor,1328,priest,discipline,108,57,51
Plexpriest,blackmoore,1328,priest,discipline,48,25,23
Mers,eredar,1328,priest,discipline,83,41,42
Lovely,silvermoon,1328,priest,discipline,72,35,37
Leyrie,draenor,1328,priest,discipline,50,22,28
Olqp,tarren-mill,1328,priest,discipline,39,16,23
Chealsey,thrall,1327,priest,discipline,63,38,25
Роа,soulflayer,1327,priest,discipline,35,20,15
Hakima,thrall,1327,priest,discipline,78,44,34
Tiktokdancér,kazzak,1327,priest,discipline,150,79,71
Libido,outland,1327,priest,discipline,257,134,123
Juîcycheeks,frostwolf,1327,priest,discipline,179,87,92
Landø,ravencrest,1327,priest,discipline,357,173,184
Livster,chamber-of-aspects,1327,priest,discipline,30,14,16
Tsunadesaama,silvermoon,1327,priest,discipline,30,14,16
Jävlarottá,ravencrest,1327,priest,discipline,30,14,16
Axewound,neptulon,1327,priest,discipline,36,16,20
Nou,aegwynn,1327,priest,discipline,36,14,22
Ørrak,hyjal,1326,priest,discipline,54,30,24
Schrêiwa,aegwynn,1326,priest,discipline,36,20,16
Youkounkoun,garona,1326,priest,discipline,254,126,128
Jediminds,tarren-mill,1326,priest,discipline,52,25,27
Moth,kazzak,1326,priest,discipline,42,18,24
Evangelyne,tarren-mill,1326,priest,discipline,36,15,21
Srysx,nazjatar,1325,priest,discipline,24,14,10
Seum,ravencrest,1325,priest,discipline,134,74,60
Sochnaochen,outland,1325,priest,discipline,142,77,65
Texstil,blackmoore,1325,priest,discipline,102,54,48
Pocketsimp,stormscale,1325,priest,discipline,202,101,101
Genthus,kazzak,1325,priest,discipline,208,103,105
Clapa,ravencrest,1325,priest,discipline,51,25,26
Baddly,silvermoon,1325,priest,discipline,304,147,157
Ministry,tirion,1325,priest,discipline,141,66,75
Jokaël,ysondre,1325,priest,discipline,162,75,87
Toljénpr,twisting-nether,1325,priest,discipline,42,19,23
Skrnz,turalyon,1325,priest,discipline,59,26,33
Chodia,silvermoon,1324,priest,discipline,89,48,41
Æsthëtìçgødx,exodar,1324,priest,discipline,30,16,14
Kalisy,ravencrest,1324,priest,discipline,52,27,25
Nésha,dun-modr,1324,priest,discipline,77,39,38
Mortex,nemesis,1324,priest,discipline,86,43,43
Viridaé,blackmoore,1324,priest,discipline,48,24,24
Benedicktus,hyjal,1324,priest,discipline,30,15,15
Overhealzz,blackmoore,1324,priest,discipline,153,75,78
Шэпахан,soulflayer,1324,priest,discipline,66,29,37
Calsote,sanguino,1324,priest,discipline,60,25,35
Góli,argent-dawn,1324,priest,discipline,36,14,22
Qoryn,ravencrest,1324,priest,discipline,36,14,22
Vandansk,kazzak,1323,priest,discipline,18,14,4
Konantenshi,doomhammer,1323,priest,discipline,48,28,20
Darkoulito,dalaran,1323,priest,discipline,24,14,10
Discoprillan,twisting-nether,1323,priest,discipline,73,42,31
Reìdood,stormscale,1323,priest,discipline,110,59,51
Доминантрикс,soulflayer,1323,priest,discipline,103,54,49
Salves,blackmoore,1323,priest,discipline,117,61,56
Mari,die-aldor,1323,priest,discipline,33,17,16
Elderiel,turalyon,1323,priest,discipline,419,212,207
Ulfsarkaom,turalyon,1323,priest,discipline,165,79,86
Вальдемарс,howling-fjord,1323,priest,discipline,65,30,35
Avengëd,nagrand,1323,priest,discipline,54,24,30
Джесу,soulflayer,1323,priest,discipline,85,37,48
Chilltcaster,blackrock,1323,priest,discipline,38,15,23
Eclaír,blackhand,1323,priest,discipline,54,21,33
Krimsy,hyjal,1322,priest,discipline,30,20,10
Adlareg,silvermoon,1322,priest,discipline,26,16,10
Darkpræcher,hyjal,1322,priest,discipline,141,82,59
Buttafly,archimonde,1322,priest,discipline,42,23,19
Aíushtha,frostmane,1322,priest,discipline,136,72,64
Лимоняшечка,soulflayer,1322,priest,discipline,116,59,57
Мерсициглер,gordunni,1322,priest,discipline,73,37,36
Haligato,archimonde,1322,priest,discipline,142,71,71
Lenanitro,blackrock,1322,priest,discipline,101,49,52
Sqizz,antonidas,1322,priest,discipline,54,24,30
Miriàl,outland,1321,priest,discipline,62,37,25
Flayin,kazzak,1321,priest,discipline,80,42,38
Pulttipiispa,ravencrest,1321,priest,discipline,89,46,43
Fantästic,kazzak,1321,priest,discipline,272,139,133
Breez,nozdormu,1321,priest,discipline,42,21,21
Crazyname,outland,1321,priest,discipline,241,119,122
Idora,aegwynn,1321,priest,discipline,30,14,16
Woodywoodpkr,senjin,1321,priest,discipline,130,60,70
Étesech,zuljin,1321,priest,discipline,84,34,50
Uanna,ravencrest,1321,priest,discipline,36,14,22
Raintime,shattrath,1320,priest,discipline,24,14,10
Voidvania,drakthul,1320,priest,discipline,59,31,28
Priestouner,khaz-modan,1320,priest,discipline,160,82,78
Дюрэкс,soulflayer,1320,priest,discipline,84,42,42
Carlolol,blackmoore,1320,priest,discipline,88,43,45
Tristessê,tarren-mill,1320,priest,discipline,481,229,252
Punkrockgirl,destromath,1320,priest,discipline,84,39,45
Whicked,outland,1320,priest,discipline,53,24,29
Labbépîerre,hyjal,1320,priest,discipline,90,38,52
Billagoushis,twisting-nether,1320,priest,discipline,36,15,21
Calonex,kazzak,1320,priest,discipline,85,35,50
Шкуропльот,gordunni,1319,priest,discipline,106,56,50
Mukkin,tarren-mill,1319,priest,discipline,44,23,21
Shalnorei,drakthul,1319,priest,discipline,90,47,43
Chuntriest,shadowsong,1319,priest,discipline,48,23,25
Chicofickfak,eredar,1319,priest,discipline,118,55,63
Gimcho,magtheridon,1318,priest,discipline,96,50,46
Dímension,ragnaros,1318,priest,discipline,170,88,82
Heandil,doomhammer,1318,priest,discipline,30,15,15
Шадоухоррор,gordunni,1318,priest,discipline,123,59,64
Garvul,stormscale,1318,priest,discipline,30,14,16
Babbúb,tarren-mill,1318,priest,discipline,35,14,21
Ødelia,anubarak,1317,priest,discipline,24,15,9
Neremin,argent-dawn,1317,priest,discipline,124,72,52
Shdwmeld,ravencrest,1317,priest,discipline,48,27,21
Asprine,kazzak,1317,priest,discipline,240,126,114
Shieldyblaze,frostwolf,1317,priest,discipline,149,78,71
Neagica,kazzak,1317,priest,discipline,354,177,177
Coldxzera,tarren-mill,1317,priest,discipline,52,23,29
Paulina,auchindoun,1317,priest,discipline,89,37,52
Adallon,blackmoore,1317,priest,discipline,42,14,28
Mininrv,dun-modr,1316,priest,discipline,165,85,80
Aeo,twisting-nether,1316,priest,discipline,156,80,76
Rickermortis,defias-brotherhood,1316,priest,discipline,82,40,42
Zhritsa,blackhand,1316,priest,discipline,35,14,21
Lizium,kazzak,1316,priest,discipline,42,16,26
Maxhima,defias-brotherhood,1315,priest,discipline,204,111,93
Nioubèy,archimonde,1315,priest,discipline,101,54,47
Microwaave,kazzak,1315,priest,discipline,72,38,34
Gromalia,hyjal,1315,priest,discipline,54,27,27
Ziaz,the-maelstrom,1315,priest,discipline,58,28,30
Bialun,argent-dawn,1315,priest,discipline,199,94,105
Evilmagic,illidan,1315,priest,discipline,41,17,24
Flokz,archimonde,1314,priest,discipline,30,18,12
Vokuheala,tarren-mill,1314,priest,discipline,71,40,31
Brunestùd,pozzo-delleternità,1314,priest,discipline,107,60,47
Hewwo,sylvanas,1314,priest,discipline,162,83,79
Soupana,darksorrow,1314,priest,discipline,133,68,65
Sickz,blackrock,1314,priest,discipline,84,41,43
Døline,hyjal,1314,priest,discipline,44,21,23
Stíckÿ,sanguino,1314,priest,discipline,108,49,59
Durinko,thunderhorn,1314,priest,discipline,114,48,66
Yugo,outland,1314,priest,discipline,41,15,26
Lethaldot,silvermoon,1313,priest,discipline,18,14,4
Кейсия,fordragon,1313,priest,discipline,42,27,15
Ensamstående,twisting-nether,1313,priest,discipline,422,211,211
Танасир,eversong,1313,priest,discipline,57,25,32
Boulotpas,hyjal,1312,priest,discipline,286,157,129
Tutenhamonek,outland,1312,priest,discipline,156,83,73
Ragwitch,draenor,1312,priest,discipline,66,35,31
Aayzsx,ysondre,1312,priest,discipline,114,59,55
Shomäre,ysondre,1312,priest,discipline,232,120,112
Гальционна,gordunni,1312,priest,discipline,84,43,41
Izêr,draenor,1312,priest,discipline,84,36,48
Юпиубивает,soulflayer,1312,priest,discipline,59,21,38
Киборн,deathweaver,1311,priest,discipline,72,42,30
Lovly,antonidas,1311,priest,discipline,24,14,10
Kelsy,zuljin,1311,priest,discipline,24,14,10
Matiagmenh,stormscale,1311,priest,discipline,54,25,29
Фрустрациия,soulflayer,1310,priest,discipline,104,55,49
Мистеняшко,gordunni,1310,priest,discipline,42,21,21
Mabz,defias-brotherhood,1310,priest,discipline,60,29,31
Gïanna,archimonde,1310,priest,discipline,205,99,106
Артэта,blackscar,1310,priest,discipline,58,28,30
Düina,tyrande,1309,priest,discipline,108,61,47
Darknëss,malganis,1309,priest,discipline,51,27,24
Nemista,hyjal,1309,priest,discipline,102,52,50
Styrbjörn,shattered-hand,1309,priest,discipline,121,61,60
Emmenenza,pozzo-delleternità,1309,priest,discipline,112,55,57
Rotzpippn,blackhand,1309,priest,discipline,69,26,43
Æç,malganis,1308,priest,discipline,53,37,16
Wundervoid,silvermoon,1308,priest,discipline,60,34,26
Votiqt,tarren-mill,1308,priest,discipline,30,17,13
Chikzy,thrall,1308,priest,discipline,29,14,15
Overshadowed,kazzak,1308,priest,discipline,211,99,112
Лимью,soulflayer,1308,priest,discipline,73,30,43
Bossku,kazzak,1308,priest,discipline,38,15,23
Рейаста,howling-fjord,1307,priest,discipline,62,35,27
Glaces,archimonde,1307,priest,discipline,107,58,49
Mirelaw,stormscale,1307,priest,discipline,125,65,60
Smålbenör,stormreaver,1307,priest,discipline,66,32,34
Filit,hyjal,1307,priest,discipline,48,22,26
Garevar,antonidas,1307,priest,discipline,88,39,49
Chukapi,stormscale,1306,priest,discipline,54,31,23
Stígmata,sanguino,1306,priest,discipline,120,60,60
Saintalfonzo,twisting-nether,1306,priest,discipline,48,24,24
Gîpsyjoe,ragnaros,1306,priest,discipline,42,21,21
Чугуныйжезл,soulflayer,1306,priest,discipline,107,48,59
Juiccyluccy,ravencrest,1306,priest,discipline,35,14,21
Xyliqa,aegwynn,1306,priest,discipline,65,25,40
Slimshadyi,burning-legion,1305,priest,discipline,48,29,19
Linara,frostmane,1305,priest,discipline,48,28,20
Madvortexe,kazzak,1305,priest,discipline,66,34,32
Xieen,outland,1305,priest,discipline,210,105,105
Мдзшка,gordunni,1305,priest,discipline,1560,779,781
Jeryss,tarren-mill,1305,priest,discipline,202,98,104
Mindchase,twisting-nether,1305,priest,discipline,48,20,28
Skottlez,ravencrest,1304,priest,discipline,49,34,15
Judâspriest,twisting-nether,1304,priest,discipline,72,41,31
Ðøð,dalaran,1304,priest,discipline,153,87,66
Tritonis,draenor,1304,priest,discipline,59,31,28
Ангеланика,gordunni,1304,priest,discipline,42,22,20
Stargóddess,kazzak,1304,priest,discipline,254,132,122
Ульзана,soulflayer,1304,priest,discipline,102,49,53
Kutjeskopper,silvermoon,1304,priest,discipline,96,46,50
Shanerys,silvermoon,1304,priest,discipline,30,14,16
Møldark,silvermoon,1304,priest,discipline,182,83,99
Eldrathir,burning-legion,1304,priest,discipline,132,60,72
Noxxill,eredar,1303,priest,discipline,24,14,10
Evangíline,stormreaver,1303,priest,discipline,41,23,18
Selenar,neptulon,1303,priest,discipline,105,56,49
Tephutes,ravencrest,1303,priest,discipline,39,20,19
Saiki,sanguino,1303,priest,discipline,118,59,59
Zászàsmaster,kazzak,1303,priest,discipline,42,21,21
Yojoyo,draenor,1303,priest,discipline,195,97,98
Ezechiel,twisting-nether,1303,priest,discipline,117,56,61
Ivabenzo,stormscale,1303,priest,discipline,159,76,83
Zârvâjh,aszune,1303,priest,discipline,48,20,28
Slees,stormscale,1303,priest,discipline,38,15,23
Floofz,auchindoun,1302,priest,discipline,57,33,24
Fkup,twisting-nether,1302,priest,discipline,36,20,16
Priestige,spinebreaker,1302,priest,discipline,48,25,23
Stahj,sanguino,1302,priest,discipline,122,61,61
Джороко,howling-fjord,1302,priest,discipline,108,54,54
Тварьгосподя,gordunni,1302,priest,discipline,410,204,206
Albibak,hyjal,1302,priest,discipline,64,31,33
Pandabéar,draenor,1302,priest,discipline,30,14,16
Appox,amanthul,1302,priest,discipline,36,16,20
Саня,razuvious,1302,priest,discipline,54,23,31
Лиэся,gordunni,1302,priest,discipline,36,15,21
Лакукарача,howling-fjord,1302,priest,discipline,88,36,52
Fictus,tarren-mill,1302,priest,discipline,48,15,33
Rulz,zuluhed,1301,priest,discipline,64,33,31
Простойа,deathguard,1301,priest,discipline,238,120,118
Feelmypainn,kazzak,1301,priest,discipline,102,51,51
Ryanis,nemesis,1301,priest,discipline,37,17,20
Vysajapolkni,burning-blade,1301,priest,discipline,37,14,23
Letsrock,aggra-português,1301,priest,discipline,54,20,34
Gaisa,die-todeskrallen,1301,priest,discipline,51,17,34
Puddypri,eredar,1300,priest,discipline,30,17,13
Quisira,aegwynn,1300,priest,discipline,54,30,24
Missdreavus,draenor,1300,priest,discipline,108,58,50
Khai,tarren-mill,1300,priest,discipline,151,80,71
Aszneê,proudmoore,1300,priest,discipline,131,64,67
Curlo,ravencrest,1300,priest,discipline,42,20,22
Batsu,hyjal,1300,priest,discipline,106,47,59
Тэслос,howling-fjord,1300,priest,discipline,82,34,48
Chris,laughing-skull,1299,priest,discipline,30,22,8
Aeriou,argent-dawn,1299,priest,discipline,24,15,9
Skavenirl,blackmoore,1299,priest,discipline,34,17,17
Zofa,sunstrider,1299,priest,discipline,211,105,106
Holyrage,frostwhisper,1299,priest,discipline,78,36,42
Kâltak,aegwynn,1299,priest,discipline,114,52,62
Fatherliam,emerald-dream,1299,priest,discipline,54,24,30
Jerolol,sanguino,1299,priest,discipline,92,40,52
Rhåenyra,ravencrest,1298,priest,discipline,42,28,14
Clergy,hellfire,1298,priest,discipline,125,78,47
Kidri,kilrogg,1298,priest,discipline,36,20,16
Katrynax,ravencrest,1298,priest,discipline,201,100,101
Whitepitch,doomhammer,1298,priest,discipline,148,73,75
Nimuëh,ragnaros,1298,priest,discipline,52,24,28
Zathada,twisting-nether,1297,priest,discipline,105,58,47
Veýýon,blackmoore,1297,priest,discipline,84,45,39
Sietrum,draenor,1297,priest,discipline,59,30,29
Tropfacil,archimonde,1297,priest,discipline,84,41,43
Attenna,ravencrest,1297,priest,discipline,105,49,56
Tackerjoè,eredar,1297,priest,discipline,54,25,29
Quecum,draenor,1297,priest,discipline,42,19,23
Nolsrcp,outland,1297,priest,discipline,106,46,60
Хенели,blackscar,1297,priest,discipline,67,29,38
Pepysmite,ysondre,1297,priest,discipline,51,21,30
Трахмэйстер,gordunni,1296,priest,discipline,119,77,42
Iømÿnudir,archimonde,1296,priest,discipline,296,150,146
Natsuki,illidan,1296,priest,discipline,181,91,90
Nuph,ravencrest,1296,priest,discipline,71,33,38
Unpsofablé,outland,1296,priest,discipline,97,42,55
Niksyvoid,destromath,1296,priest,discipline,43,18,25
Рейнисдм,gordunni,1295,priest,discipline,24,14,10
Eloapriest,blackhand,1295,priest,discipline,24,14,10
Mishas,draenor,1295,priest,discipline,62,34,28
Скорлупкина,gordunni,1295,priest,discipline,99,52,47
Nâmîz,blackrock,1295,priest,discipline,27,14,13
Joebando,ravencrest,1295,priest,discipline,373,189,184
Chaosxo,draenor,1295,priest,discipline,330,160,170
Vannax,arygos,1295,priest,discipline,78,35,43
Nixxan,arthas,1295,priest,discipline,54,24,30
Nirvänah,ysondre,1295,priest,discipline,65,28,37
Uzü,ysondre,1294,priest,discipline,24,16,8
Ghostea,silvermoon,1294,priest,discipline,24,14,10
Никорете,soulflayer,1294,priest,discipline,62,34,28
Confusedleaf,ragnaros,1294,priest,discipline,48,24,24
Shzuna,archimonde,1294,priest,discipline,141,67,74
Nahrzgrein,blackmoore,1294,priest,discipline,101,47,54
Асуартхас,gordunni,1294,priest,discipline,259,118,141
Nhajÿ,hyjal,1294,priest,discipline,42,17,25
Powerless,blackmoore,1293,priest,discipline,33,22,11
Ðæßi,hyjal,1293,priest,discipline,103,57,46
Thimble,blackhand,1293,priest,discipline,49,27,22
Henreita,darksorrow,1293,priest,discipline,71,39,32
Oohopeoo,blackmoore,1293,priest,discipline,42,23,19
Æternadead,nemesis,1293,priest,discipline,233,119,114
Robiee,twisting-nether,1293,priest,discipline,75,37,38
Credor,blackrock,1293,priest,discipline,42,19,23
Goofdookie,outland,1293,priest,discipline,36,14,22
Faderken,tarren-mill,1292,priest,discipline,78,48,30
Slavpriest,outland,1292,priest,discipline,23,14,9
Maetena,archimonde,1292,priest,discipline,60,36,24
Freazi,burning-blade,1292,priest,discipline,126,67,59
Biblebabe,tarren-mill,1292,priest,discipline,72,37,35
Ассарх,lich-king,1292,priest,discipline,132,66,66
Khoria,drakthul,1292,priest,discipline,30,14,16
Roosy,malganis,1292,priest,discipline,56,26,30
Иванпугачев,soulflayer,1292,priest,discipline,60,26,34
Charmebolzen,blackrock,1291,priest,discipline,74,53,21
Pure,kazzak,1291,priest,discipline,42,25,17
Фурлена,blackscar,1291,priest,discipline,109,56,53
Priestpvp,dun-modr,1291,priest,discipline,119,59,60
Centaurio,nemesis,1291,priest,discipline,249,121,128
Praizejeebus,auchindoun,1291,priest,discipline,54,26,28
Nyugalom,ragnaros,1291,priest,discipline,30,14,16
Purityn,blackhand,1291,priest,discipline,54,20,34
Nygel,kazzak,1290,priest,discipline,81,45,36
Aká,kazzak,1290,priest,discipline,54,25,29
Blúefox,malfurion,1290,priest,discipline,44,20,24
Iamfrosty,draenor,1290,priest,discipline,72,32,40
Grimor,talnivarr,1290,priest,discipline,36,16,20
Ezea,blackmoore,1290,priest,discipline,72,27,45
Ryverox,dun-modr,1289,priest,discipline,74,42,32
Ralaya,ravencrest,1289,priest,discipline,37,20,17
Navid,ravencrest,1289,priest,discipline,45,24,21
Holyswift,dun-morogh,1289,priest,discipline,236,125,111
Эннхэтэуэй,soulflayer,1289,priest,discipline,115,54,61
Littleflash,lightbringer,1289,priest,discipline,198,91,107
Аполонио,soulflayer,1289,priest,discipline,108,48,60
Whysomady,stormscale,1289,priest,discipline,107,47,60
Taiz,los-errantes,1289,priest,discipline,112,49,63
Elusivv,blackhand,1289,priest,discipline,84,36,48
Brainwash,darksorrow,1289,priest,discipline,53,18,35
Devîlcry,nordrassil,1288,priest,discipline,146,85,61
Nerfnerf,kazzak,1288,priest,discipline,696,353,343
Дэтметал,grom,1288,priest,discipline,381,188,193
Scarlovni,archimonde,1288,priest,discipline,54,24,30
Averye,kazzak,1287,priest,discipline,48,27,21
Tira,darksorrow,1287,priest,discipline,36,19,17
Ghøstyx,blackrock,1287,priest,discipline,129,65,64
Gangreana,kazzak,1287,priest,discipline,155,76,79
Overloordd,kazzak,1287,priest,discipline,95,46,49
Voidlekir,sanguino,1287,priest,discipline,50,24,26
Oversole,kazzak,1287,priest,discipline,54,23,31
Reizer,argent-dawn,1286,priest,discipline,27,15,12
Duaijhutari,outland,1286,priest,discipline,60,33,27
Ysharg,sinstralis,1286,priest,discipline,53,29,24
Dotctor,ysondre,1286,priest,discipline,137,73,64
Phórkys,kazzak,1286,priest,discipline,1188,594,594
Lydrian,argent-dawn,1286,priest,discipline,44,21,23
Blackheal,sanguino,1286,priest,discipline,184,84,100
Upo,kazzak,1286,priest,discipline,42,18,24
Маимморта,howling-fjord,1285,priest,discipline,78,39,39
Pysa,thrall,1285,priest,discipline,30,15,15
Blaumeaux,eredar,1285,priest,discipline,30,15,15
Nestélle,drakthul,1285,priest,discipline,305,152,153
Sissi,blackmoore,1285,priest,discipline,177,88,89
Битуну,fordragon,1285,priest,discipline,84,40,44
Токсичка,howling-fjord,1284,priest,discipline,42,22,20
Kårejonny,tarren-mill,1284,priest,discipline,171,89,82
Pregrip,twisting-nether,1284,priest,discipline,236,116,120
Ilvia,antonidas,1283,priest,discipline,40,25,15
Rexáíny,blackrock,1283,priest,discipline,65,35,30
Dapristes,silvermoon,1283,priest,discipline,53,28,25
Sykra,magtheridon,1283,priest,discipline,190,99,91
Virgosenpai,silvermoon,1283,priest,discipline,63,32,31
Nukksch,antonidas,1283,priest,discipline,349,168,181
Neddeadlius,outland,1283,priest,discipline,110,51,59
Kikoke,sanguino,1282,priest,discipline,63,36,27
Soothy,proudmoore,1282,priest,discipline,127,70,57
Поглощу,gordunni,1282,priest,discipline,119,61,58
Suchetto,kazzak,1282,priest,discipline,130,63,67
Форсибучи,soulflayer,1282,priest,discipline,193,93,100
Claudefrollo,the-maelstrom,1282,priest,discipline,133,59,74
Velerana,silvermoon,1282,priest,discipline,48,21,27
Mynameisebe,twisting-nether,1282,priest,discipline,42,18,24
Bauscia,nemesis,1282,priest,discipline,36,15,21
Tätøsz,ravencrest,1281,priest,discipline,36,24,12
Shadowgov,ravencrest,1281,priest,discipline,29,17,12
Венжифул,soulflayer,1281,priest,discipline,24,14,10
Mcnuuggets,ravencrest,1281,priest,discipline,28,16,12
Skyggepraest,stormscale,1281,priest,discipline,44,24,20
Elderath,eredar,1281,priest,discipline,180,82,98
Ноатоэль,gordunni,1281,priest,discipline,67,29,38
Хъи,gordunni,1280,priest,discipline,78,44,34
Shalalalalaè,outland,1280,priest,discipline,42,22,20
Eremit,silvermoon,1280,priest,discipline,163,85,78
Mithralas,doomhammer,1280,priest,discipline,60,29,31
Xelivia,draenor,1280,priest,discipline,197,94,103
Hïstërïä,silvermoon,1280,priest,discipline,68,31,37
Delinsx,outland,1280,priest,discipline,39,15,24
Япараноик,howling-fjord,1279,priest,discipline,65,41,24
Leja,darkspear,1279,priest,discipline,24,14,10
Adamasuba,arathor,1279,priest,discipline,60,33,27
Liliashet,sanguino,1279,priest,discipline,105,57,48
Yantu,burning-legion,1279,priest,discipline,111,60,51
Keimohansio,twisting-nether,1279,priest,discipline,138,74,64
Ûbér,darksorrow,1279,priest,discipline,28,15,13
Nicku,nerathor,1279,priest,discipline,79,42,37
Fuditth,aggra-português,1279,priest,discipline,47,24,23
Elasund,silvermoon,1279,priest,discipline,30,15,15
Norlyset,silvermoon,1279,priest,discipline,150,74,76
Grravehheart,kazzak,1279,priest,discipline,109,53,56
Тесира,blackscar,1279,priest,discipline,126,61,65
Levy,azuremyst,1279,priest,discipline,53,25,28
Brøwney,blackmoore,1279,priest,discipline,83,38,45
Tôto,stormreaver,1279,priest,discipline,48,19,29
Authorized,azshara,1279,priest,discipline,54,21,33
Gagai,ravencrest,1279,priest,discipline,36,14,22
Dayu,blackrock,1279,priest,discipline,48,18,30
Mournus,defias-brotherhood,1278,priest,discipline,155,89,66
Dinma,argent-dawn,1278,priest,discipline,225,120,105
Кармелитас,gordunni,1278,priest,discipline,48,23,25
Wildjaevel,grim-batol,1278,priest,discipline,68,32,36
Arklim,burning-blade,1278,priest,discipline,130,58,72
Soltum,eredar,1278,priest,discipline,54,22,32
Spaghettoni,tarren-mill,1278,priest,discipline,35,14,21
Lalock,grim-batol,1278,priest,discipline,45,17,28
Deadbishop,kazzak,1278,priest,discipline,69,26,43
Manita,archimonde,1277,priest,discipline,38,21,17
Patoroch,terokkar,1277,priest,discipline,78,43,35
Энлинна,soulflayer,1277,priest,discipline,40,20,20
Insicompany,antonidas,1277,priest,discipline,100,45,55
Anaalipeura,stormreaver,1277,priest,discipline,135,58,77
Pändöræ,archimonde,1277,priest,discipline,54,18,36
Liasanya,kelthuzad,1276,priest,discipline,36,22,14
Chuwbakka,kazzak,1276,priest,discipline,142,77,65
Fullymetalz,defias-brotherhood,1276,priest,discipline,64,34,30
Ästûr,sanguino,1276,priest,discipline,102,54,48
Catvrix,ravencrest,1276,priest,discipline,106,56,50
Brainðead,aegwynn,1276,priest,discipline,64,33,31
Îndura,drakthul,1276,priest,discipline,123,62,61
Squirpox,outland,1276,priest,discipline,48,24,24
Smooky,arakarahm,1276,priest,discipline,89,41,48
Zenoo,argent-dawn,1275,priest,discipline,36,22,14
Биркох,blackscar,1275,priest,discipline,139,83,56
Howaya,la-croisade-écarlate,1275,priest,discipline,120,64,56
Alfaböna,outland,1275,priest,discipline,198,102,96
Velles,nazjatar,1275,priest,discipline,917,461,456
Zerotorone,stormscale,1275,priest,discipline,116,58,58
Healy,blackrock,1275,priest,discipline,199,97,102
Дэкспрут,soulflayer,1275,priest,discipline,72,33,39
Durmadanbas,ravencrest,1275,priest,discipline,163,74,89
Disz,zuljin,1275,priest,discipline,71,31,40
Savylolsz,ravencrest,1275,priest,discipline,47,20,27
Capriestun,hellfire,1274,priest,discipline,34,20,14
Mallkie,ysondre,1274,priest,discipline,42,24,18
Топчикс,gordunni,1274,priest,discipline,100,51,49
Вартэг,blackscar,1274,priest,discipline,72,35,37
Thaitros,ragnaros,1274,priest,discipline,36,17,19
Dhed,turalyon,1274,priest,discipline,49,22,27
Harume,argent-dawn,1273,priest,discipline,24,14,10
Smitey,terenas,1273,priest,discipline,316,162,154
Voidjutsu,draenor,1273,priest,discipline,182,92,90
Vedina,bronze-dragonflight,1273,priest,discipline,96,46,50
Koskice,moonglade,1272,priest,discipline,18,15,3
Ksiadzrydzyk,draenor,1272,priest,discipline,72,41,31
Méla,pozzo-delleternità,1272,priest,discipline,83,47,36
Svetidjordje,tarren-mill,1272,priest,discipline,39,19,20
Мазка,galakrond,1272,priest,discipline,90,43,47
Luilos,twisting-nether,1272,priest,discipline,150,66,84
Sørney,aegwynn,1271,priest,discipline,27,18,9
Chowhone,archimonde,1271,priest,discipline,198,99,99
Liaru,aegwynn,1271,priest,discipline,114,43,71
Шпалкоклоб,soulflayer,1270,priest,discipline,30,18,12
Подчинись,ashenvale,1270,priest,discipline,182,95,87
Lilycat,silvermoon,1270,priest,discipline,71,37,34
Griniel,marécage-de-zangar,1270,priest,discipline,55,28,27
Aggresivdisc,hyjal,1270,priest,discipline,49,24,25
Стромъяр,gordunni,1270,priest,discipline,29,14,15
Dotterin,draenor,1270,priest,discipline,198,91,107
Theunknown,stormscale,1270,priest,discipline,35,15,20
Seniya,argent-dawn,1270,priest,discipline,51,19,32
Lílíana,thrall,1269,priest,discipline,180,88,92
Skiplegday,blackrock,1269,priest,discipline,55,26,29
Mitø,ravencrest,1269,priest,discipline,39,17,22
Kreador,twisting-nether,1269,priest,discipline,96,40,56
Sçumbåg,sylvanas,1269,priest,discipline,72,30,42
Battleprey,the-maelstrom,1268,priest,discipline,36,23,13
Bigfnatlund,silvermoon,1268,priest,discipline,59,29,30
Badgirlterri,hyjal,1267,priest,discipline,98,51,47
Утьуть,gordunni,1267,priest,discipline,151,76,75
Fixyou,aggra-português,1267,priest,discipline,161,79,82
Samtig,malganis,1267,priest,discipline,214,100,114
Brronxx,frostwolf,1267,priest,discipline,30,14,16
Zakuula,burning-legion,1267,priest,discipline,64,28,36
Blaçkout,ravencrest,1267,priest,discipline,130,54,76
Chybrozzør,archimonde,1267,priest,discipline,35,14,21
Tryqi,drakthul,1267,priest,discipline,54,21,33
Мерго,grom,1267,priest,discipline,74,26,48
Сорвиголов,howling-fjord,1266,priest,discipline,46,31,15
Маскона,howling-fjord,1266,priest,discipline,46,30,16
Skyliné,blackhand,1266,priest,discipline,104,55,49
Jazzek,burning-legion,1266,priest,discipline,98,46,52
Montane,wrathbringer,1266,priest,discipline,36,16,20
Iskáral,frostmourne,1266,priest,discipline,84,30,54
Euphorius,blackmoore,1265,priest,discipline,90,44,46
Свапмиплиз,gordunni,1265,priest,discipline,250,121,129
Obscurus,kaelthas,1265,priest,discipline,119,56,63
Shaydi,todeswache,1264,priest,discipline,30,22,8
Lighter,dragonblight,1264,priest,discipline,106,64,42
Shadowpeste,aggra-português,1264,priest,discipline,156,86,70
Alreadylost,ragnaros,1264,priest,discipline,30,14,16
Xharyo,ravencrest,1264,priest,discipline,37,16,21
Azazzel,nathrezim,1264,priest,discipline,88,38,50
Nieudolny,ravencrest,1264,priest,discipline,44,19,25
Mental,stormscale,1264,priest,discipline,42,18,24
Célaz,blackmoore,1264,priest,discipline,72,30,42
Maylà,aegwynn,1264,priest,discipline,106,43,63
Lynû,frostwolf,1264,priest,discipline,84,33,51
Залакджин,howling-fjord,1264,priest,discipline,66,25,41
Jeanpipe,khaz-modan,1263,priest,discipline,53,32,21
Techipriest,ravencrest,1263,priest,discipline,30,18,12
Mandible,aggramar,1263,priest,discipline,72,42,30
Palitox,kazzak,1263,priest,discipline,54,30,24
Madilim,kazzak,1263,priest,discipline,53,28,25
Kizzorde,ragnaros,1263,priest,discipline,272,141,131
Ruîzz,sanguino,1263,priest,discipline,212,102,110
Donbas,tarren-mill,1263,priest,discipline,42,20,22
Kertith,argent-dawn,1263,priest,discipline,91,43,48
Haysér,frostmane,1263,priest,discipline,34,15,19
Seneth,twisting-nether,1263,priest,discipline,41,16,25
Mandzukic,stormscale,1262,priest,discipline,42,24,18
Deneye,thunderhorn,1262,priest,discipline,108,61,47
Gutfroy,conseil-des-ombres,1262,priest,discipline,75,42,33
Khato,rexxar,1262,priest,discipline,75,39,36
Íhðly,silvermoon,1262,priest,discipline,231,114,117
Madpad,tarren-mill,1261,priest,discipline,49,28,21
Дайбчик,gordunni,1261,priest,discipline,80,45,35
Vainry,argent-dawn,1261,priest,discipline,90,46,44
Nightstyle,nethersturm,1261,priest,discipline,154,75,79
Chane,blackmoore,1261,priest,discipline,187,91,96
Xkv,blackmoore,1260,priest,discipline,66,39,27
Brelett,the-maelstrom,1260,priest,discipline,90,39,51
Azraelz,blackhand,1260,priest,discipline,37,16,21
Тэвиель,gordunni,1260,priest,discipline,144,61,83
Аквариусс,gordunni,1259,priest,discipline,106,53,53
Coolestguy,ravencrest,1259,priest,discipline,83,38,45
Bub,kelthuzad,1259,priest,discipline,38,16,22
Popelings,twisting-nether,1259,priest,discipline,54,20,34
Qyi,the-maelstrom,1258,priest,discipline,54,31,23
Сюрпрайзик,gordunni,1258,priest,discipline,36,20,16
Romelu,archimonde,1258,priest,discipline,102,56,46
Плут,blackscar,1258,priest,discipline,94,51,43
Pindakong,dragonblight,1258,priest,discipline,142,72,70
Ernyos,anubarak,1258,priest,discipline,54,24,30
Утяути,ashenvale,1258,priest,discipline,34,14,20
Reighl,drakthul,1257,priest,discipline,53,33,20
Capriéstsun,ravencrest,1257,priest,discipline,40,23,17
Вдл,gordunni,1257,priest,discipline,28,15,13
Elternya,hyjal,1257,priest,discipline,156,83,73
Акктуальная,deepholm,1257,priest,discipline,90,47,43
Añgêl,ravencrest,1257,priest,discipline,195,99,96
Vèrcs,silvermoon,1257,priest,discipline,77,39,38
Nérôck,frostwolf,1257,priest,discipline,57,26,31
Gudrinieks,shattered-halls,1257,priest,discipline,93,41,52
Kïmbo,kazzak,1257,priest,discipline,71,28,43
Prooph,tarren-mill,1256,priest,discipline,42,23,19
Asnur,argent-dawn,1256,priest,discipline,96,50,46
Øwlsoo,confrérie-du-thorium,1256,priest,discipline,136,70,66
Simbaba,archimonde,1256,priest,discipline,227,114,113
Cherrycat,doomhammer,1256,priest,discipline,387,194,193
Zyreenx,blackrock,1256,priest,discipline,29,14,15
Sephìrøth,malganis,1256,priest,discipline,114,53,61
Siphall,kirin-tor,1256,priest,discipline,59,27,32
Lothbruke,twisting-nether,1256,priest,discipline,170,77,93
Schlúckunweg,antonidas,1256,priest,discipline,102,46,56
Vishnia,defias-brotherhood,1255,priest,discipline,158,78,80
Mwxz,ravencrest,1255,priest,discipline,36,17,19
Róse,anachronos,1255,priest,discipline,33,14,19
Míllerzz,ragnaros,1255,priest,discipline,54,22,32
Praystatîon,dragonblight,1254,priest,discipline,132,80,52
Headieone,kazzak,1254,priest,discipline,30,18,12
Гантелявухо,eversong,1254,priest,discipline,30,17,13
Renesmè,archimonde,1254,priest,discipline,42,20,22
Leahlimit,kazzak,1254,priest,discipline,50,19,31
Дэйвора,ashenvale,1253,priest,discipline,62,37,25
Piixld,aegwynn,1253,priest,discipline,24,14,10
Zranda,magtheridon,1253,priest,discipline,192,96,96
Chrissirr,culte-de-la-rive-noire,1253,priest,discipline,36,18,18
Suzziee,silvermoon,1253,priest,discipline,118,58,60
Еками,soulflayer,1253,priest,discipline,47,19,28
Zikár,kazzak,1253,priest,discipline,39,15,24
Ожившийприст,soulflayer,1252,priest,discipline,167,92,75
Superfelyn,ragnaros,1252,priest,discipline,57,29,28
Angusbeêf,blackrock,1252,priest,discipline,314,159,155
Pillian,nordrassil,1252,priest,discipline,28,14,14
Discokuken,outland,1252,priest,discipline,77,35,42
Torcena,garrosh,1252,priest,discipline,48,16,32
Zolfiqar,tarren-mill,1251,priest,discipline,60,37,23
Даркфолс,soulflayer,1251,priest,discipline,59,30,29
Сережашвд,soulflayer,1251,priest,discipline,42,21,21
Leprie,draenor,1251,priest,discipline,69,32,37
Джаджафирз,howling-fjord,1251,priest,discipline,50,22,28
Wckd,tarren-mill,1251,priest,discipline,44,15,29
Nazo,sylvanas,1250,priest,discipline,113,63,50
Болътвоя,gordunni,1250,priest,discipline,54,30,24
Малмортис,soulflayer,1250,priest,discipline,107,58,49
Zentro,turalyon,1250,priest,discipline,145,70,75
Mlgbonbon,archimonde,1250,priest,discipline,44,19,25
Estarôn,antonidas,1250,priest,discipline,54,23,31
Szeky,ragnaros,1250,priest,discipline,54,21,33
Sdw,kargath,1249,priest,discipline,33,19,14
Isoris,hyjal,1249,priest,discipline,58,29,29
Varroc,stormscale,1249,priest,discipline,30,15,15
Adriana,los-errantes,1249,priest,discipline,113,51,62
Crazypablito,burning-legion,1249,priest,discipline,71,32,39
Grabenkrieg,blackrock,1249,priest,discipline,195,84,111
Cbbigbape,thrall,1248,priest,discipline,18,13,5
Pixelpriest,argent-dawn,1248,priest,discipline,186,109,77
Suprenext,draenor,1248,priest,discipline,24,13,11
Одинокаягора,gordunni,1248,priest,discipline,93,46,47
Gacoo,silvermoon,1248,priest,discipline,245,119,126
Alaeddin,kazzak,1248,priest,discipline,625,301,324
Desmile,eredar,1248,priest,discipline,60,28,32
Proxsjr,ravencrest,1248,priest,discipline,30,13,17
Stmichael,silvermoon,1248,priest,discipline,38,15,23
Tsipoz,outland,1247,priest,discipline,18,13,5
Skillir,der-abyssische-rat,1247,priest,discipline,18,13,5
Litenbitbifx,twisting-nether,1247,priest,discipline,18,13,5
Wontdispel,ravencrest,1247,priest,discipline,24,13,11
Finizkram,sylvanas,1247,priest,discipline,24,13,11
Kankstery,kazzak,1247,priest,discipline,30,13,17
Malíficent,draenor,1247,priest,discipline,36,15,21
Xourin,blackrock,1247,priest,discipline,34,14,20
Niwothethird,ravencrest,1246,priest,discipline,16,14,2
Neardeath,stormscale,1246,priest,discipline,24,13,11
Bottom,blackmoore,1246,priest,discipline,24,13,11
Linselohan,tarren-mill,1246,priest,discipline,30,14,16
Nixxaa,drakthul,1246,priest,discipline,48,22,26
Quepimquepam,tarren-mill,1246,priest,discipline,41,18,23
Boniesmack,stormscale,1246,priest,discipline,48,21,27
Gloffoló,ragnaros,1246,priest,discipline,30,13,17
Sîlfa,hyjal,1245,priest,discipline,18,13,5
Golthog,rashgarroth,1245,priest,discipline,24,16,8
Dade,nemesis,1245,priest,discipline,24,13,11
Søînx,archimonde,1245,priest,discipline,61,32,29
Smellypecker,argent-dawn,1245,priest,discipline,78,40,38
Prestigé,vashj,1245,priest,discipline,30,13,17
Shaquíloheal,blackrock,1245,priest,discipline,30,13,17
Divaz,eredar,1245,priest,discipline,78,33,45
Theycmedotin,blackhand,1245,priest,discipline,42,13,29
Moonacky,bronze-dragonflight,1244,priest,discipline,18,13,5
Hotdog,kult-der-verdammten,1244,priest,discipline,30,17,13
Kovács,tarren-mill,1244,priest,discipline,105,59,46
Ulalume,ravencrest,1244,priest,discipline,72,40,32
Килфлэш,howling-fjord,1244,priest,discipline,53,28,25
Styleexdd,ragnaros,1244,priest,discipline,104,54,50
Nomps,stormscale,1244,priest,discipline,52,27,25
Asuriyan,ravenholdt,1244,priest,discipline,112,55,57
Имудонка,gordunni,1244,priest,discipline,139,66,73
Doombrew,blackmoore,1244,priest,discipline,30,13,17
Diminishing,ragnaros,1244,priest,discipline,30,13,17
Пропитал,booty-bay,1244,priest,discipline,42,17,25
Takeoff,dun-morogh,1243,priest,discipline,36,23,13
Nogz,rashgarroth,1243,priest,discipline,95,56,39
Tjackballé,tarren-mill,1243,priest,discipline,24,13,11
Officinalis,hyjal,1243,priest,discipline,104,52,52
Priestagon,azjolnerub,1243,priest,discipline,30,15,15
Déspaír,silvermoon,1243,priest,discipline,221,110,111
Luxor,outland,1243,priest,discipline,30,13,17
Praystation,shadowsong,1243,priest,discipline,42,18,24
Xälis,ysondre,1243,priest,discipline,66,23,43
Negcntsm,aegwynn,1242,priest,discipline,47,27,20
Ultraviojung,kazzak,1242,priest,discipline,72,39,33
Thundiz,archimonde,1242,priest,discipline,24,13,11
Jessijones,gorgonnash,1242,priest,discipline,24,13,11
Мсикатана,gordunni,1242,priest,discipline,24,13,11
Novilas,thrall,1242,priest,discipline,54,29,25
Magnificito,silvermoon,1242,priest,discipline,60,32,28
Sandaal,drakthul,1242,priest,discipline,125,63,62
Imnotep,dun-modr,1242,priest,discipline,83,41,42
Verrottênd,frostwolf,1242,priest,discipline,118,52,66
Ajaabyo,khazgoroth,1242,priest,discipline,30,13,17
Senza,ysondre,1242,priest,discipline,30,13,17
Zìrkâ,drekthar,1242,priest,discipline,75,30,45
Captaìncrazy,tarren-mill,1242,priest,discipline,62,23,39
Toasttwo,kazzak,1241,priest,discipline,18,13,5
Pownme,blackmoore,1241,priest,discipline,60,36,24
Deyxq,lothar,1241,priest,discipline,24,13,11
Rog,norgannon,1241,priest,discipline,36,19,17
Buckless,kazzak,1241,priest,discipline,77,40,37
Áphrodite,outland,1241,priest,discipline,53,26,27
Yves,malygos,1240,priest,discipline,24,14,10
Trimégiste,hyjal,1240,priest,discipline,196,103,93
Kellen,burning-blade,1240,priest,discipline,162,82,80
Zamurak,outland,1240,priest,discipline,119,59,60
Liaril,sanguino,1240,priest,discipline,59,29,30
Kiesp,tarren-mill,1240,priest,discipline,147,71,76
Æzy,burning-blade,1240,priest,discipline,54,26,28
Карнотит,howling-fjord,1240,priest,discipline,216,100,116
Petshopboi,sylvanas,1240,priest,discipline,33,15,18
Ðispelgødx,ravencrest,1240,priest,discipline,30,13,17
Krìnzy,illidan,1240,priest,discipline,138,59,79
Gilfir,stormscale,1240,priest,discipline,113,48,65
Aptz,twisting-nether,1240,priest,discipline,36,13,23
Zul,nemesis,1239,priest,discipline,24,14,10
Druzhok,sylvanas,1239,priest,discipline,24,13,11
Ðyøx,ravencrest,1239,priest,discipline,24,13,11
Lightwøød,khaz-modan,1239,priest,discipline,281,141,140
Bldnl,ragnaros,1239,priest,discipline,323,160,163
Свежага,howling-fjord,1239,priest,discipline,129,63,66
Noyxz,frostmourne,1239,priest,discipline,44,20,24
Madreöscura,cthun,1239,priest,discipline,75,32,43
Melitelle,ravencrest,1239,priest,discipline,38,14,24
Ünholy,burning-legion,1238,priest,discipline,63,38,25
Ezrox,neptulon,1238,priest,discipline,87,45,42
Apèx,blackrock,1238,priest,discipline,78,40,38
Türapea,draenor,1238,priest,discipline,122,61,61
Moonsalt,doomhammer,1238,priest,discipline,36,17,19
Crop,nemesis,1238,priest,discipline,54,21,33
Fingerblast,sanguino,1237,priest,discipline,60,36,24
Javvi,sylvanas,1237,priest,discipline,100,59,41
Hygîa,ravencrest,1237,priest,discipline,24,14,10
Pohyoloo,turalyon,1237,priest,discipline,69,39,30
Rollingpork,burning-legion,1237,priest,discipline,30,16,14
Serach,ravencrest,1237,priest,discipline,36,19,17
Csiillux,ragnaros,1237,priest,discipline,72,37,35
Potatø,antonidas,1237,priest,discipline,114,58,56
Aléhyl,la-croisade-écarlate,1237,priest,discipline,388,194,194
Аэрэта,deathguard,1236,priest,discipline,153,83,70
Mcbooee,outland,1236,priest,discipline,115,61,54
Piotrek,hyjal,1236,priest,discipline,40,20,20
Sahu,kult-der-verdammten,1236,priest,discipline,44,21,23
Ashaî,argent-dawn,1236,priest,discipline,42,16,26
Velix,outland,1235,priest,discipline,18,13,5
Odysseuz,nazjatar,1235,priest,discipline,51,28,23
Nelvor,silvermoon,1235,priest,discipline,65,35,30
Holycowheals,the-maelstrom,1235,priest,discipline,149,80,69
Itchzi,alonsus,1235,priest,discipline,108,56,52
Щакактрахнем,gordunni,1235,priest,discipline,132,63,69
Fiftyfives,hyjal,1235,priest,discipline,30,13,17
Plzhealme,stormscale,1234,priest,discipline,18,15,3
Këkhtaräkh,tarren-mill,1234,priest,discipline,24,14,10
Mivale,aszune,1234,priest,discipline,26,15,11
Feywaen,archimonde,1234,priest,discipline,88,48,40
Hòlymoly,stormscale,1234,priest,discipline,231,119,112
Neytirinqt,doomhammer,1234,priest,discipline,218,110,108
Tlc,dragonmaw,1234,priest,discipline,163,77,86
Lousp,tarren-mill,1234,priest,discipline,69,32,37
Zubrowkâ,kazzak,1234,priest,discipline,104,48,56
Jakner,nemesis,1234,priest,discipline,60,27,33
Preoteasa,kazzak,1234,priest,discipline,120,52,68
Séfaron,blackmoore,1233,priest,discipline,93,51,42
Somai,aegwynn,1233,priest,discipline,24,13,11
Felï,tichondrius,1233,priest,discipline,33,17,16
Brach,nazjatar,1233,priest,discipline,138,70,68
Hêsêkiêl,eredar,1233,priest,discipline,96,46,50
Holykaka,tarren-mill,1233,priest,discipline,96,44,52
Popegoat,ragnaros,1232,priest,discipline,156,94,62
Dipbanned,ravencrest,1232,priest,discipline,24,14,10
Addickted,defias-brotherhood,1232,priest,discipline,36,20,16
Джейнкелли,borean-tundra,1232,priest,discipline,349,190,159
Napriest,kazzak,1232,priest,discipline,24,13,11
Temril,aegwynn,1232,priest,discipline,228,117,111
Стиллх,blackscar,1232,priest,discipline,116,58,58
Seras,bloodfeather,1232,priest,discipline,266,132,134
Dannebrog,eonar,1232,priest,discipline,77,34,43
Janinw,sylvanas,1232,priest,discipline,30,13,17
Giggezu,aegwynn,1232,priest,discipline,30,13,17
Relöaded,kazzak,1232,priest,discipline,144,60,84
Mythsionx,blackmoore,1232,priest,discipline,66,26,40
Gedzie,silvermoon,1231,priest,discipline,18,13,5
Alisíria,sylvanas,1231,priest,discipline,95,52,43
Galilea,sanguino,1231,priest,discipline,24,13,11
Jimmyhoffa,stormscale,1231,priest,discipline,108,57,51
Whitehusky,antonidas,1231,priest,discipline,72,37,35
Héternel,ysondre,1231,priest,discipline,120,59,61
Залупский,gordunni,1231,priest,discipline,60,29,31
Blondi,darksorrow,1231,priest,discipline,118,55,63
Whiteshadöw,archimonde,1231,priest,discipline,66,25,41
Jaydeenxd,ravencrest,1231,priest,discipline,42,13,29
Абсорберша,gordunni,1230,priest,discipline,36,21,15
Tokushiro,sylvanas,1230,priest,discipline,48,25,23
Зашохэйт,soulflayer,1230,priest,discipline,79,40,39
Eïtham,sanguino,1230,priest,discipline,150,75,75
Kangkong,burning-legion,1230,priest,discipline,63,31,32
Sacerfull,sanguino,1230,priest,discipline,165,80,85
Инстенли,howling-fjord,1230,priest,discipline,90,38,52
Omnissiiah,silvermoon,1230,priest,discipline,42,14,28
Epsxy,ysondre,1229,priest,discipline,92,47,45
Downtrone,blackrock,1229,priest,discipline,308,154,154
Soehzz,khaz-modan,1229,priest,discipline,132,66,66
Ellianore,les-sentinelles,1229,priest,discipline,112,54,58
Walotar,chamber-of-aspects,1229,priest,discipline,78,37,41
Holydoughnut,stormscale,1229,priest,discipline,72,34,38
Grimveil,sylvanas,1229,priest,discipline,107,50,57
Morîdîn,kazzak,1229,priest,discipline,99,46,53
Пенансиня,gordunni,1229,priest,discipline,36,13,23
Holmpriest,twisting-nether,1228,priest,discipline,36,18,18
Peterhrivnak,tarren-mill,1228,priest,discipline,31,13,18
Nostramo,kirin-tor,1228,priest,discipline,60,23,37
Anthamonn,drakthul,1228,priest,discipline,36,13,23
Felerman,kazzak,1228,priest,discipline,36,13,23
Juhduss,tarren-mill,1227,priest,discipline,47,24,23
Дракулесса,gordunni,1227,priest,discipline,75,38,37
Sinatra,sylvanas,1227,priest,discipline,163,80,83
Héntai,argent-dawn,1227,priest,discipline,42,19,23
Healenax,ravencrest,1227,priest,discipline,42,13,29
Волкерия,howling-fjord,1226,priest,discipline,124,70,54
Педаньтяйка,gordunni,1226,priest,discipline,294,161,133
Dopemine,ragnaros,1226,priest,discipline,73,38,35
Xidrin,antonidas,1226,priest,discipline,46,23,23
Priestok,archimonde,1226,priest,discipline,30,13,17
Sprife,ragnaros,1226,priest,discipline,52,22,30
Vampirism,argent-dawn,1226,priest,discipline,42,17,25
Вреднючая,gordunni,1225,priest,discipline,54,36,18
Sanbucone,pozzo-delleternità,1225,priest,discipline,96,53,43
Índica,stormreaver,1225,priest,discipline,113,59,54
Netomv,kazzak,1225,priest,discipline,53,27,26
Хавейл,gordunni,1225,priest,discipline,119,60,59
Tüddelmôrs,eredar,1225,priest,discipline,58,29,29
Snucki,eredar,1225,priest,discipline,30,15,15
Discovery,aggra-português,1225,priest,discipline,91,45,46
Жрицазла,soulflayer,1225,priest,discipline,84,41,43
Areté,sanguino,1225,priest,discipline,36,13,23
Ãbømînåtîøn,blackrock,1224,priest,discipline,64,48,16
Zöin,minahonda,1224,priest,discipline,72,50,22
Saat,dalaran,1224,priest,discipline,32,21,11
Baglet,ravencrest,1224,priest,discipline,24,13,11
Stryymm,bloodhoof,1224,priest,discipline,35,18,17
Krakjak,twisting-nether,1224,priest,discipline,80,39,41
Ahmnesia,archimonde,1224,priest,discipline,387,187,200
Bananensuppe,kult-der-verdammten,1224,priest,discipline,120,56,64
Garie,thrall,1224,priest,discipline,122,55,67
Elfhelp,ravencrest,1224,priest,discipline,140,62,78
Suseetha,sylvanas,1224,priest,discipline,93,41,52
Рукатёмная,soulflayer,1224,priest,discipline,90,39,51
Pharli,stormscale,1224,priest,discipline,30,13,17
Nøwénna,ravencrest,1224,priest,discipline,48,13,35
Итрэ,howling-fjord,1223,priest,discipline,24,13,11
Baihoi,twilights-hammer,1223,priest,discipline,60,31,29
Nupzie,stormscale,1223,priest,discipline,111,57,54
Huhu,defias-brotherhood,1223,priest,discipline,41,21,20
Ghorfindel,kaelthas,1223,priest,discipline,113,53,60
Critikal,dun-modr,1223,priest,discipline,90,35,55
Dizzaer,terokkar,1223,priest,discipline,36,14,22
Elenyel,thunderhorn,1222,priest,discipline,18,13,5
Kafrine,kaelthas,1222,priest,discipline,81,38,43
Hülda,auchindoun,1222,priest,discipline,36,13,23
Prazefin,twisting-nether,1221,priest,discipline,28,18,10
Диери,soulflayer,1221,priest,discipline,46,27,19
Diçkhëad,ravencrest,1221,priest,discipline,133,67,66
Juicyg,ragnaros,1221,priest,discipline,30,13,17
Annéfetamine,ragnaros,1221,priest,discipline,54,19,35
Schizophrens,outland,1221,priest,discipline,57,20,37
Inaeries,argent-dawn,1220,priest,discipline,109,65,44
Faperator,arathor,1220,priest,discipline,48,25,23
Stigy,auchindoun,1220,priest,discipline,120,62,58
Aetherah,outland,1220,priest,discipline,150,75,75
Aerosoll,drakthul,1220,priest,discipline,42,21,21
Брожрец,gordunni,1220,priest,discipline,96,47,49
Nicnacz,stormscale,1220,priest,discipline,142,67,75
Самурайко,booty-bay,1220,priest,discipline,97,45,52
Gullys,drakthul,1220,priest,discipline,42,17,25
Myskou,ragnaros,1219,priest,discipline,24,19,5
Hopsalopsa,argent-dawn,1219,priest,discipline,18,13,5
Sophieelise,argent-dawn,1219,priest,discipline,35,14,21
Yoshimuri,twisting-nether,1218,priest,discipline,24,14,10
Loetharion,archimonde,1218,priest,discipline,88,47,41
Anethron,ragnaros,1218,priest,discipline,254,133,121
Helerys,archimonde,1218,priest,discipline,26,13,13
Arenarooky,eredar,1218,priest,discipline,72,35,37
Монесса,howling-fjord,1218,priest,discipline,68,32,36
Eduaro,silvermoon,1218,priest,discipline,34,15,19
Pái,ravencrest,1218,priest,discipline,49,20,29
Thakjing,bladefist,1218,priest,discipline,52,20,32
Kaleshiry,kazzak,1218,priest,discipline,54,20,34
Zhyn,turalyon,1217,priest,discipline,36,22,14
Tiïnstrument,khaz-modan,1217,priest,discipline,94,51,43
Pleistras,magtheridon,1217,priest,discipline,264,142,122
Lykster,blackrock,1217,priest,discipline,80,41,39
Сеферота,howling-fjord,1217,priest,discipline,30,15,15
Drennaria,draenor,1217,priest,discipline,83,40,43
Idjut,kazzak,1217,priest,discipline,48,22,26
Nìak,ysondre,1217,priest,discipline,100,39,61
Søs,eldrethalas,1216,priest,discipline,96,55,41
Healsquad,draenor,1216,priest,discipline,128,64,64
Шадоулайтлол,soulflayer,1216,priest,discipline,54,26,28
Goonin,frostwolf,1216,priest,discipline,54,23,31
Shadoomed,kazzak,1216,priest,discipline,78,32,46
Malaboost,archimonde,1216,priest,discipline,36,14,22
Frauheilung,blackmoore,1216,priest,discipline,71,27,44
Osyrîss,garona,1216,priest,discipline,48,16,32
Rngq,kazzak,1215,priest,discipline,23,13,10
Gooldan,draenor,1215,priest,discipline,198,108,90
Лолиэль,soulflayer,1215,priest,discipline,93,49,44
Айболитова,grom,1215,priest,discipline,45,23,22
Orbea,sinstralis,1214,priest,discipline,28,23,5
Feydottir,draenor,1214,priest,discipline,36,19,17
Valnaya,draenor,1214,priest,discipline,146,77,69
Nimako,silvermoon,1214,priest,discipline,160,78,82
Флэнсер,soulflayer,1214,priest,discipline,276,131,145
Тонкаявишня,howling-fjord,1214,priest,discipline,94,38,56
Nymrasus,ravencrest,1213,priest,discipline,24,13,11
Healheal,outland,1213,priest,discipline,250,131,119
Makrit,outland,1213,priest,discipline,158,79,79
Raî,durotan,1213,priest,discipline,62,31,31
Enerpriest,ysondre,1213,priest,discipline,96,46,50
Santinix,drakthul,1213,priest,discipline,108,48,60
Milfshâkez,blackhand,1213,priest,discipline,30,13,17
Tîwele,dalvengyr,1213,priest,discipline,79,31,48
Javiér,dun-modr,1213,priest,discipline,48,18,30
Santocerdote,sanguino,1213,priest,discipline,55,18,37
Naahmah,archimonde,1212,priest,discipline,32,21,11
Deppara,twisting-nether,1212,priest,discipline,87,49,38
Eslo,outland,1212,priest,discipline,48,26,22
Gertie,blackhand,1212,priest,discipline,106,57,49
Dâhliá,blackmoore,1212,priest,discipline,91,47,44
Dotsin,kazzak,1212,priest,discipline,311,157,154
Ziraclès,archimonde,1212,priest,discipline,54,25,29
Prev,twisting-nether,1212,priest,discipline,92,39,53
Neosix,sanguino,1211,priest,discipline,66,36,30
Gsync,drakthul,1211,priest,discipline,24,13,11
Allisandre,hellscream,1211,priest,discipline,36,18,18
Кравос,soulflayer,1211,priest,discipline,53,24,29
Izgoth,blackhand,1211,priest,discipline,38,15,23
Beliar,azshara,1211,priest,discipline,42,13,29
Confess,archimonde,1210,priest,discipline,60,32,28
Sayto,kaelthas,1210,priest,discipline,72,38,34
Nekros,agamaggan,1210,priest,discipline,38,18,20
Swaggerboy,alakir,1210,priest,discipline,41,13,28
Plavusa,nozdormu,1209,priest,discipline,36,21,15
Prognosis,frostwhisper,1209,priest,discipline,88,49,39
Jeuwls,argent-dawn,1209,priest,discipline,121,64,57
Zergo,karazhan,1209,priest,discipline,254,118,136
Bubblysis,ragnaros,1209,priest,discipline,54,22,32
Гуляль,howling-fjord,1208,priest,discipline,124,70,54
Arondir,defias-brotherhood,1208,priest,discipline,112,60,52
Dúréx,sanguino,1208,priest,discipline,45,22,23
Medipack,khaz-modan,1208,priest,discipline,129,63,66
Oncooldown,thrall,1208,priest,discipline,176,84,92
Milfelina,ravencrest,1208,priest,discipline,63,26,37
Soleyy,outland,1208,priest,discipline,44,14,30
Voodoo,the-maelstrom,1207,priest,discipline,24,13,11
Ticklebell,ravencrest,1207,priest,discipline,297,155,142
Lalola,tarren-mill,1207,priest,discipline,218,110,108
Duem,kazzak,1207,priest,discipline,62,31,31
Nëophytë,zuljin,1207,priest,discipline,84,41,43
Æsthætic,draenor,1207,priest,discipline,54,25,29
Vilda,argent-dawn,1207,priest,discipline,60,27,33
Detlaff,kazzak,1207,priest,discipline,48,19,29
Пркор,soulflayer,1206,priest,discipline,24,13,11
Крайне,soulflayer,1206,priest,discipline,108,57,51
Holymoni,ragnaros,1206,priest,discipline,60,30,30
Elanura,blackrock,1206,priest,discipline,31,15,16
Bòóni,ravencrest,1206,priest,discipline,53,23,30
Опрометчивый,soulflayer,1206,priest,discipline,56,24,32
Thyrandis,dragonblight,1206,priest,discipline,34,14,20
Хиллмориус,soulflayer,1206,priest,discipline,36,14,22
Sluttyfåk,aszune,1205,priest,discipline,29,19,10
Crazyhemsire,twisting-nether,1205,priest,discipline,54,31,23
Nethenielle,malganis,1205,priest,discipline,42,20,22
Hysteç,ragnaros,1205,priest,discipline,57,26,31
Kenderke,ragnaros,1205,priest,discipline,53,24,29
Rushax,ravencrest,1204,priest,discipline,71,44,27
Illcomback,archimonde,1204,priest,discipline,47,28,19
Siionova,antonidas,1204,priest,discipline,57,31,26
Demorog,stormscale,1204,priest,discipline,36,19,17
Тосибоська,gordunni,1204,priest,discipline,29,15,14
Asolan,drakthul,1204,priest,discipline,192,98,94
Worldjudge,kazzak,1204,priest,discipline,200,100,100
Pénancé,defias-brotherhood,1204,priest,discipline,59,28,31
Vebbysor,sylvanas,1204,priest,discipline,42,19,23
Natsukie,gorgonnash,1204,priest,discipline,60,27,33
Lillthya,kazzak,1204,priest,discipline,82,34,48
Hanic,kazzak,2421,priest,shadow,133,83,50
Huï,kazzak,2402,priest,shadow,78,58,20
Permafeetup,aegwynn,2386,priest,shadow,108,64,44
Даняпампгодх,soulflayer,2355,priest,shadow,295,153,142
Tentoumushi,ravencrest,2342,priest,shadow,108,64,44
Syedi,drakthul,2338,priest,shadow,492,257,235
Хедмэнмвп,gordunni,2329,priest,shadow,419,217,202
Yuzuflex,hyjal,2325,priest,shadow,177,95,82
Медовыедотки,soulflayer,2312,priest,shadow,173,93,80
Dianaxd,dun-modr,2294,priest,shadow,154,87,67
Raikup,ravencrest,2281,priest,shadow,131,70,61
Purpl,tarren-mill,2247,priest,shadow,204,113,91
Froffzy,tarren-mill,2239,priest,shadow,96,53,43
Pu,outland,2237,priest,shadow,229,119,110
Swdjkbad,kazzak,2233,priest,shadow,90,54,36
Yggdra,ragnaros,2229,priest,shadow,66,44,22
Польскийбуль,gordunni,2229,priest,shadow,113,62,51
Vilayetko,ravencrest,2224,priest,shadow,102,56,46
Standtall,blackrock,2218,priest,shadow,150,82,68
Dbeezy,tarren-mill,2217,priest,shadow,128,68,60
Ilovemycat,silvermoon,2214,priest,shadow,102,61,41
Тоних,deathguard,2213,priest,shadow,123,65,58
Èxtêrmìnätör,kazzak,2209,priest,shadow,114,65,49
Луисвиттон,gordunni,2209,priest,shadow,215,117,98
Mérce,kazzak,2204,priest,shadow,108,60,48
Cutepangolin,khaz-modan,2195,priest,shadow,120,70,50
Bluxon,kazzak,2195,priest,shadow,430,234,196
Djalex,ravencrest,2184,priest,shadow,215,120,95
Даняпимпгадх,soulflayer,2184,priest,shadow,429,225,204
Rrj,ravencrest,2182,priest,shadow,136,79,57
Shåmssv,kazzak,2181,priest,shadow,108,57,51
Deathlý,blackrock,2179,priest,shadow,179,96,83
Cheesecake,defias-brotherhood,2174,priest,shadow,144,78,66
Bidraget,ravencrest,2169,priest,shadow,166,96,70
Akibom,drakthul,2167,priest,shadow,149,89,60
Tekdogx,blackmoore,2167,priest,shadow,268,136,132
Хьёх,blackscar,2166,priest,shadow,107,65,42
Randyrhoads,kazzak,2166,priest,shadow,95,53,42
Xsß,dun-modr,2164,priest,shadow,113,63,50
Devoura,sylvanas,2156,priest,shadow,99,57,42
Notsoholy,blackmoore,2156,priest,shadow,192,102,90
Infuséd,aegwynn,2155,priest,shadow,90,50,40
Darthlie,draenor,2155,priest,shadow,412,205,207
Dollyboo,tarren-mill,2152,priest,shadow,125,77,48
Bensherman,dalaran,2152,priest,shadow,90,51,39
Безрассудица,howling-fjord,2150,priest,shadow,108,57,51
Voidgodx,blackrock,2145,priest,shadow,95,53,42
Prøphetx,thrall,2145,priest,shadow,296,158,138
Ekkfwiedrice,ragnaros,2144,priest,shadow,138,75,63
Genjutzux,kazzak,2138,priest,shadow,84,48,36
Liptonolda,blackhand,2138,priest,shadow,528,273,255
Slimcharles,ravencrest,2137,priest,shadow,185,107,78
Crainoo,ravencrest,2137,priest,shadow,158,80,78
Stopcatabuse,silvermoon,2136,priest,shadow,537,274,263
Cornflays,outland,2130,priest,shadow,102,54,48
Синфал,blackscar,2128,priest,shadow,340,173,167
Shadowirl,ravencrest,2127,priest,shadow,60,43,17
Ondskabsfuld,kazzak,2125,priest,shadow,120,60,60
Milania,ravencrest,2124,priest,shadow,89,59,30
Felaenna,argent-dawn,2124,priest,shadow,189,98,91
Tankeløs,kazzak,2120,priest,shadow,72,42,30
Walterwhite,stormscale,2117,priest,shadow,138,70,68
Léandrä,magtheridon,2116,priest,shadow,177,96,81
Bréézee,ravencrest,2116,priest,shadow,119,64,55
Drarianna,nemesis,2113,priest,shadow,69,43,26
Blacktrain,burning-blade,2112,priest,shadow,140,70,70
Clori,argent-dawn,2110,priest,shadow,66,50,16
Rzkp,eredar,2110,priest,shadow,93,50,43
Nousey,twisting-nether,2109,priest,shadow,310,163,147
Evazhang,outland,2108,priest,shadow,72,42,30
Melábufeis,dun-modr,2108,priest,shadow,144,81,63
Zodzín,ragnaros,2106,priest,shadow,72,36,36
Thanatae,kazzak,2105,priest,shadow,85,50,35
Skillmåsterx,ravencrest,2104,priest,shadow,101,55,46
Knútx,stormscale,2103,priest,shadow,114,63,51
Cizer,kazzak,2103,priest,shadow,233,125,108
Erenndriel,twisting-nether,2102,priest,shadow,279,157,122
Pepeshadow,twisting-nether,2102,priest,shadow,194,101,93
Amtoxic,stormscale,2100,priest,shadow,89,48,41
Uselessxasel,sanguino,2098,priest,shadow,102,57,45
Deternity,stormscale,2094,priest,shadow,153,76,77
Voidfi,kult-der-verdammten,2085,priest,shadow,120,66,54
Waltergoblin,sylvanas,2084,priest,shadow,102,63,39
Talbatex,blackmoore,2084,priest,shadow,186,92,94
Voideffsucks,stormscale,2075,priest,shadow,54,32,22
Voidlink,kazzak,2075,priest,shadow,101,57,44
Manofonéway,outland,2074,priest,shadow,184,99,85
Сделайсам,gordunni,2074,priest,shadow,219,115,104
Infernión,tarren-mill,2074,priest,shadow,113,58,55
Sphero,earthen-ring,2071,priest,shadow,148,81,67
Lovelessp,stormscale,2070,priest,shadow,78,46,32
Heffer,outland,2069,priest,shadow,224,131,93
Stjärtsten,tarren-mill,2066,priest,shadow,267,148,119
Depridolens,argent-dawn,2065,priest,shadow,188,106,82
Lâughing,ravencrest,2063,priest,shadow,291,153,138
Nukyo,blackmoore,2060,priest,shadow,68,39,29
Hansmaul,thrall,2054,priest,shadow,60,33,27
Manyus,archimonde,2053,priest,shadow,96,54,42
Billybay,argent-dawn,2051,priest,shadow,170,103,67
Mímou,kazzak,2047,priest,shadow,282,153,129
Shadowvoice,outland,2043,priest,shadow,102,55,47
Iodjsaiojoij,kazzak,2040,priest,shadow,72,39,33
Dippy,blackrock,2037,priest,shadow,106,54,52
Destinyhero,aegwynn,2034,priest,shadow,109,56,53
Mcdced,archimonde,2030,priest,shadow,193,117,76
Nabøøbies,blackmoore,2030,priest,shadow,142,75,67
Rzktwo,eredar,2027,priest,shadow,125,68,57
Sinthaa,mannoroth,2023,priest,shadow,132,65,67
Talbatexx,blackmoore,2023,priest,shadow,84,39,45
Voldemort,blackrock,2021,priest,shadow,48,30,18
Sethÿr,sanguino,2021,priest,shadow,222,116,106
Kujiua,ravencrest,2016,priest,shadow,190,110,80
Facemeltina,kiljaeden,2016,priest,shadow,72,41,31
Rýzera,aegwynn,2015,priest,shadow,42,28,14
Vülemuv,silvermoon,2013,priest,shadow,60,44,16
Salkerer,stormscale,2012,priest,shadow,60,34,26
Нинаврач,howling-fjord,2012,priest,shadow,66,36,30
Некрозмх,soulflayer,2009,priest,shadow,80,44,36
Yaboyboompie,blackrock,2009,priest,shadow,123,61,62
Drynte,blackmoore,2008,priest,shadow,78,51,27
Ikaytsym,ravencrest,2007,priest,shadow,284,158,126
Бвонсаамди,soulflayer,2006,priest,shadow,200,107,93
Ðanilox,dun-modr,2004,priest,shadow,88,45,43
Moonword,archimonde,2003,priest,shadow,48,28,20
Jynii,eredar,2001,priest,shadow,84,46,38
Zerovision,nemesis,2000,priest,shadow,221,125,96
Zhadum,stormscale,2000,priest,shadow,136,72,64
Huffle,argent-dawn,1998,priest,shadow,45,30,15
Lostcause,alakir,1998,priest,shadow,161,95,66
Genjutzu,kazzak,1997,priest,shadow,54,29,25
Vaccineboost,silvermoon,1997,priest,shadow,154,77,77
Quezaris,kazzak,1996,priest,shadow,50,40,10
Айсиоу,howling-fjord,1996,priest,shadow,60,33,27
Fishler,tarren-mill,1994,priest,shadow,59,33,26
Duzurîx,burning-blade,1994,priest,shadow,72,40,32
Demølishes,ravencrest,1990,priest,shadow,117,66,51
Sonah,der-abyssische-rat,1987,priest,shadow,68,39,29
Actionjezuz,shattered-hand,1984,priest,shadow,126,72,54
Maedhrós,ravencrest,1981,priest,shadow,48,36,12
Invoid,stormreaver,1980,priest,shadow,126,68,58
Gana,twisting-nether,1980,priest,shadow,254,131,123
Asträlaws,archimonde,1976,priest,shadow,288,161,127
Умора,razuvious,1973,priest,shadow,89,55,34
Shádówý,kazzak,1973,priest,shadow,54,29,25
Енотхд,soulflayer,1972,priest,shadow,132,70,62
Shåmssp,kazzak,1971,priest,shadow,42,34,8
Yoe,twisting-nether,1971,priest,shadow,90,47,43
Donenigma,stormscale,1970,priest,shadow,246,137,109
Rýzera,tarren-mill,1970,priest,shadow,47,26,21
Newkidx,draenor,1968,priest,shadow,132,66,66
Carmechanic,defias-brotherhood,1967,priest,shadow,166,93,73
Minblock,sanguino,1967,priest,shadow,322,162,160
Sÿrax,ysondre,1965,priest,shadow,115,66,49
Миладиель,gordunni,1965,priest,shadow,270,135,135
Önnÿ,dun-modr,1965,priest,shadow,96,48,48
Dingopriest,blackrock,1962,priest,shadow,108,65,43
Реврос,gordunni,1962,priest,shadow,108,61,47
Tacøgxd,ravencrest,1960,priest,shadow,138,82,56
Птумерианец,gordunni,1958,priest,shadow,221,118,103
Alexwinkwink,kazzak,1956,priest,shadow,119,63,56
Ðrßøtÿcûs,la-croisade-écarlate,1956,priest,shadow,63,33,30
Animesenpai,kazzak,1955,priest,shadow,132,71,61
Moretti,ravencrest,1953,priest,shadow,54,32,22
Tenebraes,kazzak,1951,priest,shadow,112,62,50
Xayona,argent-dawn,1951,priest,shadow,77,38,39
Zoodiacp,blackrock,1950,priest,shadow,191,92,99
Velence,ravencrest,1946,priest,shadow,210,116,94
Шадоупуз,soulflayer,1946,priest,shadow,253,123,130
Perché,silvermoon,1945,priest,shadow,66,48,18
Гоплзнекст,gordunni,1944,priest,shadow,216,116,100
Холихэйт,howling-fjord,1943,priest,shadow,69,43,26
Rnkz,sanguino,1943,priest,shadow,102,57,45
Covidisc,outland,1943,priest,shadow,168,89,79
Räke,blackrock,1942,priest,shadow,144,72,72
Ká,outland,1941,priest,shadow,84,56,28
Physxd,blackrock,1939,priest,shadow,66,44,22
Smxkÿÿ,eredar,1939,priest,shadow,59,36,23
Jaimë,ravencrest,1938,priest,shadow,54,31,23
Vajainap,outland,1936,priest,shadow,48,27,21
Ottii,thrall,1936,priest,shadow,185,97,88
Ktulsotum,twisting-nether,1934,priest,shadow,78,44,34
Томрэдл,blackscar,1933,priest,shadow,182,101,81
Rãpidi,hyjal,1932,priest,shadow,89,56,33
Tbs,sylvanas,1932,priest,shadow,189,109,80
Dogstav,kazzak,1932,priest,shadow,60,32,28
Heal,hyjal,1931,priest,shadow,284,156,128
Cathrix,kazzak,1929,priest,shadow,78,49,29
Массаракъш,razuvious,1929,priest,shadow,81,47,34
Dakotapriest,ravencrest,1929,priest,shadow,102,55,47
Angsty,blackrock,1928,priest,shadow,207,105,102
Эсдаль,howling-fjord,1920,priest,shadow,150,88,62
Пристатеист,howling-fjord,1920,priest,shadow,90,47,43
Justtpro,twisting-nether,1919,priest,shadow,211,119,92
Sonâkî,archimonde,1914,priest,shadow,57,33,24
Insanious,skullcrusher,1912,priest,shadow,226,119,107
Elnyashka,ravencrest,1911,priest,shadow,162,92,70
Syniixp,aegwynn,1910,priest,shadow,48,34,14
Weekfortyone,blackhand,1909,priest,shadow,152,74,78
Morseeii,baelgun,1908,priest,shadow,78,44,34
Akolyte,blackmoore,1906,priest,shadow,48,28,20
Ктулсотум,soulflayer,1906,priest,shadow,97,56,41
Ezlife,blackrock,1906,priest,shadow,84,48,36
Buøbuarns,sanguino,1906,priest,shadow,158,77,81
Sadgepriest,draenor,1905,priest,shadow,42,23,19
Seijobaesuzy,archimonde,1904,priest,shadow,54,32,22
Pandacore,frostmane,1904,priest,shadow,60,30,30
Ecquidozx,ravencrest,1903,priest,shadow,65,35,30
Xiä,archimonde,1903,priest,shadow,192,102,90
Been,ravencrest,1902,priest,shadow,77,41,36
Milkysmite,twisting-nether,1901,priest,shadow,82,48,34
Gymbró,kazzak,1900,priest,shadow,72,39,33
Miraçlê,kazzak,1899,priest,shadow,102,65,37
Wérrýxs,kazzak,1899,priest,shadow,193,115,78
Omedo,stormscale,1899,priest,shadow,42,23,19
Darthmantle,silvermoon,1898,priest,shadow,77,43,34
Петушшара,gordunni,1897,priest,shadow,81,43,38
Ninjajane,sylvanas,1896,priest,shadow,203,112,91
Shadowmate,silvermoon,1895,priest,shadow,68,35,33
Physx,blackrock,1894,priest,shadow,42,23,19
Ымц,gordunni,1894,priest,shadow,168,86,82
Qoryn,ravencrest,1893,priest,shadow,114,60,54
Лайфстилх,blackscar,1892,priest,shadow,132,68,64
Nanna,agamaggan,1892,priest,shadow,418,212,206
Dümbledore,aggra-português,1891,priest,shadow,148,81,67
Rakamain,ravencrest,1890,priest,shadow,72,45,27
Døubtful,kazzak,1890,priest,shadow,36,20,16
Estragon,quelthalas,1890,priest,shadow,117,60,57
Левелнесс,howling-fjord,1889,priest,shadow,127,78,49
Satin,twilights-hammer,1888,priest,shadow,129,73,56
Keypo,khaz-modan,1887,priest,shadow,240,125,115
ßrb,sylvanas,1887,priest,shadow,82,42,40
Shiannâ,malganis,1884,priest,shadow,67,38,29
Rrobaqepesi,twisting-nether,1883,priest,shadow,85,51,34
Zeawee,frostmane,1881,priest,shadow,78,51,27
Dreamhatcher,deathwing,1879,priest,shadow,179,97,82
Lløthx,ravencrest,1878,priest,shadow,131,70,61
Steckî,blackmoore,1877,priest,shadow,42,27,15
Zabpriest,blackhand,1877,priest,shadow,76,45,31
Ahle,darkspear,1875,priest,shadow,53,29,24
Crowny,ysondre,1873,priest,shadow,60,31,29
Buan,blackmoore,1872,priest,shadow,113,70,43
Sqwabblepee,stormscale,1872,priest,shadow,167,99,68
Мистериум,howling-fjord,1872,priest,shadow,194,106,88
Snoopý,dun-modr,1872,priest,shadow,237,129,108
Magicalme,kult-der-verdammten,1871,priest,shadow,48,30,18
Kwolinger,norgannon,1871,priest,shadow,128,74,54
Stümpý,ravencrest,1870,priest,shadow,79,44,35
Ilunfabilffa,argent-dawn,1869,priest,shadow,49,32,17
Røst,ravencrest,1869,priest,shadow,47,29,18
Ølle,ravencrest,1869,priest,shadow,90,54,36
Бхонсамди,blackscar,1869,priest,shadow,107,61,46
Shuturmouth,ravencrest,1868,priest,shadow,144,81,63
Keijuna,kazzak,1868,priest,shadow,48,25,23
Râvyn,silvermoon,1866,priest,shadow,44,35,9
Sepharis,runetotem,1863,priest,shadow,209,124,85
Lësstat,hyjal,1862,priest,shadow,60,37,23
Криптика,soulflayer,1862,priest,shadow,114,63,51
Бомжскадилом,gordunni,1862,priest,shadow,322,175,147
Shucks,stormscale,1862,priest,shadow,74,37,37
Gumayusi,ravencrest,1860,priest,shadow,39,25,14
Snarks,sylvanas,1859,priest,shadow,42,24,18
Bownsamdi,tarren-mill,1859,priest,shadow,97,54,43
Slimshadey,malganis,1857,priest,shadow,48,27,21
Jpd,outland,1857,priest,shadow,54,29,25
Gladinbedirl,ravencrest,1856,priest,shadow,48,33,15
Бархомелфой,gordunni,1856,priest,shadow,95,56,39
Убикрофт,soulflayer,1855,priest,shadow,36,23,13
Rockness,blackmoore,1854,priest,shadow,137,91,46
Fläschheal,aegwynn,1853,priest,shadow,48,33,15
Ataraxia,ravencrest,1853,priest,shadow,48,31,17
Framesxøxø,ravencrest,1853,priest,shadow,124,73,51
Тарренмилл,gordunni,1853,priest,shadow,98,57,41
Sudeki,blackmoore,1853,priest,shadow,66,35,31
Аликслинкс,howling-fjord,1851,priest,shadow,36,22,14
Raspberrypíe,silvermoon,1850,priest,shadow,120,73,47
Пурпле,soulflayer,1849,priest,shadow,180,92,88
Ageyr,ragnaros,1848,priest,shadow,95,60,35
Onlycans,tarren-mill,1848,priest,shadow,48,30,18
Hòllymèdx,blackmoore,1848,priest,shadow,63,38,25
Either,kazzak,1848,priest,shadow,65,36,29
Iessei,outland,1848,priest,shadow,175,93,82
Mafiasnipers,ravencrest,1847,priest,shadow,36,21,15
Blindöts,tarren-mill,1847,priest,shadow,47,27,20
Unicycle,emerald-dream,1847,priest,shadow,60,32,28
Versio,dalvengyr,1847,priest,shadow,54,28,26
Garycash,outland,1847,priest,shadow,288,148,140
Djzerøgodx,frostwolf,1847,priest,shadow,109,56,53
Hiddenhealz,blackrock,1846,priest,shadow,158,89,69
Shukhêvych,kazzak,1846,priest,shadow,161,81,80
Vitapriest,silvermoon,1846,priest,shadow,140,70,70
Plogic,tarren-mill,1845,priest,shadow,59,40,19
Qwertyuioasd,ravencrest,1845,priest,shadow,48,27,21
Mojoo,aggramar,1845,priest,shadow,56,31,25
Pipf,blackmoore,1844,priest,shadow,65,41,24
Staljon,burning-legion,1844,priest,shadow,161,89,72
Trisks,ravencrest,1843,priest,shadow,34,20,14
Astolfo,blackrock,1841,priest,shadow,150,91,59
Absolution,stormscale,1841,priest,shadow,281,156,125
Liloz,eredar,1841,priest,shadow,65,35,30
Cyrená,ravencrest,1840,priest,shadow,66,34,32
Celdoria,eredar,1839,priest,shadow,54,30,24
Holyshadów,azjolnerub,1839,priest,shadow,310,168,142
Офелла,howling-fjord,1839,priest,shadow,618,326,292
Vibéz,outland,1839,priest,shadow,54,28,26
Прыст,howling-fjord,1838,priest,shadow,81,48,33
Jeppehpräst,stormscale,1837,priest,shadow,84,50,34
Amazingame,tarren-mill,1837,priest,shadow,59,27,32
Goodsuck,tarren-mill,1836,priest,shadow,107,62,45
Cruncher,ravencrest,1836,priest,shadow,60,31,29
Johnnybanana,argent-dawn,1835,priest,shadow,41,26,15
Mentax,kazzak,1835,priest,shadow,113,65,48
Maryhugette,archimonde,1835,priest,shadow,338,168,170
Stazia,ravencrest,1834,priest,shadow,41,24,17
Ансор,lich-king,1834,priest,shadow,183,96,87
Mýxir,burning-legion,1834,priest,shadow,89,45,44
Hoesfavorite,onyxia,1833,priest,shadow,163,94,69
Najany,archimonde,1833,priest,shadow,54,31,23
Magicstarss,the-maelstrom,1833,priest,shadow,96,52,44
Shøana,archimonde,1833,priest,shadow,107,50,57
Daykenp,kazzak,1832,priest,shadow,42,26,16
Tupal,ysondre,1829,priest,shadow,78,43,35
Schmetter,tarren-mill,1829,priest,shadow,65,29,36
Nøwmäck,archimonde,1828,priest,shadow,66,33,33
Fionsacré,archimonde,1827,priest,shadow,58,39,19
Æßsåløønå,la-croisade-écarlate,1827,priest,shadow,36,24,12
Mørphics,ravencrest,1827,priest,shadow,42,26,16
Kagarr,kazzak,1827,priest,shadow,155,94,61
Selëne,blackrock,1827,priest,shadow,72,43,29
Термидор,booty-bay,1827,priest,shadow,131,75,56
Rexonaqq,kazzak,1827,priest,shadow,72,35,37
Шадоуприст,blackscar,1826,priest,shadow,42,31,11
Сариандра,gordunni,1826,priest,shadow,345,195,150
Tradeforheal,hyjal,1826,priest,shadow,265,144,121
Anateoris,turalyon,1825,priest,shadow,76,43,33
Mirill,tarren-mill,1825,priest,shadow,211,116,95
Quezaris,stormscale,1825,priest,shadow,48,23,25
Babarøga,blackrock,1824,priest,shadow,124,67,57
Cantsqell,silvermoon,1823,priest,shadow,48,34,14
Cnsnn,ysondre,1823,priest,shadow,114,76,38
Христианин,gordunni,1823,priest,shadow,156,91,65
Oddarne,twisting-nether,1823,priest,shadow,87,46,41
Трейдарк,blackscar,1823,priest,shadow,60,31,29
Whynolove,ragnaros,1822,priest,shadow,101,69,32
Waina,defias-brotherhood,1822,priest,shadow,207,105,102
Диспайзи,gordunni,1821,priest,shadow,30,22,8
Sandcastles,ravencrest,1821,priest,shadow,140,88,52
Príêstjklól,stormscale,1821,priest,shadow,42,25,17
Nyotux,blackrock,1821,priest,shadow,140,82,58
Yirico,argent-dawn,1820,priest,shadow,47,31,16
Virtualworld,ragnaros,1820,priest,shadow,30,19,11
Dreadest,blackhand,1820,priest,shadow,90,52,38
Edoran,ragnaros,1820,priest,shadow,59,31,28
Pljoe,ravencrest,1819,priest,shadow,81,46,35
Blóódfart,kazzak,1819,priest,shadow,89,43,46
Xangha,burning-legion,1818,priest,shadow,168,99,69
Энмунд,borean-tundra,1818,priest,shadow,243,141,102
Önlyfans,draenor,1818,priest,shadow,84,48,36
Voidshuffle,laughing-skull,1818,priest,shadow,42,24,18
Диспайзх,gordunni,1817,priest,shadow,66,38,28
Divinetouch,ravencrest,1817,priest,shadow,77,42,35
Violatio,aegwynn,1817,priest,shadow,318,171,147
Дикаях,gordunni,1816,priest,shadow,159,84,75
Sakuyasp,blackrock,1816,priest,shadow,381,196,185
Akroama,archimonde,1816,priest,shadow,158,80,78
Chokipoki,twisting-nether,1815,priest,shadow,194,113,81
Makethemstop,bronzebeard,1814,priest,shadow,166,104,62
Øctawtöuch,kazzak,1814,priest,shadow,88,53,35
Êvil,ravencrest,1814,priest,shadow,41,24,17
Barthólomew,doomhammer,1814,priest,shadow,158,86,72
Найтингеилл,gordunni,1814,priest,shadow,95,50,45
Adub,tarren-mill,1814,priest,shadow,78,41,37
Wortmonster,malganis,1813,priest,shadow,53,31,22
Stèálth,sylvanas,1812,priest,shadow,24,19,5
Kobiden,stormreaver,1812,priest,shadow,89,50,39
Helín,hellfire,1812,priest,shadow,152,85,67
Vøîdgødx,antonidas,1812,priest,shadow,70,37,33
Gyom,sargeras,1811,priest,shadow,38,27,11
Zërøx,ysondre,1811,priest,shadow,30,19,11
Heilsarmee,blackhand,1811,priest,shadow,129,68,61
Tosem,antonidas,1810,priest,shadow,66,41,25
Kozou,tarren-mill,1810,priest,shadow,54,33,21
Dhurza,shendralar,1810,priest,shadow,153,83,70
Hellscon,kazzak,1810,priest,shadow,197,103,94
Шпх,howling-fjord,1810,priest,shadow,60,31,29
Truckysp,sanguino,1810,priest,shadow,66,26,40
Muyhuman,eredar,1809,priest,shadow,36,25,11
Djstache,tarren-mill,1809,priest,shadow,48,32,16
Minaegi,aegwynn,1809,priest,shadow,84,53,31
Drvoidit,blackrock,1809,priest,shadow,48,28,20
Ounxx,blackrock,1809,priest,shadow,149,84,65
Becknarbritt,stormscale,1809,priest,shadow,352,193,159
Lebronjay,ravencrest,1809,priest,shadow,142,76,66
Scade,kazzak,1809,priest,shadow,130,66,64
Фростингшп,goldrinn,1808,priest,shadow,42,31,11
Luvlyrah,draenor,1808,priest,shadow,105,64,41
Spklooril,hyjal,1808,priest,shadow,372,195,177
Yoii,nemesis,1808,priest,shadow,66,34,32
Meatyshaft,doomhammer,1807,priest,shadow,99,64,35
Driptoohard,archimonde,1807,priest,shadow,52,29,23
Theoniss,draenor,1807,priest,shadow,215,115,100
Адскийприст,gordunni,1807,priest,shadow,63,32,31
Príêstjklòl,stormscale,1807,priest,shadow,65,31,34
Lr,aszune,1806,priest,shadow,36,25,11
Debbski,tarren-mill,1806,priest,shadow,48,30,18
Kiesp,tarren-mill,1806,priest,shadow,210,115,95
Statìk,outland,1806,priest,shadow,445,234,211
Иннрей,soulflayer,1806,priest,shadow,123,58,65
Syntara,twisting-nether,1805,priest,shadow,80,50,30
Claritycraft,twisting-nether,1805,priest,shadow,36,22,14
Theunknown,thrall,1805,priest,shadow,83,49,34
Arendt,blackhand,1805,priest,shadow,60,34,26
Azæriø,rashgarroth,1804,priest,shadow,118,68,50
Solaclypsa,destromath,1803,priest,shadow,36,26,10
Sikola,ragnaros,1803,priest,shadow,52,32,20
Mataî,kazzak,1803,priest,shadow,84,49,35
Spurge,ravencrest,1803,priest,shadow,63,29,34
Нед,greymane,1802,priest,shadow,82,49,33
Zahadoom,stormscale,1802,priest,shadow,232,127,105
Margots,kazzak,1802,priest,shadow,42,22,20
Phucu,the-maelstrom,1801,priest,shadow,78,48,30
Клаима,soulflayer,1801,priest,shadow,124,72,52
Mindtyson,dun-morogh,1801,priest,shadow,114,66,48
Всезнайка,soulflayer,1801,priest,shadow,150,82,68
Sleypriest,draenor,1800,priest,shadow,48,32,16
Pórt,kazzak,1800,priest,shadow,63,39,24
Erdine,ravencrest,1800,priest,shadow,96,53,43
Verbs,kazzak,1797,priest,shadow,94,44,50
Lindp,stormreaver,1795,priest,shadow,96,59,37
Papie,kazzak,1795,priest,shadow,54,30,24
Zindrix,silvermoon,1794,priest,shadow,90,52,38
Homxcxde,ravencrest,1793,priest,shadow,48,26,22
Zultor,ragnaros,1792,priest,shadow,55,32,23
Raisedbyrap,blackrock,1791,priest,shadow,60,33,27
Extralite,stormscale,1790,priest,shadow,117,67,50
Mehtz,ravencrest,1790,priest,shadow,458,231,227
Ûñrêpørtablë,outland,1786,priest,shadow,35,27,8
Cometopastor,skullcrusher,1786,priest,shadow,73,39,34
Sevtwo,tarren-mill,1783,priest,shadow,84,56,28
Свдпрох,soulflayer,1781,priest,shadow,57,29,28
Simôc,eredar,1781,priest,shadow,108,52,56
Agotax,outland,1780,priest,shadow,66,42,24
Староезло,gordunni,1780,priest,shadow,138,65,73
Yêl,thrall,1779,priest,shadow,283,153,130
Megajuicy,blackmoore,1777,priest,shadow,264,145,119
Galatea,les-sentinelles,1777,priest,shadow,90,49,41
Spamplague,stormscale,1776,priest,shadow,96,52,44
Shroomza,blackmoore,1776,priest,shadow,60,27,33
Ptxd,alakir,1775,priest,shadow,138,72,66
Luphriest,ravencrest,1774,priest,shadow,54,25,29
Mond,eredar,1772,priest,shadow,140,76,64
Tremrfinger,dun-modr,1769,priest,shadow,98,53,45
Ftiersp,ravencrest,1768,priest,shadow,77,42,35
Ephara,outland,1767,priest,shadow,166,92,74
Schizophrens,outland,1766,priest,shadow,48,28,20
Jaimee,zirkel-des-cenarius,1765,priest,shadow,48,31,17
Boluclac,archimonde,1765,priest,shadow,42,24,18
Påsøk,stormscale,1765,priest,shadow,83,47,36
Flexzpriest,destromath,1764,priest,shadow,132,71,61
Ayhuasca,blackmoore,1763,priest,shadow,297,156,141
Elishîa,ragnaros,1763,priest,shadow,106,52,54
Häst,the-maelstrom,1762,priest,shadow,49,32,17
Rubín,sylvanas,1762,priest,shadow,68,41,27
Djops,outland,1762,priest,shadow,188,95,93
Шандресса,deepholm,1761,priest,shadow,48,31,17
Miruh,malganis,1759,priest,shadow,215,129,86
Anabølix,ravencrest,1758,priest,shadow,54,28,26
Klosso,anachronos,1758,priest,shadow,470,232,238
Фримекс,soulflayer,1756,priest,shadow,42,28,14
Awatør,ysondre,1756,priest,shadow,35,19,16
Алурелис,blackscar,1755,priest,shadow,42,25,17
Morgá,draenor,1755,priest,shadow,67,39,28
Õðæßìùa,kazzak,1753,priest,shadow,35,22,13
Mèöw,argent-dawn,1753,priest,shadow,149,84,65
Víppe,stormreaver,1753,priest,shadow,125,70,55
Targolina,argent-dawn,1753,priest,shadow,200,106,94
Biøhazard,tarren-mill,1752,priest,shadow,64,32,32
Hinorist,kazzak,1751,priest,shadow,105,60,45
Namsolo,kazzak,1751,priest,shadow,84,43,41
Fabulicious,blackrock,1751,priest,shadow,57,28,29
Shadowyx,dun-modr,1749,priest,shadow,112,63,49
Wtrix,stormscale,1748,priest,shadow,48,28,20
Alfredosauce,ravencrest,1748,priest,shadow,112,55,57
Kylähullu,ravencrest,1746,priest,shadow,134,71,63
Andreel,ravencrest,1746,priest,shadow,118,62,56
Geløpr,eredar,1744,priest,shadow,185,100,85
Fakecastguru,ravencrest,1744,priest,shadow,106,56,50
Скайвэйуокер,howling-fjord,1743,priest,shadow,101,58,43
Spherics,ravencrest,1743,priest,shadow,54,27,27
Seneth,twisting-nether,1740,priest,shadow,214,115,99
Øxytøcin,ravencrest,1737,priest,shadow,246,129,117
Iløvescärlet,khaz-modan,1736,priest,shadow,127,76,51
Oniakusa,outland,1736,priest,shadow,36,20,16
Sadix,ravencrest,1736,priest,shadow,133,68,65
Jegred,draenor,1735,priest,shadow,85,55,30
Zuhä,twisting-nether,1734,priest,shadow,78,38,40
Atahalni,argent-dawn,1734,priest,shadow,232,113,119
Joeqt,stormscale,1734,priest,shadow,227,109,118
Чикхоп,blackscar,1733,priest,shadow,144,91,53
Basxcbxtchx,ravencrest,1733,priest,shadow,48,29,19
Brûshie,kazzak,1733,priest,shadow,90,51,39
Wixzyx,ravencrest,1732,priest,shadow,48,26,22
Jonig,blackmoore,1732,priest,shadow,142,76,66
Qzrx,outland,1731,priest,shadow,75,42,33
Necrofeel,silvermoon,1731,priest,shadow,47,26,21
Megamann,dun-morogh,1731,priest,shadow,96,46,50
Nàstyx,ravencrest,1730,priest,shadow,48,28,20
Dezerta,nozdormu,1730,priest,shadow,100,55,45
Hasa,stormreaver,1730,priest,shadow,66,36,30
Priestfive,stormscale,1728,priest,shadow,78,46,32
Shdwfizk,ravencrest,1727,priest,shadow,48,30,18
Ризорпанда,soulflayer,1727,priest,shadow,59,33,26
Игорянатакуе,eversong,1727,priest,shadow,379,196,183
Khålyst,archimonde,1726,priest,shadow,60,29,31
Joniop,stormreaver,1725,priest,shadow,101,60,41
Raitwo,kazzak,1725,priest,shadow,155,85,70
Juxtapose,argent-dawn,1722,priest,shadow,66,50,16
Arima,kargath,1722,priest,shadow,94,61,33
Рейвор,gordunni,1722,priest,shadow,167,92,75
Aereza,darkspear,1722,priest,shadow,208,114,94
Mindseven,emeriss,1721,priest,shadow,42,23,19
Strvnge,stormreaver,1721,priest,shadow,65,30,35
Йоййо,gordunni,1720,priest,shadow,380,199,181
Kharòn,grim-batol,1719,priest,shadow,89,55,34
Кломми,gordunni,1718,priest,shadow,84,45,39
Cielavinja,aszune,1718,priest,shadow,62,33,29
Миссклик,goldrinn,1717,priest,shadow,160,97,63
Drë,daggerspine,1717,priest,shadow,98,48,50
Anabølixx,ravencrest,1716,priest,shadow,24,18,6
Vaßpera,tarren-mill,1716,priest,shadow,159,87,72
Knoffp,blackhand,1715,priest,shadow,138,78,60
Settemsen,tarren-mill,1714,priest,shadow,42,29,13
Sweetepi,blackmoore,1714,priest,shadow,54,32,22
Филяфан,gordunni,1714,priest,shadow,135,73,62
Báh,tarren-mill,1714,priest,shadow,66,32,34
Halysion,ravencrest,1714,priest,shadow,54,26,28
Sebbepriest,twisting-nether,1713,priest,shadow,344,183,161
Zhyn,turalyon,1712,priest,shadow,127,73,54
Bizzlebabe,lightbringer,1711,priest,shadow,24,18,6
Spinggwin,burning-legion,1710,priest,shadow,257,155,102
Priesless,sylvanas,1708,priest,shadow,96,52,44
Ревентонх,howling-fjord,1706,priest,shadow,266,143,123
Naronas,drakthul,1705,priest,shadow,72,45,27
Taeraz,archimonde,1705,priest,shadow,30,18,12
Флэшх,soulflayer,1705,priest,shadow,213,114,99
Spriestisbad,hyjal,1704,priest,shadow,30,18,12
Backpedaling,kazzak,1704,priest,shadow,174,84,90
Sakanade,twisting-nether,1703,priest,shadow,96,66,30
Dpyo,ravencrest,1703,priest,shadow,36,18,18
Skeida,bloodhoof,1703,priest,shadow,131,64,67
Thrakoun,twilights-hammer,1701,priest,shadow,167,90,77
Рэнфан,fordragon,1700,priest,shadow,94,61,33
Ittei,stormscale,1700,priest,shadow,123,77,46
Kêrrýgold,blackrock,1700,priest,shadow,163,90,73
Onlyfansp,ravencrest,1699,priest,shadow,48,22,26
Rasha,kazzak,1698,priest,shadow,90,51,39
Fandac,sylvanas,1697,priest,shadow,53,32,21
Фиброз,blackscar,1697,priest,shadow,120,68,52
Daspyen,silvermoon,1697,priest,shadow,85,46,39
Bigblackdot,grim-batol,1697,priest,shadow,54,27,27
Craquylx,hyjal,1696,priest,shadow,42,30,12
Undefined,chamber-of-aspects,1694,priest,shadow,52,36,16
Malaíka,silvermoon,1694,priest,shadow,99,56,43
Dazé,ravencrest,1694,priest,shadow,77,42,35
Peaksp,stormscale,1692,priest,shadow,66,40,26
Mizulol,ravencrest,1691,priest,shadow,251,124,127
Jaanny,defias-brotherhood,1691,priest,shadow,62,30,32
Sebrøk,nemesis,1690,priest,shadow,30,20,10
Rekson,alleria,1690,priest,shadow,60,33,27
Ankî,aegwynn,1689,priest,shadow,132,67,65
Drakzx,kazzak,1687,priest,shadow,36,24,12
Tamy,draenor,1687,priest,shadow,165,103,62
Elenie,frostwolf,1687,priest,shadow,103,56,47
Сёдзира,gordunni,1687,priest,shadow,156,84,72
Kamish,twisting-nether,1687,priest,shadow,186,98,88
Coffíndodger,magtheridon,1686,priest,shadow,32,20,12
Emala,hyjal,1686,priest,shadow,42,20,22
Lzopyec,outland,1685,priest,shadow,36,23,13
Wizsp,tarren-mill,1684,priest,shadow,48,26,22
Tùcøcø,archimonde,1684,priest,shadow,54,26,28
Voodkaa,drakthul,1683,priest,shadow,141,76,65
Lolapalula,tarren-mill,1683,priest,shadow,195,103,92
Déép,nazjatar,1682,priest,shadow,32,18,14
Llothx,ravencrest,1682,priest,shadow,114,63,51
Nadoreille,hyjal,1681,priest,shadow,115,63,52
Sleeg,tarren-mill,1681,priest,shadow,35,19,16
Cooldgreyjoy,archimonde,1681,priest,shadow,76,39,37
Anexxia,outland,1681,priest,shadow,48,23,25
Kuddles,hyjal,1680,priest,shadow,200,117,83
Jacep,kazzak,1679,priest,shadow,54,30,24
Carlogambino,dethecus,1678,priest,shadow,60,25,35
Reapzbolt,blackrock,1677,priest,shadow,120,58,62
Peprama,stormscale,1676,priest,shadow,138,76,62
Valheri,blackhand,1676,priest,shadow,46,24,22
Valadaris,outland,1675,priest,shadow,132,74,58
Jóhnnybravó,kazzak,1675,priest,shadow,123,68,55
Распутинова,galakrond,1675,priest,shadow,78,43,35
Tarantos,uldum,1675,priest,shadow,222,117,105
Cthultist,dun-modr,1675,priest,shadow,108,52,56
Because,nemesis,1674,priest,shadow,48,28,20
Синатро,deathguard,1674,priest,shadow,244,141,103
Пампнавечерх,blackscar,1674,priest,shadow,65,35,30
Zeythz,ravencrest,1674,priest,shadow,281,149,132
Waruum,outland,1673,priest,shadow,94,52,42
Galadrielkä,drakthul,1673,priest,shadow,60,33,27
Yngp,blackmoore,1673,priest,shadow,66,36,30
Файерин,soulflayer,1672,priest,shadow,126,60,66
Ðrwiz,ravencrest,1671,priest,shadow,42,23,19
Fueguchi,anubarak,1670,priest,shadow,119,62,57
Ансарм,gordunni,1670,priest,shadow,294,153,141
Hypnocat,blackrock,1670,priest,shadow,106,54,52
Draryanna,nemesis,1669,priest,shadow,42,23,19
Mojibien,burning-legion,1669,priest,shadow,161,88,73
Tsunadesaama,silvermoon,1668,priest,shadow,63,32,31
Svettvrede,sylvanas,1668,priest,shadow,89,44,45
Lenneyqt,blackmoore,1667,priest,shadow,54,31,23
Niketn,aegwynn,1667,priest,shadow,60,32,28
Asterixsu,sylvanas,1665,priest,shadow,60,38,22
Adaseth,tarren-mill,1665,priest,shadow,234,136,98
Levitation,alakir,1665,priest,shadow,78,45,33
Vavulya,blackhand,1665,priest,shadow,389,206,183
Kättare,stormscale,1663,priest,shadow,102,57,45
Valdiona,tarren-mill,1662,priest,shadow,112,68,44
Aleetheia,silvermoon,1662,priest,shadow,225,124,101
Díspelbot,ravencrest,1661,priest,shadow,39,24,15
Khäñ,ravencrest,1661,priest,shadow,227,116,111
Daisyduke,veknilash,1661,priest,shadow,81,41,40
Rházael,blackrock,1661,priest,shadow,65,31,34
Smiles,burning-steppes,1660,priest,shadow,125,72,53
Eupz,argent-dawn,1659,priest,shadow,79,42,37
Киндзер,blackscar,1658,priest,shadow,54,29,25
Equalìzer,ravencrest,1657,priest,shadow,25,22,3
Мисатэ,gordunni,1657,priest,shadow,214,121,93
Acosp,sylvanas,1657,priest,shadow,42,21,21
Moodzlol,eredar,1656,priest,shadow,48,28,20
Dotreveal,ravencrest,1656,priest,shadow,48,26,22
Shreedx,stormscale,1655,priest,shadow,66,39,27
Youguessedit,twisting-nether,1654,priest,shadow,106,55,51
Chas,argent-dawn,1654,priest,shadow,93,45,48
Виталябард,gordunni,1654,priest,shadow,66,30,36
Ihu,nazjatar,1653,priest,shadow,161,79,82
Shadowsig,silvermoon,1652,priest,shadow,237,124,113
Theorcpriest,kazzak,1651,priest,shadow,36,25,11
Essumies,stormreaver,1651,priest,shadow,44,30,14
Jim,saurfang,1651,priest,shadow,48,27,21
Финдовский,gordunni,1649,priest,shadow,102,54,48
Høly,chogall,1648,priest,shadow,96,55,41
Ruhe,silvermoon,1648,priest,shadow,48,27,21
Sypnos,zuljin,1647,priest,shadow,78,47,31
Zârvâjh,aszune,1647,priest,shadow,60,33,27
Хелектро,deathweaver,1647,priest,shadow,88,46,42
Rubzler,ravencrest,1647,priest,shadow,42,20,22
Shendilka,drakthul,1645,priest,shadow,45,30,15
Sûzy,ravencrest,1645,priest,shadow,94,54,40
Akris,ragnaros,1645,priest,shadow,154,85,69
Discknight,kazzak,1645,priest,shadow,60,24,36
Дзинкз,howling-fjord,1644,priest,shadow,52,29,23
Aaj,twisting-nether,1644,priest,shadow,69,37,32
Psychø,kazzak,1644,priest,shadow,72,38,34
Djariisimp,tarren-mill,1643,priest,shadow,36,21,15
Foxiekitten,tarren-mill,1640,priest,shadow,34,23,11
Chinko,blackmoore,1640,priest,shadow,92,58,34
Milo,argent-dawn,1640,priest,shadow,102,61,41
Казуямисима,gordunni,1640,priest,shadow,211,110,101
Gødsmack,blackhand,1640,priest,shadow,38,19,19
Äiri,blackmoore,1639,priest,shadow,82,48,34
ßelfy,twisting-nether,1639,priest,shadow,97,55,42
Mikizu,die-aldor,1638,priest,shadow,42,21,21
Soyzanahôria,zuljin,1638,priest,shadow,69,34,35
Ксерф,soulflayer,1638,priest,shadow,138,67,71
Hîlaryduff,dun-modr,1637,priest,shadow,59,28,31
Zinxe,ravencrest,1636,priest,shadow,121,73,48
Belialzs,blackrock,1636,priest,shadow,45,24,21
Mackings,the-maelstrom,1636,priest,shadow,172,89,83
Turah,the-maelstrom,1635,priest,shadow,36,22,14
Syreet,silvermoon,1635,priest,shadow,35,20,15
Toesxcker,stormscale,1635,priest,shadow,59,32,27
Cederpriest,tarren-mill,1635,priest,shadow,163,79,84
Bigdogone,arathor,1632,priest,shadow,52,29,23
Milamati,kazzak,1632,priest,shadow,78,39,39
Rynsym,ravencrest,1632,priest,shadow,72,36,36
Waycrest,ravencrest,1631,priest,shadow,83,52,31
Sosûke,archimonde,1631,priest,shadow,36,22,14
Мишатемный,gordunni,1631,priest,shadow,84,50,34
Toxxjq,sylvanas,1631,priest,shadow,135,75,60
Gbc,emerald-dream,1630,priest,shadow,30,17,13
Yrr,draenor,1630,priest,shadow,47,24,23
Iamthebarbie,sanguino,1629,priest,shadow,49,27,22
Аркприст,gordunni,1628,priest,shadow,62,35,27
Вэйворс,blackscar,1628,priest,shadow,172,95,77
Ахаххааха,gordunni,1628,priest,shadow,60,32,28
Амбрелка,fordragon,1628,priest,shadow,612,307,305
Билетлолпро,borean-tundra,1627,priest,shadow,30,17,13
Rippeep,emerald-dream,1627,priest,shadow,30,17,13
Ðòóm,archimonde,1627,priest,shadow,156,85,71
Rumbo,lightnings-blade,1627,priest,shadow,95,50,45
Tøm,silvermoon,1627,priest,shadow,48,25,23
Педрец,howling-fjord,1626,priest,shadow,144,74,70
Mohapriest,kazzak,1626,priest,shadow,77,34,43
Joncokejones,azjolnerub,1625,priest,shadow,42,20,22
Xuzilul,antonidas,1624,priest,shadow,72,40,32
Pbwser,silvermoon,1624,priest,shadow,42,22,20
Apèx,blackrock,1624,priest,shadow,99,50,49
Skypez,blackhand,1623,priest,shadow,277,147,130
Jønnybanana,blackrock,1623,priest,shadow,39,20,19
Wivienne,defias-brotherhood,1623,priest,shadow,56,25,31
Affex,tarren-mill,1622,priest,shadow,30,18,12
Дэспира,howling-fjord,1622,priest,shadow,76,40,36
Aliocha,dalaran,1622,priest,shadow,58,27,31
Imaut,emerald-dream,1621,priest,shadow,86,44,42
Axelbre,blackrock,1621,priest,shadow,42,21,21
Lightform,twisting-nether,1620,priest,shadow,81,52,29
Vatikanet,ravencrest,1620,priest,shadow,171,96,75
Shyasianpr,area-52,1620,priest,shadow,48,26,22
Zayden,ragnaros,1620,priest,shadow,151,78,73
Марриаза,blackscar,1620,priest,shadow,66,31,35
Selaria,magtheridon,1620,priest,shadow,60,28,32
Cdplz,archimonde,1619,priest,shadow,42,24,18
Zetapp,argent-dawn,1619,priest,shadow,42,22,20
Marbellexd,pozzo-delleternità,1619,priest,shadow,340,178,162
Goodison,outland,1618,priest,shadow,60,29,31
Каспера,galakrond,1617,priest,shadow,35,21,14
Afrophobia,archimonde,1617,priest,shadow,214,116,98
Prällan,darksorrow,1616,priest,shadow,24,17,7
Darkfreak,malygos,1616,priest,shadow,36,23,13
Priestazie,madmortem,1616,priest,shadow,96,57,39
Shyvi,ravencrest,1616,priest,shadow,36,21,15
Appraiser,draenor,1616,priest,shadow,36,18,18
Otecduchovny,burning-blade,1615,priest,shadow,30,17,13
Nálá,nethersturm,1615,priest,shadow,175,97,78
Callmegød,archimonde,1615,priest,shadow,108,59,49
Yoggies,tarren-mill,1615,priest,shadow,62,33,29
Mukkin,tarren-mill,1614,priest,shadow,60,35,25
Malip,ragnaros,1614,priest,shadow,93,46,47
Devoid,aggra-português,1614,priest,shadow,43,21,22
Neitter,zuljin,1613,priest,shadow,78,43,35
Simorflay,kazzak,1613,priest,shadow,63,34,29
Nûtqt,archimonde,1613,priest,shadow,139,71,68
Widdlprest,sylvanas,1613,priest,shadow,36,17,19
Astangia,nemesis,1612,priest,shadow,343,187,156
Отчепадре,gordunni,1611,priest,shadow,54,30,24
Sturepräst,kazzak,1611,priest,shadow,36,20,16
Îndura,drakthul,1611,priest,shadow,218,119,99
Thmas,outland,1611,priest,shadow,134,67,67
Dingqt,chogall,1611,priest,shadow,42,21,21
Deriont,argent-dawn,1610,priest,shadow,60,35,25
Fearocity,outland,1609,priest,shadow,42,23,19
Izêr,draenor,1609,priest,shadow,218,115,103
Xbeau,bronze-dragonflight,1607,priest,shadow,96,55,41
Tweediertie,argent-dawn,1607,priest,shadow,59,25,34
Quen,baelgun,1606,priest,shadow,66,39,27
Lowisa,sylvanas,1606,priest,shadow,106,61,45
Iamfrosty,draenor,1606,priest,shadow,204,111,93
Pennywïse,kargath,1606,priest,shadow,174,81,93
Kervalainen,outland,1605,priest,shadow,49,34,15
Вайзмейстер,blackscar,1605,priest,shadow,48,27,21
Lynseanna,ravencrest,1605,priest,shadow,99,55,44
Supahot,sylvanas,1605,priest,shadow,155,86,69
Nairima,argent-dawn,1605,priest,shadow,152,81,71
Skypray,burning-legion,1605,priest,shadow,179,95,84
Nebunia,twisting-nether,1604,priest,shadow,24,17,7
Dexploit,frostwolf,1604,priest,shadow,30,19,11
Mohammedx,tarren-mill,1604,priest,shadow,36,21,15
Амгар,galakrond,1604,priest,shadow,161,90,71
Beasteaksx,thrall,1604,priest,shadow,117,63,54
Æäõ,turalyon,1604,priest,shadow,36,19,17
Donkyrobert,tarren-mill,1604,priest,shadow,36,18,18
Ларчшп,gordunni,1604,priest,shadow,64,28,36
Bubbleup,defias-brotherhood,1603,priest,shadow,61,40,21
Putríd,sylvanas,1603,priest,shadow,77,45,32
Brìtneyfears,ravencrest,1602,priest,shadow,30,20,10
Trancemaster,dun-modr,1602,priest,shadow,30,18,12
Jonesy,blackmoore,1602,priest,shadow,82,46,36
Rakkha,ravencrest,1602,priest,shadow,111,55,56
Brobox,blackmoore,1602,priest,shadow,42,20,22
Desperion,ragnaros,1601,priest,shadow,107,65,42
Говорун,grom,1601,priest,shadow,48,28,20
Sadskîx,dun-modr,1601,priest,shadow,74,43,31
Niecheqt,tarren-mill,1601,priest,shadow,125,71,54
Momomomomomo,blackrock,1601,priest,shadow,124,63,61
Caera,blackrock,1600,priest,shadow,36,21,15
Toba,hellscream,1600,priest,shadow,42,23,19
Cifhilis,ravencrest,1600,priest,shadow,66,32,34
Syam,dun-morogh,1600,priest,shadow,42,17,25
Arkkupiispa,stormreaver,1598,priest,shadow,126,69,57
Энвиньяттар,howling-fjord,1597,priest,shadow,47,32,15
Valirda,twisting-nether,1597,priest,shadow,205,106,99
Àæn,blackrock,1596,priest,shadow,48,29,19
Zapreyy,kazzak,1596,priest,shadow,30,17,13
Sateruxs,burning-legion,1596,priest,shadow,125,69,56
Babarøqa,blackmoore,1596,priest,shadow,310,165,145
Horrðr,kazzak,1595,priest,shadow,73,40,33
Мизостигма,gordunni,1594,priest,shadow,47,23,24
Sopsy,stormscale,1593,priest,shadow,60,32,28
Саиленто,howling-fjord,1593,priest,shadow,175,90,85
Wingufreebrø,sanguino,1592,priest,shadow,141,73,68
Elreâ,blackrock,1592,priest,shadow,100,50,50
Перекованный,soulflayer,1592,priest,shadow,189,94,95
Флпрст,soulflayer,1591,priest,shadow,30,21,9
Reincarnate,tarren-mill,1591,priest,shadow,52,30,22
Саксесфул,howling-fjord,1591,priest,shadow,121,67,54
Gød,magtheridon,1591,priest,shadow,36,17,19
Brøwnyez,zuljin,1590,priest,shadow,96,45,51
Buffholy,dun-modr,1589,priest,shadow,78,43,35
Genthus,kazzak,1589,priest,shadow,108,56,52
Inferius,shadowsong,1589,priest,shadow,76,31,45
Даркфолс,soulflayer,1588,priest,shadow,48,29,19
Aenon,argent-dawn,1588,priest,shadow,53,30,23
Morsy,alleria,1588,priest,shadow,80,44,36
Ankus,tarren-mill,1588,priest,shadow,221,117,104
Stepmama,kazzak,1588,priest,shadow,42,21,21
Pombär,ragnaros,1587,priest,shadow,54,36,18
Sangububblu,silvermoon,1585,priest,shadow,51,36,15
Shmoly,stormscale,1585,priest,shadow,31,20,11
Азотод,gordunni,1585,priest,shadow,222,123,99
Priestgrade,darkspear,1585,priest,shadow,58,30,28
Трубишоп,howling-fjord,1585,priest,shadow,164,81,83
Discmaskinen,aggramar,1585,priest,shadow,36,17,19
Sadsongs,twisting-nether,1584,priest,shadow,100,55,45
Faminé,outland,1584,priest,shadow,65,29,36
Dïesel,blackhand,1583,priest,shadow,36,19,17
Strunkiin,defias-brotherhood,1583,priest,shadow,346,177,169
Charmebolzen,blackrock,1582,priest,shadow,132,67,65
Babydark,ravencrest,1582,priest,shadow,36,18,18
Darkangél,forscherliga,1582,priest,shadow,72,34,38
Galilea,sanguino,1581,priest,shadow,60,34,26
Gooflord,ravencrest,1581,priest,shadow,52,29,23
Thawx,stormscale,1581,priest,shadow,54,29,25
Vilhiil,darksorrow,1581,priest,shadow,140,75,65
Zyzzforever,ragnaros,1580,priest,shadow,30,17,13
Lothlórien,dun-modr,1579,priest,shadow,48,35,13
Imøteph,ragnaros,1579,priest,shadow,83,47,36
Cryptoflame,silvermoon,1579,priest,shadow,45,25,20
Narutosifort,archimonde,1579,priest,shadow,49,25,24
Ialoricha,dun-modr,1579,priest,shadow,176,89,87
Pewkz,draenor,1578,priest,shadow,84,50,34
Dùsty,archimonde,1575,priest,shadow,47,27,20
Aerindraelle,argent-dawn,1574,priest,shadow,30,23,7
Loldawg,stormscale,1574,priest,shadow,36,18,18
Brycen,silvermoon,1574,priest,shadow,52,25,27
Fumiiko,stormscale,1574,priest,shadow,84,38,46
Ринрайн,howling-fjord,1572,priest,shadow,30,23,7
Mórok,silvermoon,1572,priest,shadow,120,62,58
Kightz,twisting-nether,1572,priest,shadow,128,66,62
Terrored,ravencrest,1572,priest,shadow,66,28,38
Castêr,silvermoon,1571,priest,shadow,132,71,61
Brighty,sylvanas,1571,priest,shadow,159,84,75
Corruptx,ysondre,1571,priest,shadow,68,35,33
Belìal,thrall,1571,priest,shadow,41,18,23
Giruga,eredar,1570,priest,shadow,36,20,16
Флавех,gordunni,1570,priest,shadow,54,27,27
Lênax,arthas,1570,priest,shadow,69,34,35
Shûo,blackrock,1569,priest,shadow,60,29,31
Blasphemiia,outland,1567,priest,shadow,90,55,35
Greyford,blackhand,1567,priest,shadow,58,32,26
Diapösitiv,draenor,1566,priest,shadow,108,61,47
Beonin,tarren-mill,1565,priest,shadow,67,40,27
Goingshadow,silvermoon,1565,priest,shadow,54,30,24
Grompriest,echsenkessel,1565,priest,shadow,170,92,78
Øhlø,ysondre,1564,priest,shadow,94,51,43
Shavog,stormscale,1564,priest,shadow,42,22,20
Cykdwojeczka,burning-legion,1564,priest,shadow,145,73,72
Sheto,burning-legion,1563,priest,shadow,470,231,239
Azsaryn,magtheridon,1562,priest,shadow,42,22,20
Insaniro,argent-dawn,1562,priest,shadow,66,34,32
Ankhh,bloodscalp,1560,priest,shadow,142,69,73
Shadowsister,burning-blade,1559,priest,shadow,112,63,49
Kimosabee,kazzak,1559,priest,shadow,54,27,27
Соргоху,gordunni,1557,priest,shadow,72,41,31
Marsheil,blackhand,1556,priest,shadow,60,32,28
Meshen,ysondre,1556,priest,shadow,588,306,282
Qiandra,argent-dawn,1556,priest,shadow,66,32,34
Пристаболик,gordunni,1555,priest,shadow,30,19,11
Flyvoz,burning-legion,1555,priest,shadow,30,18,12
Shivaja,aegwynn,1555,priest,shadow,30,17,13
Divledann,lightnings-blade,1554,priest,shadow,104,60,44
Pãst,pozzo-delleternità,1554,priest,shadow,76,43,33
Fnúggí,kazzak,1554,priest,shadow,78,44,34
Poposy,hyjal,1554,priest,shadow,54,30,24
Skerduddle,stormscale,1554,priest,shadow,172,91,81
Bigdogs,archimonde,1554,priest,shadow,48,24,24
Фастдед,howling-fjord,1553,priest,shadow,66,34,32
Лостспейс,gordunni,1552,priest,shadow,43,30,13
Bubidiblumpr,twisting-nether,1552,priest,shadow,96,60,36
Эззи,soulflayer,1552,priest,shadow,120,65,55
Hasnaa,silvermoon,1551,priest,shadow,118,67,51
Tweenitopg,les-clairvoyants,1551,priest,shadow,36,20,16
Exörcíst,outland,1550,priest,shadow,81,53,28
Hemaplex,dun-modr,1550,priest,shadow,95,52,43
Chaerii,blackmoore,1550,priest,shadow,68,36,32
Ðotgød,nemesis,1549,priest,shadow,98,60,38
Vøidtheorem,ragnaros,1549,priest,shadow,72,31,41
Hecaté,blackhand,1548,priest,shadow,173,98,75
Зонкк,thermaplugg,1548,priest,shadow,219,117,102
Lethaa,twisting-nether,1547,priest,shadow,42,24,18
Cannapriest,frostwolf,1547,priest,shadow,72,40,32
Chaddius,stormscale,1547,priest,shadow,240,125,115
Everdark,twisting-nether,1546,priest,shadow,181,96,85
Jerolol,sanguino,1546,priest,shadow,54,28,26
Zeto,blackmoore,1545,priest,shadow,100,58,42
Aaroneira,ravencrest,1545,priest,shadow,70,38,32
Weebi,silvermoon,1544,priest,shadow,101,53,48
Urfkncringe,sylvanas,1544,priest,shadow,48,23,25
Grainbames,sylvanas,1543,priest,shadow,30,17,13
Malisna,argent-dawn,1543,priest,shadow,47,25,22
Coupdekaraté,sylvanas,1543,priest,shadow,36,18,18
Stölpen,ravencrest,1543,priest,shadow,66,32,34
Xooxl,ragnaros,1542,priest,shadow,102,60,42
Ladouce,archimonde,1541,priest,shadow,70,39,31
Willzah,outland,1541,priest,shadow,50,23,27
Moschadow,blackrock,1541,priest,shadow,65,27,38
Lathas,bloodfeather,1540,priest,shadow,88,57,31
Даркхон,howling-fjord,1540,priest,shadow,133,73,60
Mightyfool,aegwynn,1540,priest,shadow,132,66,66
Vo,dentarg,1540,priest,shadow,120,59,61
Zászàsmaster,kazzak,1537,priest,shadow,114,65,49
Ciqua,frostmane,1537,priest,shadow,58,33,25
Ormarn,twisting-nether,1536,priest,shadow,92,51,41
Moontear,ravencrest,1536,priest,shadow,51,26,25
Инсэшбл,blackscar,1536,priest,shadow,60,30,30
Дэнипампх,gordunni,1535,priest,shadow,35,23,12
Nahtod,blackmoore,1535,priest,shadow,30,19,11
Frv,tarren-mill,1535,priest,shadow,39,23,16
Kìckurâss,aegwynn,1535,priest,shadow,59,34,25
Danri,ravencrest,1535,priest,shadow,42,24,18
Vietzan,zuljin,1535,priest,shadow,72,36,36
Solaní,antonidas,1534,priest,shadow,190,101,89
Shdwmeld,ravencrest,1533,priest,shadow,112,55,57
Xelathor,twisting-nether,1532,priest,shadow,144,74,70
Zekonja,doomhammer,1532,priest,shadow,82,42,40
Sakyra,blackmoore,1531,priest,shadow,110,69,41
Cringelørd,alakir,1531,priest,shadow,91,55,36
Baihoi,twilights-hammer,1531,priest,shadow,156,88,68
Massbimba,tarren-mill,1531,priest,shadow,71,36,35
Unreal,nagrand,1531,priest,shadow,72,36,36
Basicpr,ravencrest,1530,priest,shadow,87,48,39
Varjomies,ragnaros,1530,priest,shadow,132,69,63
Âlígés,outland,1529,priest,shadow,78,39,39
Alanar,ragnaros,1527,priest,shadow,42,19,23
Rédjohn,archimonde,1526,priest,shadow,48,32,16
Kiralinia,eredar,1526,priest,shadow,63,38,25
Fosil,xavius,1526,priest,shadow,78,43,35
Jingling,kazzak,1525,priest,shadow,27,18,9
Dejica,kult-der-verdammten,1525,priest,shadow,43,21,22
Dionegativ,draenor,1525,priest,shadow,42,18,24
Littlefräu,ravencrest,1524,priest,shadow,28,17,11
Varta,arthas,1524,priest,shadow,53,29,24
Loaofanal,stormscale,1524,priest,shadow,48,26,22
Baptizer,nemesis,1523,priest,shadow,185,110,75
Psycos,kazzak,1523,priest,shadow,66,33,33
Boniesmack,stormscale,1521,priest,shadow,78,44,34
Ryik,ravencrest,1521,priest,shadow,119,64,55
Kisala,kazzak,1519,priest,shadow,94,57,37
Cinaedus,stormreaver,1519,priest,shadow,105,57,48
Deadspace,hyjal,1518,priest,shadow,95,56,39
Qalis,twisting-nether,1518,priest,shadow,48,28,20
Волкановская,eversong,1518,priest,shadow,66,34,32
Nahyra,dalaran,1518,priest,shadow,290,147,143
Gerase,blackrock,1517,priest,shadow,54,34,20
Leckpriest,sanguino,1517,priest,shadow,100,49,51
Aladra,archimonde,1517,priest,shadow,78,37,41
Abjure,silvermoon,1516,priest,shadow,48,25,23
Êttân,ravencrest,1516,priest,shadow,148,77,71
Whocare,tarren-mill,1516,priest,shadow,88,44,44
Shadowplay,theradras,1516,priest,shadow,220,109,111
ßest,archimonde,1515,priest,shadow,78,40,38
Lavidu,antonidas,1515,priest,shadow,78,38,40
Maskinjundre,bronzebeard,1515,priest,shadow,54,24,30
Stinkycreep,executus,1514,priest,shadow,102,60,42
Flyp,stormscale,1514,priest,shadow,75,37,38
Umbralx,ragnaros,1513,priest,shadow,77,45,32
Voina,ravencrest,1512,priest,shadow,68,44,24
Jinkuzo,outland,1512,priest,shadow,40,17,23
Enprästjävel,tarren-mill,1511,priest,shadow,36,20,16
Emilyvvillis,outland,1511,priest,shadow,42,16,26
Wílmàgødx,ravencrest,1510,priest,shadow,42,26,16
Experimentix,silvermoon,1510,priest,shadow,36,21,15
Skûggpräst,silvermoon,1510,priest,shadow,118,61,57
Phycobabe,sylvanas,1509,priest,shadow,180,94,86
Абсорб,gordunni,1508,priest,shadow,66,41,25
Kantar,ragnaros,1508,priest,shadow,124,65,59
Laradiel,dun-modr,1507,priest,shadow,30,17,13
Деплитфофан,gordunni,1506,priest,shadow,125,71,54
Cylantharia,eredar,1506,priest,shadow,30,16,14
Scynthia,ravencrest,1505,priest,shadow,47,22,25
Namire,thrall,1505,priest,shadow,54,24,30
Адария,booty-bay,1504,priest,shadow,35,22,13
Aiewn,elune,1503,priest,shadow,46,26,20
Dyshexia,bronze-dragonflight,1503,priest,shadow,78,39,39
Heavyhalo,ragnaros,1502,priest,shadow,42,24,18
Nygel,kazzak,1502,priest,shadow,170,90,80
Xîneâ,outland,1502,priest,shadow,36,18,18
Cynthi,arthas,1501,priest,shadow,48,22,26
Pressplz,archimonde,1500,priest,shadow,42,21,21
Puresaint,the-maelstrom,1499,priest,shadow,42,19,23
Chrønös,hyjal,1498,priest,shadow,228,116,112
Юбизумо,gordunni,1498,priest,shadow,116,59,57
Spideypap,ragnaros,1496,priest,shadow,75,42,33
Nicorøbin,uldum,1496,priest,shadow,169,94,75
Кхэрри,goldrinn,1496,priest,shadow,47,26,21
Baldracca,shendralar,1496,priest,shadow,250,126,124
Voidjeanzqt,blackmoore,1495,priest,shadow,238,127,111
Hælmenøw,archimonde,1495,priest,shadow,66,35,31
Mozahn,ragnaros,1494,priest,shadow,69,36,33
Hiyahen,silvermoon,1493,priest,shadow,90,50,40
Ниикола,booty-bay,1493,priest,shadow,94,49,45
Brainwash,darksorrow,1493,priest,shadow,62,26,36
Txypii,dun-modr,1493,priest,shadow,48,20,28
Healiea,outland,1491,priest,shadow,119,51,68
Kajifoxi,frostmane,1490,priest,shadow,60,38,22
Ragwitch,draenor,1490,priest,shadow,82,48,34
Ðizzi,dun-modr,1490,priest,shadow,42,23,19
Stiankrokås,silvermoon,1490,priest,shadow,60,30,30
Miruvai,tarren-mill,1490,priest,shadow,54,27,27
Hâicu,antonidas,1489,priest,shadow,66,39,27
Даняпампх,soulflayer,1489,priest,shadow,212,112,100
Kertith,argent-dawn,1489,priest,shadow,231,120,111
Khalix,frostwolf,1489,priest,shadow,36,18,18
Crâzycatlady,blackmoore,1488,priest,shadow,30,17,13
Seras,bloodfeather,1488,priest,shadow,227,125,102
Bercxu,ragnaros,1487,priest,shadow,60,34,26
Bierbändiger,blackhand,1487,priest,shadow,30,17,13
Elysium,darkspear,1487,priest,shadow,171,91,80
Vittelk,stormscale,1487,priest,shadow,84,44,40
Дюрэкс,soulflayer,1487,priest,shadow,46,24,22
Fiftyfives,hyjal,1487,priest,shadow,60,30,30
Shaaq,stormscale,1486,priest,shadow,24,19,5
Nomorelight,stormscale,1486,priest,shadow,54,27,27
Virdeo,aegwynn,1485,priest,shadow,61,30,31
Токиото,gordunni,1485,priest,shadow,84,40,44
Voidkäfer,ravencrest,1484,priest,shadow,36,18,18
Phplaravel,tarren-mill,1484,priest,shadow,129,62,67
Lilakaii,chamber-of-aspects,1483,priest,shadow,194,98,96
Slepa,silvermoon,1482,priest,shadow,48,26,22
Purplex,aggra-português,1482,priest,shadow,65,31,34
Grapemachine,dentarg,1482,priest,shadow,36,17,19
Elderath,eredar,1482,priest,shadow,47,18,29
Veryssra,archimonde,1479,priest,shadow,114,72,42
Онлишп,soulflayer,1479,priest,shadow,36,16,20
Rishar,ragnaros,1479,priest,shadow,48,21,27
Shinesomnya,aegwynn,1478,priest,shadow,40,23,17
Odium,alakir,1478,priest,shadow,174,95,79
Yixi,blackmoore,1478,priest,shadow,78,42,36
Nemw,chamber-of-aspects,1478,priest,shadow,213,113,100
Bøts,ravencrest,1478,priest,shadow,73,34,39
Бравер,soulflayer,1477,priest,shadow,84,47,37
Cole,veknilash,1475,priest,shadow,77,40,37
Pregrip,twisting-nether,1475,priest,shadow,67,34,33
ßumbleßeeqt,frostmane,1475,priest,shadow,67,31,36
Celz,kazzak,1474,priest,shadow,60,35,25
Симпоз,howling-fjord,1473,priest,shadow,42,26,16
Anathemas,draenor,1473,priest,shadow,100,57,43
Nbayoungboy,the-maelstrom,1473,priest,shadow,32,18,14
Джианитто,borean-tundra,1473,priest,shadow,52,28,24
Shadowpræst,argent-dawn,1473,priest,shadow,81,41,40
Deadlymoda,zenedar,1471,priest,shadow,44,24,20
Dotsin,kazzak,1471,priest,shadow,190,96,94
Warplague,argent-dawn,1471,priest,shadow,103,48,55
Psycoscream,blackmoore,1469,priest,shadow,88,44,44
Lëgolux,chogall,1468,priest,shadow,90,49,41
Superdude,stormscale,1467,priest,shadow,49,23,26
Nekemtenee,magtheridon,1466,priest,shadow,59,36,23
Люблюкофе,deathguard,1466,priest,shadow,139,75,64
Pehmoinen,korgall,1466,priest,shadow,67,34,33
Sháady,ravencrest,1466,priest,shadow,60,29,31
Umayyaa,sylvanas,1466,priest,shadow,42,18,24
Lagbugdcx,ravencrest,1465,priest,shadow,66,37,29
Sunehxp,blackrock,1465,priest,shadow,83,32,51
Smålbenör,stormreaver,1464,priest,shadow,77,39,38
Lainie,burning-legion,1463,priest,shadow,46,27,19
Prillen,kazzak,1463,priest,shadow,53,29,24
Isusgaspodi,argent-dawn,1461,priest,shadow,181,99,82
Старкстрим,gordunni,1461,priest,shadow,78,41,37
Jcewrld,blackhand,1461,priest,shadow,84,35,49
Хоуу,howling-fjord,1459,priest,shadow,48,21,27
Zildjiana,archimonde,1457,priest,shadow,138,73,65
Дикрия,eversong,1456,priest,shadow,114,59,55
Darkyy,alleria,1456,priest,shadow,42,21,21
Xyo,alleria,1456,priest,shadow,194,94,100
Dotterin,draenor,1455,priest,shadow,165,97,68
Daltheria,daggerspine,1455,priest,shadow,113,66,47
Hemovoid,nagrand,1454,priest,shadow,24,17,7
Badprïestx,twisting-nether,1454,priest,shadow,36,19,17
Eryxial,antonidas,1454,priest,shadow,59,31,28
Slagatron,ragnaros,1454,priest,shadow,79,41,38
Dardinio,ravencrest,1454,priest,shadow,83,38,45
Tyene,voljin,1453,priest,shadow,106,58,48
Vedina,bronze-dragonflight,1453,priest,shadow,105,49,56
Shreedz,blackmoore,1453,priest,shadow,86,35,51
Ансин,azuregos,1452,priest,shadow,72,47,25
Raypriest,blackrock,1452,priest,shadow,29,17,12
Duppduppjr,ravencrest,1452,priest,shadow,65,33,32
Damyo,eredar,1451,priest,shadow,108,58,50
Shinígamí,frostmane,1451,priest,shadow,126,66,60
Элдерле,gordunni,1451,priest,shadow,60,31,29
Voidpbody,nerathor,1451,priest,shadow,47,24,23
Roseanne,ragnaros,1450,priest,shadow,42,17,25
Ammp,outland,1448,priest,shadow,243,128,115
Самаэльз,blackscar,1448,priest,shadow,62,31,31
Шанэкс,howling-fjord,1447,priest,shadow,24,17,7
Kurzik,zuljin,1447,priest,shadow,46,30,16
Ariyáh,antonidas,1447,priest,shadow,172,89,83
Dípp,ravencrest,1447,priest,shadow,36,18,18
Хоозяин,blackscar,1446,priest,shadow,92,54,38
Phêq,ravencrest,1446,priest,shadow,69,31,38
Galle,frostmane,1445,priest,shadow,38,23,15
Drakharys,dun-modr,1445,priest,shadow,40,20,20
Маталор,gordunni,1444,priest,shadow,30,18,12
Meloo,dalaran,1444,priest,shadow,139,77,62
Broncos,twisting-nether,1443,priest,shadow,124,69,55
Hoon,destromath,1443,priest,shadow,135,73,62
Styxpr,blackhand,1442,priest,shadow,31,16,15
Kourroucé,archimonde,1441,priest,shadow,214,111,103
Fuggordel,argent-dawn,1441,priest,shadow,75,36,39
Søcrax,blackrock,1440,priest,shadow,90,50,40
Kendea,silvermoon,1440,priest,shadow,211,111,100
Rätzah,silvermoon,1440,priest,shadow,90,45,45
Haspela,silvermoon,1440,priest,shadow,36,18,18
Anastasiä,archimonde,1440,priest,shadow,69,34,35
Tylb,tarren-mill,1439,priest,shadow,18,15,3
Peep,emerald-dream,1439,priest,shadow,24,15,9
Gambetto,sanguino,1439,priest,shadow,24,15,9
Palitox,kazzak,1439,priest,shadow,70,38,32
Velenthan,stormrage,1438,priest,shadow,60,38,22
Jarz,kazzak,1438,priest,shadow,24,15,9
Unpretetroll,nemesis,1436,priest,shadow,168,90,78
Pedopräst,stormscale,1435,priest,shadow,106,59,47
Libstik,hyjal,1433,priest,shadow,24,15,9
Gesees,ravencrest,1433,priest,shadow,55,29,26
Jlox,stormscale,1433,priest,shadow,39,16,23
Mylini,silvermoon,1432,priest,shadow,110,59,51
Narshina,onyxia,1432,priest,shadow,48,20,28
Хастла,goldrinn,1431,priest,shadow,24,15,9
Bigorna,frostmane,1431,priest,shadow,102,58,44
Outofsoul,blackhand,1430,priest,shadow,54,39,15
Plimpi,blackmoore,1430,priest,shadow,36,19,17
Olïfä,aggra-português,1429,priest,shadow,36,23,13
Lëshder,sanguino,1429,priest,shadow,119,59,60
Kumpi,azjolnerub,1428,priest,shadow,30,19,11
Tigrok,burning-legion,1428,priest,shadow,68,35,33
Saviour,spinebreaker,1426,priest,shadow,66,39,27
Wundervoid,silvermoon,1426,priest,shadow,83,48,35
Viroz,blackmoore,1426,priest,shadow,30,16,14
Карбираторх,gordunni,1426,priest,shadow,65,32,33
Blonded,antonidas,1426,priest,shadow,48,22,26
Johnnysp,eredar,1425,priest,shadow,48,31,17
Stac,hyjal,1425,priest,shadow,24,15,9
Psystorm,frostmane,1425,priest,shadow,69,40,29
Forhandleren,draenor,1425,priest,shadow,157,75,82
Bâllí,blackmoore,1425,priest,shadow,60,27,33
Lamess,drakthul,1424,priest,shadow,55,34,21
Squîzz,archimonde,1422,priest,shadow,133,67,66
Липоскай,howling-fjord,1422,priest,shadow,48,23,25
Темняк,gordunni,1422,priest,shadow,60,27,33
Singularity,ravencrest,1421,priest,shadow,139,74,65
Evna,chogall,1421,priest,shadow,54,26,28
Shaydi,todeswache,1420,priest,shadow,36,21,15
Deadzy,moonglade,1420,priest,shadow,30,17,13
Marerittet,draenor,1420,priest,shadow,73,31,42
Henaheals,ragnaros,1419,priest,shadow,24,15,9
Evypriest,draenor,1419,priest,shadow,42,23,19
Leythan,hyjal,1419,priest,shadow,54,28,26
Chibz,twisting-nether,1419,priest,shadow,54,25,29
Claudefrollo,the-maelstrom,1418,priest,shadow,49,26,23
Prayypray,eredar,1416,priest,shadow,24,15,9
Atsio,dun-modr,1416,priest,shadow,58,26,32
Oikus,minahonda,1415,priest,shadow,131,69,62
Айдеус,lich-king,1414,priest,shadow,59,30,29
Devilcry,ravencrest,1414,priest,shadow,53,20,33
Gorali,the-venture-co,1413,priest,shadow,67,34,33
Qsandria,ravencrest,1413,priest,shadow,54,26,28
Voidis,hyjal,1413,priest,shadow,72,28,44
Prøfesor,nemesis,1412,priest,shadow,53,27,26
Shopify,nagrand,1412,priest,shadow,30,15,15
Simplesam,ravencrest,1412,priest,shadow,76,35,41
Venomspawn,ragnaros,1412,priest,shadow,48,22,26
Balhlin,argent-dawn,1411,priest,shadow,30,15,15
Smâshëd,stormscale,1411,priest,shadow,126,62,64
Lapinvicieux,archimonde,1411,priest,shadow,88,43,45
Diha,argent-dawn,1411,priest,shadow,36,17,19
Corpsemaw,silvermoon,1411,priest,shadow,41,19,22
Saintethérez,archimonde,1410,priest,shadow,45,30,15
Erkay,kazzak,1410,priest,shadow,95,49,46
Sethp,hyjal,1410,priest,shadow,30,15,15
Superböck,aggra-português,1409,priest,shadow,24,15,9
Thoryän,ragnaros,1409,priest,shadow,108,53,55
Kirrako,tarren-mill,1409,priest,shadow,42,17,25
Turbosucc,burning-blade,1408,priest,shadow,36,15,21
Шаасит,soulflayer,1407,priest,shadow,44,26,18
Frèreroger,hyjal,1407,priest,shadow,96,47,49
Kayeen,tarren-mill,1406,priest,shadow,142,68,74
Boostedandy,darksorrow,1405,priest,shadow,24,15,9
Clergy,hellfire,1405,priest,shadow,79,48,31
Simularcum,tarren-mill,1405,priest,shadow,84,37,47
Farilight,draenor,1404,priest,shadow,126,79,47
Kilmmiis,defias-brotherhood,1404,priest,shadow,72,39,33
Hörror,twisting-nether,1404,priest,shadow,96,47,49
Phïljr,ravencrest,1403,priest,shadow,78,51,27
Piixld,aegwynn,1403,priest,shadow,107,59,48
Deekon,argent-dawn,1403,priest,shadow,47,24,23
Preodek,kazzak,1403,priest,shadow,30,15,15
Unerfedsp,archimonde,1403,priest,shadow,148,69,79
Voidbro,grim-batol,1401,priest,shadow,29,15,14
Eriezel,shattered-halls,1401,priest,shadow,30,15,15
Wewo,drakthul,1401,priest,shadow,57,28,29
Eytrhfb,stormscale,1400,priest,shadow,42,27,15
Alaeddin,kazzak,1400,priest,shadow,362,187,175
Mahist,ravencrest,1398,priest,shadow,74,37,37
Shidoya,tarren-mill,1398,priest,shadow,41,17,24
Nagatary,blackmoore,1397,priest,shadow,104,58,46
Xíøn,draenor,1397,priest,shadow,35,16,19
Radenox,stormscale,1397,priest,shadow,42,16,26
Xanelor,tarren-mill,1396,priest,shadow,106,62,44
Lousp,tarren-mill,1395,priest,shadow,48,18,30
Tazera,boulderfist,1394,priest,shadow,128,63,65
Абервуд,soulflayer,1394,priest,shadow,56,27,29
Dopey,kazzak,1393,priest,shadow,92,49,43
Tschacoo,malganis,1393,priest,shadow,76,39,37
Voidlord,hyjal,1391,priest,shadow,114,62,52
Iamreaper,outland,1391,priest,shadow,72,35,37
Zlejkadlec,drakthul,1390,priest,shadow,24,16,8
Øxyzën,marécage-de-zangar,1390,priest,shadow,97,52,45
Fish,arathor,1390,priest,shadow,88,38,50
Terenal,ysondre,1389,priest,shadow,70,44,26
Vhayna,kazzak,1389,priest,shadow,107,58,49
Lamaovic,archimonde,1388,priest,shadow,73,37,36
Lashana,die-aldor,1388,priest,shadow,83,40,43
Aliasus,archimonde,1388,priest,shadow,80,38,42
Lunatica,stormscale,1387,priest,shadow,39,23,16
Oblivita,twisting-nether,1386,priest,shadow,83,39,44
Hek,sylvanas,1384,priest,shadow,72,36,36
Daenie,elune,1383,priest,shadow,54,27,27
Ohboy,eredar,1383,priest,shadow,64,30,34
Lichtl,ysera,1382,priest,shadow,96,47,49
Hans,thrall,1380,priest,shadow,30,18,12
Septembér,draenor,1379,priest,shadow,23,16,7
Ulquiørra,blackmoore,1379,priest,shadow,96,50,46
Averagenoob,ragnaros,1378,priest,shadow,98,56,42
Bonifacio,la-croisade-écarlate,1377,priest,shadow,42,20,22
Îzî,sanguino,1372,priest,shadow,114,58,56
Kdot,drakthul,1371,priest,shadow,60,35,25
Pwjetlifelol,grim-batol,1371,priest,shadow,65,30,35
Fleshcraft,ravencrest,1370,priest,shadow,26,15,11
Holypowér,twisting-nether,1369,priest,shadow,30,16,14
Низара,deathguard,1367,priest,shadow,60,24,36
Kellen,burning-blade,1366,priest,shadow,432,221,211
Ðivinà,archimonde,1366,priest,shadow,80,39,41
Zathada,twisting-nether,1365,priest,shadow,42,25,17
Весенняя,gordunni,1365,priest,shadow,50,29,21
Syntára,blackhand,1365,priest,shadow,42,20,22
Apfelrisotta,outland,1365,priest,shadow,123,56,67
Держимоепиво,blackscar,1364,priest,shadow,42,19,23
Mortyfer,kazzak,1364,priest,shadow,66,25,41
Synexia,sylvanas,1363,priest,shadow,111,62,49
Brunestùd,pozzo-delleternità,1361,priest,shadow,30,20,10
Zevulós,ravencrest,1360,priest,shadow,95,37,58
Bonbonici,sylvanas,1359,priest,shadow,66,43,23
Hârlequin,draenor,1359,priest,shadow,503,260,243
Наярда,howling-fjord,1359,priest,shadow,33,15,18
Pæìn,malganis,1359,priest,shadow,42,17,25
Hexmon,tarren-mill,1356,priest,shadow,86,53,33
Fordöbroo,ragnaros,1355,priest,shadow,284,146,138
Seehz,ysondre,1355,priest,shadow,83,33,50
Имморталрё,galakrond,1354,priest,shadow,42,29,13
Dyliz,stormscale,1354,priest,shadow,95,47,48
Thebesp,ravencrest,1354,priest,shadow,54,21,33
Офинсия,deathguard,1354,priest,shadow,47,18,29
Вексион,goldrinn,1353,priest,shadow,36,19,17
Priztar,nazjatar,1353,priest,shadow,43,22,21
Силесттиль,gordunni,1353,priest,shadow,58,29,29
Dunkelseele,ahnqiraj,1353,priest,shadow,35,17,18
Gódmic,tarren-mill,1353,priest,shadow,37,15,22
Oöm,hyjal,1352,priest,shadow,72,45,27
Голдратт,soulflayer,1352,priest,shadow,60,37,23
Testorwp,ragnaros,1352,priest,shadow,121,71,50
Nolsrcp,outland,1352,priest,shadow,36,18,18
Слышуфонк,howling-fjord,1351,priest,shadow,36,21,15
Arwen,azjolnerub,1350,priest,shadow,36,19,17
Seenoend,neptulon,1350,priest,shadow,54,26,28
Сашашвд,howling-fjord,1350,priest,shadow,48,23,25
Zappinellaa,ravencrest,1348,priest,shadow,22,15,7
Tyhjäsuoja,hyjal,1348,priest,shadow,162,83,79
Xceliann,stormscale,1348,priest,shadow,54,25,29
Рбгсамка,blackscar,1348,priest,shadow,76,33,43
Atheniss,drakthul,1347,priest,shadow,120,63,57
Eslo,outland,1347,priest,shadow,59,30,29
Кибержрица,soulflayer,1347,priest,shadow,30,15,15
Shíàpríést,kazzak,1347,priest,shadow,53,19,34
Fåith,twilights-hammer,1346,priest,shadow,155,81,74
Mellandoh,tarren-mill,1345,priest,shadow,167,90,77
Nyróx,malganis,1345,priest,shadow,122,59,63
Бранлор,howling-fjord,1345,priest,shadow,46,21,25
Meshield,draenor,1345,priest,shadow,48,19,29
Scorbute,conseil-des-ombres,1344,priest,shadow,24,15,9
Prìestìalìty,draenor,1344,priest,shadow,29,17,12
Flayin,kazzak,1344,priest,shadow,114,60,54
Voidgasm,kazzak,1344,priest,shadow,29,15,14
Achára,ravencrest,1343,priest,shadow,24,14,10
Sanebassoff,kazzak,1343,priest,shadow,226,117,109
Kasyrra,sylvanas,1342,priest,shadow,146,78,68
Нефрида,gordunni,1342,priest,shadow,56,28,28
Возрождающее,soulflayer,1342,priest,shadow,30,14,16
Vtspam,stormscale,1341,priest,shadow,24,14,10
Maysiex,twisting-nether,1341,priest,shadow,24,14,10
Зайчатинка,soulflayer,1341,priest,shadow,92,42,50
Shizo,blutkessel,1340,priest,shadow,59,34,25
Apuessii,dun-modr,1340,priest,shadow,59,31,28
Gauge,frostmane,1339,priest,shadow,210,108,102
Jhaazx,nemesis,1338,priest,shadow,69,40,29
Акциуми,howling-fjord,1338,priest,shadow,216,122,94
Velenthøs,argent-dawn,1338,priest,shadow,41,23,18
Sodomix,tarren-mill,1337,priest,shadow,271,142,129
Цитамин,deathguard,1337,priest,shadow,131,63,68
Rajip,azjolnerub,1336,priest,shadow,51,30,21
Khireeboubou,hyjal,1336,priest,shadow,30,14,16
Mjamc,stormscale,1335,priest,shadow,103,56,47
Ggdoll,twisting-nether,1335,priest,shadow,235,120,115
Viridaé,blackmoore,1334,priest,shadow,23,15,8
Nìrtus,thrall,1334,priest,shadow,24,14,10
Morgoh,die-arguswacht,1334,priest,shadow,193,100,93
Powna,blackrock,1333,priest,shadow,72,40,32
Triuna,sylvanas,1333,priest,shadow,41,22,19
Bromiaris,dun-morogh,1333,priest,shadow,72,33,39
Deethraa,argent-dawn,1332,priest,shadow,24,14,10
Sleepyshadow,drakthul,1332,priest,shadow,80,39,41
Inei,doomhammer,1331,priest,shadow,48,25,23
Sucukpriest,blackrock,1331,priest,shadow,48,25,23
Byzzi,draenor,1330,priest,shadow,36,25,11
Shokkapriest,draenor,1330,priest,shadow,36,18,18
Maxhima,defias-brotherhood,1330,priest,shadow,125,61,64
Scaremonger,thunderhorn,1328,priest,shadow,30,14,16
Ruojatar,stormreaver,1328,priest,shadow,30,14,16
Éclípsé,stormscale,1327,priest,shadow,36,17,19
Изэрвил,howling-fjord,1327,priest,shadow,66,30,36
Sai,draenor,1327,priest,shadow,97,42,55
Dumámày,silvermoon,1326,priest,shadow,24,17,7
Dysko,alakir,1326,priest,shadow,30,17,13
Daretox,turalyon,1324,priest,shadow,40,18,22
Grouptherpst,draenor,1323,priest,shadow,24,14,10
Bimboxo,argent-dawn,1323,priest,shadow,143,80,63
Míjagí,blackhand,1323,priest,shadow,70,36,34
Simisimi,twisting-nether,1322,priest,shadow,24,14,10
Сэлунна,goldrinn,1321,priest,shadow,36,14,22
Fathedead,stormreaver,1320,priest,shadow,48,18,30
Эшараджа,howling-fjord,1319,priest,shadow,24,14,10
Kristiflicka,kazzak,1319,priest,shadow,108,61,47
Нитровина,howling-fjord,1318,priest,shadow,30,19,11
Дроус,borean-tundra,1318,priest,shadow,59,30,29
Mistaké,the-maelstrom,1317,priest,shadow,227,120,107
Slenderdoom,stormscale,1317,priest,shadow,42,20,22
Balan,argent-dawn,1317,priest,shadow,30,14,16
Littlebugger,argent-dawn,1317,priest,shadow,63,28,35
Calor,nemesis,1316,priest,shadow,35,22,13
Haxxøn,die-nachtwache,1315,priest,shadow,68,37,31
Gaidemar,blackmoore,1312,priest,shadow,76,42,34
Marío,moonglade,1312,priest,shadow,36,19,17
Prästpojken,frostwhisper,1311,priest,shadow,36,19,17
Keystoned,blackmoore,1310,priest,shadow,52,32,20
Hëllokitty,sanguino,1309,priest,shadow,174,88,86
Tremblè,outland,1309,priest,shadow,68,32,36
Kíssme,archimonde,1307,priest,shadow,42,28,14
Xxede,dun-modr,1307,priest,shadow,111,52,59
Söörpriest,the-maelstrom,1305,priest,shadow,90,52,38
Secundis,silvermoon,1305,priest,shadow,30,16,14
Comptonzity,outland,1305,priest,shadow,36,16,20
Missadventur,skullcrusher,1304,priest,shadow,30,18,12
Kåstå,archimonde,1304,priest,shadow,35,17,18
Oggiz,archimonde,1302,priest,shadow,59,31,28
Medovina,silvermoon,1302,priest,shadow,72,37,35
Darkconx,silvermoon,1301,priest,shadow,90,45,45
Stevenfly,outland,1301,priest,shadow,34,16,18
Абракабра,howling-fjord,1301,priest,shadow,66,31,35
Haregnor,gorgonnash,1300,priest,shadow,40,21,19
Yaoshih,draenor,1300,priest,shadow,113,53,60
Itenja,frostmourne,1299,priest,shadow,39,19,20
Shadowchunks,argent-dawn,1299,priest,shadow,48,21,27
Alterspflege,eredar,1298,priest,shadow,44,16,28
Kåz,argent-dawn,1295,priest,shadow,71,39,32
Lurmus,outland,1295,priest,shadow,59,29,30
Aíushtha,frostmane,1295,priest,shadow,36,14,22
Zák,sylvanas,1293,priest,shadow,78,49,29
Zolfiqar,tarren-mill,1292,priest,shadow,27,14,13
Exstinctio,nemesis,1292,priest,shadow,39,18,21
Potatø,antonidas,1291,priest,shadow,29,14,15
Boomboxk,darksorrow,1290,priest,shadow,24,15,9
Абасали,howling-fjord,1290,priest,shadow,54,22,32
Ехереу,blackscar,1286,priest,shadow,24,15,9
Aeo,twisting-nether,1285,priest,shadow,41,22,19
Otheym,the-maelstrom,1285,priest,shadow,60,29,31
Jawoflash,antonidas,1281,priest,shadow,33,15,18
Annubishadow,zuljin,1280,priest,shadow,48,21,27
Battlefog,turalyon,1279,priest,shadow,72,37,35
Lubudu,burning-legion,1279,priest,shadow,30,15,15
Sxynix,thrall,1279,priest,shadow,59,29,30
Hotsanddots,auchindoun,1278,priest,shadow,24,17,7
Dântro,kult-der-verdammten,1277,priest,shadow,24,16,8
Неймхичгодх,gordunni,1277,priest,shadow,28,15,13
Nerfnerf,kazzak,1277,priest,shadow,58,27,31
Chowhone,archimonde,1277,priest,shadow,42,14,28
Chillx,blackmoore,1274,priest,shadow,197,108,89
Osvoid,draenor,1272,priest,shadow,38,19,19
Лапушок,borean-tundra,1271,priest,shadow,96,59,37
Faroz,shadowsong,1271,priest,shadow,54,28,26
Majestíc,blackmoore,1271,priest,shadow,36,17,19
Зукеро,thermaplugg,1270,priest,shadow,30,16,14
Inzàné,kazzak,1269,priest,shadow,106,57,49
Kuusistöö,kazzak,1268,priest,shadow,25,15,10
Lildiggy,outland,1268,priest,shadow,26,14,12
Biierlip,twisting-nether,1268,priest,shadow,41,19,22
Нудная,galakrond,1268,priest,shadow,58,25,33
Harukaa,aggra-português,1267,priest,shadow,60,41,19
Tøucher,silvermoon,1267,priest,shadow,42,22,20
Нимрана,deathguard,1267,priest,shadow,85,36,49
Несущийсерп,soulflayer,1266,priest,shadow,93,41,52
Nûwa,draenor,1265,priest,shadow,24,18,6
Rétestészta,arathor,1265,priest,shadow,30,16,14
Adssdfhjgh,outland,1264,priest,shadow,44,25,19
Enemypriest,argent-dawn,1263,priest,shadow,93,48,45
Nannostar,draenor,1263,priest,shadow,66,30,36
Icyîce,kazzak,1261,priest,shadow,25,15,10
Evilspel,ravencrest,1261,priest,shadow,33,18,15
Spwin,silvermoon,1260,priest,shadow,60,33,27
Mundwerk,malganis,1260,priest,shadow,153,70,83
Moogie,archimonde,1260,priest,shadow,42,15,27
Jyncs,auchindoun,1258,priest,shadow,42,18,24
Priestyo,blackrock,1257,priest,shadow,48,20,28
Laná,twisting-nether,1256,priest,shadow,56,38,18
Ylaya,garrosh,1256,priest,shadow,64,31,33
ßeastx,nethersturm,1256,priest,shadow,81,39,42
Adägïo,dun-modr,1256,priest,shadow,156,69,87
Controlled,tarren-mill,1254,priest,shadow,182,90,92
Delaiya,antonidas,1253,priest,shadow,120,58,62
Marxenjoyer,outland,1252,priest,shadow,24,14,10
Seni,gilneas,1252,priest,shadow,84,38,46
Youkounkoun,garona,1251,priest,shadow,48,30,18
Ewolet,silvermoon,1251,priest,shadow,30,16,14
Nostramu,argent-dawn,1251,priest,shadow,102,44,58
Тэтсу,greymane,1249,priest,shadow,60,39,21
Mariosee,wrathbringer,1249,priest,shadow,72,37,35
Balthe,defias-brotherhood,1248,priest,shadow,18,13,5
Nda,stormscale,1248,priest,shadow,24,13,11
Umbrazoid,sanguino,1248,priest,shadow,66,27,39
Nøskillzz,nemesis,1247,priest,shadow,18,13,5
Xktr,aggra-português,1247,priest,shadow,18,13,5
Elfriede,twisting-nether,1247,priest,shadow,24,17,7
Sacreth,ragnaros,1247,priest,shadow,68,35,33
Døtgdx,archimonde,1246,priest,shadow,18,13,5
Thudre,ravencrest,1246,priest,shadow,143,70,73
Chamelthoe,the-maelstrom,1245,priest,shadow,18,13,5
Shadoxx,malganis,1245,priest,shadow,24,13,11
Dellarien,stormscale,1245,priest,shadow,24,13,11
Majinmadara,ravencrest,1245,priest,shadow,28,14,14
Schmatzy,blackmoore,1245,priest,shadow,30,13,17
Скизма,gordunni,1243,priest,shadow,18,13,5
Lasdrael,dun-modr,1243,priest,shadow,99,54,45
Brrghhfghf,tarren-mill,1242,priest,shadow,18,13,5
Fairylite,outland,1242,priest,shadow,24,13,11
Shîn,aegwynn,1242,priest,shadow,139,68,71
Wàks,dalaran,1240,priest,shadow,34,19,15
Peikkousva,twisting-nether,1240,priest,shadow,24,13,11
Ваккарий,gordunni,1240,priest,shadow,166,84,82
Divinefilth,kazzak,1240,priest,shadow,58,27,31
Lilyrosemary,arathor,1239,priest,shadow,24,13,11
Sayash,chamber-of-aspects,1239,priest,shadow,32,14,18
Karnatia,burning-legion,1238,priest,shadow,60,27,33
Onskansmoder,shattered-hand,1235,priest,shadow,118,56,62
Xxon,blackrock,1233,priest,shadow,42,21,21
Zedrus,azshara,1233,priest,shadow,41,14,27
Rehpotsirhc,blackrock,1232,priest,shadow,30,18,12
Scalptor,blackhand,1232,priest,shadow,54,29,25
Omnissiiah,silvermoon,1232,priest,shadow,54,24,30
Диградейшен,gordunni,1232,priest,shadow,65,22,43
Prodan,frostmane,1231,priest,shadow,18,13,5
Shifune,blackhand,1231,priest,shadow,66,29,37
Didinini,outland,1229,priest,shadow,24,13,11
Pharli,stormscale,1227,priest,shadow,30,13,17
Лайкшеди,soulflayer,1226,priest,shadow,78,44,34
Rogmisa,cthun,1226,priest,shadow,96,46,50
Cbsad,madmortem,1225,priest,shadow,18,13,5
Dívíne,ravenholdt,1225,priest,shadow,18,13,5
Morteous,twisting-nether,1225,priest,shadow,303,151,152
Denzory,ysondre,1224,priest,shadow,36,22,14
Nightchime,silvermoon,1224,priest,shadow,87,46,41
Angleka,argent-dawn,1223,priest,shadow,143,70,73
Árìáne,khaz-modan,1220,priest,shadow,221,111,110
Sephìrøth,malganis,1220,priest,shadow,59,29,30
Blååb,draenor,1220,priest,shadow,30,13,17
Gimcho,magtheridon,1219,priest,shadow,24,13,11
Ænchantress,sylvanas,1219,priest,shadow,52,24,28
Genjorss,pozzo-delleternità,1218,priest,shadow,18,13,5
Madizuluka,aggra-português,1218,priest,shadow,51,26,25
Seum,ravencrest,1218,priest,shadow,30,13,17
Ahgnus,silvermoon,1218,priest,shadow,46,19,27
Blàze,tarren-mill,1217,priest,shadow,52,27,25
Grimgodx,ravencrest,1217,priest,shadow,32,15,17
Tesz,perenolde,1217,priest,shadow,36,16,20
Bozia,chamber-of-aspects,1216,priest,shadow,48,22,26
Yonaka,amanthul,1216,priest,shadow,108,47,61
Skuggzter,outland,1215,priest,shadow,42,26,16
Soulsuckerr,silvermoon,1215,priest,shadow,53,25,28
Khalphus,argent-dawn,1213,priest,shadow,51,23,28
Holybestie,eredar,1212,priest,shadow,34,19,15
Damnedangel,drakthul,1212,priest,shadow,30,13,17
Тлбк,soulflayer,1211,priest,shadow,48,24,24
Mirelaw,stormscale,1210,priest,shadow,84,53,31
Reptika,tichondrius,1210,priest,shadow,28,17,11
Caballococo,dun-modr,1210,priest,shadow,222,107,115
Toljénpr,twisting-nether,1210,priest,shadow,28,13,15
Neychen,blackrock,1209,priest,shadow,30,13,17
Neosix,sanguino,1208,priest,shadow,18,13,5
Calsote,sanguino,1208,priest,shadow,43,27,16
Уртримас,gordunni,1208,priest,shadow,92,47,45
Aezef,ysondre,1208,priest,shadow,32,14,18
Antigospa,kazzak,1208,priest,shadow,48,20,28
Szalsza,arathor,1207,priest,shadow,53,23,30
Giblets,aszune,1206,priest,shadow,24,15,9
Kadèn,ysondre,1205,priest,shadow,24,13,11
Sigor,hellfire,1204,priest,shadow,58,29,29
Дикосвет,howling-fjord,1203,priest,shadow,144,64,80
Ayuntamiento,proudmoore,1202,priest,shadow,36,23,13
Bhutyolo,azjolnerub,1202,priest,shadow,69,36,33
Æxey,antonidas,1202,priest,shadow,99,49,50
Tiinia,hyjal,1202,priest,shadow,46,17,29
Вегельдэрс,gordunni,1201,priest,shadow,48,23,25
Mylox,blackrock,1200,priest,shadow,22,14,8
Seâky,blackmoore,1198,priest,shadow,128,63,65
Achesita,sylvanas,1198,priest,shadow,27,13,14
Montane,wrathbringer,1195,priest,shadow,63,30,33
Найтлолла,blackscar,1195,priest,shadow,30,13,17
Ruad,blackrock,1193,priest,shadow,30,17,13
Zanjiya,kazzak,1193,priest,shadow,35,13,22
Шамамба,blackscar,1192,priest,shadow,30,15,15
Ënmâ,archimonde,1191,priest,shadow,67,41,26
Cptnahab,blackmoore,1190,priest,shadow,85,52,33
Powergodz,exodar,1190,priest,shadow,36,16,20
Милотанин,gordunni,1188,priest,shadow,89,46,43
Looó,los-errantes,1188,priest,shadow,72,37,35
Mydianá,aegwynn,1187,priest,shadow,29,16,13
Avatars,kirin-tor,1185,priest,shadow,94,48,46
Zakkonnik,burning-legion,1185,priest,shadow,36,17,19
Рикимарочка,gordunni,1185,priest,shadow,70,30,40
Supermacy,eredar,1184,priest,shadow,30,14,16
Phue,ragnaros,1183,priest,shadow,44,25,19
Багбери,eversong,1182,priest,shadow,504,252,252
Aerith,kazzak,1182,priest,shadow,143,65,78
Classy,drakthul,1182,priest,shadow,45,15,30
Crishroc,stormreaver,1180,priest,shadow,141,73,68
Praizejeebus,auchindoun,1180,priest,shadow,29,13,16
Veshania,blackhand,1178,priest,shadow,98,45,53
Ziglinde,shattrath,1177,priest,shadow,58,32,26
Дитеприста,greymane,1176,priest,shadow,42,25,17
Cottyx,outland,1176,priest,shadow,22,13,9
Cronershadow,stormscale,1176,priest,shadow,32,15,17
Othu,quelthalas,1175,priest,shadow,72,33,39
Hellena,neptulon,1173,priest,shadow,90,48,42
Ocastia,antonidas,1173,priest,shadow,42,22,20
Булькозавр,razuvious,1172,priest,shadow,60,32,28
Barbiemeth,silvermoon,1172,priest,shadow,35,13,22
Wulfgahr,argent-dawn,1171,priest,shadow,66,37,29
Bòóny,ravencrest,1171,priest,shadow,36,14,22
Darkprïest,kazzak,1170,priest,shadow,56,32,24
Azade,silvermoon,1168,priest,shadow,18,13,5
Liliashet,sanguino,1166,priest,shadow,36,18,18
Løxi,blackmoore,1165,priest,shadow,25,14,11
Nyathen,baelgun,1165,priest,shadow,25,13,12
Velanrous,kazzak,1164,priest,shadow,54,32,22
Húlda,auchindoun,1159,priest,shadow,28,14,14
Garock,archimonde,1159,priest,shadow,59,25,34
Scaryman,ravencrest,1157,priest,shadow,23,14,9
Ælîta,blackhand,1155,priest,shadow,48,28,20
Sanctimo,stormscale,1153,priest,shadow,24,14,10
Raiponceanus,ysondre,1152,priest,shadow,21,13,8
Portvin,terenas,1152,priest,shadow,111,56,55
Aritrosp,kargath,1152,priest,shadow,24,12,12
Hampådenbååd,kazzak,1152,priest,shadow,24,12,12
Hotdog,kult-der-verdammten,1152,priest,shadow,42,20,22
Redoubtablee,kazzak,1152,priest,shadow,72,25,47
Julîane,aegwynn,1151,priest,shadow,18,12,6
Extazia,ravencrest,1151,priest,shadow,18,12,6
Мсикатана,gordunni,1151,priest,shadow,18,12,6
Mizhx,draenor,1151,priest,shadow,18,12,6
Kamoripriest,blackhand,1151,priest,shadow,24,12,12
Grayraven,azjolnerub,1151,priest,shadow,36,12,24
Niogtreds,kazzak,1150,priest,shadow,18,12,6
Tailjob,silvermoon,1150,priest,shadow,18,12,6
Sinsofmany,ragnaros,1150,priest,shadow,18,12,6
Sharmidix,kazzak,1150,priest,shadow,24,12,12
Pretòn,nemesis,1150,priest,shadow,30,12,18
Boefjé,outland,1149,priest,shadow,96,49,47
Sîçkzømßiê,kazzak,1149,priest,shadow,24,12,12
Xuhu,azshara,1147,priest,shadow,24,12,12
Fogess,aegwynn,1147,priest,shadow,25,12,13
Xerxsiss,frostwolf,1146,priest,shadow,54,32,22
Tartaroula,twisting-nether,1146,priest,shadow,24,12,12
Kaydenkross,eredar,1146,priest,shadow,24,12,12
Rastuvius,twisting-nether,1146,priest,shadow,60,28,32
Vogthon,aggra-português,1145,priest,shadow,24,12,12
Smõke,tarren-mill,1145,priest,shadow,80,36,44
Phetaari,argent-dawn,1144,priest,shadow,24,12,12
Роуп,gordunni,1144,priest,shadow,41,18,23
Smilyface,sylvanas,1144,priest,shadow,30,12,18
Cahira,argent-dawn,1144,priest,shadow,36,12,24
Sos,nethersturm,1143,priest,shadow,24,12,12
Shädøwn,chogall,1142,priest,shadow,12,12,0
Eledrias,antonidas,1142,priest,shadow,24,12,12
Ràthaløs,sanguino,1141,priest,shadow,24,12,12
Васпохилить,howling-fjord,1141,priest,shadow,156,67,89
Erfofthesop,chants-éternels,1141,priest,shadow,30,12,18
Ravnica,nemesis,1140,priest,shadow,24,12,12
Sickwill,blackrock,1140,priest,shadow,24,12,12
Томба,ashenvale,1139,priest,shadow,18,12,6
Каратэк,howling-fjord,1139,priest,shadow,42,22,20
Pangoffy,burning-legion,1138,priest,shadow,18,12,6
Sacher,shendralar,1138,priest,shadow,96,48,48
Cyberlin,nemesis,1138,priest,shadow,24,12,12
Tylandrill,draenor,1137,priest,shadow,30,12,18
Eliana,blackrock,1136,priest,shadow,18,12,6
Амфетаминная,howling-fjord,1136,priest,shadow,137,73,64
Suurona,die-aldor,1136,priest,shadow,60,29,31
Fuzzydude,ravencrest,1135,priest,shadow,36,12,24
Energyfreaxi,aegwynn,1134,priest,shadow,29,13,16
Maximandreic,kazzak,1133,priest,shadow,48,14,34
Thergozar,stormscale,1132,priest,shadow,98,56,42
Некросиний,eversong,1130,priest,shadow,31,18,13
Mynithir,chants-éternels,1129,priest,shadow,54,26,28
Cerbero,doomhammer,1128,priest,shadow,18,12,6
Darettii,blackrock,1127,priest,shadow,33,19,14
Kizzorde,ragnaros,1127,priest,shadow,32,12,20
Farseerx,ravencrest,1125,priest,shadow,150,84,66
Шадовприст,soulflayer,1123,priest,shadow,28,16,12
Tacko,tarren-mill,1123,priest,shadow,30,12,18
Eosar,blackhand,1120,priest,shadow,24,12,12
Tarissa,ravenholdt,1116,priest,shadow,60,32,28
Санятруу,blackscar,1116,priest,shadow,156,83,73
Valdemar,alakir,1115,priest,shadow,39,21,18
Cabalist,silvermoon,1115,priest,shadow,156,79,77
Notcute,the-maelstrom,1111,priest,shadow,29,12,17
Shikamarudmx,burning-legion,1105,priest,shadow,27,13,14
Fanberra,the-venture-co,1105,priest,shadow,30,14,16
Nasurans,ravencrest,1105,priest,shadow,50,18,32
Druska,ragnaros,1103,priest,shadow,47,25,22
Nellytaa,dalaran,1103,priest,shadow,35,18,17
Zennen,ragnaros,1101,priest,shadow,25,13,12
Holymonstah,sanguino,1101,priest,shadow,66,32,34
Sáro,ravencrest,1099,priest,shadow,24,13,11
Mattá,stormscale,1097,priest,shadow,27,15,12
Atelstan,drakthul,1097,priest,shadow,149,70,79
Mushadow,kazzak,1097,priest,shadow,48,14,34
Orochimaruh,pozzo-delleternità,1096,priest,shadow,30,15,15
Семмэр,gordunni,1096,priest,shadow,116,52,64
Смотривнебоь,soulflayer,1094,priest,shadow,23,14,9
Bonka,sanguino,1093,priest,shadow,24,13,11
Ixdeadxl,stormscale,1093,priest,shadow,30,13,17
Ðarcø,archimonde,1093,priest,shadow,95,39,56
Mimox,kaelthas,1089,priest,shadow,42,25,17
Harkøn,draenor,1087,priest,shadow,28,14,14
Ravenbell,chamber-of-aspects,1087,priest,shadow,27,13,14
Arunp,magtheridon,1086,priest,shadow,32,12,20
Kraanocska,outland,1085,priest,shadow,21,13,8
Syfl,defias-brotherhood,1072,priest,shadow,42,18,24
Vanzl,ravencrest,1070,priest,shadow,36,16,20
Собакедруг,borean-tundra,1069,priest,shadow,59,23,36
Ниомана,gordunni,1067,priest,shadow,34,19,15
Beellzo,sylvanas,1065,priest,shadow,129,59,70
Rèd,antonidas,1062,priest,shadow,42,12,30
Alsyidan,khaz-modan,1059,priest,shadow,25,19,6
Efrava,dun-modr,1058,priest,shadow,145,77,68
Brainmuscle,ravencrest,1057,priest,shadow,24,14,10
Gwyneth,archimonde,1057,priest,shadow,72,41,31
Фейсслоу,galakrond,1057,priest,shadow,36,17,19
Kishoengi,ravencrest,1056,priest,shadow,12,11,1
Hanyk,kazzak,1056,priest,shadow,18,11,7
Mindboorst,kazzak,1056,priest,shadow,18,11,7
Cskgbénébéné,garona,1056,priest,shadow,18,11,7
Noskillzz,nemesis,1056,priest,shadow,18,11,7
Сергиоо,soulflayer,1056,priest,shadow,31,13,18
Noyam,dun-morogh,1055,priest,shadow,24,11,13
Buttbob,ravencrest,1054,priest,shadow,24,11,13
Elyziz,tarren-mill,1054,priest,shadow,24,11,13
Мэдмод,gordunni,1054,priest,shadow,24,11,13
Uzü,ysondre,1054,priest,shadow,28,12,16
Umyqt,ragnaros,1053,priest,shadow,18,11,7
Bombastoz,kazzak,1053,priest,shadow,24,11,13
Fluffedup,twisting-nether,1053,priest,shadow,24,11,13
Блэксикер,greymane,1053,priest,shadow,118,49,69
Narafalia,malygos,1053,priest,shadow,45,18,27
Jadæ,ragnaros,1052,priest,shadow,24,11,13
Holineß,burning-blade,1051,priest,shadow,18,11,7
Viánná,sylvanas,1051,priest,shadow,22,12,10
Anshes,draenor,1050,priest,shadow,52,31,21
Phobò,blackrock,1050,priest,shadow,24,11,13
Vardrium,antonidas,1050,priest,shadow,24,11,13
Gstah,taerar,1049,priest,shadow,24,11,13
Deshaz,tarren-mill,1049,priest,shadow,30,11,19
Sundae,nemesis,1048,priest,shadow,30,11,19
Xatori,arthas,1047,priest,shadow,24,11,13
Despéri,ysondre,1047,priest,shadow,30,11,19
Netsojsp,blackmoore,1046,priest,shadow,18,11,7
Getitoffme,auchindoun,1045,priest,shadow,25,11,14
Lexivenera,silvermoon,1044,priest,shadow,18,11,7
Boomhilde,aegwynn,1044,priest,shadow,35,15,20
Zubrowkâ,kazzak,1043,priest,shadow,24,11,13
Irrtum,nozdormu,1041,priest,shadow,30,20,10
Мараес,howling-fjord,1040,priest,shadow,26,16,10
Nightyqt,blackrock,1038,priest,shadow,23,11,12
Saintless,azuremyst,1036,priest,shadow,36,11,25
Szycho,burning-legion,1035,priest,shadow,27,12,15
Akroz,sanguino,1033,priest,shadow,30,11,19
Nextdawn,kazzak,1032,priest,shadow,24,12,12
Trencharse,draenor,1030,priest,shadow,29,11,18
Yuhé,elune,1029,priest,shadow,60,32,28
Phasmofobia,ragnaros,1028,priest,shadow,86,43,43
Asdaprice,hellfire,1027,priest,shadow,29,18,11
Блюмсик,blackscar,1025,priest,shadow,36,20,16
Festiz,tichondrius,1024,priest,shadow,30,14,16
Chïefpapi,twisting-nether,1022,priest,shadow,23,11,12
Alreadylost,ragnaros,1020,priest,shadow,18,11,7
Cpcxmpany,aegwynn,1019,priest,shadow,130,61,69
Xaeroow,archimonde,1017,priest,shadow,20,12,8
Pretronbre,hyjal,1008,priest,shadow,36,16,20
Iceys,stormscale,1005,priest,shadow,17,11,6
Leishmania,darkspear,1005,priest,shadow,24,13,11
Chevappi,silvermoon,1004,priest,shadow,32,14,18
Szpinx,stormscale,1003,priest,shadow,42,16,26
Paìn,sanguino,1001,priest,shadow,22,13,9
Марвелс,soulflayer,1000,priest,shadow,39,12,27
Pneumay,tarren-mill,996,priest,shadow,26,15,11
Arbata,doomhammer,996,priest,shadow,30,16,14
Nuger,tarren-mill,995,priest,shadow,60,35,25
Серебрия,gordunni,991,priest,shadow,99,53,46
Намдандар,howling-fjord,991,priest,shadow,90,44,46
Minabonxx,silvermoon,991,priest,shadow,95,36,59
Zypriest,silvermoon,990,priest,shadow,14,11,3
Pipen,stormscale,990,priest,shadow,29,11,18
Zargoss,sylvanas,974,priest,shadow,19,11,8
Мргорсан,eversong,974,priest,shadow,30,16,14
Stoffig,aggramar,974,priest,shadow,89,46,43
Kunc,drakthul,963,priest,shadow,24,12,12
Reimagined,sylvanas,960,priest,shadow,12,10,2
Theythem,stormscale,960,priest,shadow,12,10,2
Temtem,ravencrest,960,priest,shadow,15,10,5
Secretagentx,kazzak,960,priest,shadow,18,10,8
Flüttër,ravencrest,960,priest,shadow,18,10,8
Кинраналь,eversong,960,priest,shadow,48,24,24
Swl,blackrock,960,priest,shadow,22,11,11
Tribz,kargath,959,priest,shadow,12,10,2
Психоз,gordunni,959,priest,shadow,16,11,5
Merlinis,ravencrest,959,priest,shadow,18,10,8
Uria,moonglade,959,priest,shadow,18,10,8
Jäý,ravencrest,959,priest,shadow,18,10,8
Seankingkong,ravencrest,959,priest,shadow,18,10,8
Hilerki,draenor,959,priest,shadow,24,10,14
Dëpt,nemesis,959,priest,shadow,25,10,15
Munisgagis,twisting-nether,959,priest,shadow,30,10,20
Lestrangé,emerald-dream,958,priest,shadow,12,10,2
Teradros,blackhand,958,priest,shadow,18,10,8
Shadowleech,ragnaros,958,priest,shadow,18,10,8
Pley,sanguino,958,priest,shadow,18,10,8
Conzequ,kazzak,958,priest,shadow,18,10,8
Dárkun,kazzak,958,priest,shadow,21,11,10
Клаенз,fordragon,958,priest,shadow,24,10,14
Hoca,ravencrest,957,priest,shadow,18,10,8
Bîgmac,ravencrest,957,priest,shadow,18,10,8
Xrathor,thunderhorn,957,priest,shadow,18,10,8
Rngånxiety,ravencrest,957,priest,shadow,18,10,8
Breathing,ragnaros,957,priest,shadow,116,54,62
Insanïa,silvermoon,956,priest,shadow,30,10,20
Taxthepoor,blackhand,955,priest,shadow,24,10,14
Above,hyjal,954,priest,shadow,27,12,15
Våfflán,silvermoon,954,priest,shadow,25,10,15
Bodeeney,hellfire,954,priest,shadow,74,29,45
Twisty,malganis,953,priest,shadow,26,15,11
Danekshadow,turalyon,952,priest,shadow,24,10,14
Voldemör,zuljin,952,priest,shadow,30,11,19
Decaey,draenor,951,priest,shadow,32,10,22
Хароки,howling-fjord,950,priest,shadow,12,10,2
Caluna,aegwynn,950,priest,shadow,18,10,8
Priëstitute,stormscale,949,priest,shadow,18,10,8
Lisua,blackmoore,949,priest,shadow,82,30,52
Ixxl,der-rat-von-dalaran,949,priest,shadow,50,16,34
Holywarlock,kazzak,948,priest,shadow,18,10,8
Vríemel,silvermoon,947,priest,shadow,21,11,10
Иннй,howling-fjord,947,priest,shadow,24,11,13
Pollution,ragnaros,942,priest,shadow,19,11,8
Alycya,mannoroth,942,priest,shadow,18,10,8
Sulgyto,kazzak,941,priest,shadow,32,11,21
Papadiax,twilights-hammer,938,priest,shadow,18,10,8
Thunderbluff,xavius,936,priest,shadow,41,21,20
Ruhoniy,ysondre,934,priest,shadow,30,17,13
Даркпул,gordunni,933,priest,shadow,36,10,26
Toadwart,frostmane,928,priest,shadow,18,10,8
Abrakahudder,tarren-mill,927,priest,shadow,17,10,7
Умом,gordunni,927,priest,shadow,26,11,15
Daria,teldrassil,927,priest,shadow,42,16,26
Xartasfen,archimonde,926,priest,shadow,20,11,9
Vregoa,twisting-nether,926,priest,shadow,29,10,19
Andorelya,blackhand,924,priest,shadow,48,26,22
Karabin,culte-de-la-rive-noire,923,priest,shadow,54,28,26
Dayowe,antonidas,921,priest,shadow,279,138,141
Føxy,emerald-dream,920,priest,shadow,18,12,6
Satànâs,twisting-nether,919,priest,shadow,17,10,7
Fârge,elune,911,priest,shadow,17,10,7
Csksablanca,sargeras,911,priest,shadow,17,10,7
Priestoll,draenor,911,priest,shadow,21,10,11
Arondir,defias-brotherhood,910,priest,shadow,21,10,11
Valaç,turalyon,910,priest,shadow,21,10,11
Эсттелла,gordunni,908,priest,shadow,142,67,75
Treasons,tarren-mill,908,priest,shadow,54,16,38
Cthulou,tarren-mill,903,priest,shadow,250,123,127
Helheïm,chants-éternels,896,priest,shadow,22,10,12
Reckpump,twisting-nether,891,priest,shadow,23,10,13
Силабездны,deathguard,889,priest,shadow,132,66,66
Maayhem,blackrock,888,priest,shadow,30,12,18
Aratorass,malganis,887,priest,shadow,17,10,7
Kloown,conseil-des-ombres,886,priest,shadow,72,37,35
Triinkett,doomhammer,881,priest,shadow,75,31,44
Kasimobbel,alexstrasza,877,priest,shadow,185,80,105
Raffá,blackhand,864,priest,shadow,12,9,3
Alinfinito,ravencrest,864,priest,shadow,12,9,3
Honeydots,ravencrest,864,priest,shadow,12,9,3
Potatomoto,kazzak,864,priest,shadow,12,9,3
Iamsadstory,sylvanas,864,priest,shadow,12,9,3
Maxonos,blackmoore,864,priest,shadow,12,9,3
Romero,sylvanas,864,priest,shadow,12,9,3
Шучунекошмар,soulflayer,864,priest,shadow,18,9,9
Spyrono,kazzak,864,priest,shadow,18,9,9
Svagis,draenor,864,priest,shadow,18,9,9
Marytherese,archimonde,864,priest,shadow,18,9,9
Nätrix,tarren-mill,864,priest,shadow,18,9,9
Inavea,hyjal,864,priest,shadow,18,9,9
Memphistô,thrall,864,priest,shadow,18,9,9
Fjonnski,blackmoore,864,priest,shadow,21,10,11
Ok,blackrock,864,priest,shadow,24,9,15
Sheerzo,twisting-nether,864,priest,shadow,24,9,15
Vorramir,blackmoore,864,priest,shadow,24,9,15
Starzzovic,eredar,864,priest,shadow,24,9,15
Æåeåeåé,twisting-nether,864,priest,shadow,24,9,15
Lilsayx,blackrock,864,priest,shadow,30,9,21
Hoomanpri,ravencrest,863,priest,shadow,12,9,3
Hollywoôd,draenor,863,priest,shadow,12,9,3
Klayjamin,draenor,863,priest,shadow,12,9,3
Potati,defias-brotherhood,863,priest,shadow,12,9,3
Lailá,blackmoore,863,priest,shadow,12,9,3
Covidnovitch,archimonde,863,priest,shadow,12,9,3
Quintanaro,thrall,863,priest,shadow,12,9,3
Späxxi,amanthul,863,priest,shadow,12,9,3
Aguerran,spinebreaker,863,priest,shadow,18,9,9
Cloudfactory,ravencrest,863,priest,shadow,18,9,9
Talandra,drakthul,863,priest,shadow,18,9,9
Thami,aegwynn,863,priest,shadow,18,9,9
Bragokexx,tarren-mill,863,priest,shadow,18,9,9
Maiiko,dun-modr,863,priest,shadow,18,9,9
Tygstycke,tarren-mill,863,priest,shadow,18,9,9
Xùÿø,culte-de-la-rive-noire,863,priest,shadow,18,9,9
Sàlexz,ysondre,863,priest,shadow,18,9,9
Lerión,ravencrest,863,priest,shadow,24,9,15
Cythie,antonidas,863,priest,shadow,24,9,15
Truereligion,tarren-mill,863,priest,shadow,24,9,15
Synaxia,blackrock,863,priest,shadow,24,9,15
Konklebär,twisting-nether,863,priest,shadow,24,9,15
Clubhavana,blackrock,863,priest,shadow,65,21,44
Skaliq,tarren-mill,862,priest,shadow,12,9,3
Kaleycuoco,blackrock,862,priest,shadow,12,9,3
Shacoat,draenor,862,priest,shadow,12,9,3
Puzzles,laughing-skull,862,priest,shadow,16,10,6
Kidkuddo,blackmoore,862,priest,shadow,18,9,9
Ronlimonkek,dun-modr,862,priest,shadow,18,9,9
Holyshart,magtheridon,862,priest,shadow,18,9,9
Ximenia,eredar,862,priest,shadow,18,9,9
Treadlightly,aggra-português,862,priest,shadow,18,9,9
Ilostmybible,runetotem,862,priest,shadow,24,9,15
Aelwïn,ysondre,861,priest,shadow,12,9,3
Kavie,ravencrest,861,priest,shadow,18,9,9
Stòkkè,stormscale,861,priest,shadow,18,9,9
Dutchstuff,karazhan,861,priest,shadow,18,9,9
Qiguai,outland,861,priest,shadow,18,9,9
Ztrolol,archimonde,861,priest,shadow,24,9,15
Pristara,bloodhoof,860,priest,shadow,12,9,3
Antalgïque,outland,860,priest,shadow,18,9,9
Etherialis,kazzak,860,priest,shadow,24,9,15
Howlscastie,stormscale,858,priest,shadow,18,9,9
Darkspeech,arygos,858,priest,shadow,30,9,21
Paînswîft,blackhand,857,priest,shadow,18,9,9
Лиройгеморой,gordunni,857,priest,shadow,18,9,9
Grimer,talnivarr,856,priest,shadow,18,9,9
Orcpriest,hellfire,856,priest,shadow,24,9,15
Ethalia,kirin-tor,849,priest,shadow,18,9,9
Endchor,eredar,849,priest,shadow,138,64,74
Бихар,gordunni,847,priest,shadow,22,9,13
Alesdia,eredar,843,priest,shadow,23,9,14
Asob,tarren-mill,830,priest,shadow,17,9,8
Shaddyr,thrall,828,priest,shadow,17,9,8
Happychap,stormreaver,815,priest,shadow,21,9,12
Rymianka,ravencrest,812,priest,shadow,17,9,8
Moonliswd,blackrock,810,priest,shadow,21,10,11
Turf,drakthul,810,priest,shadow,35,9,26
Imdeadxd,twisting-nether,809,priest,shadow,18,10,8
Sliey,blackrock,809,priest,shadow,17,9,8
Supriest,alakir,809,priest,shadow,27,10,17
Oltranza,sylvanas,808,priest,shadow,20,10,10
Darkerx,silvermoon,808,priest,shadow,23,10,13
Avowed,stormscale,803,priest,shadow,31,10,21
Bäckay,silvermoon,799,priest,shadow,16,9,7
Raylinae,die-aldor,799,priest,shadow,16,9,7
Alicanx,silvermoon,798,priest,shadow,17,9,8
Jeannedârk,archimonde,797,priest,shadow,17,9,8
Grootts,burning-blade,797,priest,shadow,20,9,11
Андегвард,soulflayer,794,priest,shadow,16,9,7
Жруля,ashenvale,793,priest,shadow,42,11,31
Shankszz,argent-dawn,771,priest,shadow,16,9,7
Døgfîsh,stormscale,768,priest,shadow,12,8,4
Drákxo,kazzak,768,priest,shadow,12,8,4
Evílshadows,tarren-mill,768,priest,shadow,12,8,4
Zibs,sylvanas,768,priest,shadow,12,8,4
Happyfeis,sanguino,768,priest,shadow,12,8,4
Everdip,outland,768,priest,shadow,12,8,4
Alavéa,frostmourne,768,priest,shadow,12,8,4
Êfx,ravencrest,768,priest,shadow,12,8,4
Raëkon,nemesis,768,priest,shadow,12,8,4
Aliy,aegwynn,768,priest,shadow,12,8,4
Notthatbad,draenor,768,priest,shadow,12,8,4
Lílgoblin,draenor,768,priest,shadow,12,8,4
Cornflayz,outland,768,priest,shadow,12,8,4
Gomor,mannoroth,768,priest,shadow,18,8,10
Svenskabarn,twisting-nether,768,priest,shadow,18,8,10
Khâlÿst,archimonde,768,priest,shadow,18,8,10
Zalupaxgood,outland,768,priest,shadow,18,8,10
Jellypie,blackrock,768,priest,shadow,18,8,10
Slack,azjolnerub,768,priest,shadow,18,8,10
Westminster,tarren-mill,768,priest,shadow,18,8,10
Hoodpriest,blackrock,768,priest,shadow,24,8,16
Stickyjamxx,frostmane,768,priest,shadow,24,8,16
Obscurity,burning-steppes,768,priest,shadow,24,8,16
Zappikpriest,silvermoon,767,priest,shadow,12,8,4
Miilya,ysondre,767,priest,shadow,12,8,4
Dóubt,draenor,767,priest,shadow,12,8,4
Jøa,tarren-mill,767,priest,shadow,12,8,4
Холиспирт,deathguard,767,priest,shadow,12,8,4
Leleg,blackhand,767,priest,shadow,15,9,6
Marcellina,argent-dawn,767,priest,shadow,18,8,10
Bigdumber,kazzak,767,priest,shadow,18,8,10
Nagashizzar,arathor,767,priest,shadow,18,8,10
Luminex,marécage-de-zangar,767,priest,shadow,18,8,10
Maela,uldum,767,priest,shadow,18,8,10
Созвонимся,gordunni,767,priest,shadow,18,8,10
Dimorinny,silvermoon,767,priest,shadow,18,8,10
Strapo,archimonde,767,priest,shadow,18,8,10
Дакимакурах,gordunni,767,priest,shadow,18,8,10
Priestlolx,aegwynn,767,priest,shadow,24,8,16
Zaqsn,blackrock,767,priest,shadow,30,8,22
Mavaai,burning-legion,766,priest,shadow,12,8,4
Aducanpea,blackmoore,766,priest,shadow,12,8,4
Csúforck,ragnaros,766,priest,shadow,12,8,4
Berrylee,twisting-nether,766,priest,shadow,12,8,4
Sheshan,destromath,766,priest,shadow,12,8,4
Greatest,defias-brotherhood,766,priest,shadow,12,8,4
Valkyråe,ravencrest,766,priest,shadow,15,9,6
Ihaveibs,doomhammer,766,priest,shadow,19,9,10
Darkmayham,silvermoon,766,priest,shadow,18,8,10
Kwhy,twisting-nether,766,priest,shadow,18,8,10
Dvärg,ravencrest,766,priest,shadow,18,8,10
Мистеняшко,gordunni,766,priest,shadow,18,8,10
Chlorohhkine,chogall,766,priest,shadow,19,8,11
Ичисанчик,howling-fjord,766,priest,shadow,24,8,16
Enduring,darksorrow,766,priest,shadow,30,8,22
Derl,pozzo-delleternità,765,priest,shadow,12,8,4
Tocsick,outland,765,priest,shadow,15,9,6
Shiekma,norgannon,765,priest,shadow,18,8,10
Géèk,alakir,765,priest,shadow,19,8,11
Shalnorei,drakthul,764,priest,shadow,12,8,4
Holyface,twisting-nether,764,priest,shadow,12,8,4
Silverfate,outland,764,priest,shadow,18,8,10
Sammel,moonglade,763,priest,shadow,18,8,10
Emilie,jaedenar,763,priest,shadow,18,8,10
Madxdoctor,tarren-mill,760,priest,shadow,12,8,4
Никорете,soulflayer,759,priest,shadow,18,8,10
Святаятряпка,fordragon,754,priest,shadow,18,8,10
Vídel,cthun,751,priest,shadow,17,9,8
Barcodes,kazzak,749,priest,shadow,20,9,11
Волотт,borean-tundra,749,priest,shadow,18,8,10
Teleriah,blackmoore,735,priest,shadow,17,8,9
Xavyos,eredar,734,priest,shadow,22,8,14
Smoothiejoe,stormscale,733,priest,shadow,10,9,1
Yhullgord,nazjatar,721,priest,shadow,26,9,17
Herro,thrall,719,priest,shadow,11,8,3
Aureï,khaz-modan,716,priest,shadow,18,9,9
Dementois,magtheridon,711,priest,shadow,27,9,18
Raetwo,stormscale,703,priest,shadow,14,8,6
Hanfur,twisting-nether,703,priest,shadow,16,8,8
Манддалорец,gordunni,702,priest,shadow,22,8,14
Pycasso,tarren-mill,700,priest,shadow,84,33,51
Badpriest,blackhand,686,priest,shadow,17,10,7
Shendiva,nathrezim,681,priest,shadow,13,8,5
Laxanes,ravencrest,672,priest,shadow,12,7,5
Mshield,blackmoore,672,priest,shadow,12,7,5
Systerstål,twisting-nether,672,priest,shadow,12,7,5
Snoopydawgs,blackmoore,672,priest,shadow,12,7,5
Desti,darkmoon-faire,672,priest,shadow,12,7,5
Awator,ysondre,672,priest,shadow,12,7,5
Nordrenalin,tarren-mill,672,priest,shadow,12,7,5
Миррен,gordunni,672,priest,shadow,12,7,5
Kíguwu,draenor,672,priest,shadow,12,7,5
Teengirl,ravencrest,672,priest,shadow,12,7,5
Azazoth,sylvanas,672,priest,shadow,12,7,5
Mørøk,dun-modr,672,priest,shadow,12,7,5
Linara,frostmane,672,priest,shadow,12,7,5
Mcdutchy,arygos,672,priest,shadow,12,7,5
Dolens,argent-dawn,672,priest,shadow,12,7,5
Lerissea,argent-dawn,672,priest,shadow,12,7,5
Deform,argent-dawn,672,priest,shadow,12,7,5
Зоргдаркнесс,howling-fjord,672,priest,shadow,12,7,5
Teríyaki,blackrock,672,priest,shadow,12,7,5
Roastie,frostmane,672,priest,shadow,12,7,5
Jinxk,anachronos,672,priest,shadow,12,7,5
Medtner,stormscale,672,priest,shadow,12,7,5
Vladï,conseil-des-ombres,672,priest,shadow,12,7,5
Aesyla,drakthul,672,priest,shadow,12,7,5
Viperbites,tarren-mill,672,priest,shadow,12,7,5
Leggat,draenor,672,priest,shadow,15,8,7
Tolqen,stormscale,672,priest,shadow,18,7,11
Memelordqt,silvermoon,672,priest,shadow,18,7,11
Lilnazx,twisting-nether,672,priest,shadow,18,7,11
Iordjahmilli,blackmoore,672,priest,shadow,18,7,11
Heygoogle,ravencrest,672,priest,shadow,18,7,11
Crazyname,outland,672,priest,shadow,18,7,11
Sorshan,marécage-de-zangar,672,priest,shadow,18,7,11
Remkojatwo,blackrock,672,priest,shadow,18,7,11
Ailloria,hyjal,672,priest,shadow,18,7,11
Arratør,ysondre,672,priest,shadow,18,7,11
Madrobert,outland,672,priest,shadow,18,7,11
Рэйам,fordragon,672,priest,shadow,18,7,11
Majinbuù,sargeras,672,priest,shadow,18,7,11
Korzec,dun-modr,672,priest,shadow,18,7,11
Irlfatguy,ravencrest,672,priest,shadow,20,7,13
Iamshadow,blackrock,672,priest,shadow,23,7,16
Serayhx,blackrock,672,priest,shadow,24,7,17
Sínd,twisting-nether,672,priest,shadow,30,7,23
Hölyfans,ravencrest,671,priest,shadow,12,7,5
Neeyø,blackhand,671,priest,shadow,12,7,5
Шархиззл,soulflayer,671,priest,shadow,12,7,5
Kogarrashi,aegwynn,671,priest,shadow,12,7,5
Elivn,kazzak,671,priest,shadow,12,7,5
Xæe,blackrock,671,priest,shadow,12,7,5
Badomens,draenor,671,priest,shadow,12,7,5
Saym,blackrock,671,priest,shadow,12,7,5
Allanna,talnivarr,671,priest,shadow,12,7,5
Мариаглорум,gordunni,671,priest,shadow,12,7,5
Elarya,zenedar,671,priest,shadow,12,7,5
Exçi,blackrock,671,priest,shadow,12,7,5
Cryptoniite,kazzak,671,priest,shadow,12,7,5
Bazazath,thrall,671,priest,shadow,15,8,7
Freshpope,ravencrest,671,priest,shadow,16,8,8
Elfer,dalaran,671,priest,shadow,18,7,11
Fùkøff,stormscale,671,priest,shadow,18,7,11
Leyra,burning-blade,671,priest,shadow,18,7,11
Chaarronn,drakthul,671,priest,shadow,18,7,11
Calypsa,aegwynn,671,priest,shadow,18,7,11
Трихоманиаз,ashenvale,671,priest,shadow,18,7,11
Gagai,ravencrest,671,priest,shadow,18,7,11
Fedosia,kazzak,671,priest,shadow,18,7,11
Whitfield,cthun,671,priest,shadow,18,7,11
Ascendedpwnz,silvermoon,671,priest,shadow,18,7,11
Lêavis,kazzak,671,priest,shadow,18,7,11
Игшайл,eversong,671,priest,shadow,18,7,11
Idontmind,eredar,671,priest,shadow,18,7,11
Zileena,argent-dawn,671,priest,shadow,24,7,17
Bitcoinperp,tarren-mill,671,priest,shadow,24,7,17
Solanaelle,archimonde,671,priest,shadow,24,7,17
Alexpriest,twisting-nether,671,priest,shadow,24,7,17
Hiela,outland,670,priest,shadow,12,7,5
Copperplume,ravenholdt,670,priest,shadow,12,7,5
Kitasia,tarren-mill,670,priest,shadow,12,7,5
Chayz,thrall,670,priest,shadow,12,7,5
Nahrzgrein,blackmoore,670,priest,shadow,14,7,7
Nesar,stormscale,670,priest,shadow,18,7,11
Yellenna,argent-dawn,670,priest,shadow,18,7,11
Kavius,kazzak,670,priest,shadow,23,8,15
Nonka,azjolnerub,670,priest,shadow,24,7,17
Infliction,auchindoun,670,priest,shadow,24,7,17
Deathornot,blackrock,669,priest,shadow,12,7,5
Banedps,the-maelstrom,669,priest,shadow,18,7,11
Husqvarnasåg,tarren-mill,669,priest,shadow,27,8,19
Hoouro,ysondre,668,priest,shadow,18,7,11
Newik,burning-legion,667,priest,shadow,12,7,5
Hulluh,tarren-mill,665,priest,shadow,12,7,5
Nadora,sanguino,663,priest,shadow,29,9,20
Redfield,frostmane,663,priest,shadow,24,7,17
Spaghettoni,tarren-mill,662,priest,shadow,12,7,5
Swarzie,outland,653,priest,shadow,17,7,10
Szelén,ragnaros,640,priest,shadow,16,7,9
Solaqt,tarren-mill,639,priest,shadow,11,7,4
Llounal,silvermoon,637,priest,shadow,17,7,10
Viperaxe,stormscale,623,priest,shadow,11,7,4
Seniya,argent-dawn,623,priest,shadow,11,7,4
Voidtrix,blackrock,623,priest,shadow,17,7,10
Eliyssa,ragnaros,623,priest,shadow,17,7,10
Фьюриреидж,soulflayer,617,priest,shadow,14,8,6
Jyugins,alonsus,617,priest,shadow,18,8,10
Reeflix,blackmoore,607,priest,shadow,17,8,9
Mysticks,kirin-tor,592,priest,shadow,13,7,6
Voilencia,kazzak,592,priest,shadow,13,7,6
Ilovesumecx,aegwynn,591,priest,shadow,11,7,4
Lipzip,twisting-nether,591,priest,shadow,19,7,12
Deadandugly,eredar,576,priest,shadow,6,6,0
Noggorran,teldrassil,576,priest,shadow,10,7,3
Yazh,argent-dawn,576,priest,shadow,12,6,6
Cocolasticot,garona,576,priest,shadow,12,6,6
Сакта,howling-fjord,576,priest,shadow,12,6,6
Lilannah,archimonde,576,priest,shadow,12,6,6
Iqr,blackmoore,576,priest,shadow,12,6,6
Dboi,tarren-mill,576,priest,shadow,12,6,6
Nometalol,drakthul,576,priest,shadow,12,6,6
Enimao,tarren-mill,576,priest,shadow,12,6,6
Shadowpdots,sargeras,576,priest,shadow,12,6,6
Wonkä,archimonde,576,priest,shadow,12,6,6
Vyø,tarren-mill,576,priest,shadow,12,6,6
Shacka,tarren-mill,576,priest,shadow,12,6,6
Cultist,defias-brotherhood,576,priest,shadow,12,6,6
Mephiras,kult-der-verdammten,576,priest,shadow,12,6,6
Ilostmybibíe,silvermoon,576,priest,shadow,12,6,6
Farotep,tarren-mill,576,priest,shadow,12,6,6
Madpandax,blackmoore,576,priest,shadow,12,6,6
Vizzek,eredar,576,priest,shadow,12,6,6
Landliebe,outland,576,priest,shadow,12,6,6
Mindbomb,defias-brotherhood,576,priest,shadow,12,6,6
Saliâ,blackmoore,576,priest,shadow,12,6,6
Noreal,twisting-nether,576,priest,shadow,12,6,6
Arrhenia,blackrock,576,priest,shadow,12,6,6
Karyx,blackmoore,576,priest,shadow,12,6,6
Englestøv,stormreaver,576,priest,shadow,12,6,6
Skyfour,blackmoore,576,priest,shadow,12,6,6
Lysium,sylvanas,576,priest,shadow,12,6,6
Dakystepmom,stormreaver,576,priest,shadow,12,6,6
Stakataka,draenor,576,priest,shadow,12,6,6
Старлайтх,gordunni,576,priest,shadow,12,6,6
Ragaril,kaelthas,576,priest,shadow,12,6,6
Nomarak,drakthul,576,priest,shadow,12,6,6
Bedevil,twisting-nether,576,priest,shadow,12,6,6
Взрывмозга,howling-fjord,576,priest,shadow,12,6,6
Свдпро,soulflayer,576,priest,shadow,12,6,6
Submeplz,stormscale,576,priest,shadow,12,6,6
Chîllipriest,draenor,576,priest,shadow,12,6,6
Fluffieh,ravencrest,576,priest,shadow,12,6,6
Ellfle,kazzak,576,priest,shadow,12,6,6
Skillmåster,ravencrest,576,priest,shadow,12,6,6
Cluelêss,blackrock,576,priest,shadow,12,6,6
Siquisha,stormscale,576,priest,shadow,12,6,6
Tonyxfor,nemesis,576,priest,shadow,12,6,6
Poonies,silvermoon,576,priest,shadow,12,6,6
Torpedobæver,silvermoon,576,priest,shadow,12,6,6
Herlloomprie,stormscale,576,priest,shadow,12,6,6
Kunayu,ravencrest,576,priest,shadow,12,6,6
Prästjäväln,stormscale,576,priest,shadow,12,6,6
Holydark,forscherliga,576,priest,shadow,12,6,6
Wakizashi,ravencrest,576,priest,shadow,12,6,6
Lirrydoz,ravencrest,576,priest,shadow,12,6,6
Wasgehtjungs,blackrock,576,priest,shadow,12,6,6
Ralaya,ravencrest,576,priest,shadow,12,6,6
Sselycrem,dun-morogh,576,priest,shadow,12,6,6
Pepitzaftw,sylvanas,576,priest,shadow,12,6,6
Ursela,tarren-mill,576,priest,shadow,18,6,12
Averye,kazzak,576,priest,shadow,18,6,12
Ezea,blackmoore,576,priest,shadow,18,6,12
Ràvèn,dun-modr,576,priest,shadow,18,6,12
Obbdasknob,ravencrest,576,priest,shadow,18,6,12
ßåßåýågå,ysondre,576,priest,shadow,24,6,18
Øro,ysondre,576,priest,shadow,24,6,18
Extrasa,daggerspine,576,priest,shadow,24,6,18
Goldenapples,ravencrest,575,priest,shadow,12,6,6
Oíee,senjin,575,priest,shadow,12,6,6
Torquemad,sunstrider,575,priest,shadow,12,6,6
Attaxx,dragonmaw,575,priest,shadow,12,6,6
Drmwow,kazzak,575,priest,shadow,12,6,6
Jaya,veknilash,575,priest,shadow,12,6,6
Fathérted,kazzak,575,priest,shadow,12,6,6
Princéssà,aegwynn,575,priest,shadow,12,6,6
Арабески,galakrond,575,priest,shadow,12,6,6
Химмеллия,azuregos,575,priest,shadow,12,6,6
Scastro,silvermoon,575,priest,shadow,12,6,6
Вартэг,blackscar,575,priest,shadow,12,6,6
Cåtie,sylvanas,575,priest,shadow,18,6,12
Prepodobna,ravencrest,575,priest,shadow,18,6,12
Wintercurse,twisting-nether,575,priest,shadow,18,6,12
Siemenspvp,drakthul,575,priest,shadow,18,6,12
Mishas,draenor,575,priest,shadow,18,6,12
Luxumbra,pozzo-delleternità,574,priest,shadow,12,6,6
Azshanna,argent-dawn,574,priest,shadow,12,6,6
Tronixcs,boulderfist,574,priest,shadow,18,6,12
Zerim,blackmoore,574,priest,shadow,30,6,24
Primurä,hyjal,573,priest,shadow,18,6,12
Zagazag,ragnaros,573,priest,shadow,18,6,12
Gammelkörper,perenolde,573,priest,shadow,23,6,17
Словаболь,gordunni,572,priest,shadow,12,6,6
Сендрагон,blackscar,572,priest,shadow,18,6,12
Dayu,blackrock,572,priest,shadow,24,6,18
Mâverick,nemesis,571,priest,shadow,24,6,18
Karmapollys,silvermoon,570,priest,shadow,12,6,6
Raeratwo,archimonde,569,priest,shadow,17,8,9
Yvaru,der-mithrilorden,543,priest,shadow,11,6,5
Виатрикс,goldrinn,543,priest,shadow,16,6,10
Reallittle,kazzak,522,priest,shadow,16,7,9
Neggan,chamber-of-aspects,521,priest,shadow,21,7,14
Trînìty,kazzak,515,priest,shadow,22,10,12
Ginithepope,ragnaros,511,priest,shadow,11,6,5
Mjuk,tarren-mill,496,priest,shadow,7,6,1
Endead,stormscale,480,priest,shadow,6,5,1
Winnable,blackmoore,480,priest,shadow,6,5,1
Elunaera,twisting-nether,480,priest,shadow,6,5,1
Absôû,khaz-modan,480,priest,shadow,6,5,1
Kagera,argent-dawn,480,priest,shadow,6,5,1
Azrpr,ravencrest,480,priest,shadow,6,5,1
Attilerg,stormscale,480,priest,shadow,6,5,1
Рукатёмная,soulflayer,480,priest,shadow,6,5,1
Ralph,kazzak,480,priest,shadow,6,5,1
Easyc,gorgonnash,480,priest,shadow,6,5,1
Sântamuerte,blackrock,480,priest,shadow,6,5,1
Discórdian,twisting-nether,480,priest,shadow,6,5,1
Disillusíon,tarren-mill,480,priest,shadow,6,5,1
Darthbussy,twisting-nether,480,priest,shadow,6,5,1
Rinkahands,silvermoon,480,priest,shadow,6,5,1
Graveyards,tarren-mill,480,priest,shadow,6,5,1
Pâww,kazzak,480,priest,shadow,6,5,1
Eilísh,tarren-mill,480,priest,shadow,6,5,1
Алуриэлия,gordunni,480,priest,shadow,6,5,1
Dìscìplìned,ravencrest,480,priest,shadow,6,5,1
Gíìh,ravencrest,480,priest,shadow,6,5,1
Gladíator,blackhand,480,priest,shadow,6,5,1
Darkqt,ravencrest,480,priest,shadow,6,5,1
Gpêchépaire,archimonde,480,priest,shadow,8,5,3
Shadowkenia,ysondre,480,priest,shadow,8,5,3
Qúetee,silvermoon,480,priest,shadow,10,6,4
Slitenprest,kazzak,480,priest,shadow,12,6,6
Fredschen,blackrock,480,priest,shadow,11,5,6
Rickermortis,defias-brotherhood,480,priest,shadow,12,5,7
Zolupno,kazzak,480,priest,shadow,12,5,7
Шуддзуми,gordunni,480,priest,shadow,12,5,7
Nicany,blackmoore,480,priest,shadow,12,5,7
Haiduka,burning-legion,480,priest,shadow,12,5,7
Mcx,blackmoore,480,priest,shadow,12,5,7
Yaloxyz,blackmoore,480,priest,shadow,12,5,7
Darkmus,quelthalas,480,priest,shadow,12,5,7
Loweysp,arathor,480,priest,shadow,12,5,7
Ölümsüz,blackmoore,480,priest,shadow,12,5,7
Neverfade,dun-modr,480,priest,shadow,12,5,7
Megadima,norgannon,480,priest,shadow,12,5,7
Unhollymarie,culte-de-la-rive-noire,480,priest,shadow,12,5,7
Speedfraek,kazzak,480,priest,shadow,12,5,7
Wizarxmentar,stormscale,480,priest,shadow,12,5,7
Ompala,shattered-hand,480,priest,shadow,12,5,7
Wheydoras,blackrock,480,priest,shadow,12,5,7
Bonsoin,kirin-tor,480,priest,shadow,12,5,7
Löspajen,stormscale,480,priest,shadow,12,5,7
Lillclubbina,stormscale,480,priest,shadow,12,5,7
Xpy,kazzak,480,priest,shadow,12,5,7
Chewthefat,kazzak,480,priest,shadow,12,5,7
Pleshiv,sanguino,480,priest,shadow,12,5,7
Dirtydoc,area-52,480,priest,shadow,12,5,7
Shadowlia,blackrock,480,priest,shadow,12,5,7
Lèviåthån,stormscale,480,priest,shadow,12,5,7
Rovensin,ravencrest,480,priest,shadow,12,5,7
Jarkk,ysondre,480,priest,shadow,12,5,7
Azferia,kelthuzad,480,priest,shadow,12,5,7
Rokil,ravencrest,480,priest,shadow,12,5,7
Darrianna,outland,480,priest,shadow,12,5,7
Lyssandre,stormreaver,480,priest,shadow,12,5,7
Elixier,frostmane,480,priest,shadow,12,5,7
Shadowful,drakthul,480,priest,shadow,12,5,7
Амбракадабра,blackscar,480,priest,shadow,12,5,7
Tarboba,tarren-mill,480,priest,shadow,12,5,7
Хенели,blackscar,480,priest,shadow,12,5,7
Blackout,nemesis,480,priest,shadow,12,5,7
Taikki,stormreaver,480,priest,shadow,12,5,7
Xotz,thrall,480,priest,shadow,12,5,7
Bromerzhus,drakthul,480,priest,shadow,12,5,7
Môrtïciâ,tarren-mill,480,priest,shadow,12,5,7
Mondiie,drakthul,480,priest,shadow,12,5,7
Cillypri,ravencrest,480,priest,shadow,12,5,7
Гуул,gordunni,480,priest,shadow,12,5,7
Cmonbro,hyjal,480,priest,shadow,12,5,7
Tokz,eredar,480,priest,shadow,12,5,7
Yukasa,silvermoon,480,priest,shadow,12,5,7
Salzgehalt,antonidas,480,priest,shadow,12,5,7
Крэкслингер,howling-fjord,480,priest,shadow,13,5,8
Hellzie,darkspear,480,priest,shadow,18,5,13
Winar,tarren-mill,480,priest,shadow,18,5,13
Inanitas,tichondrius,480,priest,shadow,18,5,13
Tryagain,ravencrest,480,priest,shadow,18,5,13
Fögel,twisting-nether,480,priest,shadow,18,5,13
Nôtt,tarren-mill,479,priest,shadow,6,5,1
Xieraxe,ravencrest,479,priest,shadow,12,5,7
Olivaress,ravencrest,479,priest,shadow,12,5,7
Chandria,veknilash,479,priest,shadow,12,5,7
Балзик,blackscar,479,priest,shadow,12,5,7
Fráncess,twisting-nether,479,priest,shadow,12,5,7
Heinricht,ragnaros,479,priest,shadow,12,5,7
Лейля,goldrinn,479,priest,shadow,18,5,13
Xrystal,wrathbringer,479,priest,shadow,24,5,19
Corefusion,blackrock,478,priest,shadow,18,5,13
Kyol,colinas-pardas,478,priest,shadow,24,5,19
Stöffer,thrall,477,priest,shadow,18,5,13
Имбахилл,lich-king,476,priest,shadow,12,5,7
Falbäla,suramar,473,priest,shadow,12,5,7
Luthsha,sylvanas,448,priest,shadow,10,5,5
Immurrtal,arathor,447,priest,shadow,8,6,2
Oscoolytb,archimonde,447,priest,shadow,8,6,2
Sàd,thrall,447,priest,shadow,11,5,6
Exila,rashgarroth,432,priest,shadow,17,6,11
Celina,quelthalas,432,priest,shadow,21,6,15
Disz,zuljin,431,priest,shadow,9,6,3
Безмездная,gordunni,426,priest,shadow,16,6,10
Bloodimand,terenas,422,priest,shadow,12,6,6
Chaddý,blackrock,416,priest,shadow,10,5,5
Zepesch,dalvengyr,409,priest,shadow,21,6,15
Goldenmuda,stormscale,400,priest,shadow,7,5,2
Alucardiiog,shattered-hand,399,priest,shadow,5,5,0
Ulalume,ravencrest,393,priest,shadow,14,7,7
Spum,ravencrest,384,priest,shadow,6,4,2
Darqmatter,drakthul,384,priest,shadow,6,4,2
Ýbëzz,ravencrest,384,priest,shadow,6,4,2
Beástyqt,thrall,384,priest,shadow,6,4,2
Akenochan,hyjal,384,priest,shadow,6,4,2
Luuña,ravencrest,384,priest,shadow,6,4,2
Jesuispasbon,hyjal,384,priest,shadow,6,4,2
Tekrs,tarren-mill,384,priest,shadow,6,4,2
Ëlÿ,hyjal,384,priest,shadow,6,4,2
Shóxi,blackmoore,384,priest,shadow,6,4,2
Korvmoj,ravencrest,384,priest,shadow,6,4,2
Éllipses,kazzak,384,priest,shadow,6,4,2
Holypwo,draenor,384,priest,shadow,6,4,2
Viëna,silvermoon,384,priest,shadow,6,4,2
Edgybro,kazzak,384,priest,shadow,6,4,2
Jpxoxo,blackhand,384,priest,shadow,6,4,2
Tuitio,blackmoore,384,priest,shadow,6,4,2
Dokurochan,tarren-mill,384,priest,shadow,6,4,2
Инфесия,deathweaver,384,priest,shadow,6,4,2
Pinkfloydx,lightbringer,384,priest,shadow,6,4,2
Torino,kazzak,384,priest,shadow,6,4,2
Текл,blackscar,384,priest,shadow,6,4,2
Coqa,blackrock,384,priest,shadow,6,4,2
Dairox,blackrock,384,priest,shadow,6,4,2
Stonymontana,ravencrest,384,priest,shadow,6,4,2
Hotdoge,zenedar,384,priest,shadow,6,4,2
Mshieldo,blackmoore,384,priest,shadow,6,4,2
Keylythia,blackmoore,384,priest,shadow,6,4,2
Lumex,aegwynn,384,priest,shadow,6,4,2
Syrïal,hyjal,384,priest,shadow,6,4,2
Mønzie,stormscale,384,priest,shadow,6,4,2
Spae,twisting-nether,384,priest,shadow,6,4,2
Jamzypriest,kazzak,384,priest,shadow,6,4,2
Holymood,aegwynn,384,priest,shadow,6,4,2
Kyokaze,silvermoon,384,priest,shadow,6,4,2
Alicanx,twisting-nether,384,priest,shadow,6,4,2
Lxz,twisting-nether,384,priest,shadow,6,4,2
Galadrïel,dragonmaw,384,priest,shadow,6,4,2
Ifearnoone,outland,384,priest,shadow,6,4,2
Ylenae,twisting-nether,384,priest,shadow,6,4,2
Surx,silvermoon,384,priest,shadow,6,4,2
Alusiepriest,ravencrest,384,priest,shadow,6,4,2
Kazorn,argent-dawn,384,priest,shadow,6,4,2
Sekeios,sanguino,384,priest,shadow,6,4,2
Djsnook,ravencrest,384,priest,shadow,6,4,2
Fericul,argent-dawn,384,priest,shadow,6,4,2
Madreöscura,cthun,384,priest,shadow,6,4,2
Trac,twisting-nether,384,priest,shadow,6,4,2
Darkmìstress,nemesis,384,priest,shadow,6,4,2
Usw,outland,384,priest,shadow,6,4,2
Daftî,twisting-nether,384,priest,shadow,6,4,2
Zul,nemesis,384,priest,shadow,6,4,2
Glaedahr,blackmoore,384,priest,shadow,6,4,2
Idisck,kazzak,384,priest,shadow,6,4,2
Kapaloinsut,draenor,384,priest,shadow,6,4,2
Elunnes,the-maelstrom,384,priest,shadow,6,4,2
Ranzael,blackrock,384,priest,shadow,6,4,2
Jdotp,silvermoon,384,priest,shadow,6,4,2
Rutah,the-maelstrom,384,priest,shadow,6,4,2
Lorthonor,silvermoon,384,priest,shadow,6,4,2
Mamaa,stormscale,384,priest,shadow,6,4,2
Shaquíloheal,blackrock,384,priest,shadow,6,4,2
Ozmandius,ravencrest,384,priest,shadow,6,4,2
Clungeslag,argent-dawn,384,priest,shadow,6,4,2
Metabeta,shattered-hand,384,priest,shadow,6,4,2
Rankoneprazt,stormscale,384,priest,shadow,6,4,2
Êlectron,ravencrest,384,priest,shadow,6,4,2
Éxomil,archimonde,384,priest,shadow,6,4,2
Vqny,archimonde,384,priest,shadow,6,4,2
Níbbz,twisting-nether,384,priest,shadow,6,4,2
Mysticforces,silvermoon,384,priest,shadow,6,4,2
Shadowboness,twisting-nether,384,priest,shadow,6,4,2
Floodey,defias-brotherhood,384,priest,shadow,6,4,2
Shizophrenia,aggra-português,384,priest,shadow,6,4,2
Jimbób,malygos,384,priest,shadow,6,4,2
Massivbeton,blackmoore,384,priest,shadow,6,4,2
Sheid,zuljin,384,priest,shadow,6,4,2
Vantek,antonidas,384,priest,shadow,6,4,2
Kert,kaelthas,384,priest,shadow,6,4,2
Truther,frostmane,384,priest,shadow,6,4,2
Thogrey,archimonde,384,priest,shadow,6,4,2
Олдмэнсэйд,soulflayer,384,priest,shadow,6,4,2
Buomap,kazzak,384,priest,shadow,6,4,2
Мамкалол,soulflayer,384,priest,shadow,6,4,2
Napriest,kazzak,384,priest,shadow,6,4,2
Víxie,frostmane,384,priest,shadow,6,4,2
Prådâshådëzz,blackmoore,384,priest,shadow,6,4,2
Doyun,kazzak,384,priest,shadow,6,4,2
Cheryli,alleria,384,priest,shadow,6,4,2
Suqmyx,ragnaros,384,priest,shadow,6,4,2
Sîarra,eredar,384,priest,shadow,6,4,2
Kenzah,ysondre,384,priest,shadow,6,4,2
Влажныйшп,soulflayer,384,priest,shadow,6,4,2
Дюшапинанс,soulflayer,384,priest,shadow,6,4,2
Fetaagneta,grim-batol,384,priest,shadow,6,4,2
Spleen,archimonde,384,priest,shadow,6,4,2
Вэстервилли,howling-fjord,384,priest,shadow,6,4,2
Selecta,grim-batol,384,priest,shadow,6,4,2
Djvoodoo,ahnqiraj,384,priest,shadow,6,4,2
Nekxm,archimonde,384,priest,shadow,9,5,4
Necronidas,burning-legion,384,priest,shadow,10,5,5
Nìak,ysondre,384,priest,shadow,15,5,10
Арлектакль,blackscar,384,priest,shadow,12,4,8
Neryl,alleria,384,priest,shadow,12,4,8
Æro,malganis,384,priest,shadow,12,4,8
Mindcrackr,stormscale,384,priest,shadow,12,4,8
Xaphen,kirin-tor,384,priest,shadow,12,4,8
Crimatoriá,rajaxx,384,priest,shadow,12,4,8
Entenpanda,kazzak,384,priest,shadow,12,4,8
Holycrapx,chromaggus,384,priest,shadow,12,4,8
Râây,blackrock,384,priest,shadow,12,4,8
Niikki,blackrock,384,priest,shadow,12,4,8
Самоэль,gordunni,384,priest,shadow,12,4,8
Dælirium,antonidas,384,priest,shadow,12,4,8
Halysis,chamber-of-aspects,384,priest,shadow,12,4,8
Swoptoplong,blackhand,384,priest,shadow,12,4,8
Skilled,stormscale,384,priest,shadow,12,4,8
Shadøwz,grim-batol,384,priest,shadow,12,4,8
Hanniel,kazzak,384,priest,shadow,12,4,8
Datscrazi,ravencrest,384,priest,shadow,12,4,8
Gendzsó,ragnaros,384,priest,shadow,12,4,8
Amonrah,blutkessel,384,priest,shadow,12,4,8
Залакджин,howling-fjord,384,priest,shadow,12,4,8
Darkoze,kazzak,384,priest,shadow,12,4,8
Necrolooz,ragnaros,384,priest,shadow,12,4,8
Soupriest,ysondre,384,priest,shadow,12,4,8
Pliagonosic,drakthul,384,priest,shadow,12,4,8
Gonorreolga,tarren-mill,384,priest,shadow,12,4,8
Xalgâzor,zuljin,384,priest,shadow,12,4,8
Lfgarcatraz,aegwynn,384,priest,shadow,12,4,8
Dotmaster,darkspear,384,priest,shadow,12,4,8
Morzâr,outland,384,priest,shadow,12,4,8
Ferhur,defias-brotherhood,384,priest,shadow,12,4,8
Baubsy,ghostlands,384,priest,shadow,12,4,8
Voidknight,darkspear,384,priest,shadow,12,4,8
Jojipriest,tarren-mill,384,priest,shadow,12,4,8
Dpriesta,aegwynn,384,priest,shadow,12,4,8
Bacovia,tarren-mill,384,priest,shadow,12,4,8
Elpsycongoro,aegwynn,384,priest,shadow,12,4,8
Thyrena,twisting-nether,384,priest,shadow,12,4,8
Zzoska,burning-legion,384,priest,shadow,12,4,8
Bilalhassâni,archimonde,384,priest,shadow,12,4,8
Zaoza,dentarg,384,priest,shadow,12,4,8
Célaz,blackmoore,384,priest,shadow,12,4,8
Adamàntium,sanguino,384,priest,shadow,12,4,8
Nynaehve,archimonde,384,priest,shadow,12,4,8
Miradil,argent-dawn,384,priest,shadow,12,4,8
Kirtách,dun-modr,384,priest,shadow,12,4,8
Tobirama,stormscale,384,priest,shadow,17,4,13
Shadowdex,frostwolf,384,priest,shadow,18,4,14
Абрасд,gordunni,384,priest,shadow,18,4,14
Шкуропльот,gordunni,384,priest,shadow,18,4,14
Nukksch,antonidas,384,priest,shadow,18,4,14
Pepicka,turalyon,383,priest,shadow,6,4,2
Muromachi,kirin-tor,383,priest,shadow,6,4,2
Abnórmus,tarren-mill,383,priest,shadow,6,4,2
Ðex,chromaggus,383,priest,shadow,12,4,8
Sphard,ysondre,383,priest,shadow,12,4,8
Sýmo,kazzak,383,priest,shadow,12,4,8
Kasáya,thrall,383,priest,shadow,12,4,8
Adlareg,silvermoon,383,priest,shadow,12,4,8
Нечавкай,deathweaver,383,priest,shadow,18,4,14
Anglaran,hellscream,383,priest,shadow,24,4,20
Blyatman,tarren-mill,382,priest,shadow,6,4,2
Quinlanx,quelthalas,381,priest,shadow,18,4,14
Perchédue,silvermoon,367,priest,shadow,11,4,7
Spookyi,blackrock,366,priest,shadow,23,4,19
Împðøg,stormscale,352,priest,shadow,10,4,6
Phaedisc,defias-brotherhood,351,priest,shadow,11,4,7
Shilôz,hyjal,351,priest,shadow,11,4,7
Topshop,vashj,351,priest,shadow,11,4,7
Эльфиола,howling-fjord,349,priest,shadow,8,5,3
Levitating,argent-dawn,336,priest,shadow,9,5,4
Prästisjag,kazzak,330,priest,shadow,20,10,10
Smited,ravencrest,330,priest,shadow,15,5,10
Декомпиляция,blackscar,330,priest,shadow,19,6,13
Zetara,archimonde,320,priest,shadow,10,4,6
Blainexi,arathor,320,priest,shadow,10,4,6
Mindgames,the-maelstrom,319,priest,shadow,5,4,1
Runbaberun,hyjal,319,priest,shadow,8,4,4
Shagoku,blackmoore,319,priest,shadow,8,4,4
Whýççpèrx,ravencrest,304,priest,shadow,7,4,3
Trickyteè,tarren-mill,288,priest,shadow,6,3,3
Resgan,archimonde,288,priest,shadow,6,3,3
Proteco,antonidas,288,priest,shadow,6,3,3
Ephraziel,defias-brotherhood,288,priest,shadow,6,3,3
Nødhjelp,kazzak,288,priest,shadow,6,3,3
Doctep,sargeras,288,priest,shadow,6,3,3
Mgx,defias-brotherhood,288,priest,shadow,6,3,3
Neathi,twisting-nether,288,priest,shadow,6,3,3
Tobijara,proudmoore,288,priest,shadow,6,3,3
Neopriest,stormscale,288,priest,shadow,6,3,3
Spanpriest,kazzak,288,priest,shadow,6,3,3
Tåbðøtgøðx,archimonde,288,priest,shadow,6,3,3
Notra,shattrath,288,priest,shadow,6,3,3
Reapersark,draenor,288,priest,shadow,6,3,3
Spankulere,stormscale,288,priest,shadow,6,3,3
Gúinness,pozzo-delleternità,288,priest,shadow,6,3,3
Azeeza,stormscale,288,priest,shadow,6,3,3
Gulbulle,ysondre,288,priest,shadow,6,3,3
Eyvvah,twisting-nether,288,priest,shadow,6,3,3
Cðsima,blackmoore,288,priest,shadow,6,3,3
Kaius,mannoroth,288,priest,shadow,6,3,3
Vividots,draenor,288,priest,shadow,6,3,3
Canthms,twisting-nether,288,priest,shadow,6,3,3
Truta,ravencrest,288,priest,shadow,6,3,3
Søînx,archimonde,288,priest,shadow,6,3,3
Némonix,outland,288,priest,shadow,6,3,3
Johnblack,dun-morogh,288,priest,shadow,6,3,3
Jilizjiliz,blackmoore,288,priest,shadow,6,3,3
Salzpriest,draenor,288,priest,shadow,6,3,3
Narwarion,die-aldor,288,priest,shadow,6,3,3
Wëëee,marécage-de-zangar,288,priest,shadow,6,3,3
Croose,ravencrest,288,priest,shadow,6,3,3
Susaj,tarren-mill,288,priest,shadow,6,3,3
Jtî,ravencrest,288,priest,shadow,6,3,3
Nitza,silvermoon,288,priest,shadow,6,3,3
Imadîa,dalaran,288,priest,shadow,6,3,3
Skyrïpa,ysondre,288,priest,shadow,6,3,3
Vildhjärtat,kazzak,288,priest,shadow,6,3,3
Деняприст,gordunni,288,priest,shadow,6,3,3
Соцке,eversong,288,priest,shadow,6,3,3
Matrus,arthas,288,priest,shadow,6,3,3
Lutzki,the-maelstrom,288,priest,shadow,6,3,3
Aisha,rajaxx,288,priest,shadow,6,3,3
Wollebimsen,arthas,288,priest,shadow,6,3,3
Voltzaar,ragnaros,288,priest,shadow,6,3,3
Soonako,antonidas,288,priest,shadow,6,3,3
Slerpdaddy,ragnaros,288,priest,shadow,6,3,3
Papynou,garona,288,priest,shadow,6,3,3
Неприст,ashenvale,288,priest,shadow,6,3,3
Bîngle,ragnaros,288,priest,shadow,6,3,3
Zooling,aegwynn,288,priest,shadow,6,3,3
Eiqu,eredar,288,priest,shadow,6,3,3
Grocx,kazzak,288,priest,shadow,6,3,3
Fryp,blackrock,288,priest,shadow,6,3,3
Roxfer,ysondre,288,priest,shadow,6,3,3
Prastas,archimonde,288,priest,shadow,6,3,3
Momet,defias-brotherhood,288,priest,shadow,6,3,3
Bigdaddyap,sunstrider,288,priest,shadow,6,3,3
Lyal,silvermoon,288,priest,shadow,6,3,3
Shomäre,ysondre,288,priest,shadow,6,3,3
Haàdes,blackrock,288,priest,shadow,6,3,3
Milfed,ragnaros,288,priest,shadow,6,3,3
Bhlad,silvermoon,288,priest,shadow,6,3,3
Смегмачет,soulflayer,288,priest,shadow,6,3,3
Cheryl,alleria,288,priest,shadow,6,3,3
Stepsisstuck,ragnaros,288,priest,shadow,6,3,3
Plagegeist,blutkessel,288,priest,shadow,6,3,3
Tropicpriest,tarren-mill,288,priest,shadow,6,3,3
Zøid,ysondre,288,priest,shadow,6,3,3
Kbdp,outland,288,priest,shadow,6,3,3
Wåtrux,alakir,288,priest,shadow,6,3,3
Copperpriest,draenor,288,priest,shadow,6,3,3
Jusmitework,silvermoon,288,priest,shadow,6,3,3
Pries,eitrigg,288,priest,shadow,6,3,3
Chocopríest,blackmoore,288,priest,shadow,6,3,3
Blynde,draenor,288,priest,shadow,6,3,3
Rafikii,eredar,288,priest,shadow,6,3,3
Chromex,tarren-mill,288,priest,shadow,6,3,3
Флэнсер,soulflayer,288,priest,shadow,6,3,3
Presbyter,mazrigos,288,priest,shadow,6,3,3
Kallsen,ravencrest,288,priest,shadow,6,3,3
Ternary,draenor,288,priest,shadow,6,3,3
Dévas,aegwynn,288,priest,shadow,6,3,3
Hélp,stormscale,288,priest,shadow,6,3,3
Roovensp,aegwynn,288,priest,shadow,6,3,3
Sweedensp,hyjal,288,priest,shadow,6,3,3
Vampiro,blackhand,288,priest,shadow,6,3,3
Selfcontrol,blackhand,288,priest,shadow,6,3,3
Eldrathir,burning-legion,288,priest,shadow,6,3,3
Uivi,azjolnerub,288,priest,shadow,6,3,3
Buszeekk,outland,288,priest,shadow,6,3,3
Xaviá,blackrock,288,priest,shadow,6,3,3
Thimble,blackhand,288,priest,shadow,6,3,3
Goldensp,sanguino,288,priest,shadow,6,3,3
Roxxes,kazzak,288,priest,shadow,6,3,3
Морпехжнец,gordunni,288,priest,shadow,6,3,3
Abyssonmind,dun-modr,288,priest,shadow,6,3,3
Miikkap,blackhand,288,priest,shadow,6,3,3
Пристотян,gordunni,288,priest,shadow,6,3,3
Følísh,hyjal,288,priest,shadow,6,3,3
Worwp,burning-blade,288,priest,shadow,6,3,3
Aéltess,kirin-tor,288,priest,shadow,6,3,3
Cé,magtheridon,288,priest,shadow,6,3,3
Skymning,tarren-mill,288,priest,shadow,6,3,3
Eloapriest,blackhand,288,priest,shadow,6,3,3
Trinnity,drakthul,288,priest,shadow,6,3,3
Ondaman,ravencrest,288,priest,shadow,6,3,3
Nhajÿ,hyjal,288,priest,shadow,6,3,3
Shannannanna,darkspear,288,priest,shadow,6,3,3
Shasdöw,hyjal,288,priest,shadow,6,3,3
Taklamakan,alakir,288,priest,shadow,6,3,3
Cøttøn,ravencrest,288,priest,shadow,6,3,3
Koffìn,tarren-mill,288,priest,shadow,6,3,3
Hachiroku,terokkar,288,priest,shadow,6,3,3
Chuckbarry,kazzak,288,priest,shadow,6,3,3
Skycity,silvermoon,288,priest,shadow,6,3,3
Sofuny,neptulon,288,priest,shadow,6,3,3
Janvalek,quelthalas,288,priest,shadow,6,3,3
Швдяра,gordunni,288,priest,shadow,6,3,3
Забвениеждёт,gordunni,288,priest,shadow,6,3,3
Wkid,draenor,288,priest,shadow,6,3,3
Joë,tarren-mill,288,priest,shadow,6,3,3
Leffie,outland,288,priest,shadow,6,3,3
Alaarys,hyjal,288,priest,shadow,6,3,3
Nirsis,dun-modr,288,priest,shadow,6,3,3
Veie,ravencrest,288,priest,shadow,6,3,3
Zdpsexde,draenor,288,priest,shadow,6,3,3
Злыденькая,gordunni,288,priest,shadow,6,3,3
Дисайплес,gordunni,288,priest,shadow,6,3,3
Runristad,ravencrest,288,priest,shadow,6,3,3
Úbercharge,kazzak,288,priest,shadow,6,3,3
Ggsus,outland,288,priest,shadow,6,3,3
Smerenia,tarren-mill,288,priest,shadow,6,3,3
Ksiadzrydzyk,draenor,288,priest,shadow,6,3,3
Sàyaa,draenor,288,priest,shadow,6,3,3
Freezydot,silvermoon,288,priest,shadow,6,3,3
Jarnary,blackmoore,288,priest,shadow,9,4,5
Kopfsache,blackmoore,288,priest,shadow,7,3,4
Thundiz,archimonde,288,priest,shadow,7,3,4
Paytopray,the-maelstrom,288,priest,shadow,7,3,4
Tronixxcs,argent-dawn,288,priest,shadow,9,3,6
Shadowmourn,archimonde,288,priest,shadow,11,3,8
Preast,aegwynn,288,priest,shadow,12,3,9
Binar,baelgun,288,priest,shadow,12,3,9
Lillthya,kazzak,288,priest,shadow,12,3,9
Aaluvor,blackmoore,288,priest,shadow,12,3,9
Vès,stormscale,288,priest,shadow,12,3,9
Iílíth,draenor,288,priest,shadow,12,3,9
Painxsup,kazzak,288,priest,shadow,12,3,9
Hâstur,ravencrest,288,priest,shadow,12,3,9
Nathalio,twisting-nether,288,priest,shadow,12,3,9
Elumi,the-maelstrom,288,priest,shadow,12,3,9
Anariell,ravencrest,288,priest,shadow,12,3,9
Purpleshadow,twisting-nether,288,priest,shadow,12,3,9
Adizeww,kazzak,288,priest,shadow,12,3,9
Goldische,dun-morogh,288,priest,shadow,12,3,9
Priestouchme,blackrock,288,priest,shadow,12,3,9
Atiyesh,arthas,288,priest,shadow,12,3,9
Stolenlight,dun-morogh,288,priest,shadow,12,3,9
Beckett,outland,288,priest,shadow,12,3,9
Øzya,kirin-tor,288,priest,shadow,12,3,9
Kaleshiry,kazzak,288,priest,shadow,12,3,9
Hmp,thrall,288,priest,shadow,12,3,9
Róse,anachronos,288,priest,shadow,12,3,9
Voluptass,ragnaros,288,priest,shadow,12,3,9
Холисайра,gordunni,288,priest,shadow,13,3,10
Kaenlin,the-maelstrom,288,priest,shadow,18,3,15
Sìire,ravencrest,287,priest,shadow,6,3,3
Jês,thrall,287,priest,shadow,6,3,3
Батзона,eversong,287,priest,shadow,8,3,5
Rulna,die-aldor,287,priest,shadow,12,3,9
Nikomus,argent-dawn,286,priest,shadow,6,3,3
Alligatores,kazzak,270,priest,shadow,17,3,14
Czikibriki,ravenholdt,256,priest,shadow,4,4,0
Shadepencoin,silvermoon,256,priest,shadow,10,3,7
Бледноват,ashenvale,255,priest,shadow,8,4,4
Пристытутка,gordunni,255,priest,shadow,11,3,8
Ксержик,gordunni,255,priest,shadow,11,3,8
Syxx,blackmoore,255,priest,shadow,11,3,8
Guccimaane,twisting-nether,239,priest,shadow,5,3,2
Slasherh,ravencrest,239,priest,shadow,5,3,2
Thargunitøth,antonidas,239,priest,shadow,5,3,2
Caski,stormreaver,239,priest,shadow,5,3,2
Deeforce,argent-dawn,234,priest,shadow,6,4,2
Ainoa,grim-batol,234,priest,shadow,9,4,5
Cöpahue,sanguino,208,priest,shadow,7,3,4
Shadowflamè,outland,192,priest,shadow,4,3,1
Лакукарача,howling-fjord,192,priest,shadow,9,3,6
Zaop,blackhand,192,priest,shadow,6,2,4
Hadsup,stormscale,192,priest,shadow,6,2,4
Madclownz,blackrock,192,priest,shadow,6,2,4
Purplereign,stormscale,192,priest,shadow,6,2,4
Rallzken,stormscale,192,priest,shadow,6,2,4
Voidreaver,stormscale,192,priest,shadow,6,2,4
Huyasy,argent-dawn,192,priest,shadow,6,2,4
Gühnikologe,blackmoore,192,priest,shadow,6,2,4
Lúthien,outland,192,priest,shadow,6,2,4
Joezero,the-maelstrom,192,priest,shadow,6,2,4
Snerzomi,blackmoore,192,priest,shadow,6,2,4
Nattramnone,blackmoore,192,priest,shadow,6,2,4
Eavy,argent-dawn,192,priest,shadow,6,2,4
Stàrlîght,chants-éternels,192,priest,shadow,6,2,4
Badhêalz,aegwynn,192,priest,shadow,6,2,4
Mømmymilkers,archimonde,192,priest,shadow,6,2,4
Yugata,archimonde,192,priest,shadow,6,2,4
Azèm,archimonde,192,priest,shadow,6,2,4
Brin,archimonde,192,priest,shadow,6,2,4
Baaliz,senjin,192,priest,shadow,6,2,4
Nõlîfer,archimonde,192,priest,shadow,6,2,4
Siezlababo,blackrock,192,priest,shadow,6,2,4
Calïxløve,der-rat-von-dalaran,192,priest,shadow,6,2,4
Jamii,kazzak,192,priest,shadow,6,2,4
Oknelim,blackmoore,192,priest,shadow,6,2,4
Noobpriest,blackrock,192,priest,shadow,6,2,4
Lythra,burning-legion,192,priest,shadow,6,2,4
Evillshadow,archimonde,192,priest,shadow,6,2,4
Tingoess,silvermoon,192,priest,shadow,6,2,4
Lugburzz,draenor,192,priest,shadow,6,2,4
Shalacho,blackrock,192,priest,shadow,6,2,4
Repples,draenor,192,priest,shadow,6,2,4
Banishee,shadowsong,192,priest,shadow,6,2,4
Discbabe,outland,192,priest,shadow,6,2,4
Magnusson,the-shatar,192,priest,shadow,6,2,4
Cokezeroo,thrall,192,priest,shadow,6,2,4
Dombili,frostmane,192,priest,shadow,6,2,4
Artist,outland,192,priest,shadow,6,2,4
Mugenshotto,outland,192,priest,shadow,6,2,4
Mayhemqt,silvermoon,192,priest,shadow,6,2,4
Omejan,frostmane,192,priest,shadow,6,2,4
Jeanshield,varimathras,192,priest,shadow,6,2,4
Livster,chamber-of-aspects,192,priest,shadow,6,2,4
Elëctra,vashj,192,priest,shadow,6,2,4
Storemanager,tarren-mill,192,priest,shadow,6,2,4
Nemüs,pozzo-delleternità,192,priest,shadow,6,2,4
Sïfën,tarren-mill,192,priest,shadow,6,2,4
Illordz,nemesis,192,priest,shadow,6,2,4
Crzzy,dun-modr,192,priest,shadow,6,2,4
Периссвет,thermaplugg,192,priest,shadow,6,2,4
Мемфисминни,blackscar,192,priest,shadow,6,2,4
Reïny,tarren-mill,192,priest,shadow,6,2,4
Докчай,gordunni,192,priest,shadow,6,2,4
Элунаир,gordunni,192,priest,shadow,6,2,4
Асах,gordunni,192,priest,shadow,6,2,4
Жрецдуши,gordunni,192,priest,shadow,6,2,4
Unhealing,tarren-mill,192,priest,shadow,6,2,4
Шестьнадцать,gordunni,192,priest,shadow,6,2,4
Wsp,tarren-mill,192,priest,shadow,6,2,4
Ilvia,antonidas,192,priest,shadow,6,2,4
Шарадин,gordunni,192,priest,shadow,6,2,4
Встанислав,gordunni,192,priest,shadow,6,2,4
Dreadx,antonidas,192,priest,shadow,6,2,4
Ostrogami,silvermoon,192,priest,shadow,6,2,4
Prigart,sylvanas,192,priest,shadow,6,2,4
Æbe,tarren-mill,192,priest,shadow,6,2,4
Putoeinstein,sylvanas,192,priest,shadow,6,2,4
Andérsón,magtheridon,192,priest,shadow,6,2,4
Blesschrist,tarren-mill,192,priest,shadow,6,2,4
Sotriggered,sylvanas,192,priest,shadow,6,2,4
Holyshiët,sylvanas,192,priest,shadow,6,2,4
Dispelbotx,sylvanas,192,priest,shadow,6,2,4
Alriel,tarren-mill,192,priest,shadow,6,2,4
Alpharîus,argent-dawn,192,priest,shadow,6,2,4
Durinsbane,silvermoon,192,priest,shadow,6,2,4
Grimor,talnivarr,192,priest,shadow,6,2,4
Lollithu,argent-dawn,192,priest,shadow,6,2,4
Аполонио,soulflayer,192,priest,shadow,6,2,4
Bandgap,antonidas,192,priest,shadow,6,2,4
Wiglere,argent-dawn,192,priest,shadow,6,2,4
Gidy,blackmoore,192,priest,shadow,6,2,4
Шиписс,soulflayer,192,priest,shadow,6,2,4
Fèä,argent-dawn,192,priest,shadow,6,2,4
Sadira,malganis,192,priest,shadow,6,2,4
Badboypanna,twisting-nether,192,priest,shadow,6,2,4
Шаллуунья,eversong,192,priest,shadow,6,2,4
Tóffs,twisting-nether,192,priest,shadow,6,2,4
Daven,ysondre,192,priest,shadow,6,2,4
Ilaènel,burning-legion,192,priest,shadow,6,2,4
Esthea,malganis,192,priest,shadow,6,2,4
Beatrixz,twisting-nether,192,priest,shadow,6,2,4
Yunamd,blackhand,192,priest,shadow,6,2,4
Piizzdiica,twisting-nether,192,priest,shadow,6,2,4
Ehresha,kazzak,192,priest,shadow,6,2,4
Smø,kazzak,192,priest,shadow,6,2,4
Imahipstaqt,eredar,192,priest,shadow,6,2,4
Wrapadoro,sanguino,192,priest,shadow,6,2,4
Abî,frostwolf,192,priest,shadow,6,2,4
Pssp,kazzak,192,priest,shadow,6,2,4
Nyxoqtxd,ravencrest,192,priest,shadow,6,2,4
Cröptöl,dun-modr,192,priest,shadow,6,2,4
Makemyday,dun-modr,192,priest,shadow,6,2,4
Goblingøs,ravencrest,192,priest,shadow,6,2,4
Elthrone,kazzak,192,priest,shadow,6,2,4
Misántropo,dun-modr,192,priest,shadow,6,2,4
Chekkó,blackrock,192,priest,shadow,6,2,4
Moth,kazzak,192,priest,shadow,6,2,4
Cto,gorgonnash,192,priest,shadow,6,2,4
Svistis,ravencrest,192,priest,shadow,6,2,4
Debiloid,ravencrest,192,priest,shadow,6,2,4
Gravetaker,quelthalas,192,priest,shadow,6,2,4
Priath,magtheridon,192,priest,shadow,6,2,4
Darendur,die-aldor,192,priest,shadow,6,2,4
Zootx,magtheridon,192,priest,shadow,6,2,4
Акктуальная,deepholm,192,priest,shadow,6,2,4
Rustyroll,stormscale,192,priest,shadow,6,2,4
Phobò,antonidas,192,priest,shadow,6,2,4
Fqú,wrathbringer,192,priest,shadow,6,2,4
Nightstyle,nethersturm,192,priest,shadow,6,2,4
Squidlicker,twisting-nether,192,priest,shadow,6,2,4
Funstopshere,ravencrest,192,priest,shadow,6,2,4
Psychobutter,blackmoore,192,priest,shadow,6,2,4
Aruna,ravencrest,192,priest,shadow,6,2,4
Maxý,ravencrest,192,priest,shadow,6,2,4
Zaylem,ravencrest,192,priest,shadow,6,2,4
Tuljan,twisting-nether,192,priest,shadow,6,2,4
Vengigodxx,ravencrest,192,priest,shadow,6,2,4
Clemexyo,stormscale,192,priest,shadow,6,2,4
Arithon,blackrock,192,priest,shadow,6,2,4
Сеферота,howling-fjord,192,priest,shadow,6,2,4
Thotegirl,ravencrest,192,priest,shadow,6,2,4
Tosspot,ragnaros,192,priest,shadow,6,2,4
Notdespo,kazzak,192,priest,shadow,6,2,4
Chabbe,ragnaros,192,priest,shadow,6,2,4
Ørbänvîktôrx,ragnaros,192,priest,shadow,6,2,4
Ðyøx,ravencrest,192,priest,shadow,6,2,4
Сайннз,howling-fjord,192,priest,shadow,6,2,4
Фагъя,howling-fjord,192,priest,shadow,6,2,4
Дашажмитучу,howling-fjord,192,priest,shadow,6,2,4
Сорвиголов,howling-fjord,192,priest,shadow,6,2,4
Badgirxl,kargath,192,priest,shadow,6,2,4
Goky,kazzak,192,priest,shadow,6,2,4
Darkkraim,blackrock,192,priest,shadow,6,2,4
Ejoz,khaz-modan,192,priest,shadow,6,2,4
Sadkitten,sylvanas,192,priest,shadow,7,2,5
Гундяй,soulflayer,192,priest,shadow,7,2,5
Indrades,blackmoore,192,priest,shadow,9,2,7
Simpsmasher,kazzak,192,priest,shadow,11,2,9
Noir,nemesis,192,priest,shadow,12,2,10
Awcute,kazzak,192,priest,shadow,12,2,10
Chibrausorus,archimonde,192,priest,shadow,12,2,10
Miniøndëëps,hyjal,192,priest,shadow,12,2,10
Nelpriest,hyjal,192,priest,shadow,12,2,10
Unworthy,twisting-nether,192,priest,shadow,12,2,10
Эйттёрналинь,fordragon,192,priest,shadow,12,2,10
Господствуй,gordunni,192,priest,shadow,12,2,10
Marcianoroc,dalaran,192,priest,shadow,12,2,10
Poc,burning-legion,192,priest,shadow,12,2,10
Helerys,archimonde,192,priest,shadow,12,2,10
Nefertum,alakir,192,priest,shadow,12,2,10
Harmónia,outland,192,priest,shadow,12,2,10
Ajcz,draenor,192,priest,shadow,12,2,10
Déathcaster,silvermoon,192,priest,shadow,12,2,10
Hûndling,blackrock,192,priest,shadow,12,2,10
Adev,drakthul,192,priest,shadow,12,2,10
Painlêss,eredar,192,priest,shadow,12,2,10
Lemalötz,silvermoon,192,priest,shadow,12,2,10
Rxwkii,hellscream,192,priest,shadow,18,2,16
Zilania,ragnaros,192,priest,shadow,18,2,16
Tatewaki,drakthul,191,priest,shadow,4,3,1
Frérelacôte,khaz-modan,191,priest,shadow,6,2,4
Cypherz,kazzak,191,priest,shadow,12,2,10
Tabítha,blackrock,159,priest,shadow,5,2,3
Holykaka,tarren-mill,159,priest,shadow,5,2,3
Luziz,blackmoore,159,priest,shadow,5,2,3
Mephîsto,anubarak,159,priest,shadow,5,2,3
Girlidlion,twisting-nether,159,priest,shadow,5,2,3
Randdy,silvermoon,159,priest,shadow,11,2,9
Qku,ravencrest,144,priest,shadow,9,3,6
Miivanmii,ragnaros,138,priest,shadow,10,4,6
Yukíø,antonidas,138,priest,shadow,10,3,7
Slight,aggra-português,138,priest,shadow,10,3,7
Alswynn,draenor,138,priest,shadow,13,3,10
Onixa,tarren-mill,128,priest,shadow,4,2,2
Moppriest,twisting-nether,128,priest,shadow,4,2,2
Yologrumples,tarren-mill,128,priest,shadow,4,2,2
Heeyø,drakthul,128,priest,shadow,4,2,2
Idén,quelthalas,96,priest,shadow,3,2,1
Кошнеок,deathguard,96,priest,shadow,3,2,1
Shalvy,aegwynn,96,priest,shadow,3,2,1
Vampirski,kazzak,96,priest,shadow,3,2,1
Baltrom,ravencrest,96,priest,shadow,6,1,5
Jakepriest,twisting-nether,96,priest,shadow,6,1,5
Valfore,eldrethalas,96,priest,shadow,6,1,5
Zodos,ravencrest,96,priest,shadow,6,1,5
Мегаствол,howling-fjord,96,priest,shadow,6,1,5
Popelings,twisting-nether,96,priest,shadow,6,1,5
Míllerzz,ragnaros,96,priest,shadow,6,1,5
Dìsc,ravencrest,96,priest,shadow,6,1,5
Ноубадди,howling-fjord,96,priest,shadow,6,1,5
Fillî,antonidas,96,priest,shadow,6,1,5
Serach,ravencrest,96,priest,shadow,6,1,5
Sbubbi,ravencrest,96,priest,shadow,6,1,5
Rdot,dun-modr,96,priest,shadow,6,1,5
Nérôck,frostwolf,96,priest,shadow,6,1,5
Chê,sanguino,96,priest,shadow,6,1,5
Virulence,twisting-nether,96,priest,shadow,6,1,5
Chimara,eredar,96,priest,shadow,6,1,5
Winstõn,sanguino,96,priest,shadow,6,1,5
Jäckassmd,ravencrest,96,priest,shadow,6,1,5
Splís,ravencrest,96,priest,shadow,6,1,5
Абсорбиболь,howling-fjord,96,priest,shadow,6,1,5
Mârcwel,burning-legion,96,priest,shadow,6,1,5
Rines,thrall,96,priest,shadow,6,1,5
Piarir,azjolnerub,96,priest,shadow,6,1,5
Harrydøtter,ysondre,96,priest,shadow,6,1,5
Maddøc,die-aldor,96,priest,shadow,6,1,5
Катранасс,eversong,96,priest,shadow,6,1,5
Zevs,sanguino,96,priest,shadow,6,1,5
Milfelina,ravencrest,96,priest,shadow,6,1,5
Psyfiend,argent-dawn,96,priest,shadow,6,1,5
Aretiel,the-maelstrom,96,priest,shadow,6,1,5
Shonsized,argent-dawn,96,priest,shadow,6,1,5
Evilspook,silvermoon,96,priest,shadow,6,1,5
Skitcy,ghostlands,96,priest,shadow,6,1,5
Фаталих,soulflayer,96,priest,shadow,6,1,5
Шатолюгран,soulflayer,96,priest,shadow,6,1,5
Чупатаявошь,soulflayer,96,priest,shadow,6,1,5
Gobie,sunstrider,96,priest,shadow,6,1,5
Drioz,ysondre,96,priest,shadow,6,1,5
Gisborn,laughing-skull,96,priest,shadow,6,1,5
Jeanlumina,stormscale,96,priest,shadow,6,1,5
Nocturon,ravencrest,96,priest,shadow,6,1,5
Uwucatgir,silvermoon,96,priest,shadow,6,1,5
Fictus,tarren-mill,96,priest,shadow,6,1,5
Øbz,sylvanas,96,priest,shadow,6,1,5
Holytoad,ravencrest,96,priest,shadow,6,1,5
Caliadan,kazzak,96,priest,shadow,6,1,5
Попячебрило,gordunni,96,priest,shadow,6,1,5
Lurxya,ysondre,96,priest,shadow,6,1,5
Cthuulu,tarren-mill,96,priest,shadow,6,1,5
Nicnacz,stormscale,96,priest,shadow,6,1,5
Karpi,ravencrest,96,priest,shadow,6,1,5
Scrotoepalle,nemesis,96,priest,shadow,6,1,5
Endlin,silvermoon,96,priest,shadow,6,1,5
Higgle,argent-dawn,96,priest,shadow,6,1,5
Spárrowhawk,silvermoon,96,priest,shadow,6,1,5
Ghostroller,pozzo-delleternità,96,priest,shadow,6,1,5
Aerîs,veknilash,96,priest,shadow,6,1,5
Noonex,hakkar,96,priest,shadow,6,1,5
Tregant,agamaggan,96,priest,shadow,6,1,5
Nothanksman,haomarush,96,priest,shadow,6,1,5
Daphne,thunderhorn,96,priest,shadow,6,1,5
Zukatana,tarren-mill,96,priest,shadow,6,1,5
Vtqt,outland,96,priest,shadow,6,1,5
Nestélle,drakthul,96,priest,shadow,6,1,5
Macroman,stormscale,96,priest,shadow,6,1,5
Bädx,silvermoon,96,priest,shadow,6,1,5
Kales,grim-batol,96,priest,shadow,6,1,5
Keo,anachronos,96,priest,shadow,6,1,5
Gríffin,anachronos,96,priest,shadow,6,1,5
Haffination,frostmane,96,priest,shadow,6,1,5
Dunderprälle,outland,96,priest,shadow,6,1,5
Deicidex,blackrock,96,priest,shadow,6,1,5
Oktavian,ysera,96,priest,shadow,6,1,5
Soulmedic,draenor,96,priest,shadow,6,1,5
Arliston,draenor,96,priest,shadow,6,1,5
Vexxdd,outland,96,priest,shadow,6,1,5
Jamioz,draenor,96,priest,shadow,6,1,5
Gæxelademad,draenor,96,priest,shadow,6,1,5
Arvia,outland,96,priest,shadow,6,1,5
Dörti,rajaxx,96,priest,shadow,6,1,5
Whitezetsu,outland,96,priest,shadow,6,1,5
Izarath,outland,96,priest,shadow,6,1,5
Stola,archimonde,96,priest,shadow,6,1,5
Gobblestick,draenor,96,priest,shadow,6,1,5
Tinypump,silvermoon,96,priest,shadow,6,1,5
Thizus,draenor,96,priest,shadow,6,1,5
Abudhabi,blackhand,96,priest,shadow,6,1,5
Prostamolle,conseil-des-ombres,96,priest,shadow,6,1,5
Sabakk,archimonde,96,priest,shadow,6,1,5
Infâme,culte-de-la-rive-noire,96,priest,shadow,6,1,5
Shiroe,la-croisade-écarlate,96,priest,shadow,6,1,5
Åme,kirin-tor,96,priest,shadow,6,1,5
Learntohealz,outland,96,priest,shadow,6,1,5
Kopperuud,stormscale,96,priest,shadow,6,1,5
Râdouan,archimonde,96,priest,shadow,6,1,5
Disturbd,archimonde,96,priest,shadow,6,1,5
Gòldfinger,norgannon,96,priest,shadow,6,1,5
Aruman,norgannon,96,priest,shadow,6,1,5
Barbïelolz,sargeras,96,priest,shadow,6,1,5
Löô,archimonde,96,priest,shadow,6,1,5
Elfouf,rashgarroth,96,priest,shadow,6,1,5
Kianprie,silvermoon,96,priest,shadow,6,1,5
Асуартхас,gordunni,96,priest,shadow,6,1,5
Koíré,defias-brotherhood,96,priest,shadow,6,1,5
Faol,the-venture-co,96,priest,shadow,6,1,5
Jimipalais,blackmoore,96,priest,shadow,6,1,5
Ulrach,hyjal,96,priest,shadow,6,1,5
Gromalia,hyjal,96,priest,shadow,6,1,5
Bij,outland,96,priest,shadow,6,1,5
Nitalima,outland,96,priest,shadow,6,1,5
Hairyholy,blackmoore,96,priest,shadow,6,1,5
Moondúst,blackmoore,96,priest,shadow,6,1,5
Omelet,conseil-des-ombres,96,priest,shadow,11,1,10
Tiras,argent-dawn,96,priest,shadow,12,1,11
Råin,draenor,96,priest,shadow,12,1,11
Dispellmg,ravencrest,96,priest,shadow,12,1,11
Healshurts,kazzak,96,priest,shadow,12,1,11
Darknun,aggra-português,96,priest,shadow,12,1,11
Jannire,dun-modr,96,priest,shadow,12,1,11
Kde,burning-legion,96,priest,shadow,12,1,11
Câtryona,sylvanas,96,priest,shadow,12,1,11
Néfarius,forscherliga,95,priest,shadow,3,2,1
Peesussy,kazzak,79,priest,shadow,5,1,4
Malorbian,blackhand,79,priest,shadow,5,1,4
Xharyo,ravencrest,64,priest,shadow,4,1,3
Gandals,shadowsong,64,priest,shadow,4,1,3
Bellumsana,frostmane,64,priest,shadow,10,1,9
Møldark,silvermoon,48,priest,shadow,3,1,2
Xail,blackrock,48,priest,shadow,3,1,2
Benighted,nerathor,48,priest,shadow,3,1,2
Amáni,die-aldor,42,priest,shadow,6,2,4
Velansera,argent-dawn,42,priest,shadow,7,2,5
Psyp,kazzak,42,priest,shadow,8,2,6
Yshaarjy,silvermoon,42,priest,shadow,8,2,6
Dvy,azjolnerub,42,priest,shadow,9,2,7
Hayvo,blackmoore,42,priest,shadow,11,2,9
Holyhigh,baelgun,31,priest,shadow,2,1,1
Lexartin,argent-dawn,31,priest,shadow,2,1,1
Bloodanglee,outland,16,priest,shadow,1,1,0
Goonin,frostwolf,16,priest,shadow,1,1,0
Jimcarre,eredar,16,priest,shadow,1,1,0
Rãz,stormscale,2303,rogue,outlaw,132,71,61
Drdaggerstwo,outland,2036,rogue,outlaw,74,38,36
Sneakysteve,bloodfeather,1949,rogue,outlaw,42,22,20
Kreay,tarren-mill,1947,rogue,outlaw,208,127,81
Kreayx,ysondre,1929,rogue,outlaw,108,51,57
Kreay,ysondre,1921,rogue,outlaw,66,35,31
Krixor,ravencrest,1880,rogue,outlaw,235,117,118
Zbojník,ravencrest,1837,rogue,outlaw,72,32,40
Макевин,gordunni,1833,rogue,outlaw,150,73,77
Dêlaral,der-rat-von-dalaran,1817,rogue,outlaw,70,40,30
Kekuriix,vashj,1816,rogue,outlaw,178,92,86
Rivso,auchindoun,1784,rogue,outlaw,76,29,47
Déjávu,ravencrest,1732,rogue,outlaw,60,32,28
Yessa,argent-dawn,1721,rogue,outlaw,36,18,18
Banaulikode,twisting-nether,1715,rogue,outlaw,66,34,32
Rogiko,twisting-nether,1715,rogue,outlaw,54,26,28
Дизелюжн,howling-fjord,1693,rogue,outlaw,527,260,267
Koopa,argent-dawn,1668,rogue,outlaw,140,69,71
Феинт,galakrond,1654,rogue,outlaw,70,26,44
Ранконх,lich-king,1626,rogue,outlaw,101,45,56
Spiike,culte-de-la-rive-noire,1625,rogue,outlaw,28,19,9
Radiogodx,stormscale,1622,rogue,outlaw,225,109,116
Lidiaubaro,ravencrest,1614,rogue,outlaw,404,202,202
Jalsket,tarren-mill,1606,rogue,outlaw,54,27,27
Ålûñàhlulz,kilrogg,1604,rogue,outlaw,48,30,18
Izzmonab,blackmoore,1604,rogue,outlaw,36,21,15
Gerzy,drakthul,1604,rogue,outlaw,65,32,33
Estriil,dalaran,1603,rogue,outlaw,42,24,18
Delrøq,draenor,1601,rogue,outlaw,172,94,78
Bikrut,hyjal,1599,rogue,outlaw,42,22,20
Alizwood,aegwynn,1597,rogue,outlaw,60,34,26
Syrn,ravencrest,1579,rogue,outlaw,78,38,40
Terya,ragnaros,1575,rogue,outlaw,122,59,63
Scotlander,argent-dawn,1569,rogue,outlaw,72,38,34
Bannedfrigid,outland,1556,rogue,outlaw,165,77,88
Зувер,blackscar,1523,rogue,outlaw,160,85,75
Flogue,area-52,1512,rogue,outlaw,36,19,17
Metabender,blackmoore,1507,rogue,outlaw,36,23,13
Nèwt,aggramar,1505,rogue,outlaw,214,108,106
Фораст,gordunni,1498,rogue,outlaw,54,24,30
Xaen,hellscream,1495,rogue,outlaw,42,20,22
Åråmsëß,grim-batol,1487,rogue,outlaw,87,51,36
Donchichi,archimonde,1484,rogue,outlaw,50,23,27
Deevoll,tarren-mill,1481,rogue,outlaw,108,48,60
Sigleif,argent-dawn,1471,rogue,outlaw,111,57,54
Rogass,auchindoun,1471,rogue,outlaw,66,29,37
Джулт,soulflayer,1448,rogue,outlaw,120,56,64
Loubina,silvermoon,1446,rogue,outlaw,36,16,20
Zind,dalaran,1435,rogue,outlaw,29,16,13
Xsanji,kazzak,1433,rogue,outlaw,48,22,26
Röguetönerö,dun-modr,1429,rogue,outlaw,77,28,49
Carvyn,defias-brotherhood,1425,rogue,outlaw,153,80,73
Yinyíng,ravencrest,1422,rogue,outlaw,62,29,33
Shinõbikék,outland,1421,rogue,outlaw,57,25,32
Cipusan,kazzak,1416,rogue,outlaw,42,24,18
Johnnyblazex,azjolnerub,1413,rogue,outlaw,36,16,20
Akirã,blackmoore,1379,rogue,outlaw,76,33,43
Aurellix,argent-dawn,1371,rogue,outlaw,30,16,14
Bonelesschic,silvermoon,1357,rogue,outlaw,321,163,158
Louisv,ravencrest,1355,rogue,outlaw,176,98,78
Zerocell,kazzak,1354,rogue,outlaw,33,16,17
Kirby,kaelthas,1351,rogue,outlaw,90,42,48
Ðaegr,ravencrest,1348,rogue,outlaw,104,55,49
Pistolpete,grim-batol,1343,rogue,outlaw,30,14,16
Callmerose,ravencrest,1334,rogue,outlaw,24,14,10
Dritzdourden,dun-modr,1333,rogue,outlaw,30,15,15
Zep,auchindoun,1332,rogue,outlaw,24,14,10
Veil,ravencrest,1331,rogue,outlaw,193,96,97
Murkyy,gilneas,1329,rogue,outlaw,32,16,16
Shredfngrz,garona,1326,rogue,outlaw,97,44,53
Djeud,archimonde,1325,rogue,outlaw,64,34,30
Tidløs,dun-morogh,1325,rogue,outlaw,77,33,44
Miiløx,silvermoon,1319,rogue,outlaw,30,14,16
Villainx,blackrock,1313,rogue,outlaw,30,14,16
Mol,defias-brotherhood,1311,rogue,outlaw,24,15,9
Chillo,ravencrest,1301,rogue,outlaw,130,57,73
Маллестар,ashenvale,1292,rogue,outlaw,97,50,47
Pasarelo,dun-modr,1291,rogue,outlaw,83,39,44
Örog,hyjal,1288,rogue,outlaw,47,26,21
Rasponi,ragnaros,1279,rogue,outlaw,100,53,47
Jasolo,silvermoon,1269,rogue,outlaw,408,212,196
Nhea,twisting-nether,1266,rogue,outlaw,50,22,28
Dimmu,haomarush,1260,rogue,outlaw,147,71,76
Faoil,defias-brotherhood,1260,rogue,outlaw,84,39,45
Badabôôm,wrathbringer,1257,rogue,outlaw,116,57,59
Mawrat,mazrigos,1248,rogue,outlaw,30,13,17
Weworog,drakthul,1229,rogue,outlaw,101,56,45
Alena,arathi,1226,rogue,outlaw,54,32,22
Omgjkgtfo,ravencrest,1225,rogue,outlaw,60,25,35
Sqz,archimonde,1222,rogue,outlaw,30,18,12
Zapunk,argent-dawn,1221,rogue,outlaw,59,22,37
Vinziboo,hyjal,1220,rogue,outlaw,74,35,39
Шторкаа,gordunni,1216,rogue,outlaw,45,25,20
Jinzou,blackmoore,1214,rogue,outlaw,75,39,36
Tîru,ravencrest,1209,rogue,outlaw,42,25,17
Mirajen,archimonde,1201,rogue,outlaw,61,29,32
Odingg,dun-modr,1194,rogue,outlaw,36,17,19
Enthuque,draenor,1186,rogue,outlaw,30,17,13
Velvíe,turalyon,1175,rogue,outlaw,36,19,17
Nocrath,blades-edge,1175,rogue,outlaw,66,33,33
Kussiee,chromaggus,1165,rogue,outlaw,59,26,33
Drunks,aegwynn,1145,rogue,outlaw,50,20,30
Слишкомданя,galakrond,1139,rogue,outlaw,36,14,22
Thyrosi,shattered-halls,1133,rogue,outlaw,24,12,12
Pidroseus,argent-dawn,1133,rogue,outlaw,30,13,17
Aldorick,kirin-tor,1114,rogue,outlaw,42,20,22
Alatheril,argent-dawn,1104,rogue,outlaw,101,48,53
Cigarette,emeriss,1079,rogue,outlaw,24,12,12
Lättja,hyjal,1060,rogue,outlaw,41,19,22
Тимареканец,eversong,1048,rogue,outlaw,84,38,46
Shènz,ysondre,1047,rogue,outlaw,30,11,19
Bxtchslayer,blackmoore,1045,rogue,outlaw,71,39,32
Rã,archimonde,1039,rogue,outlaw,30,13,17
Svddendeath,ragnaros,1034,rogue,outlaw,24,11,13
Рокрэйф,howling-fjord,1024,rogue,outlaw,30,17,13
Oriaxx,ragnaros,1024,rogue,outlaw,33,15,18
Génn,silvermoon,1020,rogue,outlaw,152,74,78
Spiochrr,burning-legion,1020,rogue,outlaw,84,35,49
Оа,soulflayer,1017,rogue,outlaw,42,11,31
Haewhi,kazzak,1007,rogue,outlaw,54,20,34
Neolamer,pozzo-delleternità,994,rogue,outlaw,168,81,87
Mycki,voljin,993,rogue,outlaw,50,18,32
Хасби,grom,978,rogue,outlaw,68,32,36
Melahl,kazzak,967,rogue,outlaw,89,47,42
Soothinqq,emerald-dream,963,rogue,outlaw,23,15,8
Lïke,frostwolf,960,rogue,outlaw,18,10,8
Foulsteel,stormscale,951,rogue,outlaw,18,10,8
Necrott,blackhand,936,rogue,outlaw,54,16,38
Riviele,argent-dawn,913,rogue,outlaw,20,11,9
Masteez,ahnqiraj,897,rogue,outlaw,135,68,67
Tipok,tarren-mill,897,rogue,outlaw,51,20,31
Yoghurtx,ravencrest,863,rogue,outlaw,12,9,3
Practicex,blackhand,863,rogue,outlaw,18,9,9
Backstabjr,blackmoore,863,rogue,outlaw,18,9,9
Knifeyknifey,ravencrest,862,rogue,outlaw,18,9,9
Omuspan,magtheridon,862,rogue,outlaw,99,44,55
Nasíapamatar,colinas-pardas,862,rogue,outlaw,42,12,30
Пондимониум,azuregos,860,rogue,outlaw,24,9,15
Жижель,howling-fjord,859,rogue,outlaw,18,9,9
Yoruichì,kazzak,853,rogue,outlaw,18,9,9
Kodlak,silvermoon,852,rogue,outlaw,18,9,9
Cornvus,burning-legion,836,rogue,outlaw,48,22,26
Mcgora,doomhammer,822,rogue,outlaw,36,15,21
Kedrus,turalyon,812,rogue,outlaw,24,10,14
Фофламидзе,gordunni,802,rogue,outlaw,21,10,11
Aaronblade,aggra-português,795,rogue,outlaw,30,12,18
Blàckbèàrd,silvermoon,788,rogue,outlaw,42,17,25
Redfinshadow,stormrage,768,rogue,outlaw,35,16,19
Vokhun,outland,768,rogue,outlaw,18,8,10
Swaeard,ravencrest,767,rogue,outlaw,18,8,10
Ðeathdream,stormscale,767,rogue,outlaw,18,8,10
Wxlf,ravencrest,767,rogue,outlaw,18,8,10
Gotfrey,darkspear,762,rogue,outlaw,18,8,10
Okani,hyjal,761,rogue,outlaw,18,8,10
Dredge,kaelthas,761,rogue,outlaw,24,8,16
Hânnäh,hyjal,756,rogue,outlaw,48,20,28
Shichi,archimonde,751,rogue,outlaw,23,8,15
Viligar,kazzak,687,rogue,outlaw,21,8,13
Shåggy,vashj,672,rogue,outlaw,12,7,5
Dían,ravencrest,672,rogue,outlaw,12,7,5
Kidneyou,ragnaros,672,rogue,outlaw,18,7,11
Matheeus,hyjal,672,rogue,outlaw,24,8,16
Trixnaz,silvermoon,671,rogue,outlaw,18,7,11
Afareo,ragnaros,671,rogue,outlaw,18,7,11
Skygann,burning-legion,670,rogue,outlaw,12,7,5
Ilovearena,eredar,668,rogue,outlaw,24,7,17
Shåð,zuljin,576,rogue,outlaw,12,6,6
Anom,kargath,575,rogue,outlaw,12,6,6
Noodlegoose,tarren-mill,575,rogue,outlaw,12,6,6
Ружнуар,gordunni,575,rogue,outlaw,18,6,12
Кингксу,gordunni,575,rogue,outlaw,24,6,18
Helax,turalyon,569,rogue,outlaw,24,6,18
Shirasz,silvermoon,557,rogue,outlaw,18,6,12
Biefstuk,burning-blade,556,rogue,outlaw,30,6,24
Gloomykenny,tarren-mill,543,rogue,outlaw,17,6,11
Геопанк,howling-fjord,528,rogue,outlaw,15,7,8
Barisso,burning-legion,511,rogue,outlaw,14,6,8
Zômbiê,blackrock,491,rogue,outlaw,13,6,7
Tåxic,sylvanas,480,rogue,outlaw,6,5,1
Акаарикс,gordunni,480,rogue,outlaw,6,5,1
Featfawkes,ragnaros,480,rogue,outlaw,12,5,7
Хайденстрайк,gordunni,480,rogue,outlaw,12,5,7
Cox,nagrand,480,rogue,outlaw,12,5,7
Ékhö,argent-dawn,480,rogue,outlaw,12,5,7
Fivepoint,blackmoore,480,rogue,outlaw,12,5,7
Therazer,burning-legion,480,rogue,outlaw,12,5,7
Coolbassoff,kazzak,480,rogue,outlaw,18,5,13
Vyze,blackmoore,480,rogue,outlaw,18,5,13
Ладжо,gordunni,480,rogue,outlaw,18,5,13
Toxîne,archimonde,479,rogue,outlaw,12,5,7
Rujo,magtheridon,479,rogue,outlaw,12,5,7
Djsapblindx,archimonde,479,rogue,outlaw,18,5,13
Hosenpinkler,lordaeron,478,rogue,outlaw,12,5,7
Wøølfgang,archimonde,477,rogue,outlaw,12,5,7
Feucht,argent-dawn,472,rogue,outlaw,36,5,31
Razaah,ravencrest,431,rogue,outlaw,11,5,6
Бонасера,blackscar,425,rogue,outlaw,23,6,17
Darkchomeur,archimonde,384,rogue,outlaw,6,4,2
Purpleskies,hyjal,384,rogue,outlaw,6,4,2
Yoyoei,blackmoore,384,rogue,outlaw,6,4,2
Clavikule,elune,384,rogue,outlaw,6,4,2
Аквик,howling-fjord,384,rogue,outlaw,6,4,2
Obliveron,dalaran,384,rogue,outlaw,12,4,8
Лайсгл,gordunni,384,rogue,outlaw,12,4,8
Tommywright,stormscale,384,rogue,outlaw,12,4,8
Machmacan,thrall,384,rogue,outlaw,12,4,8
Synexo,sylvanas,384,rogue,outlaw,12,4,8
Кортикос,gordunni,384,rogue,outlaw,12,4,8
Anokir,sylvanas,384,rogue,outlaw,18,4,14
Slaach,khaz-modan,384,rogue,outlaw,18,4,14
Minimælk,saurfang,383,rogue,outlaw,6,4,2
Mïta,blackmoore,383,rogue,outlaw,6,4,2
Джоллиан,gordunni,383,rogue,outlaw,8,4,4
Scyl,forscherliga,383,rogue,outlaw,12,4,8
Groendienst,quelthalas,381,rogue,outlaw,12,4,8
Azzerue,ysondre,367,rogue,outlaw,17,4,13
Trímønâ,gorgonnash,351,rogue,outlaw,11,4,7
Skeevy,stormscale,351,rogue,outlaw,20,5,15
Zyreanxy,blackrock,330,rogue,outlaw,16,5,11
Evit,frostwolf,330,rogue,outlaw,17,5,12
Афтикс,howling-fjord,319,rogue,outlaw,5,4,1
Kuribo,gorgonnash,288,rogue,outlaw,6,3,3
Играючестно,howling-fjord,288,rogue,outlaw,6,3,3
Onlyluvhurt,dun-modr,288,rogue,outlaw,6,3,3
Shadxwstep,ravencrest,288,rogue,outlaw,6,3,3
Rouge,der-rat-von-dalaran,288,rogue,outlaw,6,3,3
Coldsummer,drakthul,288,rogue,outlaw,6,3,3
Cobaka,blackrock,288,rogue,outlaw,12,3,9
Daraco,hyjal,288,rogue,outlaw,12,3,9
Finisher,sanguino,288,rogue,outlaw,12,3,9
Marrit,die-aldor,288,rogue,outlaw,12,3,9
Heulleise,die-ewige-wacht,288,rogue,outlaw,12,3,9
Szpachela,burning-legion,288,rogue,outlaw,12,3,9
Kassondra,ragnaros,288,rogue,outlaw,18,3,15
Ванэйти,gordunni,287,rogue,outlaw,6,3,3
Golixledur,archimonde,287,rogue,outlaw,12,3,9
Blackmetall,aegwynn,286,rogue,outlaw,12,3,9
Ceule,sanguino,255,rogue,outlaw,11,3,8
Сереф,gordunni,239,rogue,outlaw,11,3,8
Cardsharkjoe,argent-dawn,223,rogue,outlaw,14,3,11
Nyxal,argent-dawn,192,rogue,outlaw,6,2,4
Dawnsaber,argent-dawn,192,rogue,outlaw,6,2,4
Invisage,grim-batol,192,rogue,outlaw,6,2,4
Nidrir,argent-dawn,192,rogue,outlaw,6,2,4
Rashaz,blackhand,192,rogue,outlaw,6,2,4
Cheapshotwin,nethersturm,192,rogue,outlaw,6,2,4
Израф,lich-king,192,rogue,outlaw,6,2,4
Stunlock,silvermoon,192,rogue,outlaw,6,2,4
Lefthook,argent-dawn,192,rogue,outlaw,6,2,4
Nomota,sanguino,192,rogue,outlaw,6,2,4
Рышкопс,howling-fjord,192,rogue,outlaw,6,2,4
Zyhmø,archimonde,192,rogue,outlaw,6,2,4
Berneo,burning-legion,192,rogue,outlaw,6,2,4
Tômmixi,dragonmaw,192,rogue,outlaw,6,2,4
Shadeheart,ragnaros,192,rogue,outlaw,6,2,4
Snøv,outland,192,rogue,outlaw,6,2,4
Salakelmi,sylvanas,192,rogue,outlaw,6,2,4
Angelbeats,outland,192,rogue,outlaw,6,2,4
Оргельна,gordunni,192,rogue,outlaw,6,2,4
Djjake,outland,192,rogue,outlaw,6,2,4
Zlash,doomhammer,192,rogue,outlaw,6,2,4
Paralisis,zuljin,192,rogue,outlaw,6,2,4
Daelilthron,blackmoore,192,rogue,outlaw,12,2,10
Elydriel,khaz-modan,192,rogue,outlaw,12,2,10
Alvoriace,hyjal,192,rogue,outlaw,12,2,10
Rotbite,defias-brotherhood,192,rogue,outlaw,12,2,10
Stabkanta,antonidas,192,rogue,outlaw,12,2,10
Vaze,ravencrest,192,rogue,outlaw,18,2,16
Kausa,dun-modr,191,rogue,outlaw,6,2,4
Valtesse,medivh,159,rogue,outlaw,5,2,3
Piperx,ravencrest,159,rogue,outlaw,11,2,9
Роророл,gordunni,138,rogue,outlaw,8,3,5
Crípplé,ravencrest,128,rogue,outlaw,4,2,2
Ñøway,archimonde,96,rogue,outlaw,3,2,1
Akira,outland,96,rogue,outlaw,6,1,5
Леронда,deepholm,96,rogue,outlaw,6,1,5
Аутянин,soulflayer,96,rogue,outlaw,6,1,5
Sneekster,ravencrest,96,rogue,outlaw,6,1,5
Stepx,uldaman,96,rogue,outlaw,6,1,5
Øníxßtw,eitrigg,96,rogue,outlaw,6,1,5
Yüm,burning-blade,96,rogue,outlaw,6,1,5
Døgrogue,outland,96,rogue,outlaw,6,1,5
Ciaordel,sylvanas,96,rogue,outlaw,6,1,5
Ótsutsukí,kazzak,96,rogue,outlaw,6,1,5
Mallaurya,dalaran,96,rogue,outlaw,6,1,5
Ninjaops,ravencrest,96,rogue,outlaw,6,1,5
Shadowvamp,tarren-mill,96,rogue,outlaw,6,1,5
Natillaa,dun-modr,96,rogue,outlaw,6,1,5
Sty,aerie-peak,96,rogue,outlaw,6,1,5
Goodwin,sanguino,96,rogue,outlaw,7,1,6
Jester,bladefist,96,rogue,outlaw,12,1,11
Tiltman,dun-morogh,79,rogue,outlaw,5,1,4
Maieva,frostmane,64,rogue,outlaw,4,1,3
Nabatean,magtheridon,48,rogue,outlaw,3,1,2
Getbleeded,stormscale,31,rogue,outlaw,2,1,1
Rãz,stormscale,2428,rogue,subtlety,135,84,51
Howton,archimonde,2424,rogue,subtlety,86,57,29
Ncrø,aszune,2418,rogue,subtlety,229,133,96
Lollelt,ravencrest,2415,rogue,subtlety,158,106,52
Ncroxd,ravencrest,2410,rogue,subtlety,120,84,36
Pridå,thrall,2380,rogue,subtlety,126,73,53
Aythusha,twisting-nether,2373,rogue,subtlety,342,184,158
Shoxy,ravencrest,2361,rogue,subtlety,106,63,43
Ewynarog,silvermoon,2348,rogue,subtlety,101,57,44
Nàsklolz,hyjal,2325,rogue,subtlety,236,128,108
Asumah,ravencrest,2270,rogue,subtlety,174,100,74
Whaazlysnipz,tarren-mill,2261,rogue,subtlety,60,40,20
Smøkyyx,eredar,2238,rogue,subtlety,201,107,94
Naláa,ravencrest,2232,rogue,subtlety,230,123,107
Sunø,archimonde,2221,rogue,subtlety,270,139,131
Pridå,ravencrest,2219,rogue,subtlety,136,71,65
Sapécomejaja,archimonde,2218,rogue,subtlety,62,41,21
Loznah,outland,2209,rogue,subtlety,96,52,44
Vulkos,lightbringer,2195,rogue,subtlety,153,82,71
Nasklagattv,hyjal,2193,rogue,subtlety,114,57,57
Rímen,archimonde,2192,rogue,subtlety,107,56,51
Cazzette,ravencrest,2176,rogue,subtlety,111,61,50
Troxerboxer,tarren-mill,2165,rogue,subtlety,78,43,35
Пожилойпупь,gordunni,2161,rogue,subtlety,83,52,31
Xzr,stormscale,2155,rogue,subtlety,160,105,55
Tracersxrude,ravencrest,2153,rogue,subtlety,344,176,168
Brensø,nemesis,2152,rogue,subtlety,201,122,79
Chatdisabled,drakthul,2151,rogue,subtlety,345,181,164
Stealthi,stormscale,2149,rogue,subtlety,113,58,55
Plebxar,arathor,2146,rogue,subtlety,137,75,62
Keeke,outland,2137,rogue,subtlety,70,50,20
Nothingleft,draenor,2137,rogue,subtlety,197,111,86
Critmakër,outland,2135,rogue,subtlety,160,93,67
Zuqzwang,outland,2132,rogue,subtlety,84,51,33
Axelaz,ravencrest,2131,rogue,subtlety,66,42,24
Elnyasha,ravencrest,2131,rogue,subtlety,93,49,44
Лолелт,borean-tundra,2131,rogue,subtlety,104,53,51
Çvß,kazzak,2130,rogue,subtlety,107,57,50
Såj,tarren-mill,2129,rogue,subtlety,72,39,33
Wítchblades,ravencrest,2127,rogue,subtlety,48,41,7
Máül,ravencrest,2122,rogue,subtlety,85,47,38
Lkzx,archimonde,2121,rogue,subtlety,323,163,160
Cntrlld,ravencrest,2120,rogue,subtlety,120,73,47
Magepèt,tarren-mill,2118,rogue,subtlety,184,106,78
Baboonx,burning-legion,2118,rogue,subtlety,204,115,89
Naiikaii,antonidas,2117,rogue,subtlety,89,50,39
Lfgenjoyer,tarren-mill,2114,rogue,subtlety,126,77,49
Социалистсс,gordunni,2114,rogue,subtlety,145,84,61
Xìaó,kazzak,2110,rogue,subtlety,106,67,39
Pulvèr,dalaran,2109,rogue,subtlety,138,74,64
Iqws,ravencrest,2108,rogue,subtlety,114,64,50
Denjinx,culte-de-la-rive-noire,2107,rogue,subtlety,78,43,35
Subzerõ,archimonde,2107,rogue,subtlety,641,322,319
Chatbann,blackrock,2105,rogue,subtlety,417,226,191
Løre,blackrock,2105,rogue,subtlety,138,72,66
Эмилилавс,galakrond,2100,rogue,subtlety,224,131,93
Babøønx,burning-legion,2100,rogue,subtlety,96,54,42
Xiro,dalaran,2100,rogue,subtlety,184,99,85
Dødgez,cthun,2092,rogue,subtlety,130,81,49
Physic,silvermoon,2083,rogue,subtlety,157,88,69
Sátyrícon,ravencrest,2083,rogue,subtlety,84,47,37
Badmy,stormscale,2078,rogue,subtlety,72,37,35
Лолелт,howling-fjord,2074,rogue,subtlety,89,51,38
Änanké,outland,2061,rogue,subtlety,159,78,81
Làekz,archimonde,2043,rogue,subtlety,87,42,45
Byebyé,ravencrest,2030,rogue,subtlety,263,144,119
Calestrian,tarren-mill,2028,rogue,subtlety,274,147,127
Смертьвсмоке,gordunni,2026,rogue,subtlety,461,231,230
Xyúmopjoßblú,ravencrest,2021,rogue,subtlety,78,40,38
Anr,burning-legion,2013,rogue,subtlety,190,110,80
Nahj,ravencrest,2012,rogue,subtlety,60,38,22
Rinj,antonidas,2009,rogue,subtlety,302,159,143
Clawdíte,blackrock,2008,rogue,subtlety,132,67,65
Jugalos,ravencrest,2001,rogue,subtlety,130,64,66
Погибайдуде,gordunni,1998,rogue,subtlety,65,52,13
Asm,the-maelstrom,1995,rogue,subtlety,202,99,103
Terrorman,ravencrest,1988,rogue,subtlety,72,42,30
Brunhityx,ravencrest,1973,rogue,subtlety,44,29,15
Guççí,blackrock,1970,rogue,subtlety,203,108,95
Supremacy,sylvanas,1969,rogue,subtlety,141,82,59
Флексити,soulflayer,1968,rogue,subtlety,150,78,72
Lówskill,outland,1967,rogue,subtlety,259,137,122
Dfagódx,outland,1966,rogue,subtlety,248,138,110
Престиж,greymane,1966,rogue,subtlety,54,29,25
Тира,grom,1962,rogue,subtlety,54,30,24
Oczku,burning-legion,1957,rogue,subtlety,72,43,29
Denjastwo,archimonde,1956,rogue,subtlety,54,34,20
Máuul,ravencrest,1956,rogue,subtlety,78,36,42
Vensq,drakthul,1950,rogue,subtlety,137,71,66
Phøñkðånçér,ravencrest,1948,rogue,subtlety,76,37,39
Lilbubblegum,emerald-dream,1946,rogue,subtlety,185,94,91
Rnghero,blackmoore,1935,rogue,subtlety,60,25,35
Çhimaev,ravencrest,1934,rogue,subtlety,46,29,17
Kallelelel,tarren-mill,1933,rogue,subtlety,42,26,16
Ålleyézonme,ravencrest,1930,rogue,subtlety,570,285,285
Plsðõntcry,ravencrest,1928,rogue,subtlety,403,216,187
Traickorogue,antonidas,1925,rogue,subtlety,29,21,8
Drydamage,kazzak,1920,rogue,subtlety,167,86,81
Nøctürnë,archimonde,1919,rogue,subtlety,48,32,16
Shadezlöl,ravencrest,1916,rogue,subtlety,310,158,152
Xdd,frostmane,1914,rogue,subtlety,109,61,48
Иждолк,gordunni,1912,rogue,subtlety,307,162,145
Cortzy,stormscale,1911,rogue,subtlety,138,72,66
Knoffchad,blackhand,1908,rogue,subtlety,271,147,124
Çåñçér,sylvanas,1907,rogue,subtlety,114,56,58
Ipøuli,quelthalas,1906,rogue,subtlety,108,58,50
Waluuz,silvermoon,1903,rogue,subtlety,109,55,54
Пожилойпуп,gordunni,1901,rogue,subtlety,36,28,8
Naazki,stormscale,1901,rogue,subtlety,60,28,32
Famous,blackhand,1899,rogue,subtlety,72,41,31
Лайнэл,deathweaver,1898,rogue,subtlety,138,79,59
Slapshot,das-konsortium,1898,rogue,subtlety,60,32,28
Deadraw,aegwynn,1897,rogue,subtlety,102,56,46
Dêlaral,blackhand,1896,rogue,subtlety,96,47,49
Meowkek,kazzak,1895,rogue,subtlety,551,280,271
Тохуо,lich-king,1894,rogue,subtlety,60,32,28
Smokebox,ravencrest,1893,rogue,subtlety,54,30,24
Moroz,ravencrest,1893,rogue,subtlety,212,112,100
Illmatíc,ravencrest,1892,rogue,subtlety,62,32,30
Rmp,khaz-modan,1888,rogue,subtlety,102,49,53
Røper,blackmoore,1882,rogue,subtlety,60,28,32
Whøråcle,tarren-mill,1878,rogue,subtlety,255,132,123
Unìque,sylvanas,1877,rogue,subtlety,161,83,78
Malasap,archimonde,1876,rogue,subtlety,626,322,304
Amén,sanguino,1876,rogue,subtlety,102,49,53
Sodarogue,blackrock,1875,rogue,subtlety,74,42,32
Párbajkároj,ragnaros,1875,rogue,subtlety,71,33,38
Roguestuff,silvermoon,1872,rogue,subtlety,72,44,28
Getschwîfty,ravencrest,1872,rogue,subtlety,122,71,51
Thirdrogue,blackhand,1871,rogue,subtlety,108,68,40
Nevolav,turalyon,1869,rogue,subtlety,66,44,22
Kénzos,silvermoon,1865,rogue,subtlety,93,45,48
Sunøbrain,archimonde,1861,rogue,subtlety,58,31,27
Liquidité,azuremyst,1860,rogue,subtlety,236,128,108
Gløøm,ravencrest,1857,rogue,subtlety,80,40,40
Sfyr,ysondre,1856,rogue,subtlety,238,128,110
Abej,malygos,1856,rogue,subtlety,66,33,33
Denjas,archimonde,1855,rogue,subtlety,67,34,33
Âkame,argent-dawn,1853,rogue,subtlety,59,32,27
Мейсадисс,gordunni,1853,rogue,subtlety,72,33,39
Buffassa,ravencrest,1852,rogue,subtlety,108,61,47
Teskes,tyrande,1851,rogue,subtlety,132,73,59
Zîky,dun-modr,1850,rogue,subtlety,100,69,31
Нойсеен,gordunni,1849,rogue,subtlety,54,32,22
Морхалл,gordunni,1848,rogue,subtlety,132,74,58
Rylie,garona,1848,rogue,subtlety,223,116,107
Akwaaba,ravencrest,1847,rogue,subtlety,225,122,103
Zerotyluv,silvermoon,1846,rogue,subtlety,48,34,14
Kickcake,ravencrest,1846,rogue,subtlety,156,88,68
Synergize,stormreaver,1843,rogue,subtlety,241,132,109
Dagyhy,the-maelstrom,1843,rogue,subtlety,60,29,31
Lemaroxd,tarren-mill,1841,rogue,subtlety,54,34,20
Krida,archimonde,1841,rogue,subtlety,102,54,48
Lilaven,turalyon,1841,rogue,subtlety,156,80,76
Deevoll,tarren-mill,1840,rogue,subtlety,267,145,122
Котянкахд,howling-fjord,1839,rogue,subtlety,36,22,14
Quq,kazzak,1838,rogue,subtlety,316,174,142
Susquehanna,ragnaros,1838,rogue,subtlety,198,107,91
Avidance,wrathbringer,1837,rogue,subtlety,42,23,19
Ладжо,gordunni,1837,rogue,subtlety,216,109,107
Dàgé,twisting-nether,1836,rogue,subtlety,178,106,72
Dêlaral,der-mithrilorden,1835,rogue,subtlety,120,60,60
Fîññ,ravencrest,1835,rogue,subtlety,132,64,68
Xoxoxoxoxoxö,archimonde,1833,rogue,subtlety,100,55,45
Cheapshotwin,nethersturm,1831,rogue,subtlety,88,50,38
Shuo,blackrock,1830,rogue,subtlety,143,86,57
Knutten,wildhammer,1830,rogue,subtlety,153,88,65
Killvision,kul-tiras,1829,rogue,subtlety,96,57,39
Bleakhøuse,ravencrest,1829,rogue,subtlety,58,29,29
Izzyb,auchindoun,1828,rogue,subtlety,76,44,32
Lízåriñ,ravencrest,1827,rogue,subtlety,48,38,10
Locgog,argent-dawn,1827,rogue,subtlety,138,79,59
Memphismp,drakthul,1826,rogue,subtlety,53,28,25
Slimshadyqt,terokkar,1825,rogue,subtlety,95,55,40
Эдкенуэй,gordunni,1825,rogue,subtlety,237,136,101
Exiv,ragnaros,1825,rogue,subtlety,140,73,67
Roguanal,hyjal,1825,rogue,subtlety,58,30,28
Chizué,sylvanas,1824,rogue,subtlety,54,34,20
Radiogodx,stormscale,1824,rogue,subtlety,148,75,73
Mortecieca,ravencrest,1824,rogue,subtlety,60,27,33
Fatnutsac,eredar,1823,rogue,subtlety,48,29,19
Asterisyup,silvermoon,1823,rogue,subtlety,119,67,52
Scørp,ravencrest,1823,rogue,subtlety,64,35,29
Noraex,silvermoon,1822,rogue,subtlety,81,47,34
Nippzy,twisting-nether,1821,rogue,subtlety,239,140,99
Leanadle,hyjal,1820,rogue,subtlety,76,46,30
Sbx,alakir,1820,rogue,subtlety,200,108,92
Rlwlwlwrogue,twisting-nether,1819,rogue,subtlety,103,62,41
Râpidø,elune,1819,rogue,subtlety,185,93,92
Rmp,outland,1818,rogue,subtlety,30,19,11
Disturbdx,archimonde,1818,rogue,subtlety,129,76,53
Slonerbrah,ravencrest,1818,rogue,subtlety,60,32,28
Smílèy,ravencrest,1818,rogue,subtlety,114,51,63
Ålùnæh,azjolnerub,1817,rogue,subtlety,126,71,55
Vganzgptx,ravencrest,1817,rogue,subtlety,119,66,53
Holaszemed,ragnaros,1816,rogue,subtlety,183,96,87
Wrathlolz,terokkar,1815,rogue,subtlety,105,61,44
Starfighter,pozzo-delleternità,1815,rogue,subtlety,238,128,110
Mâêl,blackmoore,1815,rogue,subtlety,245,130,115
Salakelmi,sylvanas,1814,rogue,subtlety,113,65,48
Старллесс,gordunni,1814,rogue,subtlety,553,295,258
Bruckmann,ragnaros,1813,rogue,subtlety,187,95,92
Kekful,defias-brotherhood,1811,rogue,subtlety,36,26,10
Анми,gordunni,1811,rogue,subtlety,66,40,26
Sly,emerald-dream,1810,rogue,subtlety,101,55,46
Venom,stormscale,1809,rogue,subtlety,90,48,42
Randomidiot,ravencrest,1809,rogue,subtlety,126,66,60
Keeganx,tarren-mill,1808,rogue,subtlety,71,39,32
Makethemrog,archimonde,1808,rogue,subtlety,309,146,163
Appatras,tarren-mill,1807,rogue,subtlety,115,68,47
Xtoyo,zuljin,1807,rogue,subtlety,233,118,115
Ropedrink,stormscale,1805,rogue,subtlety,71,47,24
Bumaqt,silvermoon,1805,rogue,subtlety,66,41,25
Dancex,kazzak,1805,rogue,subtlety,126,76,50
Azirios,kazzak,1805,rogue,subtlety,233,124,109
Ooqu,silvermoon,1804,rogue,subtlety,30,23,7
Læffgøðx,stormscale,1804,rogue,subtlety,63,38,25
Rhayesh,silvermoon,1804,rogue,subtlety,136,70,66
Kenjí,silvermoon,1804,rogue,subtlety,291,148,143
Rogxy,blackrock,1803,rogue,subtlety,54,32,22
Noxxy,archimonde,1803,rogue,subtlety,121,66,55
Monero,thrall,1802,rogue,subtlety,121,75,46
Jeruna,veklor,1801,rogue,subtlety,98,57,41
Crøweta,argent-dawn,1796,rogue,subtlety,84,42,42
Åluñahtøpg,azjolnerub,1794,rogue,subtlety,150,78,72
Jáckz,twisting-nether,1793,rogue,subtlety,92,53,39
Nightnelly,archimonde,1792,rogue,subtlety,51,34,17
Lânnïster,kazzak,1792,rogue,subtlety,156,82,74
Sábros,ravencrest,1791,rogue,subtlety,210,104,106
Nyzx,blackhand,1789,rogue,subtlety,57,37,20
Kasualaf,stormscale,1788,rogue,subtlety,55,32,23
Rindar,dun-modr,1787,rogue,subtlety,471,246,225
Fibpatrool,ravencrest,1786,rogue,subtlety,125,70,55
Màrto,archimonde,1783,rogue,subtlety,113,69,44
Путьказаха,gordunni,1779,rogue,subtlety,78,45,33
Ennvi,defias-brotherhood,1779,rogue,subtlety,173,91,82
Läêkz,archimonde,1779,rogue,subtlety,48,21,27
Digmorre,drakthul,1778,rogue,subtlety,29,19,10
Voldaxd,blackhand,1777,rogue,subtlety,45,28,17
Dáydreamín,draenor,1774,rogue,subtlety,42,21,21
Кишмякх,howling-fjord,1773,rogue,subtlety,192,90,102
Ratirl,kult-der-verdammten,1771,rogue,subtlety,93,57,36
Critys,drakthul,1770,rogue,subtlety,36,21,15
Stabmaster,outland,1770,rogue,subtlety,120,68,52
Botsrogue,kazzak,1769,rogue,subtlety,36,22,14
Insomnla,silvermoon,1766,rogue,subtlety,156,81,75
Евриклол,soulflayer,1765,rogue,subtlety,65,30,35
Sariena,sylvanas,1764,rogue,subtlety,327,167,160
Eiscreme,blackmoore,1763,rogue,subtlety,36,19,17
Zilemjr,stormscale,1762,rogue,subtlety,194,111,83
Sâybyëbæ,dun-modr,1762,rogue,subtlety,205,109,96
Simsub,tarren-mill,1761,rogue,subtlety,66,34,32
Saanka,eredar,1759,rogue,subtlety,56,28,28
Kasualasf,stormscale,1758,rogue,subtlety,61,31,30
Jljr,twisting-nether,1757,rogue,subtlety,66,33,33
Whiteløtûs,dun-modr,1757,rogue,subtlety,48,23,25
Featfawkes,ragnaros,1756,rogue,subtlety,116,59,57
Sapco,ravencrest,1754,rogue,subtlety,54,29,25
Stråwberrý,archimonde,1753,rogue,subtlety,69,34,35
Tïnderhoe,dalaran,1752,rogue,subtlety,41,28,13
Jqmie,ravencrest,1752,rogue,subtlety,127,78,49
Tanssy,ragnaros,1752,rogue,subtlety,80,48,32
Icdeadpixelz,ravencrest,1751,rogue,subtlety,36,20,16
Sÿkz,hyjal,1751,rogue,subtlety,89,47,42
Trîçk,aegwynn,1747,rogue,subtlety,78,43,35
Naïmitsu,hyjal,1747,rogue,subtlety,132,69,63
Dópamine,hyjal,1746,rogue,subtlety,214,113,101
Воронкхал,ashenvale,1745,rogue,subtlety,66,35,31
Xyzonk,kazzak,1745,rogue,subtlety,42,22,20
Bahi,ysondre,1745,rogue,subtlety,312,159,153
Инфера,lich-king,1741,rogue,subtlety,72,33,39
Keophz,tarren-mill,1740,rogue,subtlety,203,119,84
Axroa,blackmoore,1740,rogue,subtlety,60,24,36
Ziqqi,thrall,1739,rogue,subtlety,126,68,58
Served,twisting-nether,1738,rogue,subtlety,40,25,15
Хасилей,booty-bay,1738,rogue,subtlety,152,82,70
Márto,archimonde,1738,rogue,subtlety,244,129,115
Imaginesub,blackmoore,1735,rogue,subtlety,49,36,13
Panigalex,veknilash,1733,rogue,subtlety,159,93,66
Bloodsmell,outland,1733,rogue,subtlety,284,157,127
Ënd,ravencrest,1733,rogue,subtlety,114,54,60
Asukabed,ravencrest,1732,rogue,subtlety,36,19,17
Deadlybrew,twisting-nether,1732,rogue,subtlety,88,46,42
Namelless,twisting-nether,1732,rogue,subtlety,291,148,143
Skimpy,stormscale,1731,rogue,subtlety,65,38,27
Ач,gordunni,1731,rogue,subtlety,137,73,64
Hidéfromnooß,twisting-nether,1730,rogue,subtlety,108,56,52
Ccedox,stormscale,1729,rogue,subtlety,30,20,10
Cheapshôt,archimonde,1728,rogue,subtlety,229,122,107
Tazzae,draenor,1728,rogue,subtlety,270,142,128
Johnnyprep,ravencrest,1726,rogue,subtlety,95,59,36
Pavlo,nathrezim,1726,rogue,subtlety,73,32,41
Snøv,outland,1723,rogue,subtlety,130,72,58
Shoamunj,archimonde,1722,rogue,subtlety,42,26,16
Dìsørderx,ravencrest,1721,rogue,subtlety,130,72,58
Röguetönerö,dun-modr,1720,rogue,subtlety,66,36,30
Azziinoth,ragnaros,1719,rogue,subtlety,128,60,68
Hoodrogue,blackrock,1715,rogue,subtlety,110,64,46
Eltitoedu,dun-modr,1714,rogue,subtlety,89,44,45
Zygzåg,hyjal,1712,rogue,subtlety,29,19,10
Amuini,magtheridon,1712,rogue,subtlety,50,26,24
Nephology,ravencrest,1712,rogue,subtlety,48,23,25
Nerfalliance,ravencrest,1709,rogue,subtlety,48,27,21
Huprâ,ravencrest,1709,rogue,subtlety,54,26,28
Fivepoint,blackmoore,1708,rogue,subtlety,84,49,35
Gøldzahn,antonidas,1707,rogue,subtlety,100,54,46
Saptrinket,stormscale,1707,rogue,subtlety,445,222,223
Zzemzza,kazzak,1705,rogue,subtlety,107,58,49
Kleptomancy,sylvanas,1702,rogue,subtlety,42,26,16
Architeggt,eredar,1700,rogue,subtlety,102,47,55
Whoton,archimonde,1699,rogue,subtlety,40,24,16
Bizzarerogue,tarren-mill,1698,rogue,subtlety,54,32,22
Trapstar,stormscale,1697,rogue,subtlety,225,119,106
Exi,elune,1697,rogue,subtlety,74,33,41
Ÿøßø,archimonde,1695,rogue,subtlety,144,78,66
Shôka,dalaran,1694,rogue,subtlety,52,25,27
Machmacan,thrall,1693,rogue,subtlety,125,67,58
Киу,howling-fjord,1693,rogue,subtlety,96,48,48
Skullboy,blackmoore,1692,rogue,subtlety,65,35,30
Sêrgi,minahonda,1689,rogue,subtlety,60,32,28
Whîspyr,blackmoore,1689,rogue,subtlety,54,28,26
Releaserage,draenor,1689,rogue,subtlety,73,34,39
Notlikethis,twisting-nether,1687,rogue,subtlety,36,24,12
Meccura,silvermoon,1687,rogue,subtlety,153,86,67
Nihilix,dalaran,1687,rogue,subtlety,197,101,96
Солевыегубки,gordunni,1686,rogue,subtlety,79,48,31
Fawkkes,la-croisade-écarlate,1686,rogue,subtlety,65,39,26
Wasp,twisting-nether,1686,rogue,subtlety,72,35,37
Strangeboy,ravencrest,1685,rogue,subtlety,30,19,11
Роземсти,gordunni,1685,rogue,subtlety,210,105,105
Hidefromnooß,twisting-nether,1683,rogue,subtlety,54,33,21
Брайнз,gordunni,1682,rogue,subtlety,234,131,103
Mfx,arathi,1681,rogue,subtlety,49,33,16
Txm,argent-dawn,1681,rogue,subtlety,48,26,22
Рели,blackscar,1681,rogue,subtlety,78,39,39
Пусякиллерх,gordunni,1680,rogue,subtlety,105,62,43
Fivepointx,blackmoore,1680,rogue,subtlety,104,58,46
Ðoppex,blackmoore,1680,rogue,subtlety,36,20,16
Zayøn,outland,1680,rogue,subtlety,60,33,27
Røgger,ragnaros,1677,rogue,subtlety,190,94,96
Бладстейн,blackscar,1676,rogue,subtlety,330,170,160
Stonyhavana,ravencrest,1676,rogue,subtlety,167,86,81
Handuil,blackmoore,1675,rogue,subtlety,255,134,121
Renhri,burning-legion,1675,rogue,subtlety,533,268,265
Søllek,culte-de-la-rive-noire,1674,rogue,subtlety,74,36,38
Cucumber,laughing-skull,1673,rogue,subtlety,48,24,24
Ámbush,sylvanas,1671,rogue,subtlety,164,82,82
Grifika,outland,1670,rogue,subtlety,121,71,50
Augustina,draenor,1669,rogue,subtlety,102,55,47
Nitelite,outland,1669,rogue,subtlety,72,35,37
Misttrogue,hyjal,1668,rogue,subtlety,48,26,22
Ilrunne,silvermoon,1668,rogue,subtlety,220,117,103
Yumiee,arygos,1668,rogue,subtlety,325,166,159
Notôríous,ravencrest,1667,rogue,subtlety,72,38,34
Ccedolol,stormscale,1666,rogue,subtlety,71,38,33
Nasklagatv,rashgarroth,1666,rogue,subtlety,42,22,20
Reezr,stormscale,1666,rogue,subtlety,132,64,68
Aläen,ravencrest,1663,rogue,subtlety,138,78,60
Tàazz,ysondre,1663,rogue,subtlety,84,45,39
Astereex,sylvanas,1662,rogue,subtlety,36,26,10
Кишмякх,gordunni,1662,rogue,subtlety,93,50,43
Rantie,eredar,1662,rogue,subtlety,54,28,26
Sinterklaas,earthen-ring,1661,rogue,subtlety,54,33,21
Кайсити,gordunni,1660,rogue,subtlety,42,18,24
Redork,twisting-nether,1657,rogue,subtlety,36,21,15
Абисиан,soulflayer,1657,rogue,subtlety,150,84,66
Skýfire,ravencrest,1657,rogue,subtlety,90,48,42
Jussylol,stormscale,1656,rogue,subtlety,45,27,18
Sombredagues,ysondre,1656,rogue,subtlety,370,192,178
Nîllá,blackmoore,1656,rogue,subtlety,72,33,39
Rakzena,ravencrest,1655,rogue,subtlety,60,33,27
Clickbaitx,blackmoore,1655,rogue,subtlety,329,159,170
Сильфитт,gordunni,1655,rogue,subtlety,152,72,80
Ðjczx,twisting-nether,1654,rogue,subtlety,115,62,53
Кеонетво,howling-fjord,1653,rogue,subtlety,70,39,31
Lhitriân,saurfang,1652,rogue,subtlety,151,74,77
Subsònik,tarren-mill,1650,rogue,subtlety,76,43,33
Режупополам,howling-fjord,1649,rogue,subtlety,42,30,12
Subisfun,ravencrest,1649,rogue,subtlety,58,35,23
Vizifyx,ravencrest,1649,rogue,subtlety,36,21,15
Ryvz,ravencrest,1647,rogue,subtlety,95,47,48
Сармонн,howling-fjord,1646,rogue,subtlety,84,56,28
Ibizå,ravencrest,1646,rogue,subtlety,138,75,63
Shivx,tarren-mill,1644,rogue,subtlety,234,118,116
Calpic,sanguino,1643,rogue,subtlety,217,121,96
Aaze,kazzak,1643,rogue,subtlety,201,101,100
Ogc,draenor,1642,rogue,subtlety,74,48,26
Zrka,hyjal,1642,rogue,subtlety,30,18,12
Tzc,argent-dawn,1642,rogue,subtlety,48,26,22
Ripuli,alakir,1640,rogue,subtlety,36,21,15
Dancebar,silvermoon,1640,rogue,subtlety,290,141,149
Kafross,silvermoon,1640,rogue,subtlety,41,19,22
Vennomous,darkspear,1639,rogue,subtlety,58,38,20
Xlums,archimonde,1639,rogue,subtlety,98,55,43
Элисандресса,gordunni,1639,rogue,subtlety,84,42,42
Форсгодх,gordunni,1639,rogue,subtlety,83,37,46
Xzo,stormscale,1637,rogue,subtlety,25,21,4
Vâleera,kazzak,1637,rogue,subtlety,36,18,18
Exanimu,ravencrest,1637,rogue,subtlety,446,220,226
Dawnsaber,argent-dawn,1635,rogue,subtlety,54,31,23
Momíne,stormscale,1635,rogue,subtlety,41,18,23
Zoodiac,khazgoroth,1634,rogue,subtlety,59,29,30
Amazindante,burning-legion,1633,rogue,subtlety,72,36,36
Stormhardt,stormscale,1633,rogue,subtlety,75,30,45
Doritomix,dun-modr,1628,rogue,subtlety,50,29,21
Mns,drakthul,1627,rogue,subtlety,68,38,30
Grzech,burning-legion,1627,rogue,subtlety,235,123,112
Myønlyfans,hyjal,1627,rogue,subtlety,46,23,23
Luciferx,stormscale,1626,rogue,subtlety,42,31,11
Freemode,outland,1625,rogue,subtlety,36,26,10
Геопанк,howling-fjord,1625,rogue,subtlety,66,43,23
Lotorr,burning-legion,1625,rogue,subtlety,156,80,76
Pheq,ravencrest,1625,rogue,subtlety,201,101,100
Juxtapose,ravencrest,1624,rogue,subtlety,72,38,34
Skitzo,ravencrest,1624,rogue,subtlety,36,17,19
Kidneyqt,thrall,1623,rogue,subtlety,85,52,33
Pcessleia,twisting-nether,1622,rogue,subtlety,30,17,13
Vögue,burning-legion,1622,rogue,subtlety,157,80,77
Donchichi,archimonde,1620,rogue,subtlety,66,31,35
Smo,kargath,1619,rogue,subtlety,74,42,32
Морзо,howling-fjord,1619,rogue,subtlety,101,57,44
Isucu,burning-legion,1619,rogue,subtlety,242,136,106
Nojdobra,tarren-mill,1619,rogue,subtlety,147,80,67
Ramses,onyxia,1619,rogue,subtlety,120,60,60
Doomdagger,chamber-of-aspects,1618,rogue,subtlety,65,35,30
Maxrizzx,ravencrest,1618,rogue,subtlety,57,30,27
Onlyrogue,ragnaros,1618,rogue,subtlety,60,31,29
Filiduttpvp,ravencrest,1617,rogue,subtlety,66,42,24
Энтерсэндман,blackscar,1617,rogue,subtlety,35,20,15
Shadowprank,ravencrest,1617,rogue,subtlety,87,45,42
Villain,aegwynn,1617,rogue,subtlety,71,35,36
Rukiia,blackrock,1615,rogue,subtlety,60,31,29
Kerim,antonidas,1614,rogue,subtlety,36,22,14
Syniel,conseil-des-ombres,1614,rogue,subtlety,46,25,21
Tinylol,dun-morogh,1614,rogue,subtlety,115,62,53
Odrey,aegwynn,1613,rogue,subtlety,68,42,26
Zep,auchindoun,1613,rogue,subtlety,77,46,31
Ömme,archimonde,1613,rogue,subtlety,153,84,69
Kãlí,blackmoore,1613,rogue,subtlety,535,274,261
ßênz,archimonde,1612,rogue,subtlety,94,52,42
Ðelvin,dalaran,1612,rogue,subtlety,48,21,27
Hollowized,silvermoon,1611,rogue,subtlety,30,20,10
Ândrey,ravencrest,1611,rogue,subtlety,116,63,53
Jenz,blackmoore,1610,rogue,subtlety,72,40,32
Akyô,archimonde,1609,rogue,subtlety,30,17,13
Onlyluvhurt,dun-modr,1609,rogue,subtlety,136,77,59
Krsty,antonidas,1609,rogue,subtlety,36,20,16
Venøøm,eredar,1609,rogue,subtlety,198,108,90
Rexore,ravencrest,1609,rogue,subtlety,87,47,40
Carvyn,defias-brotherhood,1608,rogue,subtlety,54,31,23
Jaydeeñ,ravencrest,1608,rogue,subtlety,54,29,25
Ohdaesu,aegwynn,1608,rogue,subtlety,36,18,18
Cøntrøl,stormreaver,1607,rogue,subtlety,150,83,67
Billgatez,blackrock,1607,rogue,subtlety,45,23,22
Râáy,blackrock,1607,rogue,subtlety,187,95,92
Killnoobs,kazzak,1606,rogue,subtlety,36,20,16
Meldee,burning-legion,1606,rogue,subtlety,60,32,28
Zømbië,kazzak,1606,rogue,subtlety,284,141,143
Falewyn,ragnaros,1605,rogue,subtlety,36,23,13
Funhinten,blackmoore,1605,rogue,subtlety,78,47,31
Стеллакокс,howling-fjord,1605,rogue,subtlety,70,39,31
Гэнт,soulflayer,1605,rogue,subtlety,84,45,39
Drkidney,malfurion,1605,rogue,subtlety,75,32,43
Nâzaar,antonidas,1604,rogue,subtlety,167,96,71
Gamezcorex,aegwynn,1604,rogue,subtlety,234,122,112
Mecu,ravencrest,1604,rogue,subtlety,126,64,62
Buú,kazzak,1604,rogue,subtlety,42,20,22
Tripleníne,silvermoon,1603,rogue,subtlety,167,94,73
Зорго,deathguard,1603,rogue,subtlety,89,50,39
Злойкиллер,howling-fjord,1603,rogue,subtlety,432,218,214
Shreddera,ravencrest,1602,rogue,subtlety,90,51,39
Местьбучи,howling-fjord,1602,rogue,subtlety,162,90,72
Inyria,outland,1602,rogue,subtlety,271,143,128
Madisonivyqt,blackmoore,1601,rogue,subtlety,106,56,50
Redcutter,silvermoon,1601,rogue,subtlety,78,41,37
Альназир,howling-fjord,1601,rogue,subtlety,149,78,71
Weird,blackmoore,1600,rogue,subtlety,46,29,17
Mortnoïre,naxxramas,1600,rogue,subtlety,142,76,66
Sunå,archimonde,1600,rogue,subtlety,36,19,17
Givilwtf,eredar,1598,rogue,subtlety,144,79,65
Insidióus,sylvanas,1597,rogue,subtlety,150,75,75
Beefboss,neptulon,1596,rogue,subtlety,29,17,12
Бэрнии,howling-fjord,1594,rogue,subtlety,210,109,101
Энбонни,gordunni,1591,rogue,subtlety,60,34,26
Jaffar,mannoroth,1591,rogue,subtlety,112,57,55
Ishízu,exodar,1591,rogue,subtlety,162,76,86
Icekisstv,hyjal,1590,rogue,subtlety,30,18,12
Súpremé,ravencrest,1590,rogue,subtlety,169,96,73
Rockstore,twisting-nether,1590,rogue,subtlety,42,23,19
Kohakugawa,kazzak,1590,rogue,subtlety,36,19,17
Ambuh,ragnaros,1589,rogue,subtlety,59,32,27
Jayjayklobsn,antonidas,1589,rogue,subtlety,36,19,17
Sebik,ravencrest,1585,rogue,subtlety,29,17,12
Baldoh,kazzak,1584,rogue,subtlety,36,24,12
Yourexwifey,ravencrest,1584,rogue,subtlety,133,76,57
Jëllyxøxø,twisting-nether,1584,rogue,subtlety,176,94,82
Rogueas,stormscale,1583,rogue,subtlety,65,40,25
Intrix,draenor,1583,rogue,subtlety,54,31,23
Вр,blackscar,1582,rogue,subtlety,30,18,12
Johnyqt,hyjal,1582,rogue,subtlety,100,59,41
Abéj,malygos,1581,rogue,subtlety,42,19,23
Lechatbotté,tarren-mill,1580,rogue,subtlety,125,74,51
Aszaryn,magtheridon,1580,rogue,subtlety,78,43,35
Oxyrog,ravencrest,1580,rogue,subtlety,42,22,20
Yörgs,eredar,1579,rogue,subtlety,42,24,18
Liarø,archimonde,1577,rogue,subtlety,175,89,86
Bendegúzz,ravencrest,1576,rogue,subtlety,81,43,38
Háttori,twisting-nether,1575,rogue,subtlety,48,26,22
Дэмайо,gordunni,1575,rogue,subtlety,48,26,22
Sniiky,kazzak,1575,rogue,subtlety,333,173,160
Chimmee,draenor,1575,rogue,subtlety,96,42,54
Leepz,outland,1574,rogue,subtlety,102,62,40
Flares,ravencrest,1574,rogue,subtlety,35,19,16
Артимидушка,gordunni,1573,rogue,subtlety,30,18,12
Oguru,eredar,1573,rogue,subtlety,66,35,31
Ninjaassasin,aegwynn,1573,rogue,subtlety,261,135,126
Øptì,ravencrest,1573,rogue,subtlety,87,41,46
Shyy,dun-modr,1572,rogue,subtlety,54,26,28
Dôlf,hyjal,1568,rogue,subtlety,120,70,50
Sénsorium,draenor,1568,rogue,subtlety,273,146,127
Lalice,argent-dawn,1567,rogue,subtlety,90,56,34
Ripcurll,grim-batol,1567,rogue,subtlety,119,63,56
Sshaka,tarren-mill,1566,rogue,subtlety,176,90,86
Djswaghetti,stormscale,1566,rogue,subtlety,36,18,18
Haikyu,blackhand,1566,rogue,subtlety,72,33,39
Danori,grim-batol,1565,rogue,subtlety,30,17,13
Tonaxstab,ragnaros,1565,rogue,subtlety,116,62,54
Sicariø,argent-dawn,1565,rogue,subtlety,243,128,115
Säxnthecrity,blackmoore,1565,rogue,subtlety,360,183,177
Adskydroch,ravencrest,1564,rogue,subtlety,60,31,29
Mutoeksi,twisting-nether,1563,rogue,subtlety,48,27,21
Sapperinö,sylvanas,1563,rogue,subtlety,423,219,204
Тираэлюшка,thermaplugg,1562,rogue,subtlety,28,18,10
Shadowstrìke,silvermoon,1562,rogue,subtlety,35,19,16
Waistêd,ravencrest,1561,rogue,subtlety,36,17,19
Gane,sanguino,1560,rogue,subtlety,75,46,29
Хайдвей,ashenvale,1560,rogue,subtlety,42,18,24
Omeger,thrall,1559,rogue,subtlety,65,24,41
Ouvrebwate,archimonde,1558,rogue,subtlety,89,43,46
Chéat,stormscale,1557,rogue,subtlety,48,28,20
Xdxdxdxdxdxd,drakthul,1556,rogue,subtlety,60,36,24
Deok,tarren-mill,1556,rogue,subtlety,54,31,23
Grindz,ravencrest,1556,rogue,subtlety,692,357,335
Jeanklanche,archimonde,1556,rogue,subtlety,90,45,45
Tripletwenty,ravencrest,1555,rogue,subtlety,36,24,12
Îüçkÿmêñ,outland,1554,rogue,subtlety,208,109,99
Monstermads,kazzak,1554,rogue,subtlety,60,29,31
Kiiby,ravencrest,1554,rogue,subtlety,72,29,43
Subzy,burning-legion,1553,rogue,subtlety,277,153,124
Shabu,nemesis,1553,rogue,subtlety,101,45,56
Триплсап,howling-fjord,1553,rogue,subtlety,53,23,30
Spykee,culte-de-la-rive-noire,1552,rogue,subtlety,42,24,18
Roguecow,tarren-mill,1551,rogue,subtlety,338,177,161
Röguelol,outland,1551,rogue,subtlety,156,80,76
Rîzer,ravencrest,1551,rogue,subtlety,112,50,62
Allchatoff,drakthul,1550,rogue,subtlety,23,17,6
Ddhelpra,ravencrest,1550,rogue,subtlety,52,28,24
Frequenzalfa,silvermoon,1549,rogue,subtlety,52,26,26
Ddhelpra,blackrock,1549,rogue,subtlety,94,45,49
Ayatsuji,nemesis,1549,rogue,subtlety,42,18,24
Зеротулав,gordunni,1549,rogue,subtlety,42,17,25
Hookäh,chants-éternels,1548,rogue,subtlety,48,23,25
Kyssme,archimonde,1548,rogue,subtlety,54,25,29
Pfourtwenty,eredar,1547,rogue,subtlety,36,18,18
Bursthilde,blackmoore,1545,rogue,subtlety,128,70,58
Helloimjohn,darksorrow,1543,rogue,subtlety,77,43,34
Sapstunlol,tarren-mill,1543,rogue,subtlety,42,22,20
Roanz,stormreaver,1543,rogue,subtlety,67,35,32
Кумоо,gordunni,1543,rogue,subtlety,66,31,35
Bamsejuicee,kazzak,1542,rogue,subtlety,30,20,10
Rikdy,kazzak,1540,rogue,subtlety,36,20,16
Xkebyzlobg,outland,1540,rogue,subtlety,47,26,21
Cander,kazzak,1540,rogue,subtlety,85,45,40
Хавиа,gordunni,1539,rogue,subtlety,101,53,48
Silesi,kazzak,1538,rogue,subtlety,24,17,7
Spky,ravencrest,1538,rogue,subtlety,41,26,15
Nexzr,outland,1538,rogue,subtlety,42,23,19
Ayami,blackhand,1537,rogue,subtlety,42,18,24
Chipicaua,silvermoon,1537,rogue,subtlety,78,33,45
Ванэйти,gordunni,1536,rogue,subtlety,525,270,255
Nastêe,archimonde,1535,rogue,subtlety,28,17,11
Belwarx,darksorrow,1535,rogue,subtlety,249,115,134
Сабик,howling-fjord,1534,rogue,subtlety,95,57,38
Лэйап,soulflayer,1534,rogue,subtlety,30,16,14
Reyzumi,antonidas,1533,rogue,subtlety,36,21,15
Nitroxygen,outland,1533,rogue,subtlety,213,108,105
Stealthb,ravencrest,1532,rogue,subtlety,74,41,33
Unsullièd,kazzak,1532,rogue,subtlety,60,31,29
Veronkierto,stormreaver,1531,rogue,subtlety,119,64,55
Sinist,twisting-nether,1531,rogue,subtlety,50,23,27
Südh,sanguino,1530,rogue,subtlety,90,43,47
Дракакула,blackscar,1528,rogue,subtlety,33,22,11
Iowlq,outland,1528,rogue,subtlety,36,22,14
Нэйлио,deepholm,1527,rogue,subtlety,24,16,8
Kidneyou,ragnaros,1527,rogue,subtlety,82,43,39
Isseen,burning-legion,1527,rogue,subtlety,41,19,22
Miiløx,silvermoon,1526,rogue,subtlety,159,78,81
Kiwiganker,argent-dawn,1526,rogue,subtlety,58,27,31
Jèlly,outland,1525,rogue,subtlety,105,65,40
Stâr,archimonde,1525,rogue,subtlety,123,75,48
Кэйтлис,howling-fjord,1525,rogue,subtlety,90,47,43
Fragmint,aggra-português,1525,rogue,subtlety,36,18,18
Droomprins,stormscale,1522,rogue,subtlety,142,73,69
Royalflüx,grim-batol,1522,rogue,subtlety,81,41,40
Kidknee,outland,1522,rogue,subtlety,36,18,18
Catthief,ravencrest,1521,rogue,subtlety,116,64,52
Nécrømåncy,ravencrest,1520,rogue,subtlety,30,16,14
Paxmortem,silvermoon,1520,rogue,subtlety,132,69,63
Pottomzola,ragnaros,1520,rogue,subtlety,66,28,38
Faytun,kult-der-verdammten,1519,rogue,subtlety,54,34,20
Sumiftw,drakthul,1519,rogue,subtlety,30,16,14
Gvcci,aegwynn,1517,rogue,subtlety,24,16,8
Шадовкилер,blackscar,1517,rogue,subtlety,90,48,42
Críppléz,ravencrest,1517,rogue,subtlety,120,63,57
Mînz,twisting-nether,1517,rogue,subtlety,65,30,35
Прошмандэ,gordunni,1516,rogue,subtlety,76,45,31
Psajcho,ragnaros,1516,rogue,subtlety,41,22,19
Neyloa,kazzak,1515,rogue,subtlety,55,30,25
Zujàz,frostwhisper,1515,rogue,subtlety,90,48,42
Jdç,tarren-mill,1515,rogue,subtlety,42,22,20
Zourkan,archimonde,1513,rogue,subtlety,581,307,274
Morgan,argent-dawn,1511,rogue,subtlety,144,80,64
Kopka,draenor,1511,rogue,subtlety,30,16,14
Subzhero,draenor,1511,rogue,subtlety,36,17,19
Zappsarap,onyxia,1510,rogue,subtlety,54,25,29
Xãwé,kazzak,1509,rogue,subtlety,45,26,19
Shinzaoh,khaz-modan,1509,rogue,subtlety,64,33,31
Psychørogue,antonidas,1507,rogue,subtlety,48,25,23
Кверест,howling-fjord,1506,rogue,subtlety,36,20,16
Yinyíng,ravencrest,1505,rogue,subtlety,92,50,42
Сенямбус,gordunni,1504,rogue,subtlety,66,36,30
Sìhaya,outland,1504,rogue,subtlety,55,29,26
Zënø,ragnaros,1503,rogue,subtlety,260,142,118
Зенофар,soulflayer,1503,rogue,subtlety,299,147,152
Stayhumble,turalyon,1502,rogue,subtlety,58,32,26
Sumsarx,ravencrest,1501,rogue,subtlety,137,72,65
Neirdà,hyjal,1498,rogue,subtlety,49,23,26
Spr,malfurion,1496,rogue,subtlety,118,65,53
Murkyy,gilneas,1496,rogue,subtlety,58,29,29
Mishøna,kazzak,1495,rogue,subtlety,167,96,71
Opaska,ravencrest,1495,rogue,subtlety,212,106,106
Izanamî,tarren-mill,1495,rogue,subtlety,132,66,66
Msweasel,sylvanas,1494,rogue,subtlety,48,28,20
Arkblenderx,silvermoon,1494,rogue,subtlety,187,92,95
Fakekick,blackrock,1493,rogue,subtlety,42,25,17
Эвисирейт,gordunni,1493,rogue,subtlety,77,42,35
Buffdh,eredar,1493,rogue,subtlety,48,23,25
Jøwy,archimonde,1492,rogue,subtlety,112,61,51
Letmeplay,ravencrest,1492,rogue,subtlety,53,28,25
Bekkz,todeswache,1492,rogue,subtlety,66,33,33
Nightq,tarren-mill,1491,rogue,subtlety,84,48,36
Doperog,antonidas,1491,rogue,subtlety,234,126,108
Grimdoll,tarren-mill,1490,rogue,subtlety,273,150,123
Shízzel,blackhand,1489,rogue,subtlety,141,73,68
Shaeni,silvermoon,1489,rogue,subtlety,368,190,178
Chratoo,blackmoore,1489,rogue,subtlety,109,53,56
Redewolf,argent-dawn,1488,rogue,subtlety,30,18,12
Winwin,silvermoon,1488,rogue,subtlety,236,134,102
Dölf,archimonde,1487,rogue,subtlety,170,92,78
Лютьер,soulflayer,1487,rogue,subtlety,222,115,107
Xok,draenor,1487,rogue,subtlety,52,26,26
Шпилля,gordunni,1487,rogue,subtlety,77,38,39
Kneiv,frostwhisper,1487,rogue,subtlety,36,16,20
Свёклапро,gordunni,1486,rogue,subtlety,162,93,69
Lilrookie,argent-dawn,1486,rogue,subtlety,164,93,71
Fugly,ragnaros,1486,rogue,subtlety,67,33,34
Cýphia,amanthul,1484,rogue,subtlety,68,36,32
Эйфуча,gordunni,1484,rogue,subtlety,229,121,108
Txf,aegwynn,1484,rogue,subtlety,90,46,44
Vanquishz,arathor,1484,rogue,subtlety,78,36,42
Ruck,madmortem,1483,rogue,subtlety,114,61,53
Shadystabby,stormscale,1483,rogue,subtlety,167,87,80
Coolbassoff,kazzak,1483,rogue,subtlety,110,53,57
Diagnoze,twisting-nether,1481,rogue,subtlety,29,16,13
Ghøstkid,blackrock,1481,rogue,subtlety,194,98,96
Текин,howling-fjord,1480,rogue,subtlety,162,85,77
Getbleeded,stormscale,1479,rogue,subtlety,96,54,42
Cataleýa,outland,1479,rogue,subtlety,152,85,67
Stoff,archimonde,1479,rogue,subtlety,153,76,77
Subhub,ragnaros,1478,rogue,subtlety,132,68,64
Kire,daggerspine,1478,rogue,subtlety,65,30,35
Войенх,gordunni,1477,rogue,subtlety,111,55,56
Peechiyy,blackmoore,1476,rogue,subtlety,93,52,41
Лэйкиро,gordunni,1476,rogue,subtlety,30,16,14
Zôuloulou,archimonde,1476,rogue,subtlety,86,45,41
Shnuppah,sylvanas,1474,rogue,subtlety,72,39,33
Doxxei,draenor,1474,rogue,subtlety,231,122,109
Вагнеса,howling-fjord,1474,rogue,subtlety,95,48,47
Эремми,gordunni,1473,rogue,subtlety,146,79,67
Ванябигпуш,blackscar,1473,rogue,subtlety,189,98,91
Счастливое,howling-fjord,1471,rogue,subtlety,116,58,58
Nandryn,kelthuzad,1470,rogue,subtlety,30,17,13
Faptastíc,blackmoore,1469,rogue,subtlety,54,30,24
Shâdowfreeze,onyxia,1469,rogue,subtlety,114,59,55
Thelones,antonidas,1469,rogue,subtlety,76,39,37
Ziqqiqt,thrall,1469,rogue,subtlety,100,49,51
Zodracir,scarshield-legion,1469,rogue,subtlety,66,29,37
Мипракн,fordragon,1468,rogue,subtlety,66,47,19
Tason,argent-dawn,1468,rogue,subtlety,42,25,17
Xalupa,dun-modr,1468,rogue,subtlety,129,62,67
Senzus,twisting-nether,1466,rogue,subtlety,36,19,17
Yasu,outland,1465,rogue,subtlety,235,122,113
Bonelesschic,silvermoon,1465,rogue,subtlety,36,17,19
Veryscaryguý,twisting-nether,1464,rogue,subtlety,54,33,21
Chipson,kazzak,1462,rogue,subtlety,96,50,46
Decoyed,sylvanas,1462,rogue,subtlety,53,27,26
Rêve,the-maelstrom,1461,rogue,subtlety,52,30,22
Raewyn,teldrassil,1461,rogue,subtlety,77,42,35
Sykin,eredar,1461,rogue,subtlety,137,73,64
Rekki,terokkar,1461,rogue,subtlety,42,21,21
Knifez,ravencrest,1461,rogue,subtlety,66,32,34
Azovrouge,terokkar,1460,rogue,subtlety,279,149,130
Orestes,pozzo-delleternità,1460,rogue,subtlety,105,55,50
Unreallx,silvermoon,1460,rogue,subtlety,647,336,311
Бллейз,gordunni,1460,rogue,subtlety,42,19,23
Bízkit,stormscale,1459,rogue,subtlety,42,27,15
Diazz,aegwynn,1459,rogue,subtlety,115,60,55
Chazsakaï,chogall,1458,rogue,subtlety,34,23,11
Bodhibombx,arthas,1458,rogue,subtlety,58,33,25
Джокэссиди,blackscar,1458,rogue,subtlety,43,24,19
Ænutz,ysondre,1458,rogue,subtlety,33,18,15
Nìghtwalker,ravencrest,1458,rogue,subtlety,326,166,160
Sashikorosu,archimonde,1457,rogue,subtlety,116,65,51
Ryxanâ,blackrock,1457,rogue,subtlety,96,48,48
Schníttchen,antonidas,1455,rogue,subtlety,29,19,10
Sheldowws,tarren-mill,1455,rogue,subtlety,63,34,29
Spyzie,hyjal,1455,rogue,subtlety,45,21,24
Norlix,ravencrest,1455,rogue,subtlety,66,30,36
Ganker,antonidas,1455,rogue,subtlety,54,24,30
Voki,dalaran,1454,rogue,subtlety,135,70,65
Adwl,archimonde,1453,rogue,subtlety,385,196,189
Neskagrall,aegwynn,1453,rogue,subtlety,48,23,25
Jaikka,archimonde,1452,rogue,subtlety,56,31,25
Jaqenhghar,pozzo-delleternità,1452,rogue,subtlety,145,76,69
Snusbusen,ravencrest,1452,rogue,subtlety,42,21,21
Sacrehptit,naxxramas,1450,rogue,subtlety,42,26,16
Richardjerry,stormscale,1450,rogue,subtlety,48,28,20
Banginghard,dunemaul,1450,rogue,subtlety,90,48,42
Lastkiss,aggramar,1450,rogue,subtlety,77,41,36
Zanaken,stormscale,1449,rogue,subtlety,370,193,177
Mpß,tarren-mill,1449,rogue,subtlety,53,23,30
Critmaker,outland,1448,rogue,subtlety,24,16,8
Bandèra,ragnaros,1446,rogue,subtlety,65,28,37
Pidroseus,argent-dawn,1445,rogue,subtlety,99,53,46
Drpiper,twisting-nether,1445,rogue,subtlety,43,22,21
Ultriz,twisting-nether,1445,rogue,subtlety,65,30,35
Bountyhunter,malygos,1445,rogue,subtlety,36,16,20
Oboejoe,burning-legion,1444,rogue,subtlety,207,111,96
Pérplèxîty,thrall,1443,rogue,subtlety,73,39,34
Mont,nemesis,1441,rogue,subtlety,102,51,51
Darkxenojiva,blackmoore,1441,rogue,subtlety,87,39,48
Rat,mazrigos,1440,rogue,subtlety,24,15,9
Wraithh,minahonda,1440,rogue,subtlety,141,77,64
Daggerdashx,ravencrest,1440,rogue,subtlety,698,366,332
Ворейн,howling-fjord,1440,rogue,subtlety,295,149,146
Xulem,silvermoon,1439,rogue,subtlety,64,38,26
Takenòtes,nemesis,1438,rogue,subtlety,24,15,9
Stabbingpunk,ravencrest,1438,rogue,subtlety,96,47,49
Распяздяй,gordunni,1437,rogue,subtlety,108,59,49
Jrj,hyjal,1437,rogue,subtlety,34,16,18
Sparrowxd,aegwynn,1437,rogue,subtlety,39,17,22
Grousie,ravencrest,1436,rogue,subtlety,48,20,28
Slayered,burning-legion,1436,rogue,subtlety,36,15,21
Lïke,frostwolf,1435,rogue,subtlety,24,15,9
Aznare,silvermoon,1435,rogue,subtlety,83,44,39
Jechijr,silvermoon,1435,rogue,subtlety,72,37,35
Вейлинс,gordunni,1435,rogue,subtlety,60,28,32
Hazero,frostmane,1435,rogue,subtlety,54,25,29
Asdfqwerty,ravencrest,1435,rogue,subtlety,48,21,27
Akazuki,alleria,1434,rogue,subtlety,66,31,35
Utis,kazzak,1433,rogue,subtlety,29,18,11
Swayzii,hyjal,1433,rogue,subtlety,47,26,21
ßrklynprnc,blackrock,1433,rogue,subtlety,30,15,15
Ambushgirl,ravencrest,1433,rogue,subtlety,89,44,45
Ypoxthonius,silvermoon,1432,rogue,subtlety,36,18,18
Trashbàg,alakir,1432,rogue,subtlety,30,15,15
Achterom,tarren-mill,1432,rogue,subtlety,128,59,69
Fullblind,tarren-mill,1431,rogue,subtlety,227,116,111
Maláika,silvermoon,1431,rogue,subtlety,161,81,80
Jahseh,blackmoore,1430,rogue,subtlety,42,20,22
Eáz,ravencrest,1429,rogue,subtlety,48,31,17
Выебузадницу,soulflayer,1429,rogue,subtlety,54,28,26
Altramoulaga,archimonde,1429,rogue,subtlety,36,15,21
Crípplé,ravencrest,1428,rogue,subtlety,30,19,11
Mâtâtâ,die-ewige-wacht,1428,rogue,subtlety,77,42,35
Ipresskidney,tarren-mill,1428,rogue,subtlety,170,87,83
Sùbzerø,archimonde,1428,rogue,subtlety,48,24,24
Aschoni,dethecus,1428,rogue,subtlety,41,20,21
Zx,frostmane,1428,rogue,subtlety,60,29,31
Grris,stormscale,1428,rogue,subtlety,78,28,50
Smetakleta,draenor,1427,rogue,subtlety,26,17,9
Муфдшы,gordunni,1427,rogue,subtlety,72,47,25
Dägorath,dun-modr,1427,rogue,subtlety,39,24,15
Edaniel,draenor,1427,rogue,subtlety,135,72,63
Shipshot,blackrock,1426,rogue,subtlety,24,15,9
Aahz,tarren-mill,1425,rogue,subtlety,54,27,27
Reprouvette,dalaran,1424,rogue,subtlety,51,29,22
Jimaal,stormscale,1424,rogue,subtlety,67,38,29
Bizcochondo,sanguino,1424,rogue,subtlety,66,36,30
Klassikas,kazzak,1423,rogue,subtlety,48,31,17
Daggerz,outland,1423,rogue,subtlety,54,28,26
Evivalarte,burning-legion,1423,rogue,subtlety,113,54,59
Mxx,stormscale,1422,rogue,subtlety,319,169,150
Jkrx,draenor,1421,rogue,subtlety,36,18,18
Бейнс,howling-fjord,1420,rogue,subtlety,36,20,16
Ритор,deathguard,1420,rogue,subtlety,65,33,32
Zeiden,sanguino,1420,rogue,subtlety,90,45,45
Csak,defias-brotherhood,1420,rogue,subtlety,69,34,35
Actualcarry,dentarg,1419,rogue,subtlety,100,54,46
Zkyy,ravencrest,1418,rogue,subtlety,30,17,13
Nairobii,tarren-mill,1417,rogue,subtlety,54,30,24
Tinyshank,drakthul,1416,rogue,subtlety,122,63,59
Морнер,howling-fjord,1416,rogue,subtlety,65,33,32
Дэ,blackscar,1416,rogue,subtlety,30,15,15
Nopzs,outland,1415,rogue,subtlety,154,77,77
Жабоклик,gordunni,1414,rogue,subtlety,146,74,72
Nomota,sanguino,1413,rogue,subtlety,56,33,23
Dahlin,stormscale,1413,rogue,subtlety,47,24,23
Ултра,gordunni,1412,rogue,subtlety,273,140,133
Лиргенвард,deathguard,1412,rogue,subtlety,167,83,84
Самерон,howling-fjord,1411,rogue,subtlety,36,24,12
Янигугулак,soulflayer,1411,rogue,subtlety,24,15,9
Nínjutsu,ravencrest,1410,rogue,subtlety,56,25,31
Qiiss,stormscale,1409,rogue,subtlety,96,54,42
Ryzem,archimonde,1409,rogue,subtlety,800,410,390
Decrios,outland,1409,rogue,subtlety,50,20,30
Hajdit,frostmourne,1408,rogue,subtlety,51,33,18
Rïmr,haomarush,1407,rogue,subtlety,42,16,26
Royalflux,grim-batol,1405,rogue,subtlety,30,17,13
Ассаин,gordunni,1405,rogue,subtlety,55,31,24
Jamzyrogue,emerald-dream,1405,rogue,subtlety,36,19,17
Дамаскус,booty-bay,1404,rogue,subtlety,42,23,19
Mocarta,draenor,1404,rogue,subtlety,96,47,49
Teba,cthun,1404,rogue,subtlety,40,19,21
Бэтх,soulflayer,1402,rogue,subtlety,60,36,24
Cerrian,argent-dawn,1401,rogue,subtlety,65,37,28
Erenyeagerx,kazzak,1401,rogue,subtlety,137,71,66
Ææçæçæçæ,twisting-nether,1401,rogue,subtlety,78,39,39
Svartesven,auchindoun,1401,rogue,subtlety,90,43,47
Zelìx,frostmane,1400,rogue,subtlety,120,72,48
Expositiv,blackmoore,1400,rogue,subtlety,30,18,12
Exine,sanguino,1400,rogue,subtlety,30,17,13
Альназир,gordunni,1400,rogue,subtlety,42,22,20
Killthatmage,shattered-hand,1400,rogue,subtlety,42,21,21
Robersillo,sanguino,1400,rogue,subtlety,56,25,31
Maitrefurtif,argent-dawn,1398,rogue,subtlety,29,19,10
Floorjansen,sylvanas,1398,rogue,subtlety,42,25,17
Kshero,sylvanas,1398,rogue,subtlety,28,15,13
Zélla,twisting-nether,1398,rogue,subtlety,122,61,61
Nîmaj,hyjal,1398,rogue,subtlety,48,21,27
Elbrønkas,sanguino,1398,rogue,subtlety,47,19,28
Shelzy,eredar,1397,rogue,subtlety,77,33,44
Freemmr,draenor,1396,rogue,subtlety,172,88,84
Deathcvlt,hyjal,1396,rogue,subtlety,292,145,147
Sajina,kazzak,1396,rogue,subtlety,48,23,25
Neymar,ysondre,1395,rogue,subtlety,114,62,52
Zobrak,twisting-nether,1395,rogue,subtlety,120,63,57
Lenani,blackrock,1395,rogue,subtlety,48,20,28
Skitstöveln,stormscale,1394,rogue,subtlety,24,15,9
Смекрус,soulflayer,1394,rogue,subtlety,165,83,82
Evi,korgall,1394,rogue,subtlety,60,27,33
Mega,nordrassil,1393,rogue,subtlety,31,18,13
Akira,outland,1393,rogue,subtlety,291,156,135
Tsvetomir,doomhammer,1392,rogue,subtlety,38,22,16
Dàwn,boulderfist,1391,rogue,subtlety,88,48,40
Dimidimi,wildhammer,1391,rogue,subtlety,48,21,27
Apuñalá,cthun,1390,rogue,subtlety,30,15,15
Эбиб,soulflayer,1390,rogue,subtlety,52,24,28
Guiseppe,grim-batol,1389,rogue,subtlety,105,57,48
Songoro,tirion,1389,rogue,subtlety,63,30,33
Biggut,khadgar,1389,rogue,subtlety,39,17,22
Hidinginash,twisting-nether,1388,rogue,subtlety,50,25,25
Arachni,ravencrest,1388,rogue,subtlety,109,52,57
Xblackhole,tarren-mill,1387,rogue,subtlety,170,86,84
Âtrâlês,azshara,1386,rogue,subtlety,33,16,17
Knivparty,draenor,1384,rogue,subtlety,76,41,35
Óoo,outland,1384,rogue,subtlety,78,40,38
Технорэйв,gordunni,1384,rogue,subtlety,78,35,43
Feinted,kazzak,1383,rogue,subtlety,109,56,53
Lilsalad,ravencrest,1383,rogue,subtlety,107,53,54
Automutilate,outland,1383,rogue,subtlety,62,26,36
Althieves,ravencrest,1382,rogue,subtlety,132,72,60
Roguebot,draenor,1381,rogue,subtlety,136,71,65
Shadowgraph,eredar,1381,rogue,subtlety,60,31,29
Kryptonite,nemesis,1381,rogue,subtlety,147,75,72
Дернирог,howling-fjord,1381,rogue,subtlety,133,66,67
Mmrmmxmm,turalyon,1381,rogue,subtlety,65,28,37
Dredge,kaelthas,1379,rogue,subtlety,44,22,22
Ucg,twisting-nether,1379,rogue,subtlety,47,22,25
Дакоока,soulflayer,1378,rogue,subtlety,24,16,8
Nopz,outland,1378,rogue,subtlety,54,29,25
Schering,frostwolf,1377,rogue,subtlety,54,27,27
Behindü,frostmane,1376,rogue,subtlety,150,75,75
Käz,argent-dawn,1376,rogue,subtlety,42,16,26
Evasión,aegwynn,1375,rogue,subtlety,107,56,51
Ibizà,ravencrest,1375,rogue,subtlety,369,183,186
Sedái,twisting-nether,1375,rogue,subtlety,70,29,41
Мутилэйтлав,soulflayer,1374,rogue,subtlety,48,24,24
Trímønâ,gorgonnash,1374,rogue,subtlety,36,16,20
Фалвир,howling-fjord,1372,rogue,subtlety,65,38,27
Binbág,draenor,1372,rogue,subtlety,108,62,46
Juuzou,outland,1372,rogue,subtlety,35,15,20
Trimøná,gorgonnash,1371,rogue,subtlety,30,16,14
Анивиана,howling-fjord,1371,rogue,subtlety,134,64,70
Lêmon,argent-dawn,1370,rogue,subtlety,52,31,21
Timesneak,stormscale,1370,rogue,subtlety,78,36,42
Bakalan,dun-modr,1370,rogue,subtlety,48,20,28
Elfreyja,archimonde,1369,rogue,subtlety,111,53,58
Smètso,stormscale,1369,rogue,subtlety,72,33,39
Bloodwraith,stormscale,1369,rogue,subtlety,99,44,55
Daterx,ravencrest,1369,rogue,subtlety,36,15,21
Maløcøxysse,dalaran,1368,rogue,subtlety,138,75,63
Hertyso,outland,1368,rogue,subtlety,36,17,19
Sableye,arathor,1368,rogue,subtlety,35,15,20
Boornys,burning-legion,1367,rogue,subtlety,94,50,44
Mercyã,outland,1367,rogue,subtlety,149,79,70
Меттерз,gordunni,1367,rogue,subtlety,48,25,23
Zavebe,nathrezim,1367,rogue,subtlety,53,26,27
Usainßreak,chogall,1366,rogue,subtlety,82,47,35
Hashlund,stormscale,1366,rogue,subtlety,86,46,40
Verk,twilights-hammer,1365,rogue,subtlety,42,18,24
Exbandit,sanguino,1364,rogue,subtlety,72,44,28
Asine,boulderfist,1364,rogue,subtlety,147,72,75
Behiq,aggramar,1363,rogue,subtlety,48,31,17
Иннхотеп,howling-fjord,1363,rogue,subtlety,84,49,35
Vexior,argent-dawn,1363,rogue,subtlety,93,44,49
Gankbang,frostmane,1363,rogue,subtlety,78,35,43
Ykw,tarren-mill,1362,rogue,subtlety,173,94,79
Vanisha,outland,1362,rogue,subtlety,138,65,73
Dedka,hyjal,1361,rogue,subtlety,103,49,54
Czêro,grim-batol,1361,rogue,subtlety,49,22,27
Rngkillaz,archimonde,1360,rogue,subtlety,37,20,17
Takàà,archimonde,1360,rogue,subtlety,55,29,26
Alyana,eldrethalas,1359,rogue,subtlety,43,21,22
Illyan,jaedenar,1358,rogue,subtlety,30,17,13
Cenvadois,blackmoore,1358,rogue,subtlety,54,26,28
Mulu,defias-brotherhood,1358,rogue,subtlety,50,23,27
Venominom,aegwynn,1357,rogue,subtlety,30,17,13
Эквалири,gordunni,1357,rogue,subtlety,94,45,49
Артимидушка,soulflayer,1356,rogue,subtlety,22,15,7
Yokze,ravencrest,1356,rogue,subtlety,154,77,77
Aikaza,blackmoore,1356,rogue,subtlety,51,23,28
Søsaboy,nemesis,1355,rogue,subtlety,24,15,9
Månny,archimonde,1355,rogue,subtlety,104,53,51
Helcof,emerald-dream,1353,rogue,subtlety,30,15,15
Zerozsub,tarren-mill,1352,rogue,subtlety,184,102,82
Galathea,turalyon,1352,rogue,subtlety,167,83,84
Øníxßtw,eitrigg,1350,rogue,subtlety,30,15,15
Maybeok,twisting-nether,1349,rogue,subtlety,96,56,40
Vanéry,ravencrest,1349,rogue,subtlety,36,20,16
Мариалолз,gordunni,1349,rogue,subtlety,60,26,34
Shadowspike,sanguino,1348,rogue,subtlety,47,22,25
Danjiki,ravencrest,1348,rogue,subtlety,54,24,30
Hahårry,ravencrest,1347,rogue,subtlety,48,24,24
Zappdead,frostwolf,1347,rogue,subtlety,52,22,30
Syneth,drakthul,1346,rogue,subtlety,40,25,15
Billybang,outland,1346,rogue,subtlety,136,71,65
Rannec,der-rat-von-dalaran,1346,rogue,subtlety,36,15,21
Later,saurfang,1344,rogue,subtlety,34,16,18
Crimatoria,rajaxx,1344,rogue,subtlety,57,25,32
Akroshalolz,outland,1343,rogue,subtlety,24,14,10
Urthël,culte-de-la-rive-noire,1343,rogue,subtlety,24,14,10
Taniwa,archimonde,1343,rogue,subtlety,168,87,81
Scrumptious,darksorrow,1343,rogue,subtlety,96,47,49
Rúckus,ravencrest,1342,rogue,subtlety,24,14,10
Djeud,archimonde,1342,rogue,subtlety,136,79,57
Gingahboy,doomhammer,1340,rogue,subtlety,215,118,97
Vorsix,tarren-mill,1340,rogue,subtlety,195,103,92
Erx,ragnaros,1339,rogue,subtlety,36,20,16
Рестинписер,soulflayer,1339,rogue,subtlety,473,240,233
Аренамастерх,blackscar,1339,rogue,subtlety,30,15,15
Xenara,argent-dawn,1339,rogue,subtlety,81,39,42
Xôár,aegwynn,1339,rogue,subtlety,37,16,21
Zordochrog,kazzak,1338,rogue,subtlety,32,16,16
Изифаза,deathguard,1338,rogue,subtlety,30,14,16
Æsthaetic,silvermoon,1337,rogue,subtlety,529,260,269
Jáyjay,antonidas,1337,rogue,subtlety,96,41,55
Neverdyingx,ragnaros,1337,rogue,subtlety,54,18,36
Ракфорн,howling-fjord,1336,rogue,subtlety,185,91,94
Bennyweth,argent-dawn,1336,rogue,subtlety,66,32,34
Lookbehîndu,aegwynn,1336,rogue,subtlety,73,35,38
Anklash,blackrock,1336,rogue,subtlety,73,31,42
Сайгакк,galakrond,1334,rogue,subtlety,51,29,22
Moprogue,twisting-nether,1333,rogue,subtlety,24,14,10
Behêmoth,hyjal,1333,rogue,subtlety,24,14,10
Ruckusxx,ravencrest,1332,rogue,subtlety,21,15,6
Tootskie,outland,1332,rogue,subtlety,163,91,72
Eriksonn,drakthul,1332,rogue,subtlety,85,44,41
Daekrun,argent-dawn,1332,rogue,subtlety,104,52,52
Ñavy,archimonde,1332,rogue,subtlety,86,37,49
Yakio,silvermoon,1332,rogue,subtlety,60,25,35
Maam,ravencrest,1331,rogue,subtlety,48,26,22
Midoa,nerathor,1331,rogue,subtlety,122,65,57
Fluctuosap,dun-modr,1331,rogue,subtlety,42,19,23
Gavranovski,ravencrest,1330,rogue,subtlety,24,14,10
Йаяга,soulflayer,1330,rogue,subtlety,36,19,17
Duzhel,kazzak,1329,rogue,subtlety,71,36,35
Marcel,blackrock,1329,rogue,subtlety,30,14,16
Ibz,kazzak,1329,rogue,subtlety,54,24,30
Егоист,howling-fjord,1327,rogue,subtlety,72,45,27
Meshay,kazzak,1327,rogue,subtlety,43,24,19
Luckeri,antonidas,1327,rogue,subtlety,74,37,37
Cørek,blackhand,1327,rogue,subtlety,30,14,16
Азунайт,ashenvale,1325,rogue,subtlety,29,15,14
Andrizle,blackmoore,1325,rogue,subtlety,30,14,16
Yamajinzu,blackmoore,1324,rogue,subtlety,317,159,158
Lesyria,blackrock,1323,rogue,subtlety,46,25,21
Nekhâ,hyjal,1322,rogue,subtlety,24,14,10
Cowmbat,tarren-mill,1322,rogue,subtlety,62,30,32
Pierrè,draenor,1322,rogue,subtlety,30,14,16
Monster,kazzak,1322,rogue,subtlety,36,15,21
Рюджик,soulflayer,1321,rogue,subtlety,30,14,16
Kuttunga,ravencrest,1320,rogue,subtlety,63,32,31
Xyfer,azshara,1319,rogue,subtlety,48,26,22
Tripoid,draenor,1319,rogue,subtlety,78,35,43
Suikastman,silvermoon,1318,rogue,subtlety,94,48,46
Bleeds,thrall,1318,rogue,subtlety,65,33,32
Coaraze,eldrethalas,1318,rogue,subtlety,155,78,77
Rbgdowngrade,ravencrest,1318,rogue,subtlety,30,15,15
Dreamt,twisting-nether,1317,rogue,subtlety,66,36,30
Ðàrx,archimonde,1317,rogue,subtlety,77,35,42
Dåjjal,ravencrest,1316,rogue,subtlety,87,45,42
Ultraviølett,gorgonnash,1316,rogue,subtlety,73,34,39
Alltaïr,ravencrest,1315,rogue,subtlety,177,96,81
Poughkeepsie,outland,1315,rogue,subtlety,36,17,19
Tonu,sanguino,1315,rogue,subtlety,30,14,16
Caská,blackhand,1315,rogue,subtlety,72,32,40
Envenoman,ravencrest,1315,rogue,subtlety,71,31,40
Spâde,outland,1315,rogue,subtlety,39,17,22
Snack,burning-legion,1314,rogue,subtlety,57,27,30
Rvogue,draenor,1314,rogue,subtlety,57,27,30
Snurry,tarren-mill,1313,rogue,subtlety,24,14,10
Тучёна,soulflayer,1313,rogue,subtlety,90,51,39
Furky,blackmoore,1312,rogue,subtlety,36,22,14
Aati,the-maelstrom,1312,rogue,subtlety,128,64,64
Kouru,outland,1312,rogue,subtlety,48,24,24
Iwashíding,draenor,1312,rogue,subtlety,54,26,28
Strangeboyxx,ravencrest,1312,rogue,subtlety,36,14,22
Jakes,aerie-peak,1311,rogue,subtlety,30,14,16
Shiverbane,sargeras,1310,rogue,subtlety,46,26,20
Kruuv,dun-morogh,1310,rogue,subtlety,54,28,26
Mealy,auchindoun,1310,rogue,subtlety,126,65,61
Tripx,ravencrest,1310,rogue,subtlety,163,84,79
Yunalescax,outland,1310,rogue,subtlety,42,16,26
Andayn,shattered-hand,1309,rogue,subtlety,59,34,25
Boorza,silvermoon,1309,rogue,subtlety,30,16,14
Bárathrum,stormscale,1308,rogue,subtlety,48,30,18
Trulor,wildhammer,1308,rogue,subtlety,89,45,44
Absol,hellscream,1308,rogue,subtlety,118,59,59
Ланароудсс,gordunni,1307,rogue,subtlety,54,25,29
Ханджии,soulflayer,1306,rogue,subtlety,60,35,25
Levíeus,blackrock,1305,rogue,subtlety,132,73,59
Книфек,howling-fjord,1305,rogue,subtlety,34,18,16
Knifeparty,silvermoon,1305,rogue,subtlety,56,28,28
Lupos,anubarak,1305,rogue,subtlety,70,32,38
Rhûlf,ravencrest,1304,rogue,subtlety,115,53,62
Zindally,dalaran,1304,rogue,subtlety,36,15,21
Lînkos,aegwynn,1303,rogue,subtlety,30,14,16
Horvathzu,ravencrest,1303,rogue,subtlety,57,26,31
Káji,frostmane,1302,rogue,subtlety,18,14,4
Meliä,ravencrest,1302,rogue,subtlety,28,15,13
Siegderliebe,nemesis,1302,rogue,subtlety,30,14,16
Цилана,gordunni,1301,rogue,subtlety,56,31,25
Loopermann,silvermoon,1301,rogue,subtlety,200,94,106
Madmann,ravencrest,1301,rogue,subtlety,87,34,53
Hérat,silvermoon,1298,rogue,subtlety,60,26,34
Johncéná,stormscale,1297,rogue,subtlety,42,22,20
Лофиан,gordunni,1297,rogue,subtlety,140,69,71
Лаленвин,gordunni,1295,rogue,subtlety,85,43,42
Løuvees,archimonde,1294,rogue,subtlety,42,22,20
Снэйк,blackscar,1294,rogue,subtlety,30,15,15
Soukalamink,tarren-mill,1294,rogue,subtlety,48,17,31
Ilikesap,blackmoore,1293,rogue,subtlety,60,32,28
Grimv,frostmane,1293,rogue,subtlety,30,15,15
Niapro,dun-morogh,1292,rogue,subtlety,72,36,36
Viltraxus,twisting-nether,1292,rogue,subtlety,100,43,57
Вишнуизм,gordunni,1291,rogue,subtlety,48,19,29
Hittzer,archimonde,1290,rogue,subtlety,42,18,24
Swiftshank,grim-batol,1290,rogue,subtlety,72,29,43
Kaleigh,grim-batol,1289,rogue,subtlety,24,14,10
Somaliapirat,eredar,1289,rogue,subtlety,30,15,15
Hasansabbah,twisting-nether,1289,rogue,subtlety,72,24,48
Kilabre,twisting-nether,1288,rogue,subtlety,31,16,15
Nexieane,ravencrest,1288,rogue,subtlety,166,84,82
Vexsis,kazzak,1287,rogue,subtlety,24,16,8
Snustjuven,stormscale,1287,rogue,subtlety,24,15,9
Weìrdelle,silvermoon,1286,rogue,subtlety,184,95,89
Guiltythief,stormscale,1286,rogue,subtlety,43,22,21
Cnac,stormscale,1286,rogue,subtlety,52,21,31
Kïdney,stormscale,1285,rogue,subtlety,78,43,35
Chïnaski,sargeras,1285,rogue,subtlety,37,19,18
Отбитыйвхлам,howling-fjord,1285,rogue,subtlety,47,19,28
Buttonsfly,silvermoon,1284,rogue,subtlety,138,84,54
Highz,zenedar,1284,rogue,subtlety,53,29,24
Йзвинись,howling-fjord,1284,rogue,subtlety,42,21,21
Guzirogue,azshara,1284,rogue,subtlety,58,22,36
Chïefkeef,twisting-nether,1283,rogue,subtlety,28,15,13
Rogioz,outland,1283,rogue,subtlety,60,23,37
Svddendeath,ragnaros,1281,rogue,subtlety,84,38,46
Swâggerino,kazzak,1280,rogue,subtlety,62,32,30
Syrio,nemesis,1279,rogue,subtlety,81,35,46
Pixelrogue,argent-dawn,1278,rogue,subtlety,83,44,39
Deathwalkxr,silvermoon,1278,rogue,subtlety,141,70,71
Misantropia,nemesis,1278,rogue,subtlety,138,64,74
Rogueseanne,blackrock,1277,rogue,subtlety,126,62,64
Zhadowên,outland,1276,rogue,subtlety,72,34,38
Káríc,draenor,1276,rogue,subtlety,58,27,31
Refundlands,kazzak,1275,rogue,subtlety,68,33,35
Дангерр,gordunni,1275,rogue,subtlety,114,54,60
Juelz,ravencrest,1272,rogue,subtlety,29,18,11
Petsakos,ravencrest,1272,rogue,subtlety,33,15,18
Янимагу,soulflayer,1271,rogue,subtlety,55,24,31
Ôzzi,draenor,1270,rogue,subtlety,54,32,22
Валанбалас,soulflayer,1269,rogue,subtlety,64,37,27
Garriw,nemesis,1269,rogue,subtlety,84,38,46
Audiotronic,blackmoore,1268,rogue,subtlety,161,81,80
Bartolomew,hellscream,1268,rogue,subtlety,147,72,75
Neoly,outland,1267,rogue,subtlety,54,35,19
Шикорро,soulflayer,1266,rogue,subtlety,36,18,18
Rhytmic,drakthul,1266,rogue,subtlety,36,15,21
Тирниса,gordunni,1263,rogue,subtlety,54,32,22
Kosmonaut,pozzo-delleternità,1262,rogue,subtlety,23,14,9
Smeyra,magtheridon,1262,rogue,subtlety,114,63,51
Jinxy,outland,1261,rogue,subtlety,22,15,7
Shrèéd,blackmoore,1261,rogue,subtlety,107,52,55
Shiréz,blackmoore,1260,rogue,subtlety,157,79,78
Monoxid,eredar,1260,rogue,subtlety,125,61,64
Gansull,nemesis,1260,rogue,subtlety,131,63,68
Интерфи,blackscar,1260,rogue,subtlety,140,66,74
Huffim,tarren-mill,1259,rogue,subtlety,158,79,79
Qylu,argent-dawn,1259,rogue,subtlety,30,15,15
Takeitèásy,blackrock,1259,rogue,subtlety,56,23,33
Nacknschelle,thrall,1259,rogue,subtlety,41,15,26
Bizkitz,argent-dawn,1258,rogue,subtlety,84,36,48
Joyfulundead,frostwolf,1257,rogue,subtlety,78,43,35
Késs,aegwynn,1257,rogue,subtlety,36,14,22
Sánkà,ysondre,1255,rogue,subtlety,66,33,33
Stin,blackrock,1255,rogue,subtlety,137,62,75
Vrederun,blackrock,1254,rogue,subtlety,42,20,22
Pschítt,archimonde,1254,rogue,subtlety,140,60,80
Xaiko,baelgun,1253,rogue,subtlety,44,28,16
Фирмиана,howling-fjord,1253,rogue,subtlety,66,35,31
Chãøs,silvermoon,1253,rogue,subtlety,72,37,35
Sambä,sanguino,1253,rogue,subtlety,93,44,49
Heskmad,kazzak,1252,rogue,subtlety,64,33,31
Mokey,boulderfist,1250,rogue,subtlety,45,27,18
Blades,blackmoore,1250,rogue,subtlety,84,48,36
Ambushmike,gorgonnash,1249,rogue,subtlety,190,96,94
Zvarka,drakthul,1248,rogue,subtlety,36,24,12
Dræmz,twisting-nether,1248,rogue,subtlety,36,20,16
Heulleise,die-ewige-wacht,1248,rogue,subtlety,93,48,45
Backcracker,thunderhorn,1248,rogue,subtlety,36,16,20
Freý,twisting-nether,1247,rogue,subtlety,65,30,35
Jrexx,silvermoon,1247,rogue,subtlety,42,16,26
Missesinvis,blackmoore,1246,rogue,subtlety,18,13,5
Xeggy,turalyon,1246,rogue,subtlety,202,109,93
Optoo,ragnaros,1246,rogue,subtlety,41,21,20
Rawbérry,aggramar,1246,rogue,subtlety,36,17,19
Woishi,hyjal,1246,rogue,subtlety,36,14,22
Rayukalolz,dun-modr,1246,rogue,subtlety,48,15,33
Sneakysáp,ravencrest,1245,rogue,subtlety,18,13,5
Narar,stormscale,1245,rogue,subtlety,66,42,24
Lesbinan,kazzak,1245,rogue,subtlety,24,13,11
Nerfexpected,silvermoon,1245,rogue,subtlety,39,16,23
Mizoy,blackmoore,1245,rogue,subtlety,58,21,37
Эрихард,howling-fjord,1244,rogue,subtlety,64,31,33
Зити,blackscar,1243,rogue,subtlety,24,13,11
Purexrogue,dragonblight,1243,rogue,subtlety,78,38,40
Smoothiè,twisting-nether,1242,rogue,subtlety,129,63,66
Finkle,blackmoore,1242,rogue,subtlety,42,19,23
Xhtzn,ysondre,1240,rogue,subtlety,24,13,11
Arrzhan,silvermoon,1239,rogue,subtlety,104,60,44
Skillissuex,tarren-mill,1238,rogue,subtlety,615,314,301
Whitedolphin,turalyon,1237,rogue,subtlety,24,13,11
Мипанка,gordunni,1237,rogue,subtlety,24,13,11
Abovz,ragnaros,1236,rogue,subtlety,36,14,22
Darkveil,xavius,1236,rogue,subtlety,59,22,37
Клоуняша,gordunni,1234,rogue,subtlety,30,15,15
Revelith,nemesis,1234,rogue,subtlety,36,15,21
Vexia,twisting-nether,1233,rogue,subtlety,24,13,11
Thehand,eonar,1232,rogue,subtlety,96,53,43
Kusgag,ragnaros,1232,rogue,subtlety,24,13,11
Masanari,die-nachtwache,1232,rogue,subtlety,74,30,44
Шмарамышь,soulflayer,1231,rogue,subtlety,139,70,69
Pøpsmoke,outland,1231,rogue,subtlety,152,72,80
Alekkush,silvermoon,1231,rogue,subtlety,30,13,17
Sylvershade,kazzak,1231,rogue,subtlety,34,14,20
Únk,dalaran,1230,rogue,subtlety,26,13,13
Соважь,soulflayer,1229,rogue,subtlety,66,27,39
Pikanother,dalaran,1228,rogue,subtlety,179,93,86
Фордрэн,deathguard,1228,rogue,subtlety,46,23,23
Puyopop,archimonde,1228,rogue,subtlety,36,13,23
Silnce,outland,1227,rogue,subtlety,78,36,42
Rallzkens,stormscale,1227,rogue,subtlety,30,13,17
Darkenough,outland,1227,rogue,subtlety,30,13,17
Deprress,silvermoon,1226,rogue,subtlety,42,25,17
Чернабаев,soulflayer,1226,rogue,subtlety,28,15,13
Mckk,tarren-mill,1225,rogue,subtlety,77,41,36
Samuraisepp,stormscale,1225,rogue,subtlety,33,14,19
Jisz,doomhammer,1224,rogue,subtlety,108,56,52
Chetnik,illidan,1222,rogue,subtlety,24,13,11
Sozokujin,ysondre,1222,rogue,subtlety,74,37,37
Hallogenic,silvermoon,1222,rogue,subtlety,54,26,28
Wøølfgang,archimonde,1222,rogue,subtlety,83,39,44
Slashendash,outland,1222,rogue,subtlety,53,22,31
Gpóínt,blackmoore,1221,rogue,subtlety,46,24,22
Theriaeu,ravencrest,1221,rogue,subtlety,86,44,42
Gìngèr,kazzak,1220,rogue,subtlety,30,15,15
Jimzopf,eredar,1220,rogue,subtlety,53,26,27
Souldreader,draenor,1218,rogue,subtlety,54,30,24
Siktiritos,malganis,1218,rogue,subtlety,84,38,46
Dígga,nemesis,1218,rogue,subtlety,186,83,103
Neyokqt,blackrock,1217,rogue,subtlety,24,13,11
Grope,alonsus,1217,rogue,subtlety,160,78,82
Makerrx,tarren-mill,1216,rogue,subtlety,18,13,5
Галиновна,soulflayer,1215,rogue,subtlety,316,156,160
Kiksi,ravencrest,1215,rogue,subtlety,143,70,73
Fopi,sanguino,1215,rogue,subtlety,84,38,46
Ézzah,blackhand,1215,rogue,subtlety,140,60,80
Benvagin,hyjal,1215,rogue,subtlety,44,16,28
Obsçuritý,ragnaros,1214,rogue,subtlety,115,65,50
Трикстэд,soulflayer,1214,rogue,subtlety,120,63,57
Rámiel,ragnaros,1214,rogue,subtlety,53,24,29
Bzuco,tarren-mill,1213,rogue,subtlety,42,24,18
Snýz,darksorrow,1213,rogue,subtlety,23,13,10
Outofstuns,earthen-ring,1213,rogue,subtlety,42,19,23
Instealth,draenor,1213,rogue,subtlety,156,70,86
Zenajlz,outland,1213,rogue,subtlety,42,18,24
Jäshin,hyjal,1213,rogue,subtlety,42,13,29
Ксионас,gordunni,1212,rogue,subtlety,82,36,46
Катягоудж,gordunni,1210,rogue,subtlety,30,13,17
Darkral,nemesis,1210,rogue,subtlety,78,30,48
Mojojina,theradras,1209,rogue,subtlety,64,36,28
Sneakypuss,sylvanas,1209,rogue,subtlety,52,21,31
Zergroidz,kazzak,1208,rogue,subtlety,169,82,87
Evadeez,tarren-mill,1208,rogue,subtlety,42,15,27
Jeryss,sylvanas,1207,rogue,subtlety,36,13,23
Теньглуши,gordunni,1206,rogue,subtlety,65,29,36
Tez,malganis,1204,rogue,subtlety,24,13,11
Paveli,ravencrest,1202,rogue,subtlety,120,58,62
Тарний,gordunni,1202,rogue,subtlety,36,17,19
Sussulto,nemesis,1202,rogue,subtlety,36,13,23
Сладкийперец,borean-tundra,1200,rogue,subtlety,64,31,33
Byonics,durotan,1199,rogue,subtlety,24,16,8
Sokillu,nemesis,1199,rogue,subtlety,66,28,38
Mozzart,ragnaros,1198,rogue,subtlety,54,26,28
Ohhchetos,nemesis,1198,rogue,subtlety,54,25,29
Elizaya,eredar,1198,rogue,subtlety,54,24,30
Paranoiaqt,outland,1197,rogue,subtlety,33,13,20
Скримшейд,gordunni,1196,rogue,subtlety,48,21,27
Envyss,stormscale,1195,rogue,subtlety,23,13,10
Baldim,silvermoon,1195,rogue,subtlety,31,16,15
Mysies,ysondre,1195,rogue,subtlety,41,19,22
Digmore,drakthul,1192,rogue,subtlety,23,13,10
Lêgòlàs,blackmoore,1192,rogue,subtlety,119,66,53
Nineball,frostmane,1192,rogue,subtlety,29,13,16
Чайрлайн,blackscar,1190,rogue,subtlety,40,17,23
Klynatzz,draenor,1190,rogue,subtlety,54,20,34
Inextricabil,stormscale,1189,rogue,subtlety,48,21,27
Hemorhoid,outland,1188,rogue,subtlety,252,138,114
Kurichu,archimonde,1188,rogue,subtlety,77,34,43
Бигсмурф,gordunni,1187,rogue,subtlety,68,28,40
Rálvius,blackrock,1186,rogue,subtlety,30,19,11
Darkan,kaelthas,1186,rogue,subtlety,102,57,45
Celadríe,argent-dawn,1184,rogue,subtlety,36,24,12
Soulpanic,draenor,1184,rogue,subtlety,76,46,30
Tidløs,dun-morogh,1184,rogue,subtlety,46,18,28
Vathié,twisting-nether,1183,rogue,subtlety,43,18,25
Djinnx,malganis,1181,rogue,subtlety,54,22,32
Louier,outland,1179,rogue,subtlety,29,13,16
Скорпеон,deathguard,1178,rogue,subtlety,78,48,30
Firekry,stormscale,1176,rogue,subtlety,63,26,37
Попочке,soulflayer,1175,rogue,subtlety,36,23,13
Tjockolocø,tarren-mill,1174,rogue,subtlety,18,13,5
Coshmar,tarren-mill,1171,rogue,subtlety,38,19,19
Uùr,burning-legion,1171,rogue,subtlety,29,13,16
Crixor,blackrock,1170,rogue,subtlety,24,13,11
Cesar,blackhand,1170,rogue,subtlety,242,129,113
Zakarïa,draenor,1170,rogue,subtlety,59,30,29
Cantseeme,anachronos,1170,rogue,subtlety,60,23,37
Kuribo,gorgonnash,1169,rogue,subtlety,36,17,19
Biianca,sylvanas,1168,rogue,subtlety,28,13,15
Varne,les-sentinelles,1168,rogue,subtlety,42,16,26
Моямайя,eversong,1166,rogue,subtlety,101,46,55
Linglel,blackhand,1165,rogue,subtlety,42,16,26
Kylìemirogue,blackrock,1164,rogue,subtlety,113,47,66
Spinetapper,ravencrest,1163,rogue,subtlety,36,18,18
Киржик,soulflayer,1163,rogue,subtlety,48,23,25
Blantek,defias-brotherhood,1161,rogue,subtlety,58,33,25
Turrok,ravencrest,1161,rogue,subtlety,42,21,21
Duo,karazhan,1158,rogue,subtlety,234,108,126
Houston,aegwynn,1157,rogue,subtlety,54,26,28
Голдмак,eversong,1156,rogue,subtlety,36,17,19
Пораменяться,gordunni,1156,rogue,subtlety,186,84,102
Bayanista,draenor,1156,rogue,subtlety,30,13,17
Shuffeyrt,frostmane,1154,rogue,subtlety,51,26,25
Flambî,dalaran,1153,rogue,subtlety,82,41,41
Stabymoose,draenor,1153,rogue,subtlety,140,64,76
Knivestikker,twisting-nether,1153,rogue,subtlety,64,29,35
Ilovefanny,archimonde,1152,rogue,subtlety,12,12,0
Dexaqt,ravencrest,1152,rogue,subtlety,18,12,6
Melfîce,blackhand,1152,rogue,subtlety,48,20,28
Озхоггер,gordunni,1151,rogue,subtlety,18,12,6
Чипшотина,azuregos,1151,rogue,subtlety,18,12,6
Гаротка,razuvious,1150,rogue,subtlety,18,12,6
Stepdancer,blackmoore,1150,rogue,subtlety,24,12,12
Hængøvèr,antonidas,1150,rogue,subtlety,30,12,18
Feradelia,thrall,1149,rogue,subtlety,18,12,6
Devourswine,argent-dawn,1149,rogue,subtlety,18,12,6
Daichi,onyxia,1149,rogue,subtlety,32,13,19
Qxes,kazzak,1148,rogue,subtlety,42,15,27
Menajerie,outland,1147,rogue,subtlety,24,12,12
Коффемолка,ashenvale,1147,rogue,subtlety,120,53,67
Lyroth,silvermoon,1147,rogue,subtlety,85,37,48
Schärrehänd,blackrock,1147,rogue,subtlety,53,21,32
Radgaa,draenor,1147,rogue,subtlety,65,22,43
Фистим,gordunni,1146,rogue,subtlety,24,17,7
Mercìles,kazzak,1146,rogue,subtlety,97,57,40
Teralala,kazzak,1146,rogue,subtlety,24,12,12
Wraiith,chogall,1146,rogue,subtlety,24,12,12
Nínjantiz,antonidas,1145,rogue,subtlety,24,12,12
Huro,aggramar,1143,rogue,subtlety,18,12,6
Fodepalmas,sanguino,1141,rogue,subtlety,89,44,45
Omyl,burning-blade,1141,rogue,subtlety,30,12,18
Mitaktika,silvermoon,1140,rogue,subtlety,18,12,6
Lovetospoon,ravencrest,1140,rogue,subtlety,43,22,21
Lånaya,sylvanas,1140,rogue,subtlety,137,65,72
Roguegutten,quelthalas,1140,rogue,subtlety,35,15,20
Читэри,soulflayer,1139,rogue,subtlety,26,13,13
Tíxoz,archimonde,1139,rogue,subtlety,24,12,12
Unbanmepls,ravencrest,1139,rogue,subtlety,30,12,18
Факюселф,gordunni,1138,rogue,subtlety,24,13,11
Shepotunzxc,ravencrest,1138,rogue,subtlety,24,12,12
Whaiipy,ravencrest,1137,rogue,subtlety,191,105,86
Gihan,the-shatar,1135,rogue,subtlety,18,12,6
Sanzoo,blackmoore,1135,rogue,subtlety,30,12,18
Zhopsy,nemesis,1135,rogue,subtlety,48,18,30
Thenotorious,shadowsong,1134,rogue,subtlety,122,52,70
Ithilyien,blackmoore,1134,rogue,subtlety,62,21,41
Yoninja,turalyon,1133,rogue,subtlety,132,61,71
Ðarëk,dun-modr,1133,rogue,subtlety,100,44,56
Shdlens,argent-dawn,1133,rogue,subtlety,95,39,56
Bxtchslayer,blackmoore,1133,rogue,subtlety,36,14,22
Maxtnulaujeu,archimonde,1132,rogue,subtlety,71,33,38
Nirvána,outland,1130,rogue,subtlety,146,74,72
Básmaith,draenor,1130,rogue,subtlety,36,14,22
Sneakachu,thunderhorn,1129,rogue,subtlety,37,16,21
Eightball,frostmane,1128,rogue,subtlety,24,12,12
Nodps,zuljin,1126,rogue,subtlety,18,12,6
Prøven,archimonde,1126,rogue,subtlety,117,55,62
Jomoama,norgannon,1126,rogue,subtlety,60,24,36
Vulneraan,nemesis,1125,rogue,subtlety,42,17,25
Cuckboy,chogall,1124,rogue,subtlety,83,49,34
Anala,stormreaver,1123,rogue,subtlety,24,14,10
Badsap,ravencrest,1123,rogue,subtlety,186,90,96
Copoka,dun-morogh,1122,rogue,subtlety,63,34,29
Faelylanea,argent-dawn,1122,rogue,subtlety,36,16,20
Gradedmg,drakthul,1122,rogue,subtlety,83,36,47
Тайнушка,soulflayer,1121,rogue,subtlety,156,77,79
Berneo,burning-legion,1121,rogue,subtlety,42,13,29
Mïta,blackmoore,1119,rogue,subtlety,54,23,31
Zyklvn,zuljin,1118,rogue,subtlety,30,12,18
Underarmor,kul-tiras,1117,rogue,subtlety,125,56,69
Скэлд,ashenvale,1116,rogue,subtlety,36,14,22
Вайлиция,ashenvale,1115,rogue,subtlety,57,34,23
Hersuub,blackmoore,1115,rogue,subtlety,139,69,70
Закраска,gordunni,1114,rogue,subtlety,54,21,33
Сабанутый,howling-fjord,1112,rogue,subtlety,122,67,55
Coronababy,argent-dawn,1111,rogue,subtlety,24,13,11
Disagre,kazzak,1109,rogue,subtlety,37,12,25
Пузэн,howling-fjord,1108,rogue,subtlety,210,112,98
Kodlak,silvermoon,1108,rogue,subtlety,30,13,17
Niceplan,frostmane,1106,rogue,subtlety,31,16,15
Vaipen,outland,1106,rogue,subtlety,72,33,39
Jiraishin,blackmoore,1105,rogue,subtlety,42,18,24
Murzel,antonidas,1105,rogue,subtlety,36,15,21
Злайа,blackscar,1105,rogue,subtlety,82,32,50
Dmfd,darksorrow,1104,rogue,subtlety,178,94,84
Тоб,soulflayer,1104,rogue,subtlety,23,12,11
Graymyst,outland,1103,rogue,subtlety,30,14,16
Cesârion,antonidas,1102,rogue,subtlety,335,163,172
Lqueespack,kazzak,1101,rogue,subtlety,45,14,31
Понниваиз,gordunni,1100,rogue,subtlety,56,28,28
Mass,chogall,1100,rogue,subtlety,36,13,23
Райан,fordragon,1100,rogue,subtlety,44,13,31
Deceitfull,stormscale,1096,rogue,subtlety,42,20,22
Mantîs,tarren-mill,1095,rogue,subtlety,81,41,40
Knifeex,ravencrest,1094,rogue,subtlety,32,13,19
Watchurstep,stormscale,1094,rogue,subtlety,48,16,32
Jailkaz,thrall,1093,rogue,subtlety,29,13,16
Batsu,alleria,1091,rogue,subtlety,54,28,26
Swiftyfan,silvermoon,1091,rogue,subtlety,29,13,16
Ylidel,silvermoon,1091,rogue,subtlety,36,12,24
Prky,doomhammer,1090,rogue,subtlety,23,12,11
Yamoshí,sanguino,1089,rogue,subtlety,76,38,38
Twinkyzzö,archimonde,1088,rogue,subtlety,81,43,38
Беточка,gordunni,1087,rogue,subtlety,54,31,23
Dallrend,stormscale,1086,rogue,subtlety,108,52,56
Tøxykø,archimonde,1086,rogue,subtlety,46,21,25
Baklava,uldaman,1086,rogue,subtlety,52,18,34
Kraílyx,malorne,1085,rogue,subtlety,236,121,115
Babyrogy,aggra-português,1084,rogue,subtlety,24,12,12
Pummra,kul-tiras,1083,rogue,subtlety,88,44,44
Fumai,blackmoore,1082,rogue,subtlety,30,13,17
Roóty,ravencrest,1080,rogue,subtlety,36,17,19
Messerarbeit,thrall,1079,rogue,subtlety,36,20,16
Streîk,hyjal,1079,rogue,subtlety,179,86,93
Fastspectre,ravencrest,1077,rogue,subtlety,109,57,52
Sênsus,antonidas,1076,rogue,subtlety,156,68,88
Neverdie,tarren-mill,1076,rogue,subtlety,42,17,25
Pepperbox,twisting-nether,1074,rogue,subtlety,30,15,15
Зацеп,gordunni,1073,rogue,subtlety,36,22,14
Löka,amanthul,1071,rogue,subtlety,117,59,58
Псиихооз,eversong,1070,rogue,subtlety,25,13,12
Avøry,antonidas,1068,rogue,subtlety,113,45,68
ßøß,ysondre,1067,rogue,subtlety,116,55,61
Azg,chogall,1067,rogue,subtlety,33,15,18
Stuxothug,silvermoon,1066,rogue,subtlety,91,47,44
Малиноф,borean-tundra,1066,rogue,subtlety,50,17,33
Ithru,twisting-nether,1065,rogue,subtlety,319,160,159
Kucheenstab,blackrock,1065,rogue,subtlety,30,13,17
Mídnight,khaz-modan,1065,rogue,subtlety,45,16,29
Mallaurya,dalaran,1064,rogue,subtlety,30,19,11
Akiy,blackrock,1064,rogue,subtlety,48,16,32
Spnzr,draenor,1063,rogue,subtlety,36,21,15
Kalstab,silvermoon,1062,rogue,subtlety,26,13,13
Йолк,galakrond,1061,rogue,subtlety,36,19,17
Розбэйник,gordunni,1061,rogue,subtlety,90,47,43
Grinfester,stormscale,1061,rogue,subtlety,61,21,40
Bultars,argent-dawn,1058,rogue,subtlety,78,29,49
Ichiegoichie,draenor,1056,rogue,subtlety,12,11,1
Zkittlez,blackhand,1056,rogue,subtlety,18,11,7
Roundrobin,ravencrest,1056,rogue,subtlety,30,11,19
Mollyperph,ravencrest,1055,rogue,subtlety,18,11,7
Like,aegwynn,1055,rogue,subtlety,21,12,9
Aouron,archimonde,1055,rogue,subtlety,25,13,12
Qwqrxyz,ravencrest,1055,rogue,subtlety,24,11,13
Zygzäg,hyjal,1055,rogue,subtlety,24,11,13
Флеймсфорт,gordunni,1055,rogue,subtlety,35,16,19
Gigasoyboy,auchindoun,1054,rogue,subtlety,18,11,7
Oshä,dalaran,1054,rogue,subtlety,30,18,12
Rhotmir,silvermoon,1054,rogue,subtlety,24,11,13
Natillaa,dun-modr,1053,rogue,subtlety,18,11,7
Eloßutcher,outland,1053,rogue,subtlety,18,11,7
Jeepz,blackmoore,1053,rogue,subtlety,24,11,13
Dubfey,silvermoon,1052,rogue,subtlety,24,11,13
Awaaylol,stormscale,1052,rogue,subtlety,24,11,13
Xuìalol,blackmoore,1051,rogue,subtlety,24,11,13
Pinipiniizz,archimonde,1050,rogue,subtlety,12,11,1
Jorppe,kazzak,1050,rogue,subtlety,80,45,35
Eynrus,quelthalas,1050,rogue,subtlety,24,11,13
Shinõbikék,outland,1050,rogue,subtlety,30,11,19
Missàh,archimonde,1049,rogue,subtlety,18,11,7
Shirá,hyjal,1049,rogue,subtlety,18,11,7
Энвитио,gordunni,1048,rogue,subtlety,24,15,9
Йованов,gordunni,1048,rogue,subtlety,18,11,7
Thedarkness,sylvanas,1047,rogue,subtlety,27,15,12
Shëîk,hyjal,1047,rogue,subtlety,49,24,25
Yüm,burning-blade,1047,rogue,subtlety,77,33,44
Johnnyblazex,azjolnerub,1047,rogue,subtlety,30,11,19
Stabs,frostmourne,1046,rogue,subtlety,18,11,7
Cusmos,twisting-nether,1046,rogue,subtlety,42,21,21
Kalona,ravencrest,1046,rogue,subtlety,30,14,16
Zedinger,azjolnerub,1046,rogue,subtlety,25,11,14
Mestepping,draenor,1046,rogue,subtlety,39,16,23
Omêrta,blackmoore,1046,rogue,subtlety,66,24,42
Тоатахо,gordunni,1045,rogue,subtlety,18,11,7
Celendyl,ravencrest,1045,rogue,subtlety,24,13,11
Rezhuloxov,silvermoon,1045,rogue,subtlety,24,11,13
Снэйк,ashenvale,1044,rogue,subtlety,30,11,19
Vampor,sylvanas,1043,rogue,subtlety,175,78,97
Rearmer,burning-legion,1043,rogue,subtlety,30,11,19
Кийян,howling-fjord,1042,rogue,subtlety,23,12,11
Lenwe,blackmoore,1042,rogue,subtlety,35,17,18
Mndx,sylvanas,1042,rogue,subtlety,24,11,13
Sæqq,blackmoore,1042,rogue,subtlety,125,57,68
Sicario,aegwynn,1041,rogue,subtlety,24,11,13
Koteczka,burning-legion,1040,rogue,subtlety,18,11,7
Goldenblitz,blackmoore,1040,rogue,subtlety,42,13,29
Vyllaftw,hyjal,1039,rogue,subtlety,24,11,13
Умбрен,lich-king,1038,rogue,subtlety,54,31,23
Rudyghb,doomhammer,1038,rogue,subtlety,59,31,28
Mishana,thrall,1038,rogue,subtlety,52,27,25
Nanary,blackrock,1037,rogue,subtlety,38,14,24
Kabloingus,tarren-mill,1035,rogue,subtlety,24,11,13
Allurinea,silvermoon,1034,rogue,subtlety,123,67,56
Ccrogue,nemesis,1034,rogue,subtlety,66,34,32
Geroge,sylvanas,1033,rogue,subtlety,33,22,11
Hade,azjolnerub,1033,rogue,subtlety,24,11,13
Drakaess,archimonde,1032,rogue,subtlety,24,11,13
Koutzai,stormscale,1032,rogue,subtlety,94,39,55
Горланг,ashenvale,1031,rogue,subtlety,29,15,14
Sutisong,dun-modr,1031,rogue,subtlety,24,11,13
Acronia,ragnaros,1030,rogue,subtlety,29,11,18
Аутянин,soulflayer,1030,rogue,subtlety,78,24,54
Rêdbello,dun-morogh,1029,rogue,subtlety,102,56,46
Sentaria,argent-dawn,1028,rogue,subtlety,84,46,38
Freddybst,twisting-nether,1028,rogue,subtlety,38,20,18
Lylestra,neptulon,1028,rogue,subtlety,30,11,19
Shanos,ravencrest,1026,rogue,subtlety,24,12,12
Leylaris,argent-dawn,1026,rogue,subtlety,36,16,20
Vanquish,laughing-skull,1025,rogue,subtlety,45,27,18
Эренх,gordunni,1025,rogue,subtlety,215,108,107
Рэйбэк,howling-fjord,1024,rogue,subtlety,30,11,19
Onemine,sanguino,1023,rogue,subtlety,84,46,38
Greshnak,blackhand,1023,rogue,subtlety,56,22,34
Pitmaster,burning-legion,1020,rogue,subtlety,97,48,49
Malfeasance,argent-dawn,1019,rogue,subtlety,24,11,13
Stabwøund,the-maelstrom,1018,rogue,subtlety,18,11,7
Liquidgaba,ravencrest,1018,rogue,subtlety,168,87,81
Iznögød,uldaman,1018,rogue,subtlety,36,11,25
Cramzes,defias-brotherhood,1017,rogue,subtlety,29,12,17
Greendager,cthun,1016,rogue,subtlety,59,18,41
Madnessbg,tarren-mill,1013,rogue,subtlety,50,28,22
Penita,aegwynn,1012,rogue,subtlety,36,17,19
Bset,zuljin,1010,rogue,subtlety,30,13,17
Rookierook,draenor,1008,rogue,subtlety,71,33,38
Sît,twisting-nether,1008,rogue,subtlety,65,25,40
Pis,nagrand,1008,rogue,subtlety,32,12,20
Mordis,outland,1007,rogue,subtlety,23,11,12
Gobygoby,naxxramas,1007,rogue,subtlety,30,14,16
Снарки,booty-bay,1006,rogue,subtlety,118,61,57
Chuppay,kazzak,1006,rogue,subtlety,36,15,21
Ratolí,dun-modr,1005,rogue,subtlety,24,16,8
Idrîl,rashgarroth,1002,rogue,subtlety,113,55,58
Valiéna,dun-morogh,1002,rogue,subtlety,76,27,49
Gravestam,sunstrider,1002,rogue,subtlety,36,11,25
Unpelrogue,blackmoore,1001,rogue,subtlety,39,16,23
Lizwi,ragnaros,1001,rogue,subtlety,69,27,42
Katarïnä,khaz-modan,1000,rogue,subtlety,58,31,27
Axeldarq,draenor,998,rogue,subtlety,39,11,28
Surinamort,voljin,996,rogue,subtlety,114,44,70
Drakhez,sanguino,995,rogue,subtlety,18,12,6
Niinim,draenor,994,rogue,subtlety,360,194,166
Azn,anubarak,993,rogue,subtlety,147,63,84
Nemesiis,blackmoore,993,rogue,subtlety,32,13,19
Clinz,ravencrest,992,rogue,subtlety,32,12,20
Roguevatar,quelthalas,990,rogue,subtlety,66,33,33
Зебол,howling-fjord,990,rogue,subtlety,96,46,50
Outofnowhere,ravencrest,990,rogue,subtlety,23,11,12
Dontlikeme,aegwynn,989,rogue,subtlety,22,11,11
Loax,archimonde,988,rogue,subtlety,35,11,24
Reginlief,argent-dawn,987,rogue,subtlety,119,59,60
Charbiya,silvermoon,986,rogue,subtlety,24,12,12
Незн,howling-fjord,982,rogue,subtlety,93,51,42
Sheyrrà,aegwynn,980,rogue,subtlety,54,18,36
Thicck,twisting-nether,980,rogue,subtlety,48,13,35
Gsi,hyjal,979,rogue,subtlety,101,40,61
Injux,blackmoore,978,rogue,subtlety,25,13,12
Gartham,tarren-mill,977,rogue,subtlety,22,13,9
Raglaron,draenor,977,rogue,subtlety,33,13,20
Sycko,alakir,976,rogue,subtlety,48,28,20
Laxer,burning-legion,976,rogue,subtlety,34,13,21
Dudemar,ravencrest,975,rogue,subtlety,24,11,13
Hyrule,onyxia,973,rogue,subtlety,131,63,68
Shababe,tirion,971,rogue,subtlety,54,28,26
Rifinou,archimonde,970,rogue,subtlety,24,14,10
Dainhek,gilneas,970,rogue,subtlety,91,49,42
Protolink,zuljin,969,rogue,subtlety,82,32,50
Mannheim,kazzak,968,rogue,subtlety,42,23,19
Jacktripper,blackrock,966,rogue,subtlety,72,26,46
Пупичудо,howling-fjord,965,rogue,subtlety,89,28,61
Shíey,antonidas,963,rogue,subtlety,59,21,38
Shibaii,archimonde,961,rogue,subtlety,244,111,133
Hàze,sargeras,960,rogue,subtlety,18,10,8
Proilas,draenor,960,rogue,subtlety,24,10,14
Звиздаттый,blackscar,960,rogue,subtlety,24,10,14
Mestarikélmi,ravencrest,960,rogue,subtlety,27,10,17
Ðazzrog,archimonde,959,rogue,subtlety,12,10,2
Chliapacka,burning-blade,959,rogue,subtlety,18,10,8
Имисида,howling-fjord,959,rogue,subtlety,18,10,8
Noboorstsub,ravencrest,959,rogue,subtlety,18,10,8
Rantie,onyxia,959,rogue,subtlety,24,10,14
Reichy,ravencrest,959,rogue,subtlety,36,10,26
Mamutyo,kazzak,958,rogue,subtlety,12,10,2
Theshining,stormscale,958,rogue,subtlety,42,24,18
Djdillá,kazzak,958,rogue,subtlety,18,10,8
Ynohtna,blackhand,958,rogue,subtlety,18,10,8
Blackrabbít,azshara,958,rogue,subtlety,21,10,11
Shythairogue,area-52,957,rogue,subtlety,18,10,8
Kolto,argent-dawn,957,rogue,subtlety,24,10,14
Ilyrya,azuremyst,955,rogue,subtlety,18,10,8
Øê,ravencrest,955,rogue,subtlety,21,10,11
Psg,argent-dawn,955,rogue,subtlety,25,10,15
Lurked,kazzak,955,rogue,subtlety,36,10,26
Zëkke,sanguino,954,rogue,subtlety,16,11,5
Amhaia,twisting-nether,954,rogue,subtlety,24,10,14
Сбертяночка,gordunni,953,rogue,subtlety,24,10,14
Tyzla,blackrock,953,rogue,subtlety,24,10,14
Breuss,elune,951,rogue,subtlety,18,10,8
Zervi,silvermoon,949,rogue,subtlety,53,24,29
Shagen,archimonde,948,rogue,subtlety,24,10,14
Грема,howling-fjord,948,rogue,subtlety,27,11,16
Calyon,hyjal,947,rogue,subtlety,76,26,50
Lolblizard,gorgonnash,946,rogue,subtlety,27,15,12
Garretygdar,nazjatar,946,rogue,subtlety,96,45,51
Shaadowz,ragnaros,944,rogue,subtlety,77,40,37
Синграйм,soulflayer,942,rogue,subtlety,48,26,22
Thiranor,cthun,940,rogue,subtlety,18,12,6
Bückdichdoch,blackhand,940,rogue,subtlety,30,10,20
Valdemort,uldum,939,rogue,subtlety,24,10,14
Кизо,blackscar,939,rogue,subtlety,48,19,29
Ramone,ravencrest,935,rogue,subtlety,19,11,8
Theroles,ravencrest,934,rogue,subtlety,33,10,23
Puge,norgannon,930,rogue,subtlety,71,22,49
Чекдесаута,gordunni,927,rogue,subtlety,24,10,14
Owoaho,eonar,926,rogue,subtlety,24,14,10
Ридлли,soulflayer,926,rogue,subtlety,22,11,11
Amerzy,ravencrest,926,rogue,subtlety,23,10,13
Nuttcracker,ragnaros,926,rogue,subtlety,72,25,47
Drakusus,azshara,924,rogue,subtlety,37,16,21
Strikes,eredar,923,rogue,subtlety,42,22,20
Zambiealex,doomhammer,920,rogue,subtlety,44,19,25
Sødø,silvermoon,918,rogue,subtlety,111,56,55
Бекро,gordunni,915,rogue,subtlety,24,11,13
Rayven,teldrassil,915,rogue,subtlety,24,11,13
Nurycho,twisting-nether,915,rogue,subtlety,76,32,44
Gegitka,burning-blade,914,rogue,subtlety,18,10,8
Gimliwitdega,doomhammer,914,rogue,subtlety,332,167,165
Iceyspicey,outland,912,rogue,subtlety,42,12,30
Alvoriace,hyjal,911,rogue,subtlety,33,17,16
Sensule,darkspear,908,rogue,subtlety,23,10,13
Silence,burning-blade,906,rogue,subtlety,105,42,63
Skankky,ragnaros,904,rogue,subtlety,39,19,20
Fizgaroth,argent-dawn,902,rogue,subtlety,115,58,57
Shurkan,antonidas,902,rogue,subtlety,48,22,26
Теньвора,howling-fjord,902,rogue,subtlety,47,20,27
Whitestabber,thunderhorn,900,rogue,subtlety,35,10,25
Trinchö,sanguino,898,rogue,subtlety,105,50,55
Marwyn,laughing-skull,894,rogue,subtlety,20,10,10
Haregan,gorgonnash,891,rogue,subtlety,18,10,8
Saroumani,eitrigg,891,rogue,subtlety,30,16,14
Øks,culte-de-la-rive-noire,891,rogue,subtlety,22,10,12
Скрытнаярога,ashenvale,886,rogue,subtlety,80,23,57
Wedgyrog,stormscale,885,rogue,subtlety,31,13,18
Davshadows,magtheridon,879,rogue,subtlety,64,30,34
Ракельяр,blackscar,875,rogue,subtlety,15,11,4
Rizzardx,ravencrest,875,rogue,subtlety,18,10,8
Kikkshifter,zuluhed,874,rogue,subtlety,36,17,19
Sephika,chants-éternels,871,rogue,subtlety,55,13,42
Zarlen,argent-dawn,870,rogue,subtlety,108,41,67
Oazo,ysondre,869,rogue,subtlety,156,72,84
Mortdorei,argent-dawn,866,rogue,subtlety,97,47,50
Rafax,cthun,865,rogue,subtlety,78,34,44
Liirja,twisting-nether,865,rogue,subtlety,54,10,44
Kostik,ravencrest,864,rogue,subtlety,12,9,3
Youcrymydear,outland,864,rogue,subtlety,12,9,3
Hængøver,antonidas,864,rogue,subtlety,12,9,3
Penetrantos,eredar,864,rogue,subtlety,12,9,3
Фрозенденс,gordunni,864,rogue,subtlety,12,9,3
Фейкрогуех,soulflayer,864,rogue,subtlety,12,9,3
Spåcejåmz,archimonde,864,rogue,subtlety,12,9,3
Groobii,area-52,864,rogue,subtlety,18,9,9
Rsksrb,tarren-mill,864,rogue,subtlety,18,9,9
Irugä,dun-modr,864,rogue,subtlety,18,9,9
Draytonlove,nemesis,864,rogue,subtlety,18,9,9
Cortyup,ravencrest,864,rogue,subtlety,18,9,9
Geá,ravencrest,864,rogue,subtlety,18,9,9
Хищницагодх,gordunni,864,rogue,subtlety,18,9,9
Ðéstr,ravencrest,864,rogue,subtlety,18,9,9
Revanious,kazzak,864,rogue,subtlety,25,11,14
Ambulances,kazzak,863,rogue,subtlety,12,9,3
Vganzyborg,ravencrest,863,rogue,subtlety,12,9,3
Gserog,chamber-of-aspects,863,rogue,subtlety,12,9,3
Parze,tarren-mill,863,rogue,subtlety,12,9,3
Wâter,silvermoon,863,rogue,subtlety,12,9,3
Visegrád,aggra-português,863,rogue,subtlety,12,9,3
Stepsan,tarren-mill,863,rogue,subtlety,18,9,9
Alleyezonme,stormscale,863,rogue,subtlety,18,9,9
Herétìc,silvermoon,863,rogue,subtlety,18,9,9
Сэвенлайф,soulflayer,863,rogue,subtlety,18,9,9
Рэкрейвон,gordunni,863,rogue,subtlety,18,9,9
Taistelu,outland,863,rogue,subtlety,18,9,9
Destroguex,blackmoore,863,rogue,subtlety,18,9,9
Síns,runetotem,863,rogue,subtlety,18,9,9
Charanka,sanguino,863,rogue,subtlety,18,9,9
Sølølvlîng,dun-modr,863,rogue,subtlety,30,9,21
Въеном,gordunni,862,rogue,subtlety,12,9,3
Rikistab,tarren-mill,862,rogue,subtlety,12,9,3
Бонястелс,gordunni,862,rogue,subtlety,12,9,3
Leanderrisin,ragnaros,862,rogue,subtlety,18,9,9
Nícks,tarren-mill,862,rogue,subtlety,18,9,9
Imrat,stormscale,862,rogue,subtlety,18,9,9
Zkn,archimonde,862,rogue,subtlety,18,9,9
Stun,festung-der-stürme,862,rogue,subtlety,18,9,9
Oldschool,sanguino,862,rogue,subtlety,18,9,9
Isodad,kazzak,861,rogue,subtlety,18,9,9
Lêvi,outland,861,rogue,subtlety,18,9,9
Fwizk,twisting-nether,861,rogue,subtlety,18,9,9
Duffbeer,silvermoon,861,rogue,subtlety,18,9,9
Хоткиннс,soulflayer,861,rogue,subtlety,24,9,15
Shinkillua,archimonde,860,rogue,subtlety,18,9,9
Kaizero,tarren-mill,860,rogue,subtlety,18,9,9
Stepbrogue,tarren-mill,860,rogue,subtlety,18,9,9
Kødäy,hyjal,860,rogue,subtlety,24,9,15
Nighteshift,silvermoon,860,rogue,subtlety,32,10,22
Bagirä,sylvanas,859,rogue,subtlety,21,9,12
Красаа,soulflayer,859,rogue,subtlety,24,9,15
Invisage,grim-batol,859,rogue,subtlety,24,9,15
Куцитар,gordunni,858,rogue,subtlety,18,9,9
Emìlia,tarren-mill,858,rogue,subtlety,18,9,9
Sequoja,blackrock,858,rogue,subtlety,24,9,15
Asmodal,die-nachtwache,858,rogue,subtlety,24,9,15
Aluneran,silvermoon,857,rogue,subtlety,24,9,15
Rogftw,blackmoore,857,rogue,subtlety,36,9,27
Эльфайнити,gordunni,856,rogue,subtlety,24,9,15
Burdel,nemesis,856,rogue,subtlety,36,9,27
Eagleyetr,karazhan,855,rogue,subtlety,36,15,21
Антиппод,razuvious,854,rogue,subtlety,15,10,5
Hellboo,uldaman,853,rogue,subtlety,18,9,9
Тучс,gordunni,853,rogue,subtlety,19,9,10
Wìzléy,ravencrest,852,rogue,subtlety,81,39,42
Angelbeats,outland,852,rogue,subtlety,53,17,36
Doga,ravencrest,851,rogue,subtlety,24,9,15
Ungcharmør,ravencrest,850,rogue,subtlety,18,9,9
Rouge,der-rat-von-dalaran,849,rogue,subtlety,18,9,9
Sassasine,amanthul,849,rogue,subtlety,136,62,74
Брюкивруки,gordunni,847,rogue,subtlety,24,9,15
Genesiz,sylvanas,847,rogue,subtlety,30,9,21
Røcket,festung-der-stürme,846,rogue,subtlety,28,10,18
Câ,outland,845,rogue,subtlety,22,10,12
Snogri,burning-legion,845,rogue,subtlety,54,20,34
Jabbo,silvermoon,845,rogue,subtlety,36,11,25
Badfjodr,argent-dawn,844,rogue,subtlety,23,9,14
Prda,aegwynn,842,rogue,subtlety,102,45,57
Sanykrugo,ragnaros,842,rogue,subtlety,24,9,15
Фогус,greymane,841,rogue,subtlety,38,17,21
Kindwurm,blackmoore,831,rogue,subtlety,22,9,13
Пандафей,deathweaver,831,rogue,subtlety,24,9,15
Aeønaxx,hyjal,827,rogue,subtlety,76,32,44
Snake,nethersturm,827,rogue,subtlety,89,30,59
Dezirae,silvermoon,826,rogue,subtlety,22,9,13
Боузи,howling-fjord,825,rogue,subtlety,24,9,15
Haelkil,kazzak,824,rogue,subtlety,16,9,7
Yenzie,dragonblight,824,rogue,subtlety,69,30,39
Sanarah,marécage-de-zangar,824,rogue,subtlety,53,18,35
Ecray,burning-legion,821,rogue,subtlety,104,50,54
Tnk,twisting-nether,817,rogue,subtlety,18,10,8
Røxxilly,blackmoore,817,rogue,subtlety,22,10,12
Raulo,tarren-mill,811,rogue,subtlety,27,9,18
Wurzelzepp,blackrock,810,rogue,subtlety,23,9,14
Sikhxd,twisting-nether,809,rogue,subtlety,22,11,11
Roxley,der-mithrilorden,809,rogue,subtlety,52,21,31
Dellya,twisting-nether,806,rogue,subtlety,24,9,15
Cabalion,draenor,800,rogue,subtlety,54,24,30
Ashâa,hyjal,799,rogue,subtlety,18,9,9
Stabither,twisting-nether,798,rogue,subtlety,18,9,9
Auarg,argent-dawn,797,rogue,subtlety,18,9,9
Schadostep,archimonde,797,rogue,subtlety,33,10,23
Grikra,argent-dawn,792,rogue,subtlety,74,34,40
Gizr,haomarush,791,rogue,subtlety,108,47,61
Zlash,doomhammer,788,rogue,subtlety,42,9,33
Imnotnice,terenas,783,rogue,subtlety,22,10,12
Cozu,stormrage,781,rogue,subtlety,145,70,75
Singularität,silvermoon,774,rogue,subtlety,163,80,83
Tukie,blackhand,774,rogue,subtlety,66,19,47
Idcwhatusay,drakthul,768,rogue,subtlety,12,8,4
Dêlaral,zirkel-des-cenarius,768,rogue,subtlety,12,8,4
Lastsight,burning-legion,768,rogue,subtlety,12,8,4
Kelzàn,ysondre,768,rogue,subtlety,12,8,4
Robtherobber,kazzak,768,rogue,subtlety,12,8,4
Фрозенблейдс,gordunni,768,rogue,subtlety,12,8,4
Sheepmycheap,draenor,768,rogue,subtlety,12,8,4
Майндтрикс,blackscar,768,rogue,subtlety,12,8,4
Tilikum,pozzo-delleternità,768,rogue,subtlety,12,8,4
Джеанит,gordunni,768,rogue,subtlety,12,8,4
Skaterboy,stormscale,768,rogue,subtlety,18,8,10
Àlleyezonme,ravencrest,768,rogue,subtlety,18,8,10
Disembowel,ravencrest,768,rogue,subtlety,18,8,10
Ferrãof,aggra-português,767,rogue,subtlety,12,8,4
Chavidancerr,twisting-nether,767,rogue,subtlety,12,8,4
Zenone,marécage-de-zangar,767,rogue,subtlety,16,9,7
Notsuitable,blackhand,767,rogue,subtlety,18,8,10
Cirell,tarren-mill,767,rogue,subtlety,18,8,10
Mdadx,stormreaver,767,rogue,subtlety,18,8,10
Shinti,eredar,767,rogue,subtlety,18,8,10
Vixene,burning-legion,767,rogue,subtlety,18,8,10
Hantaran,anachronos,767,rogue,subtlety,18,8,10
Jayrog,ysondre,767,rogue,subtlety,18,8,10
Ðrxy,outland,767,rogue,subtlety,18,8,10
Kleptomaniac,aggra-português,767,rogue,subtlety,24,8,16
Whîspêr,ravencrest,767,rogue,subtlety,24,8,16
Batskcab,blackmoore,767,rogue,subtlety,30,8,22
Backstabjr,blackmoore,767,rogue,subtlety,30,8,22
Хаймох,gordunni,767,rogue,subtlety,30,8,22
Falciparum,bladefist,766,rogue,subtlety,12,8,4
Jixi,wildhammer,766,rogue,subtlety,12,8,4
Baradiir,defias-brotherhood,766,rogue,subtlety,12,8,4
Ytaku,stormscale,766,rogue,subtlety,13,8,5
Liix,ravencrest,766,rogue,subtlety,18,8,10
Néithyl,the-maelstrom,766,rogue,subtlety,18,8,10
Lurk,saurfang,766,rogue,subtlety,18,8,10
Tênsion,silvermoon,765,rogue,subtlety,12,8,4
Kppz,burning-legion,765,rogue,subtlety,18,8,10
Люняшка,booty-bay,765,rogue,subtlety,18,8,10
Лоулайф,soulflayer,765,rogue,subtlety,18,8,10
Ytz,hyjal,765,rogue,subtlety,18,8,10
Neero,outland,765,rogue,subtlety,28,10,18
Pirry,sanguino,764,rogue,subtlety,12,8,4
Trenbeast,tarren-mill,764,rogue,subtlety,19,10,9
Wingobear,ysondre,764,rogue,subtlety,18,8,10
Chuckloriss,garona,764,rogue,subtlety,18,8,10
Censørd,steamwheedle-cartel,764,rogue,subtlety,18,8,10
Ojisanx,outland,764,rogue,subtlety,24,8,16
Jpi,ragnaros,764,rogue,subtlety,24,8,16
Zaliria,sanguino,763,rogue,subtlety,24,8,16
Akcell,silvermoon,762,rogue,subtlety,12,8,4
Fanatikq,antonidas,762,rogue,subtlety,18,8,10
Hellhydra,draenor,761,rogue,subtlety,27,9,18
Sayy,nemesis,759,rogue,subtlety,24,8,16
Shadowstern,daggerspine,758,rogue,subtlety,18,8,10
Cebis,ragnaros,756,rogue,subtlety,18,8,10
Ipshero,ragnaros,751,rogue,subtlety,17,9,8
Jénny,sylvanas,751,rogue,subtlety,222,102,120
Всечтобыло,howling-fjord,748,rogue,subtlety,12,8,4
Ghostrogue,garona,748,rogue,subtlety,29,8,21
Berruskaa,drakthul,745,rogue,subtlety,18,8,10
Rushhd,exodar,745,rogue,subtlety,81,21,60
Faded,terokkar,744,rogue,subtlety,30,8,22
Scorpina,tarren-mill,742,rogue,subtlety,25,9,16
Vëo,grim-batol,738,rogue,subtlety,18,8,10
Nyreslag,stormreaver,734,rogue,subtlety,14,9,5
Ergaviota,colinas-pardas,734,rogue,subtlety,118,41,77
Skene,sanguino,719,rogue,subtlety,85,29,56
Raveshaw,argent-dawn,717,rogue,subtlety,23,8,15
Nesä,hyjal,716,rogue,subtlety,21,8,13
Briggo,silvermoon,714,rogue,subtlety,23,9,14
Natekoti,kazzak,714,rogue,subtlety,42,10,32
Nakli,antonidas,713,rogue,subtlety,21,9,12
Leÿji,archimonde,713,rogue,subtlety,23,9,14
Akamee,temple-noir,713,rogue,subtlety,27,10,17
Faable,silvermoon,709,rogue,subtlety,59,19,40
Alovina,stormscale,705,rogue,subtlety,12,9,3
Abomïñatïøñ,ravencrest,704,rogue,subtlety,108,39,69
Raneya,antonidas,704,rogue,subtlety,41,9,32
Ronyarattig,tarren-mill,703,rogue,subtlety,14,8,6
Khorvus,ragnaros,702,rogue,subtlety,20,8,12
Venomate,draenor,702,rogue,subtlety,22,8,14
Deave,kazzak,702,rogue,subtlety,22,8,14
Yakku,drakthul,701,rogue,subtlety,26,8,18
Strânge,tarren-mill,689,rogue,subtlety,19,9,10
Naiikaii,aegwynn,688,rogue,subtlety,14,8,6
Olivares,ravencrest,686,rogue,subtlety,19,8,11
Erepthor,the-maelstrom,686,rogue,subtlety,25,8,17
Owlcat,argent-dawn,681,rogue,subtlety,24,8,16
Tagaichi,silvermoon,672,rogue,subtlety,12,7,5
Bläcklotus,sanguino,672,rogue,subtlety,12,7,5
Lovethighs,argent-dawn,672,rogue,subtlety,12,7,5
Corpsbeau,ysondre,672,rogue,subtlety,12,7,5
Qira,burning-blade,672,rogue,subtlety,12,7,5
Steal,nemesis,672,rogue,subtlety,12,7,5
Izisra,draenor,672,rogue,subtlety,12,7,5
Jincksrogue,argent-dawn,672,rogue,subtlety,12,7,5
Menos,draenor,672,rogue,subtlety,12,7,5
Lorinthel,argent-dawn,672,rogue,subtlety,12,7,5
Троджегард,gordunni,672,rogue,subtlety,12,7,5
Bladeage,nazjatar,672,rogue,subtlety,12,7,5
Benh,ysondre,672,rogue,subtlety,12,7,5
Camora,aegwynn,672,rogue,subtlety,12,7,5
Zygzaag,hyjal,672,rogue,subtlety,12,7,5
Skipperr,blackmoore,672,rogue,subtlety,12,7,5
Szeneca,sylvanas,672,rogue,subtlety,12,7,5
Zyx,ravencrest,672,rogue,subtlety,12,7,5
Shreya,blackrock,672,rogue,subtlety,12,7,5
Rmprockstar,blackrock,672,rogue,subtlety,12,7,5
Zappdaddy,frostwolf,672,rogue,subtlety,18,7,11
Caípi,frostwolf,672,rogue,subtlety,18,7,11
Darkesthonor,silvermoon,672,rogue,subtlety,18,7,11
Inviseriu,nordrassil,672,rogue,subtlety,18,7,11
Backpaddlerx,malygos,672,rogue,subtlety,18,7,11
Селемена,gordunni,672,rogue,subtlety,18,7,11
Lôre,blackrock,672,rogue,subtlety,18,7,11
Nirùút,blackrock,672,rogue,subtlety,27,8,19
Ic,frostmane,672,rogue,subtlety,24,7,17
Heartripper,ravencrest,671,rogue,subtlety,12,7,5
Soulshank,ragnaros,671,rogue,subtlety,12,7,5
Hyake,zuljin,671,rogue,subtlety,12,7,5
Cøntfarmer,stormscale,671,rogue,subtlety,12,7,5
Codens,kazzak,671,rogue,subtlety,12,7,5
Epi,stormrage,671,rogue,subtlety,12,7,5
Казутора,lich-king,671,rogue,subtlety,12,7,5
Zyhmø,archimonde,671,rogue,subtlety,12,7,5
Wtbmeld,tarren-mill,671,rogue,subtlety,15,8,7
Karomox,blackmoore,671,rogue,subtlety,18,7,11
Katara,antonidas,671,rogue,subtlety,18,7,11
Ellira,stormscale,671,rogue,subtlety,18,7,11
Elysm,stormscale,671,rogue,subtlety,18,7,11
Gakha,draenor,671,rogue,subtlety,18,7,11
Anglåchel,sanguino,671,rogue,subtlety,18,7,11
Nargun,archimonde,671,rogue,subtlety,18,7,11
Backstabbín,kazzak,671,rogue,subtlety,18,7,11
Sapthat,kazzak,671,rogue,subtlety,18,7,11
Lanewuquvi,alonsus,671,rogue,subtlety,18,7,11
Khazren,ravencrest,671,rogue,subtlety,18,7,11
Róquet,eredar,671,rogue,subtlety,18,7,11
Achterom,outland,671,rogue,subtlety,18,7,11
Roronao,sanguino,671,rogue,subtlety,18,7,11
Bibiavie,hyjal,671,rogue,subtlety,18,7,11
Сабстил,soulflayer,671,rogue,subtlety,18,7,11
Macmurloc,hyjal,671,rogue,subtlety,18,7,11
Totentánz,silvermoon,671,rogue,subtlety,18,7,11
Атредис,howling-fjord,671,rogue,subtlety,18,7,11
Grvvxyvrd,sanguino,671,rogue,subtlety,18,7,11
Shènz,ysondre,671,rogue,subtlety,18,7,11
Smörkniven,argent-dawn,671,rogue,subtlety,18,7,11
Адхщба,gordunni,671,rogue,subtlety,21,8,13
Tybiereus,argent-dawn,671,rogue,subtlety,22,7,15
Princip,drakthul,671,rogue,subtlety,24,7,17
Toketje,sylvanas,671,rogue,subtlety,24,7,17
Daggoth,kiljaeden,671,rogue,subtlety,24,7,17
Nøtiçe,kazzak,671,rogue,subtlety,24,7,17
Sneakypeakii,ravencrest,671,rogue,subtlety,24,7,17
Bluto,stormscale,671,rogue,subtlety,30,7,23
Кайфутдин,soulflayer,670,rogue,subtlety,12,7,5
Pièro,burning-legion,670,rogue,subtlety,12,7,5
Barneý,tarren-mill,670,rogue,subtlety,12,7,5
Kylíemirogue,blackrock,670,rogue,subtlety,12,7,5
Xenakeuh,kazzak,670,rogue,subtlety,12,7,5
Rekaens,sylvanas,670,rogue,subtlety,18,7,11
Yämura,sanguino,670,rogue,subtlety,18,7,11
Cigarette,emeriss,670,rogue,subtlety,18,7,11
Shâdow,ravenholdt,670,rogue,subtlety,24,7,17
Sharlay,drakthul,670,rogue,subtlety,30,7,23
Пникекс,soulflayer,669,rogue,subtlety,12,7,5
Lepreuchan,archimonde,669,rogue,subtlety,12,7,5
Unkempt,argent-dawn,669,rogue,subtlety,12,7,5
Drbackstab,hellfire,669,rogue,subtlety,18,7,11
Аникет,howling-fjord,669,rogue,subtlety,18,7,11
Dabo,archimonde,669,rogue,subtlety,24,7,17
Plot,zenedar,669,rogue,subtlety,24,7,17
Nullname,ragnaros,669,rogue,subtlety,24,7,17
Elnos,conseil-des-ombres,668,rogue,subtlety,12,7,5
Tiemyrópe,outland,668,rogue,subtlety,12,7,5
Bambuso,ravencrest,668,rogue,subtlety,24,7,17
Путаюсь,gordunni,667,rogue,subtlety,12,7,5
Fintex,ravencrest,667,rogue,subtlety,18,7,11
Kunigunde,shattered-hand,667,rogue,subtlety,18,7,11
Cimitir,kazzak,667,rogue,subtlety,18,7,11
Jackcoupeber,dalaran,667,rogue,subtlety,24,7,17
Kamagrajelly,blackrock,667,rogue,subtlety,24,7,17
Cacucoxpahu,kazzak,666,rogue,subtlety,12,7,5
Pantagat,silvermoon,666,rogue,subtlety,24,7,17
Vicenzo,archimonde,665,rogue,subtlety,18,7,11
Posaydon,malorne,664,rogue,subtlety,18,7,11
Misscash,ragnaros,661,rogue,subtlety,12,7,5
Drspectres,tarren-mill,650,rogue,subtlety,84,22,62
Boxxo,dun-modr,644,rogue,subtlety,38,8,30
Apsalar,thrall,638,rogue,subtlety,17,7,10
Brancovich,magtheridon,638,rogue,subtlety,17,7,10
Ladona,kazzak,632,rogue,subtlety,40,7,33
Vound,tarren-mill,621,rogue,subtlety,30,8,22
Найсгодх,gordunni,618,rogue,subtlety,17,7,10
Ripye,shattered-hand,617,rogue,subtlety,11,7,4
Alyannå,culte-de-la-rive-noire,607,rogue,subtlety,11,7,4
Bashag,blackmoore,607,rogue,subtlety,14,7,7
Stekfläsk,argent-dawn,607,rogue,subtlety,14,7,7
Aprroo,ragnaros,607,rogue,subtlety,20,7,13
Szmergla,burning-legion,606,rogue,subtlety,20,7,13
Pistolpete,grim-batol,576,rogue,subtlety,6,6,0
Dixylebanit,outland,576,rogue,subtlety,6,6,0
Logicalxy,ravencrest,576,rogue,subtlety,6,6,0
Flexibedo,archimonde,576,rogue,subtlety,10,7,3
Jabbz,blackhand,576,rogue,subtlety,12,6,6
Миикз,gordunni,576,rogue,subtlety,12,6,6
Seeralex,anetheron,576,rogue,subtlety,12,6,6
Ciosy,blackrock,576,rogue,subtlety,12,6,6
Элайджигроу,howling-fjord,576,rogue,subtlety,12,6,6
Tebzr,ravencrest,576,rogue,subtlety,12,6,6
Гуцул,howling-fjord,576,rogue,subtlety,12,6,6
Rogerg,dun-morogh,576,rogue,subtlety,12,6,6
Msrogue,eredar,576,rogue,subtlety,12,6,6
Killmani,ravencrest,576,rogue,subtlety,12,6,6
Albane,moonglade,576,rogue,subtlety,12,6,6
Truesilver,deathwing,576,rogue,subtlety,12,6,6
Shinjia,nemesis,576,rogue,subtlety,12,6,6
Ewlynaisbad,ragnaros,576,rogue,subtlety,12,6,6
Vorne,grim-batol,576,rogue,subtlety,12,6,6
Ghøßt,outland,576,rogue,subtlety,12,6,6
Рогадачери,gordunni,576,rogue,subtlety,12,6,6
Nightboyz,kazzak,576,rogue,subtlety,12,6,6
Mokmok,frostwolf,576,rogue,subtlety,12,6,6
Maybejaydeen,ravencrest,576,rogue,subtlety,12,6,6
Unluckythen,ravencrest,576,rogue,subtlety,12,6,6
Harinef,silvermoon,576,rogue,subtlety,12,6,6
Triggersap,blackmoore,576,rogue,subtlety,12,6,6
Morphicsxd,silvermoon,576,rogue,subtlety,12,6,6
Lynczi,stormscale,576,rogue,subtlety,12,6,6
Laserschwert,frostwolf,576,rogue,subtlety,12,6,6
Уммиикк,goldrinn,576,rogue,subtlety,12,6,6
Røguøross,archimonde,576,rogue,subtlety,12,6,6
Deceptionz,ravencrest,576,rogue,subtlety,12,6,6
Elyndri,archimonde,576,rogue,subtlety,12,6,6
Soulriver,kelthuzad,576,rogue,subtlety,15,7,8
Donowan,stormscale,576,rogue,subtlety,18,6,12
Dîspatchx,defias-brotherhood,576,rogue,subtlety,18,6,12
Celadrie,kazzak,576,rogue,subtlety,18,6,12
Corufaire,senjin,576,rogue,subtlety,18,6,12
Cobrâk,archimonde,576,rogue,subtlety,18,6,12
Kerìon,nemesis,576,rogue,subtlety,18,6,12
Tashunkosapa,xavius,576,rogue,subtlety,18,6,12
Haigø,archimonde,576,rogue,subtlety,18,6,12
Isteria,sylvanas,576,rogue,subtlety,18,6,12
Грустныйрог,gordunni,576,rogue,subtlety,18,6,12
Shînka,tyrande,576,rogue,subtlety,24,6,18
Ðarkbleeds,ravencrest,576,rogue,subtlety,24,6,18
Blihhubba,silvermoon,576,rogue,subtlety,24,6,18
Åvírøñgðd,ravencrest,576,rogue,subtlety,24,6,18
Lambine,mannoroth,576,rogue,subtlety,24,6,18
Øzs,argent-dawn,576,rogue,subtlety,24,6,18
Cêline,silvermoon,576,rogue,subtlety,30,6,24
Eup,outland,575,rogue,subtlety,12,6,6
Føxyy,blackrock,575,rogue,subtlety,12,6,6
Stonecold,twilights-hammer,575,rogue,subtlety,12,6,6
Pxsquals,kazzak,575,rogue,subtlety,12,6,6
Botnet,blackmoore,575,rogue,subtlety,12,6,6
Candyshot,thrall,575,rogue,subtlety,12,6,6
Kalix,agamaggan,575,rogue,subtlety,12,6,6
Navysëäls,dun-modr,575,rogue,subtlety,12,6,6
Igel,antonidas,575,rogue,subtlety,12,6,6
Arydir,quelthalas,575,rogue,subtlety,12,6,6
Kheledon,frostwolf,575,rogue,subtlety,12,6,6
Throatslash,twisting-nether,575,rogue,subtlety,12,6,6
Bananashow,aegwynn,575,rogue,subtlety,12,6,6
Nóre,kazzak,575,rogue,subtlety,12,6,6
Thatsdmg,blackmoore,575,rogue,subtlety,12,6,6
Crispflake,frostwolf,575,rogue,subtlety,12,6,6
Messene,hellscream,575,rogue,subtlety,18,6,12
Aviarumata,draenor,575,rogue,subtlety,18,6,12
Girlname,the-maelstrom,575,rogue,subtlety,18,6,12
Coolspot,archimonde,575,rogue,subtlety,18,6,12
Шторкаа,gordunni,575,rogue,subtlety,18,6,12
Corpzy,ragnaros,575,rogue,subtlety,18,6,12
Zeratul,die-ewige-wacht,574,rogue,subtlety,12,6,6
Soshady,spinebreaker,574,rogue,subtlety,12,6,6
Deathfather,kazzak,574,rogue,subtlety,12,6,6
Zëd,draenor,574,rogue,subtlety,12,6,6
Raiyqyu,archimonde,574,rogue,subtlety,16,7,9
Zerbanger,dun-morogh,574,rogue,subtlety,18,6,12
Rojiel,die-todeskrallen,574,rogue,subtlety,24,6,18
Eviroz,culte-de-la-rive-noire,573,rogue,subtlety,12,6,6
Töbïï,sylvanas,573,rogue,subtlety,12,6,6
Sylvielle,azshara,573,rogue,subtlety,12,6,6
Clownshow,eredar,573,rogue,subtlety,18,6,12
Misamia,nemesis,573,rogue,subtlety,24,6,18
Shïbarï,ysondre,572,rogue,subtlety,12,6,6
Sundae,arthas,572,rogue,subtlety,24,6,18
Kaynasi,hyjal,572,rogue,subtlety,104,23,81
Öz,sylvanas,571,rogue,subtlety,12,6,6
Wolffgang,dalaran,571,rogue,subtlety,12,6,6
Xargonis,blackrock,571,rogue,subtlety,18,6,12
Slicendicex,turalyon,571,rogue,subtlety,18,6,12
Darkolive,defias-brotherhood,571,rogue,subtlety,19,6,13
Leukhra,dun-modr,570,rogue,subtlety,12,6,6
Demonrok,stormscale,569,rogue,subtlety,12,6,6
Lêvî,sanguino,569,rogue,subtlety,12,6,6
Frézzer,tirion,566,rogue,subtlety,12,6,6
Rhaacvar,magtheridon,566,rogue,subtlety,12,6,6
Grenouillard,chogall,566,rogue,subtlety,30,6,24
Шибеник,eversong,565,rogue,subtlety,12,6,6
Cinimimi,magtheridon,560,rogue,subtlety,18,6,12
Grekén,bronze-dragonflight,558,rogue,subtlety,17,6,11
Sizzurp,kargath,555,rogue,subtlety,36,6,30
Lolstarrogue,ambossar,544,rogue,subtlety,10,6,4
Roguy,wildhammer,543,rogue,subtlety,17,6,11
Ежикх,soulflayer,543,rogue,subtlety,17,6,11
Kathagô,antonidas,543,rogue,subtlety,17,6,11
Marryhim,blackhand,543,rogue,subtlety,17,6,11
Килларан,howling-fjord,539,rogue,subtlety,8,7,1
Notwhaazz,ravencrest,528,rogue,subtlety,9,7,2
Tøsén,outland,528,rogue,subtlety,15,6,9
Hellborne,alakir,527,rogue,subtlety,15,6,9
Shlaifa,ragnaros,527,rogue,subtlety,21,6,15
Vii,defias-brotherhood,521,rogue,subtlety,19,8,11
Jaramshaela,cthun,521,rogue,subtlety,28,7,21
Mamus,tarren-mill,517,rogue,subtlety,30,6,24
Azkiel,archimonde,513,rogue,subtlety,23,7,16
Forgettme,kazzak,511,rogue,subtlety,11,6,5
Malignance,drakthul,511,rogue,subtlety,14,7,7
Marcnk,stormscale,511,rogue,subtlety,16,6,10
Viiltäjäjack,stormscale,510,rogue,subtlety,14,6,8
Vanthir,drakthul,510,rogue,subtlety,31,7,24
Stepbaack,silvermoon,504,rogue,subtlety,18,6,12
Stealthr,silvermoon,495,rogue,subtlety,11,6,5
Ripinpiece,outland,494,rogue,subtlety,19,6,13
Rnkx,dun-modr,480,rogue,subtlety,6,5,1
Deinorsin,outland,480,rogue,subtlety,6,5,1
Tinwee,ravencrest,480,rogue,subtlety,6,5,1
Rightplay,outland,480,rogue,subtlety,6,5,1
Вейкингдрим,gordunni,480,rogue,subtlety,6,5,1
Фэйкуои,gordunni,480,rogue,subtlety,6,5,1
Аренатрюки,soulflayer,480,rogue,subtlety,6,5,1
Kongjemen,quelthalas,480,rogue,subtlety,6,5,1
Mastrmind,twisting-nether,480,rogue,subtlety,6,5,1
Deadrâw,aegwynn,480,rogue,subtlety,6,5,1
Araniana,kazzak,480,rogue,subtlety,6,5,1
Equiper,silvermoon,480,rogue,subtlety,6,5,1
Dreltharius,burning-blade,480,rogue,subtlety,6,5,1
Storsnasen,frostmane,480,rogue,subtlety,6,5,1
Blinderno,twisting-nether,480,rogue,subtlety,6,5,1
Ticklzepickl,silvermoon,480,rogue,subtlety,12,5,7
Rakuwata,the-maelstrom,480,rogue,subtlety,12,5,7
Khepaso,sanguino,480,rogue,subtlety,12,5,7
Madboo,kazzak,480,rogue,subtlety,12,5,7
Beyzqt,antonidas,480,rogue,subtlety,12,5,7
Madivy,ragnaros,480,rogue,subtlety,12,5,7
Iöny,silvermoon,480,rogue,subtlety,12,5,7
Okiboo,silvermoon,480,rogue,subtlety,12,5,7
ßuha,stormscale,480,rogue,subtlety,12,5,7
Zuckmicekoc,ravencrest,480,rogue,subtlety,12,5,7
Киднитучер,fordragon,480,rogue,subtlety,12,5,7
Silverrosee,burning-legion,480,rogue,subtlety,12,5,7
Raevslikker,outland,480,rogue,subtlety,12,5,7
Орижигало,borean-tundra,480,rogue,subtlety,12,5,7
Obstechhawi,argent-dawn,480,rogue,subtlety,12,5,7
Killcraft,anachronos,480,rogue,subtlety,12,5,7
Xahl,ysondre,480,rogue,subtlety,12,5,7
Darkmageuil,kazzak,480,rogue,subtlety,12,5,7
Альтушкаа,gordunni,480,rogue,subtlety,12,5,7
Roguefarm,hyjal,480,rogue,subtlety,12,5,7
Mesyo,blackhand,480,rogue,subtlety,12,5,7
Травметх,deathguard,480,rogue,subtlety,12,5,7
Кашеварить,gordunni,480,rogue,subtlety,12,5,7
Ра,gordunni,480,rogue,subtlety,12,5,7
Blazestórm,stormscale,480,rogue,subtlety,12,5,7
Srtumor,zuljin,480,rogue,subtlety,12,5,7
Thriva,blackmoore,480,rogue,subtlety,12,5,7
Кмска,soulflayer,480,rogue,subtlety,12,5,7
Ghrøm,hyjal,480,rogue,subtlety,12,5,7
Sánta,tarren-mill,480,rogue,subtlety,12,5,7
Xatra,hyjal,480,rogue,subtlety,12,5,7
Mâriejânee,nozdormu,480,rogue,subtlety,12,5,7
Pyridoxin,blackmoore,480,rogue,subtlety,12,5,7
Nhonhonho,silvermoon,480,rogue,subtlety,12,5,7
Mírai,sylvanas,480,rogue,subtlety,12,5,7
Mzaa,ravencrest,480,rogue,subtlety,12,5,7
Soufraki,tarren-mill,480,rogue,subtlety,12,5,7
Айтик,howling-fjord,480,rogue,subtlety,12,5,7
Radious,thrall,480,rogue,subtlety,12,5,7
Фрозеншедов,gordunni,480,rogue,subtlety,12,5,7
Ingesa,blackhand,480,rogue,subtlety,12,5,7
Prseven,blackmoore,480,rogue,subtlety,12,5,7
Slicéndicé,wildhammer,480,rogue,subtlety,12,5,7
Fabì,argent-dawn,480,rogue,subtlety,12,5,7
Muzkek,argent-dawn,480,rogue,subtlety,12,5,7
Janx,aegwynn,480,rogue,subtlety,12,5,7
Chokee,blackrock,480,rogue,subtlety,12,5,7
Protpaladin,sylvanas,480,rogue,subtlety,12,5,7
Gosleep,stormscale,480,rogue,subtlety,12,5,7
Dumámày,kazzak,480,rogue,subtlety,12,5,7
Mateew,drakthul,480,rogue,subtlety,12,5,7
Inanisdance,outland,480,rogue,subtlety,12,5,7
Poizen,steamwheedle-cartel,480,rogue,subtlety,12,5,7
Loydleretour,hyjal,480,rogue,subtlety,15,5,10
Aronie,stormreaver,480,rogue,subtlety,21,6,15
Nohks,blackmoore,480,rogue,subtlety,18,5,13
Ðefsmøkêz,tyrande,480,rogue,subtlety,18,5,13
Youngdolph,frostwolf,480,rogue,subtlety,18,5,13
Ajwenx,ravencrest,480,rogue,subtlety,18,5,13
Waakø,todeswache,480,rogue,subtlety,18,5,13
Жорий,borean-tundra,480,rogue,subtlety,18,5,13
Skaúr,malganis,480,rogue,subtlety,24,5,19
Новиччокк,gordunni,480,rogue,subtlety,24,5,19
Typhoo,ravencrest,480,rogue,subtlety,30,5,25
Ruthraz,outland,479,rogue,subtlety,6,5,1
Инвесторша,gordunni,479,rogue,subtlety,6,5,1
Rydéordie,blackrock,479,rogue,subtlety,12,5,7
Grocco,doomhammer,479,rogue,subtlety,12,5,7
Nøxia,hyjal,479,rogue,subtlety,12,5,7
Tsakaloss,doomhammer,479,rogue,subtlety,12,5,7
Deadchivalry,argent-dawn,479,rogue,subtlety,12,5,7
Smorcoolio,stormscale,479,rogue,subtlety,12,5,7
Raizø,argent-dawn,479,rogue,subtlety,12,5,7
Conspirace,silvermoon,479,rogue,subtlety,12,5,7
Ryxon,arathor,479,rogue,subtlety,12,5,7
Abrhykoo,hyjal,479,rogue,subtlety,12,5,7
Modzsz,zenedar,479,rogue,subtlety,12,5,7
Giftdolken,outland,479,rogue,subtlety,12,5,7
Smøth,ysondre,479,rogue,subtlety,15,6,9
Eléya,blackhand,479,rogue,subtlety,13,5,8
Zeroshadow,burning-legion,479,rogue,subtlety,18,5,13
Пусирога,soulflayer,479,rogue,subtlety,18,5,13
Yuunr,kazzak,478,rogue,subtlety,12,5,7
Soulreapeer,twisting-nether,478,rogue,subtlety,21,6,15
Mozenn,draenor,478,rogue,subtlety,19,5,14
Delenor,stormscale,478,rogue,subtlety,24,5,19
Эльтаэрон,gordunni,477,rogue,subtlety,12,5,7
Приколдэсса,gordunni,477,rogue,subtlety,18,5,13
Batonrouge,kazzak,476,rogue,subtlety,12,5,7
Skeeto,blackmoore,476,rogue,subtlety,18,5,13
Deadpull,shadowsong,473,rogue,subtlety,30,5,25
Drpsykose,tarren-mill,472,rogue,subtlety,12,5,7
Иордани,gordunni,467,rogue,subtlety,30,8,22
Scratcheye,twisting-nether,465,rogue,subtlety,24,5,19
Seltharion,outland,463,rogue,subtlety,11,5,6
Sýn,eredar,457,rogue,subtlety,11,7,4
Кумаме,howling-fjord,447,rogue,subtlety,11,5,6
Foruu,tarren-mill,447,rogue,subtlety,11,5,6
Cälisto,drakthul,440,rogue,subtlety,23,9,14
Leselenrmax,archimonde,432,rogue,subtlety,15,5,10
Сексикаесу,soulflayer,431,rogue,subtlety,11,5,6
Effitwo,nagrand,431,rogue,subtlety,11,5,6
Iwillberone,ravencrest,431,rogue,subtlety,17,5,12
Gødmõdë,outland,426,rogue,subtlety,13,6,7
Asäp,archimonde,426,rogue,subtlety,21,7,14
Phaîne,outland,424,rogue,subtlety,16,7,9
Shalorai,ravencrest,416,rogue,subtlety,16,5,11
Itsforme,kazzak,415,rogue,subtlety,14,5,9
Bystroscy,silvermoon,398,rogue,subtlety,10,5,5
Algopyrin,ragnaros,396,rogue,subtlety,13,5,8
Elegánt,ravencrest,384,rogue,subtlety,6,4,2
Мум,blackscar,384,rogue,subtlety,6,4,2
Rubberducky,argent-dawn,384,rogue,subtlety,6,4,2
Blckrogue,bloodfeather,384,rogue,subtlety,6,4,2
Choclatéosol,archimonde,384,rogue,subtlety,6,4,2
Stabbs,balnazzar,384,rogue,subtlety,6,4,2
Lonarsalami,archimonde,384,rogue,subtlety,6,4,2
Крредоубийца,howling-fjord,384,rogue,subtlety,6,4,2
Spector,outland,384,rogue,subtlety,6,4,2
Takiya,ysondre,384,rogue,subtlety,6,4,2
Краулен,blackscar,384,rogue,subtlety,6,4,2
Itmcl,silvermoon,384,rogue,subtlety,6,4,2
Vevowton,silvermoon,384,rogue,subtlety,6,4,2
Freijasap,ravencrest,384,rogue,subtlety,6,4,2
Мейнкеректер,gordunni,384,rogue,subtlety,6,4,2
Лолнайт,blackscar,384,rogue,subtlety,6,4,2
Çløåk,outland,384,rogue,subtlety,6,4,2
Jutsu,argent-dawn,384,rogue,subtlety,6,4,2
Grens,kazzak,384,rogue,subtlety,6,4,2
Hook,malganis,384,rogue,subtlety,6,4,2
Kaliuchis,culte-de-la-rive-noire,384,rogue,subtlety,6,4,2
Cawzi,silvermoon,384,rogue,subtlety,6,4,2
Mol,defias-brotherhood,384,rogue,subtlety,6,4,2
Ilovevalen,zuljin,384,rogue,subtlety,6,4,2
Møgzu,blackmoore,384,rogue,subtlety,6,4,2
Dysxleic,tarren-mill,384,rogue,subtlety,6,4,2
Madnoopy,archimonde,384,rogue,subtlety,6,4,2
Rîze,blackrock,384,rogue,subtlety,6,4,2
Akimbá,antonidas,384,rogue,subtlety,6,4,2
Alizwood,aegwynn,384,rogue,subtlety,6,4,2
Nøcturas,ambossar,384,rogue,subtlety,6,4,2
Sickbratan,aegwynn,384,rogue,subtlety,6,4,2
Rm,archimonde,384,rogue,subtlety,6,4,2
Áppíé,hellfire,384,rogue,subtlety,6,4,2
Тенероби,soulflayer,384,rogue,subtlety,6,4,2
Darx,sunstrider,384,rogue,subtlety,6,4,2
Aneza,sylvanas,384,rogue,subtlety,6,4,2
Flygspark,tarren-mill,384,rogue,subtlety,6,4,2
Ронаис,soulflayer,384,rogue,subtlety,6,4,2
Pirateboi,blades-edge,384,rogue,subtlety,6,4,2
Crystallake,dun-morogh,384,rogue,subtlety,6,4,2
Rogee,tarren-mill,384,rogue,subtlety,6,4,2
Jaykerx,stormscale,384,rogue,subtlety,6,4,2
Nxnja,silvermoon,384,rogue,subtlety,6,4,2
Xayý,der-rat-von-dalaran,384,rogue,subtlety,6,4,2
Thefiller,ravencrest,384,rogue,subtlety,6,4,2
Talayr,argent-dawn,384,rogue,subtlety,6,4,2
Rajigagi,silvermoon,384,rogue,subtlety,6,4,2
Lilmort,ravencrest,384,rogue,subtlety,6,4,2
Tsuyoi,silvermoon,384,rogue,subtlety,6,4,2
Joelbiten,auchindoun,384,rogue,subtlety,6,4,2
Kazgaròth,draenor,384,rogue,subtlety,6,4,2
Wrestlér,sylvanas,384,rogue,subtlety,6,4,2
Mentthe,hyjal,384,rogue,subtlety,6,4,2
Siele,twisting-nether,384,rogue,subtlety,6,4,2
Lulune,frostmane,384,rogue,subtlety,6,4,2
Echilly,tarren-mill,384,rogue,subtlety,6,4,2
Djnelly,stormreaver,384,rogue,subtlety,6,4,2
Kushino,pozzo-delleternità,384,rogue,subtlety,6,4,2
Körtel,tarren-mill,384,rogue,subtlety,6,4,2
Havitýx,ravencrest,384,rogue,subtlety,9,5,4
Yellowbanana,argent-dawn,384,rogue,subtlety,9,5,4
Cleancl,blackhand,384,rogue,subtlety,8,4,4
Zeelyx,ragnaros,384,rogue,subtlety,10,4,6
Аязлаая,blackscar,384,rogue,subtlety,12,4,8
Xanders,draenor,384,rogue,subtlety,12,4,8
Fálke,dun-modr,384,rogue,subtlety,12,4,8
Senorino,tarren-mill,384,rogue,subtlety,12,4,8
Vaenerys,nemesis,384,rogue,subtlety,12,4,8
Thesia,archimonde,384,rogue,subtlety,12,4,8
Lillajc,tarren-mill,384,rogue,subtlety,12,4,8
Fusei,turalyon,384,rogue,subtlety,12,4,8
Вуцз,gordunni,384,rogue,subtlety,12,4,8
Starkad,archimonde,384,rogue,subtlety,12,4,8
Selecta,bloodhoof,384,rogue,subtlety,12,4,8
Hiddenbovine,twisting-nether,384,rogue,subtlety,12,4,8
Ýýçyka,kazzak,384,rogue,subtlety,12,4,8
Макимак,howling-fjord,384,rogue,subtlety,12,4,8
Izzmonab,blackmoore,384,rogue,subtlety,12,4,8
Jokis,uldum,384,rogue,subtlety,12,4,8
Saryotv,silvermoon,384,rogue,subtlety,12,4,8
Goblindrill,blackmoore,384,rogue,subtlety,12,4,8
Retardèad,darksorrow,384,rogue,subtlety,12,4,8
Asiripro,ravencrest,384,rogue,subtlety,12,4,8
Pomstaa,tarren-mill,384,rogue,subtlety,12,4,8
Cringefemboy,blackrock,384,rogue,subtlety,12,4,8
Horsexp,kazzak,384,rogue,subtlety,12,4,8
Noshivz,ragnaros,384,rogue,subtlety,12,4,8
Shadeveil,ravencrest,384,rogue,subtlety,12,4,8
Денисинвиз,soulflayer,384,rogue,subtlety,12,4,8
Møve,blackhand,384,rogue,subtlety,12,4,8
Jsprxo,stormscale,384,rogue,subtlety,12,4,8
Kami,frostmane,384,rogue,subtlety,12,4,8
Даняпрекринж,azuregos,384,rogue,subtlety,12,4,8
Battousai,burning-legion,384,rogue,subtlety,12,4,8
Enafdehvide,stormscale,384,rogue,subtlety,12,4,8
Милеса,soulflayer,384,rogue,subtlety,12,4,8
Dévi,twisting-nether,384,rogue,subtlety,12,4,8
Taishani,thrall,384,rogue,subtlety,12,4,8
Fatedancer,outland,384,rogue,subtlety,12,4,8
Нунас,soulflayer,384,rogue,subtlety,12,4,8
Zèph,outland,384,rogue,subtlety,12,4,8
Szabina,outland,384,rogue,subtlety,12,4,8
Le,stormreaver,384,rogue,subtlety,12,4,8
Очч,blackscar,384,rogue,subtlety,18,4,14
Undy,chromaggus,384,rogue,subtlety,18,4,14
Galore,azjolnerub,384,rogue,subtlety,18,4,14
Vaelaestra,argent-dawn,384,rogue,subtlety,18,4,14
Líl,outland,384,rogue,subtlety,18,4,14
Snupzy,kazzak,384,rogue,subtlety,18,4,14
Bloogue,silvermoon,384,rogue,subtlety,18,4,14
Damiian,colinas-pardas,384,rogue,subtlety,24,4,20
Ven,frostmane,383,rogue,subtlety,6,4,2
Vanishdotcom,blackrock,383,rogue,subtlety,6,4,2
Саулите,deathguard,383,rogue,subtlety,10,4,6
Helsperd,draenor,383,rogue,subtlety,12,4,8
Berreboy,tarren-mill,383,rogue,subtlety,12,4,8
Cangrë,dun-modr,383,rogue,subtlety,12,4,8
Alucardø,blackhand,383,rogue,subtlety,18,4,14
Alyzon,ravencrest,383,rogue,subtlety,18,4,14
Daunt,antonidas,383,rogue,subtlety,24,4,20
Монтанатони,eversong,383,rogue,subtlety,24,4,20
Bîgbîzeps,thrall,383,rogue,subtlety,30,4,26
Helax,turalyon,382,rogue,subtlety,6,4,2
Khatarshis,sanguino,382,rogue,subtlety,6,4,2
Sødï,khaz-modan,382,rogue,subtlety,6,4,2
Belina,draenor,382,rogue,subtlety,6,4,2
Adelr,onyxia,382,rogue,subtlety,12,4,8
Оптимально,soulflayer,382,rogue,subtlety,12,4,8
Jõsi,dalaran,382,rogue,subtlety,30,4,26
Nekros,chromaggus,379,rogue,subtlety,12,4,8
Чернаясоска,eversong,352,rogue,subtlety,10,4,6
Reawakened,darksorrow,352,rogue,subtlety,10,4,6
Shurký,blackmoore,351,rogue,subtlety,8,5,3
Jinêxo,shattrath,351,rogue,subtlety,11,4,7
Korppari,draenor,335,rogue,subtlety,11,4,7
Xeløe,hyjal,330,rogue,subtlety,14,5,9
Lëmönhäzë,dun-modr,330,rogue,subtlety,17,5,12
Vinlol,blackrock,319,rogue,subtlety,8,4,4
Kanilol,eredar,319,rogue,subtlety,8,4,4
Стэйм,gordunni,303,rogue,subtlety,7,4,3
Opiïum,ysondre,303,rogue,subtlety,7,4,3
Natsukage,blackmoore,288,rogue,subtlety,6,3,3
Emilymeow,silvermoon,288,rogue,subtlety,6,3,3
Brzlik,stormscale,288,rogue,subtlety,6,3,3
Neilyo,thrall,288,rogue,subtlety,6,3,3
Zasty,drakthul,288,rogue,subtlety,6,3,3
Garou,blackhand,288,rogue,subtlety,6,3,3
Corleoonee,archimonde,288,rogue,subtlety,6,3,3
Cotta,silvermoon,288,rogue,subtlety,6,3,3
Årtist,sanguino,288,rogue,subtlety,6,3,3
Stælf,argent-dawn,288,rogue,subtlety,6,3,3
Nezukóchan,ravencrest,288,rogue,subtlety,6,3,3
Àylen,blackmoore,288,rogue,subtlety,6,3,3
Sholace,blackrock,288,rogue,subtlety,6,3,3
Stepbro,kelthuzad,288,rogue,subtlety,6,3,3
Elsieboo,ravencrest,288,rogue,subtlety,6,3,3
Vïn,anachronos,288,rogue,subtlety,6,3,3
Wizzo,onyxia,288,rogue,subtlety,6,3,3
Appelschorlê,eredar,288,rogue,subtlety,6,3,3
Fredge,stormscale,288,rogue,subtlety,6,3,3
Darkchomeur,archimonde,288,rogue,subtlety,6,3,3
Vanisshh,hyjal,288,rogue,subtlety,6,3,3
Skrbke,tarren-mill,288,rogue,subtlety,6,3,3
Sethr,blackmoore,288,rogue,subtlety,6,3,3
Келгар,soulflayer,288,rogue,subtlety,6,3,3
Xhemil,tarren-mill,288,rogue,subtlety,6,3,3
Фуфломет,gordunni,288,rogue,subtlety,6,3,3
Juicyrime,aegwynn,288,rogue,subtlety,6,3,3
Shadxwstep,ravencrest,288,rogue,subtlety,6,3,3
Sempya,archimonde,288,rogue,subtlety,6,3,3
Popsmoke,bronze-dragonflight,288,rogue,subtlety,6,3,3
Runár,proudmoore,288,rogue,subtlety,6,3,3
Barkai,kazzak,288,rogue,subtlety,6,3,3
Flogue,area-52,288,rogue,subtlety,6,3,3
Friyie,stormscale,288,rogue,subtlety,6,3,3
Vxb,hyjal,288,rogue,subtlety,6,3,3
Nhèl,stormscale,288,rogue,subtlety,6,3,3
Kejú,alleria,288,rogue,subtlety,6,3,3
Shawnty,defias-brotherhood,288,rogue,subtlety,6,3,3
Abush,ravencrest,288,rogue,subtlety,6,3,3
Nerica,kazzak,288,rogue,subtlety,6,3,3
Vexxey,magtheridon,288,rogue,subtlety,6,3,3
Altaux,nordrassil,288,rogue,subtlety,6,3,3
Bumstuff,kilrogg,288,rogue,subtlety,6,3,3
Jawen,silvermoon,288,rogue,subtlety,6,3,3
Pretylo,marécage-de-zangar,288,rogue,subtlety,6,3,3
Shazam,zenedar,288,rogue,subtlety,6,3,3
Cylizr,stormscale,288,rogue,subtlety,6,3,3
Pocketpaw,stormreaver,288,rogue,subtlety,6,3,3
Erised,ravencrest,288,rogue,subtlety,6,3,3
Flôky,twisting-nether,288,rogue,subtlety,6,3,3
Киришима,blackscar,288,rogue,subtlety,6,3,3
Sweetcc,amanthul,288,rogue,subtlety,6,3,3
Томасмразь,blackscar,288,rogue,subtlety,6,3,3
Peeon,drakthul,288,rogue,subtlety,6,3,3
Ezk,eredar,288,rogue,subtlety,6,3,3
Madita,frostmourne,288,rogue,subtlety,6,3,3
Mekóz,draenor,288,rogue,subtlety,6,3,3
Whitters,stormscale,288,rogue,subtlety,6,3,3
Jymbe,blackrock,288,rogue,subtlety,6,3,3
Sadgexd,draenor,288,rogue,subtlety,6,3,3
Waakie,frostmane,288,rogue,subtlety,6,3,3
Tiredpurple,dalaran,288,rogue,subtlety,6,3,3
Synthaetic,draenor,288,rogue,subtlety,6,3,3
Spookyrog,silvermoon,288,rogue,subtlety,6,3,3
Sporkieh,tarren-mill,288,rogue,subtlety,6,3,3
Flêxô,antonidas,288,rogue,subtlety,6,3,3
Smäshiboy,blackrock,288,rogue,subtlety,6,3,3
Háhàháhàháhà,kazzak,288,rogue,subtlety,6,3,3
Banaulikode,twisting-nether,288,rogue,subtlety,6,3,3
Imacelebrity,ravencrest,288,rogue,subtlety,6,3,3
Iwannacry,kazzak,288,rogue,subtlety,6,3,3
Vultzy,draenor,288,rogue,subtlety,6,3,3
Checkormate,aegwynn,288,rogue,subtlety,6,3,3
Djpiglet,outland,288,rogue,subtlety,6,3,3
Jhx,antonidas,288,rogue,subtlety,6,3,3
Вентури,borean-tundra,288,rogue,subtlety,6,3,3
Хвангер,gordunni,288,rogue,subtlety,6,3,3
Ãkz,hyjal,288,rogue,subtlety,6,3,3
Rontoxd,ragnaros,288,rogue,subtlety,6,3,3
Noxxra,blackhand,288,rogue,subtlety,6,3,3
Кеспул,soulflayer,288,rogue,subtlety,6,3,3
Koopa,argent-dawn,288,rogue,subtlety,6,3,3
Geegeenoree,kazzak,288,rogue,subtlety,6,3,3
Exodian,aegwynn,288,rogue,subtlety,6,3,3
Plshalpme,dun-modr,288,rogue,subtlety,6,3,3
Кейнилин,gordunni,288,rogue,subtlety,6,3,3
Checkormate,ravencrest,288,rogue,subtlety,6,3,3
Vxgas,ragnaros,288,rogue,subtlety,6,3,3
Sáp,blackmoore,288,rogue,subtlety,6,3,3
Zaelÿ,archimonde,288,rogue,subtlety,6,3,3
Scotlander,argent-dawn,288,rogue,subtlety,6,3,3
Crû,silvermoon,288,rogue,subtlety,6,3,3
Scythetwo,ravencrest,288,rogue,subtlety,6,3,3
Sâitama,zuljin,288,rogue,subtlety,6,3,3
Finanzamtlg,blackrock,288,rogue,subtlety,6,3,3
Laasky,archimonde,288,rogue,subtlety,6,3,3
Крошувсалат,gordunni,288,rogue,subtlety,6,3,3
Grøax,ragnaros,288,rogue,subtlety,6,3,3
Rubjerg,blackrock,288,rogue,subtlety,6,3,3
Seregolas,argent-dawn,288,rogue,subtlety,6,3,3
Klexor,sylvanas,288,rogue,subtlety,6,3,3
Mótu,frostwolf,288,rogue,subtlety,6,3,3
Загляденье,gordunni,288,rogue,subtlety,6,3,3
Lycosidae,doomhammer,288,rogue,subtlety,6,3,3
Goshîmoshî,stormscale,288,rogue,subtlety,6,3,3
Hàly,ravencrest,288,rogue,subtlety,6,3,3
Meel,dun-modr,288,rogue,subtlety,6,3,3
Mores,anetheron,288,rogue,subtlety,6,3,3
Nìghtstørm,ravencrest,288,rogue,subtlety,6,3,3
Renyth,argent-dawn,288,rogue,subtlety,9,4,5
Ssjblacklolz,kaelthas,288,rogue,subtlety,9,4,5
Kaizaro,hyjal,288,rogue,subtlety,17,6,11
Babysteps,the-maelstrom,288,rogue,subtlety,12,4,8
Uareincombat,drakthul,288,rogue,subtlety,11,3,8
Тимкок,soulflayer,288,rogue,subtlety,12,3,9
Chililôl,dun-modr,288,rogue,subtlety,12,3,9
Kidney,sanguino,288,rogue,subtlety,12,3,9
Ssoeyjrjr,kazzak,288,rogue,subtlety,12,3,9
Byaow,ravencrest,288,rogue,subtlety,12,3,9
Asasina,los-errantes,288,rogue,subtlety,12,3,9
Nithrea,ravencrest,288,rogue,subtlety,12,3,9
Leakara,blackrock,288,rogue,subtlety,12,3,9
Nÿst,khaz-modan,288,rogue,subtlety,12,3,9
Cabbagerolls,argent-dawn,288,rogue,subtlety,12,3,9
Kïbs,dalaran,288,rogue,subtlety,12,3,9
Дзендэр,soulflayer,288,rogue,subtlety,12,3,9
Rufinol,twisting-nether,288,rogue,subtlety,12,3,9
Hikorust,drakthul,288,rogue,subtlety,12,3,9
Remnus,silvermoon,288,rogue,subtlety,12,3,9
Fishersfritz,aegwynn,288,rogue,subtlety,12,3,9
Highestapm,archimonde,288,rogue,subtlety,12,3,9
Dayanir,aggra-português,288,rogue,subtlety,12,3,9
Воробнальщик,soulflayer,288,rogue,subtlety,12,3,9
Ñú,ravencrest,288,rogue,subtlety,12,3,9
Romiel,ravencrest,288,rogue,subtlety,12,3,9
Kenchio,elune,288,rogue,subtlety,12,3,9
Flaycesap,blackmoore,288,rogue,subtlety,12,3,9
Apexpreditar,doomhammer,288,rogue,subtlety,12,3,9
Pestctrl,argent-dawn,288,rogue,subtlety,12,3,9
Luigitama,dun-modr,288,rogue,subtlety,12,3,9
Thebestrogue,tarren-mill,288,rogue,subtlety,12,3,9
Oczkune,burning-legion,288,rogue,subtlety,12,3,9
Shadowcraft,the-maelstrom,288,rogue,subtlety,12,3,9
Creepydude,burning-legion,288,rogue,subtlety,12,3,9
Savoie,kazzak,288,rogue,subtlety,12,3,9
Carnagè,dentarg,288,rogue,subtlety,12,3,9
Tmlu,nazjatar,288,rogue,subtlety,12,3,9
Volyavolume,ravencrest,288,rogue,subtlety,12,3,9
Trytocapnoob,stormscale,288,rogue,subtlety,12,3,9
Zoldyck,bloodhoof,288,rogue,subtlety,12,3,9
Soupasayajin,hyjal,288,rogue,subtlety,12,3,9
Drunks,aegwynn,288,rogue,subtlety,12,3,9
Izame,archimonde,288,rogue,subtlety,12,3,9
Kkraken,dalaran,288,rogue,subtlety,12,3,9
Xéshon,tarren-mill,288,rogue,subtlety,12,3,9
Cbrook,sylvanas,288,rogue,subtlety,12,3,9
Ragroh,burning-legion,288,rogue,subtlety,12,3,9
Schleichor,aegwynn,288,rogue,subtlety,12,3,9
Durret,aggra-português,288,rogue,subtlety,12,3,9
Kongnognog,ragnaros,288,rogue,subtlety,12,3,9
Ристоврация,gordunni,288,rogue,subtlety,12,3,9
Vancleéf,sylvanas,288,rogue,subtlety,12,3,9
Jawdropper,blackmoore,288,rogue,subtlety,12,3,9
Boky,baelgun,288,rogue,subtlety,12,3,9
Razcallz,arthas,288,rogue,subtlety,12,3,9
Вайлоу,gordunni,288,rogue,subtlety,12,3,9
Skíll,sanguino,288,rogue,subtlety,12,3,9
Alexius,kazzak,288,rogue,subtlety,13,3,10
Sinxgødx,outland,288,rogue,subtlety,18,3,15
Persecution,nemesis,288,rogue,subtlety,18,3,15
Мутина,galakrond,288,rogue,subtlety,18,3,15
Гриксон,blackscar,288,rogue,subtlety,18,3,15
Etro,argent-dawn,288,rogue,subtlety,18,3,15
Мадарец,howling-fjord,288,rogue,subtlety,18,3,15
Bú,nemesis,288,rogue,subtlety,24,3,21
Silvano,zuljin,288,rogue,subtlety,24,3,21
Azhothz,argent-dawn,287,rogue,subtlety,6,3,3
Blaks,ravencrest,287,rogue,subtlety,6,3,3
Icècôld,blackmoore,287,rogue,subtlety,6,3,3
Stabsy,stormscale,287,rogue,subtlety,6,3,3
Hëather,confrérie-du-thorium,287,rogue,subtlety,6,3,3
Shåkø,tarren-mill,287,rogue,subtlety,6,3,3
Libanes,uldum,287,rogue,subtlety,6,3,3
Téhashcéé,archimonde,287,rogue,subtlety,6,3,3
Ilailafruit,quelthalas,287,rogue,subtlety,9,4,5
Styggvanas,tarren-mill,287,rogue,subtlety,15,4,11
Котуй,borean-tundra,287,rogue,subtlety,12,3,9
Задорезка,blackscar,287,rogue,subtlety,12,3,9
Xkd,blackmoore,287,rogue,subtlety,12,3,9
Djsapblindx,archimonde,287,rogue,subtlety,18,3,15
Sylaba,burning-legion,287,rogue,subtlety,18,3,15
Wiredéath,twisting-nether,287,rogue,subtlety,18,3,15
Furrooscuro,sanguino,287,rogue,subtlety,18,3,15
Pitot,kirin-tor,287,rogue,subtlety,18,3,15
Celenium,chogall,287,rogue,subtlety,24,3,21
Sombrafina,tyrande,286,rogue,subtlety,6,3,3
Kausa,dun-modr,286,rogue,subtlety,6,3,3
Jontor,deathwing,286,rogue,subtlety,12,3,9
Killboom,rexxar,286,rogue,subtlety,18,3,15
Nïhal,suramar,275,rogue,subtlety,24,6,18
Fatzaky,turalyon,274,rogue,subtlety,31,7,24
Iuun,hyjal,271,rogue,subtlety,17,3,14
Strayda,kazzak,265,rogue,subtlety,18,5,13
Deded,argent-dawn,256,rogue,subtlety,10,3,7
Madlain,jaedenar,255,rogue,subtlety,8,4,4
Domiqs,blackhand,255,rogue,subtlety,8,4,4
Jimlostson,dun-modr,239,rogue,subtlety,5,3,2
Trinketeflag,archimonde,239,rogue,subtlety,5,3,2
Auugust,stormscale,239,rogue,subtlety,11,3,8
Pinnar,blackmoore,234,rogue,subtlety,8,4,4
Shadôwcraft,outland,234,rogue,subtlety,8,4,4
Köna,archimonde,234,rogue,subtlety,15,6,9
Casp,gorgonnash,234,rogue,subtlety,15,5,10
Gögel,draenor,224,rogue,subtlety,10,3,7
Эвенгорн,gordunni,224,rogue,subtlety,16,3,13
Danmoretti,drakthul,223,rogue,subtlety,8,3,5
Persës,outland,223,rogue,subtlety,8,3,5
Piperx,ravencrest,223,rogue,subtlety,8,3,5
Яматсуми,gordunni,223,rogue,subtlety,8,3,5
Ggyoulowbro,blackmoore,208,rogue,subtlety,7,3,4
Jaundso,thrall,207,rogue,subtlety,13,3,10
Rhaiku,tarren-mill,192,rogue,subtlety,9,4,5
Loom,sylvanas,192,rogue,subtlety,9,3,6
Совечица,gordunni,192,rogue,subtlety,9,3,6
Kyupi,hyjal,192,rogue,subtlety,6,2,4
Elthalulz,illidan,192,rogue,subtlety,6,2,4
Голадриель,gordunni,192,rogue,subtlety,6,2,4
Stealthyist,darkmoon-faire,192,rogue,subtlety,6,2,4
Mexxn,eredar,192,rogue,subtlety,6,2,4
Brojenson,ravencrest,192,rogue,subtlety,6,2,4
Enoìla,blackmoore,192,rogue,subtlety,6,2,4
Hade,stormscale,192,rogue,subtlety,6,2,4
Nefqq,stormscale,192,rogue,subtlety,6,2,4
Скиррона,gordunni,192,rogue,subtlety,6,2,4
Heraa,kaelthas,192,rogue,subtlety,6,2,4
Flynnzer,hyjal,192,rogue,subtlety,6,2,4
Wrathed,stormreaver,192,rogue,subtlety,6,2,4
Sýnra,eredar,192,rogue,subtlety,6,2,4
Taurielz,twisting-nether,192,rogue,subtlety,6,2,4
Pøggerhontas,antonidas,192,rogue,subtlety,6,2,4
Рогаупорога,howling-fjord,192,rogue,subtlety,6,2,4
Feylia,terenas,192,rogue,subtlety,6,2,4
Ackyrogue,ysondre,192,rogue,subtlety,6,2,4
Гамбиит,gordunni,192,rogue,subtlety,6,2,4
Колстар,howling-fjord,192,rogue,subtlety,6,2,4
Blóodless,stormscale,192,rogue,subtlety,6,2,4
Tinkié,stormscale,192,rogue,subtlety,6,2,4
Navaton,sanguino,192,rogue,subtlety,6,2,4
Фораст,gordunni,192,rogue,subtlety,6,2,4
Trixster,aggramar,192,rogue,subtlety,6,2,4
Brinvilliers,aegwynn,192,rogue,subtlety,6,2,4
Stigh,twisting-nether,192,rogue,subtlety,6,2,4
Lyaà,dun-morogh,192,rogue,subtlety,6,2,4
Nbzz,hyjal,192,rogue,subtlety,6,2,4
Múgala,outland,192,rogue,subtlety,6,2,4
Sizzla,die-nachtwache,192,rogue,subtlety,6,2,4
Redwinter,sylvanas,192,rogue,subtlety,6,2,4
Ноумингод,gordunni,192,rogue,subtlety,6,2,4
Brazi,dalaran,192,rogue,subtlety,6,2,4
Recondite,doomhammer,192,rogue,subtlety,6,2,4
Leviathann,doomhammer,192,rogue,subtlety,6,2,4
Ksunq,hyjal,192,rogue,subtlety,6,2,4
Subaslaw,ravencrest,192,rogue,subtlety,6,2,4
Рикимартини,gordunni,192,rogue,subtlety,6,2,4
Lucifas,antonidas,192,rogue,subtlety,6,2,4
Misimisi,sanguino,192,rogue,subtlety,6,2,4
Скивс,soulflayer,192,rogue,subtlety,6,2,4
Rhaaxx,hyjal,192,rogue,subtlety,6,2,4
Каверзати,howling-fjord,192,rogue,subtlety,6,2,4
Equino,sylvanas,192,rogue,subtlety,6,2,4
Stepkickgodx,blackmoore,192,rogue,subtlety,6,2,4
Sheepshoot,archimonde,192,rogue,subtlety,6,2,4
Webouge,blackmoore,192,rogue,subtlety,6,2,4
Niha,ravencrest,192,rogue,subtlety,6,2,4
Sigleif,argent-dawn,192,rogue,subtlety,6,2,4
Aëlynn,la-croisade-écarlate,192,rogue,subtlety,6,2,4
Tipsydagger,twisting-nether,192,rogue,subtlety,6,2,4
Elusivé,sylvanas,192,rogue,subtlety,6,2,4
Kìnsley,archimonde,192,rogue,subtlety,6,2,4
Sháde,zuljin,192,rogue,subtlety,6,2,4
Alacarda,draenor,192,rogue,subtlety,6,2,4
Sqc,ravencrest,192,rogue,subtlety,6,2,4
Namw,draenor,192,rogue,subtlety,6,2,4
Tatzz,draenor,192,rogue,subtlety,6,2,4
Inviscuz,draenor,192,rogue,subtlety,6,2,4
Вэндиго,deathweaver,192,rogue,subtlety,6,2,4
Canelitae,minahonda,192,rogue,subtlety,6,2,4
Evilbiscuit,quelthalas,192,rogue,subtlety,6,2,4
Rilöded,ravencrest,192,rogue,subtlety,6,2,4
Miooko,outland,192,rogue,subtlety,6,2,4
Lenây,blackmoore,192,rogue,subtlety,6,2,4
Rehab,draenor,192,rogue,subtlety,6,2,4
Cptnyac,tarren-mill,192,rogue,subtlety,6,2,4
Turbocandle,ravencrest,192,rogue,subtlety,6,2,4
Bleix,sanguino,192,rogue,subtlety,6,2,4
Milchmann,ysera,192,rogue,subtlety,6,2,4
Watzoqt,archimonde,192,rogue,subtlety,6,2,4
Dhayna,shendralar,192,rogue,subtlety,6,2,4
Jæto,ravencrest,192,rogue,subtlety,6,2,4
Mdvmachines,nemesis,192,rogue,subtlety,6,2,4
Celaena,shadowsong,192,rogue,subtlety,6,2,4
Stepdead,tarren-mill,192,rogue,subtlety,6,2,4
Excelsiôr,blackmoore,192,rogue,subtlety,6,2,4
Gameøvr,sanguino,192,rogue,subtlety,6,2,4
Снэбак,soulflayer,192,rogue,subtlety,6,2,4
Phantazma,ravencrest,192,rogue,subtlety,6,2,4
Medievh,sanguino,192,rogue,subtlety,6,2,4
Meÿ,archimonde,192,rogue,subtlety,6,2,4
Flexberg,the-maelstrom,192,rogue,subtlety,6,2,4
Juutalainen,tarren-mill,192,rogue,subtlety,6,2,4
Yugi,zuljin,192,rogue,subtlety,6,2,4
Brainwash,the-maelstrom,192,rogue,subtlety,6,2,4
Latravia,blackhand,192,rogue,subtlety,6,2,4
Chipshot,tarren-mill,192,rogue,subtlety,6,2,4
Venomblood,sanguino,192,rogue,subtlety,6,2,4
Sohnisch,azshara,192,rogue,subtlety,6,2,4
Mècr,outland,192,rogue,subtlety,6,2,4
Blindsidé,bronze-dragonflight,192,rogue,subtlety,6,2,4
Gremulition,deathwing,192,rogue,subtlety,6,2,4
Pumpa,thunderhorn,192,rogue,subtlety,6,2,4
Fonss,sanguino,192,rogue,subtlety,6,2,4
Kontrol,burning-legion,192,rogue,subtlety,6,2,4
Блимкинг,soulflayer,192,rogue,subtlety,6,2,4
Poerta,burning-blade,192,rogue,subtlety,6,2,4
Lictilsmulic,kirin-tor,192,rogue,subtlety,6,2,4
Sethrevenn,ragnaros,192,rogue,subtlety,6,2,4
Epidemic,stormscale,192,rogue,subtlety,6,2,4
Revisiôn,tarren-mill,192,rogue,subtlety,6,2,4
Malvaxxs,tarren-mill,192,rogue,subtlety,6,2,4
Ît,stormscale,192,rogue,subtlety,6,2,4
Boneface,malganis,192,rogue,subtlety,6,2,4
Гесху,eversong,192,rogue,subtlety,6,2,4
Yulitz,dun-modr,192,rogue,subtlety,6,2,4
Миньон,eversong,192,rogue,subtlety,6,2,4
Voices,dentarg,192,rogue,subtlety,6,2,4
Jinzuto,outland,192,rogue,subtlety,6,2,4
Harmawz,archimonde,192,rogue,subtlety,6,2,4
Бигидипс,eversong,192,rogue,subtlety,6,2,4
Azulérà,elune,192,rogue,subtlety,6,2,4
Fakeroguex,outland,192,rogue,subtlety,6,2,4
Xwb,sanguino,192,rogue,subtlety,6,2,4
Rumbling,stormreaver,192,rogue,subtlety,6,2,4
Middlesneak,outland,192,rogue,subtlety,6,2,4
Медиивэл,deepholm,192,rogue,subtlety,6,2,4
Enthuque,draenor,192,rogue,subtlety,6,2,4
Miisterkaka,stormscale,192,rogue,subtlety,6,2,4
Унижака,deathguard,192,rogue,subtlety,6,2,4
Zte,frostmane,192,rogue,subtlety,6,2,4
Qoxinyohas,stormscale,192,rogue,subtlety,6,2,4
Edgybanana,stormscale,192,rogue,subtlety,6,2,4
Øoøoøoø,drakthul,192,rogue,subtlety,6,2,4
Sapyøu,tarren-mill,192,rogue,subtlety,6,2,4
Rasponi,ragnaros,192,rogue,subtlety,6,2,4
Knezr,silvermoon,192,rogue,subtlety,6,2,4
Steálth,silvermoon,192,rogue,subtlety,6,2,4
Cowwithknife,silvermoon,192,rogue,subtlety,6,2,4
Giftknirps,silvermoon,192,rogue,subtlety,6,2,4
Dròól,kazzak,192,rogue,subtlety,6,2,4
Valyona,silvermoon,192,rogue,subtlety,6,2,4
Striçken,silvermoon,192,rogue,subtlety,6,2,4
Darkbleeds,kazzak,192,rogue,subtlety,6,2,4
Nichrome,silvermoon,192,rogue,subtlety,6,2,4
Xyil,kazzak,192,rogue,subtlety,6,2,4
Luccea,silvermoon,192,rogue,subtlety,6,2,4
Bwònsàmdì,twisting-nether,192,rogue,subtlety,10,3,7
Ratkebab,silvermoon,192,rogue,subtlety,11,3,8
Greiskull,cthun,192,rogue,subtlety,15,3,12
Rascall,anetheron,192,rogue,subtlety,11,2,9
Mimorion,blackhand,192,rogue,subtlety,12,2,10
Gorkamorki,stormscale,192,rogue,subtlety,12,2,10
Thurgodd,silvermoon,192,rogue,subtlety,12,2,10
Destrektor,kazzak,192,rogue,subtlety,12,2,10
Acheravar,antonidas,192,rogue,subtlety,12,2,10
Mirekk,silvermoon,192,rogue,subtlety,12,2,10
Shaklyn,antonidas,192,rogue,subtlety,12,2,10
Zongshroud,archimonde,192,rogue,subtlety,12,2,10
Падинайди,howling-fjord,192,rogue,subtlety,12,2,10
Ordwin,silvermoon,192,rogue,subtlety,12,2,10
Könän,dalaran,192,rogue,subtlety,12,2,10
Cøsmøz,dalaran,192,rogue,subtlety,12,2,10
Tàazz,archimonde,192,rogue,subtlety,12,2,10
Découpeur,hyjal,192,rogue,subtlety,12,2,10
Câptcâp,twisting-nether,192,rogue,subtlety,12,2,10
Кингксу,gordunni,192,rogue,subtlety,12,2,10
Deróthus,arathor,192,rogue,subtlety,12,2,10
Wxlf,ravencrest,192,rogue,subtlety,12,2,10
Verstopt,azjolnerub,192,rogue,subtlety,12,2,10
Shènzo,tarren-mill,192,rogue,subtlety,12,2,10
Bauwten,ravencrest,192,rogue,subtlety,12,2,10
Weworog,drakthul,192,rogue,subtlety,12,2,10
Kateria,sanguino,192,rogue,subtlety,12,2,10
Pandagonstab,shadowsong,192,rogue,subtlety,12,2,10
Килрилон,lich-king,192,rogue,subtlety,12,2,10
Erèlenn,draenor,192,rogue,subtlety,12,2,10
Shacopaco,zuljin,192,rogue,subtlety,12,2,10
Jackpot,sargeras,192,rogue,subtlety,12,2,10
Милкаа,deathguard,192,rogue,subtlety,12,2,10
Strit,outland,192,rogue,subtlety,12,2,10
Nomad,sylvanas,192,rogue,subtlety,12,2,10
Grogun,tyrande,192,rogue,subtlety,14,2,12
Scarefoe,sylvanas,192,rogue,subtlety,18,2,16
Antomen,sylvanas,192,rogue,subtlety,18,2,16
Afrodittan,dun-modr,192,rogue,subtlety,22,2,20
Moustache,outland,191,rogue,subtlety,6,2,4
Fenrirsson,stormscale,191,rogue,subtlety,6,2,4
Røsenstërn,ravencrest,191,rogue,subtlety,12,2,10
Geomy,minahonda,191,rogue,subtlety,12,2,10
Deathrow,nethersturm,191,rogue,subtlety,18,2,16
Cutscene,argent-dawn,159,rogue,subtlety,5,2,3
Julekos,ravenholdt,159,rogue,subtlety,5,2,3
Kechke,ragnaros,159,rogue,subtlety,5,2,3
Гароона,blackscar,159,rogue,subtlety,5,2,3
Tsukuyø,ravencrest,159,rogue,subtlety,5,2,3
Keeqq,silvermoon,144,rogue,subtlety,3,3,0
Projectindex,malganis,138,rogue,subtlety,10,4,6
Dawz,malganis,138,rogue,subtlety,10,4,6
Bacheline,antonidas,138,rogue,subtlety,9,3,6
Omegacry,dun-modr,138,rogue,subtlety,10,3,7
Macon,arthas,138,rogue,subtlety,18,4,14
Núb,burning-blade,138,rogue,subtlety,15,3,12
Zaintsas,tarren-mill,128,rogue,subtlety,4,2,2
Earnedblood,kazzak,128,rogue,subtlety,4,2,2
Quînox,archimonde,128,rogue,subtlety,4,2,2
Defrieder,ravencrest,127,rogue,subtlety,5,3,2
Pâzlîght,perenolde,127,rogue,subtlety,8,2,6
Cornvus,burning-legion,112,rogue,subtlety,7,2,5
Frká,kazzak,112,rogue,subtlety,7,2,5
Pzylol,anetheron,96,rogue,subtlety,3,2,1
Solotop,archimonde,96,rogue,subtlety,3,2,1
Penetrantwo,eredar,96,rogue,subtlety,3,2,1
Krippie,thunderhorn,96,rogue,subtlety,3,2,1
Cheexy,lightbringer,96,rogue,subtlety,30,5,25
Unshaken,dun-modr,96,rogue,subtlety,6,1,5
Grimson,kazzak,96,rogue,subtlety,6,1,5
Seihend,zuljin,96,rogue,subtlety,6,1,5
Бамболейлоо,grom,96,rogue,subtlety,6,1,5
Faso,thunderhorn,96,rogue,subtlety,6,1,5
Theone,sanguino,96,rogue,subtlety,6,1,5
Чоколэйт,gordunni,96,rogue,subtlety,6,1,5
Mattyc,bronze-dragonflight,96,rogue,subtlety,6,1,5
Coldbloodxx,twisting-nether,96,rogue,subtlety,6,1,5
Skruffles,grim-batol,96,rogue,subtlety,6,1,5
Théyzha,kazzak,96,rogue,subtlety,6,1,5
Amý,grim-batol,96,rogue,subtlety,6,1,5
Behemothr,kazzak,96,rogue,subtlety,6,1,5
Trxë,twisting-nether,96,rogue,subtlety,6,1,5
Кэнсэй,gordunni,96,rogue,subtlety,6,1,5
Настябэкстаб,gordunni,96,rogue,subtlety,6,1,5
Элонли,gordunni,96,rogue,subtlety,6,1,5
Depleter,outland,96,rogue,subtlety,6,1,5
Loulina,outland,96,rogue,subtlety,6,1,5
Arishem,burning-legion,96,rogue,subtlety,6,1,5
Nerkmind,ragnaros,96,rogue,subtlety,6,1,5
Urbanck,kazzak,96,rogue,subtlety,6,1,5
Sørä,ragnaros,96,rogue,subtlety,6,1,5
Гламурятина,gordunni,96,rogue,subtlety,6,1,5
Kolbass,ragnaros,96,rogue,subtlety,6,1,5
Ótsutsukí,kazzak,96,rogue,subtlety,6,1,5
Рэйзакх,howling-fjord,96,rogue,subtlety,6,1,5
Кикбезкд,gordunni,96,rogue,subtlety,6,1,5
Lefugitif,archimonde,96,rogue,subtlety,6,1,5
Cutegirlxx,outland,96,rogue,subtlety,6,1,5
Аквик,howling-fjord,96,rogue,subtlety,6,1,5
Адыхай,howling-fjord,96,rogue,subtlety,6,1,5
Тварьебаная,howling-fjord,96,rogue,subtlety,6,1,5
Щасбудетвайп,howling-fjord,96,rogue,subtlety,6,1,5
Knockyz,khaz-modan,96,rogue,subtlety,6,1,5
Vellira,khaz-modan,96,rogue,subtlety,6,1,5
Teldruil,illidan,96,rogue,subtlety,6,1,5
Rogalica,stormscale,96,rogue,subtlety,6,1,5
Targram,hyjal,96,rogue,subtlety,6,1,5
Satlol,outland,96,rogue,subtlety,6,1,5
Кишкумэн,ashenvale,96,rogue,subtlety,6,1,5
Tyranoxoth,stormscale,96,rogue,subtlety,6,1,5
Sephirøthh,hyjal,96,rogue,subtlety,6,1,5
Varthaa,stormscale,96,rogue,subtlety,6,1,5
Àrléngødx,kazzak,96,rogue,subtlety,6,1,5
Anokir,sylvanas,96,rogue,subtlety,6,1,5
Outride,outland,96,rogue,subtlety,6,1,5
Lookbehindu,stormscale,96,rogue,subtlety,6,1,5
Bellarìa,hyjal,96,rogue,subtlety,6,1,5
Lixht,the-maelstrom,96,rogue,subtlety,6,1,5
Letheus,stormscale,96,rogue,subtlety,6,1,5
Félblade,outland,96,rogue,subtlety,6,1,5
Lättja,hyjal,96,rogue,subtlety,6,1,5
Clownsap,blackhand,96,rogue,subtlety,6,1,5
Стронг,soulflayer,96,rogue,subtlety,6,1,5
Grinchfurtif,hyjal,96,rogue,subtlety,6,1,5
Ålûñàhlulz,kilrogg,96,rogue,subtlety,6,1,5
Tzsub,blackhand,96,rogue,subtlety,6,1,5
Lavanda,outland,96,rogue,subtlety,6,1,5
Une,quelthalas,96,rogue,subtlety,6,1,5
Saucee,ravencrest,96,rogue,subtlety,6,1,5
Menzo,ravencrest,96,rogue,subtlety,6,1,5
Øpti,ravencrest,96,rogue,subtlety,6,1,5
Escá,magtheridon,96,rogue,subtlety,6,1,5
Sumcrit,ravencrest,96,rogue,subtlety,6,1,5
Llamiryl,ravencrest,96,rogue,subtlety,6,1,5
Maedyv,magtheridon,96,rogue,subtlety,6,1,5
Chøsen,stormscale,96,rogue,subtlety,6,1,5
Proesis,ravencrest,96,rogue,subtlety,6,1,5
Malborko,ravencrest,96,rogue,subtlety,6,1,5
Ôeuf,ravencrest,96,rogue,subtlety,6,1,5
Ñøøß,tarren-mill,96,rogue,subtlety,6,1,5
Impostér,tarren-mill,96,rogue,subtlety,6,1,5
Niceflmqt,thrall,96,rogue,subtlety,6,1,5
Helmclever,tarren-mill,96,rogue,subtlety,6,1,5
Dancewithme,arthas,96,rogue,subtlety,6,1,5
Cinque,das-konsortium,96,rogue,subtlety,6,1,5
Nuguri,blackrock,96,rogue,subtlety,6,1,5
Neversapx,blackrock,96,rogue,subtlety,6,1,5
Soraoy,silvermoon,96,rogue,subtlety,6,1,5
Zerøskil,antonidas,96,rogue,subtlety,6,1,5
Szybkora,silvermoon,96,rogue,subtlety,6,1,5
Førtñîtégøðx,eredar,96,rogue,subtlety,6,1,5
Nyhana,blackmoore,96,rogue,subtlety,6,1,5
Allydede,blackmoore,96,rogue,subtlety,6,1,5
Selfcut,blackmoore,96,rogue,subtlety,6,1,5
Kâyato,ysondre,96,rogue,subtlety,6,1,5
Nixze,tarren-mill,96,rogue,subtlety,6,1,5
Churro,the-venture-co,96,rogue,subtlety,6,1,5
Sunyshahko,doomhammer,96,rogue,subtlety,6,1,5
Yaelynn,argent-dawn,96,rogue,subtlety,6,1,5
Aasy,silvermoon,96,rogue,subtlety,6,1,5
Korteina,darkmoon-faire,96,rogue,subtlety,6,1,5
Klingo,defias-brotherhood,96,rogue,subtlety,6,1,5
Azryel,tarren-mill,96,rogue,subtlety,6,1,5
Naizo,doomhammer,96,rogue,subtlety,6,1,5
Ôrígìnälnezo,drakthul,96,rogue,subtlety,6,1,5
Qikerip,drekthar,96,rogue,subtlety,6,1,5
Deccosneak,defias-brotherhood,96,rogue,subtlety,6,1,5
Ðæmøn,tarren-mill,96,rogue,subtlety,6,1,5
Toskle,drakthul,96,rogue,subtlety,6,1,5
Xlover,silvermoon,96,rogue,subtlety,6,1,5
Shirike,kirin-tor,96,rogue,subtlety,6,1,5
Synsinte,silvermoon,96,rogue,subtlety,6,1,5
Gravmörker,defias-brotherhood,96,rogue,subtlety,6,1,5
Rûniç,draenor,96,rogue,subtlety,6,1,5
Retaya,draenor,96,rogue,subtlety,6,1,5
Orcrogue,khadgar,96,rogue,subtlety,6,1,5
Skyptor,forscherliga,96,rogue,subtlety,6,1,5
Søn,draenor,96,rogue,subtlety,6,1,5
Viezeman,aszune,96,rogue,subtlety,6,1,5
Альдинг,howling-fjord,96,rogue,subtlety,12,1,11
Nønchalan,twisting-nether,96,rogue,subtlety,12,1,11
Alefon,sanguino,96,rogue,subtlety,12,1,11
Sanguinea,minahonda,96,rogue,subtlety,12,1,11
Imbazed,azshara,96,rogue,subtlety,12,1,11
Swar,stormscale,96,rogue,subtlety,12,1,11
Azzineth,silvermoon,96,rogue,subtlety,12,1,11
Stabie,twisting-nether,96,rogue,subtlety,12,1,11
Taniks,cthun,96,rogue,subtlety,12,1,11
Lotthbrok,uldum,96,rogue,subtlety,12,1,11
Sprayze,doomhammer,96,rogue,subtlety,12,1,11
Gífti,norgannon,96,rogue,subtlety,12,1,11
Дивеас,blackscar,96,rogue,subtlety,12,1,11
Velouría,silvermoon,96,rogue,subtlety,12,1,11
Darkkstep,blackmoore,96,rogue,subtlety,12,1,11
Critneyspear,runetotem,96,rogue,subtlety,12,1,11
Bhabì,uldaman,96,rogue,subtlety,12,1,11
Максимрога,soulflayer,96,rogue,subtlety,12,1,11
Calmrusgirl,ravenholdt,96,rogue,subtlety,12,1,11
Xý,ysondre,96,rogue,subtlety,18,1,17
Gassenjunge,blackhand,96,rogue,subtlety,18,1,17
Swexlairone,outland,95,rogue,subtlety,12,1,11
Howhigh,stormscale,89,rogue,subtlety,7,3,4
Nesth,silvermoon,79,rogue,subtlety,5,1,4
Coopér,argent-dawn,79,rogue,subtlety,5,1,4
Ulaküí,zuljin,79,rogue,subtlety,5,1,4
Chabelita,ravencrest,79,rogue,subtlety,5,1,4
Viperna,blackrock,64,rogue,subtlety,4,1,3
Wenok,kazzak,64,rogue,subtlety,4,1,3
Thæñûmßêrøñê,stormscale,64,rogue,subtlety,4,1,3
Ssebii,terokkar,64,rogue,subtlety,4,1,3
Newmit,drakthul,64,rogue,subtlety,4,1,3
Kneebiter,darkmoon-faire,64,rogue,subtlety,10,1,9
Tommywright,stormscale,63,rogue,subtlety,2,2,0
Vanishkey,dun-modr,63,rogue,subtlety,2,2,0
Failtastic,defias-brotherhood,63,rogue,subtlety,2,2,0
Albumx,archimonde,58,rogue,subtlety,8,3,5
Ddlcmg,drakthul,48,rogue,subtlety,3,1,2
Glebels,burning-legion,48,rogue,subtlety,3,1,2
Хамарсон,gordunni,42,rogue,subtlety,8,3,5
Hz,marécage-de-zangar,42,rogue,subtlety,10,2,8
Kaylonetc,kazzak,42,rogue,subtlety,10,2,8
Secaboo,eredar,42,rogue,subtlety,12,2,10
Sàpik,ysondre,31,rogue,subtlety,2,1,1
Shadowhelm,silvermoon,31,rogue,subtlety,8,1,7
Nællya,archimonde,16,rogue,subtlety,1,1,0
Vlkyria,silvermoon,16,rogue,subtlety,13,1,12
Mortecieca,ravencrest,2281,rogue,assassination,209,110,99
Ewyna,silvermoon,2280,rogue,assassination,147,81,66
Mentol,stormscale,2229,rogue,assassination,113,78,35
Asàd,draenor,2197,rogue,assassination,111,57,54
Sub,kazzak,2192,rogue,assassination,236,119,117
Shadenax,ravencrest,2149,rogue,assassination,78,42,36
Rãz,stormscale,2148,rogue,assassination,84,44,40
Rightplay,outland,2143,rogue,assassination,96,49,47
Shadeniz,ravencrest,2137,rogue,assassination,113,57,56
Fánsly,silvermoon,2120,rogue,assassination,102,53,49
Aæ,stormscale,2114,rogue,assassination,204,105,99
Shadenox,ravencrest,2113,rogue,assassination,592,294,298
Heavý,argent-dawn,2111,rogue,assassination,157,82,75
Naláa,ravencrest,2107,rogue,assassination,88,45,43
Bestjkbetter,ravencrest,2093,rogue,assassination,141,70,71
Blindlol,emerald-dream,2049,rogue,assassination,319,173,146
Томасмразь,blackscar,2046,rogue,assassination,114,54,60
Shadekin,ravencrest,2004,rogue,assassination,135,72,63
Tyreall,drakthul,1991,rogue,assassination,190,96,94
Stepchildx,uldum,1980,rogue,assassination,240,150,90
Icdeadpixelz,ysondre,1980,rogue,assassination,78,37,41
Pyridoxin,blackmoore,1978,rogue,assassination,270,134,136
Wasp,twisting-nether,1949,rogue,assassination,222,119,103
Shadeco,ravencrest,1938,rogue,assassination,108,49,59
Watchmeyoe,ravencrest,1918,rogue,assassination,83,47,36
Lookåtme,ravencrest,1911,rogue,assassination,187,93,94
Aknana,vashj,1911,rogue,assassination,89,43,46
Venomblood,sanguino,1907,rogue,assassination,119,57,62
Vulrin,argent-dawn,1899,rogue,assassination,77,44,33
Buffassa,ravencrest,1887,rogue,assassination,143,81,62
Myk,xavius,1883,rogue,assassination,34,21,13
Bytoku,chants-éternels,1882,rogue,assassination,116,59,57
Visuáls,antonidas,1879,rogue,assassination,99,42,57
Botsrogue,kazzak,1868,rogue,assassination,42,24,18
Årtist,sanguino,1866,rogue,assassination,72,37,35
Rajigagi,silvermoon,1864,rogue,assassination,85,46,39
Pøóçhgøðx,archimonde,1857,rogue,assassination,59,31,28
Rivia,stormscale,1850,rogue,assassination,102,51,51
Civarea,blackrock,1849,rogue,assassination,63,29,34
Vayyel,silvermoon,1846,rogue,assassination,379,187,192
Prei,hyjal,1839,rogue,assassination,96,49,47
Baboonx,burning-legion,1839,rogue,assassination,72,31,41
Ohdaesu,aegwynn,1837,rogue,assassination,168,77,91
Gorgeousred,aegwynn,1835,rogue,assassination,54,24,30
Мирайх,howling-fjord,1834,rogue,assassination,69,31,38
Oggish,tarren-mill,1832,rogue,assassination,90,35,55
Chínerox,thunderhorn,1831,rogue,assassination,696,344,352
Cntrlld,ravencrest,1829,rogue,assassination,66,30,36
Yepuwuyepowo,defias-brotherhood,1827,rogue,assassination,90,47,43
Snøv,outland,1826,rogue,assassination,151,65,86
Grøax,ragnaros,1818,rogue,assassination,113,54,59
Скварлет,howling-fjord,1818,rogue,assassination,66,30,36
Sadgexd,draenor,1814,rogue,assassination,52,26,26
Redcutter,silvermoon,1813,rogue,assassination,52,25,27
Rubberducky,argent-dawn,1811,rogue,assassination,36,25,11
Изифаза,deathguard,1811,rogue,assassination,97,47,50
Пожилойпуп,gordunni,1811,rogue,assassination,54,26,28
Shipshot,blackrock,1809,rogue,assassination,62,37,25
Lildretch,dun-morogh,1808,rogue,assassination,63,35,28
Getownédyo,aggramar,1803,rogue,assassination,139,63,76
Deadlybrew,twisting-nether,1803,rogue,assassination,90,39,51
Eiscreme,blackmoore,1802,rogue,assassination,95,50,45
Kidneyou,ragnaros,1801,rogue,assassination,54,33,21
Afto,argent-dawn,1801,rogue,assassination,138,63,75
Çhïñêsémøñkè,argent-dawn,1800,rogue,assassination,262,139,123
Inly,ysondre,1800,rogue,assassination,140,72,68
Hèffer,outland,1797,rogue,assassination,210,110,100
Ålùnæh,azjolnerub,1797,rogue,assassination,126,61,65
Trashcarlitâ,eredar,1783,rogue,assassination,41,19,22
Слаадкий,gordunni,1780,rogue,assassination,189,92,97
Dáydreamín,draenor,1772,rogue,assassination,60,27,33
Иллвилл,soulflayer,1769,rogue,assassination,42,23,19
Gamer,aggramar,1768,rogue,assassination,78,42,36
Dnee,ravencrest,1766,rogue,assassination,29,24,5
Pheq,ravencrest,1765,rogue,assassination,83,33,50
Tsoupoma,tarren-mill,1762,rogue,assassination,90,47,43
Роземсти,gordunni,1758,rogue,assassination,272,156,116
Dropdeath,dun-modr,1756,rogue,assassination,49,26,23
Ру,galakrond,1754,rogue,assassination,60,33,27
Ридлли,soulflayer,1751,rogue,assassination,77,37,40
Naiikaii,antonidas,1751,rogue,assassination,54,23,31
Babøønx,burning-legion,1748,rogue,assassination,125,56,69
Sussulto,nemesis,1732,rogue,assassination,65,37,28
Пашавернись,gordunni,1730,rogue,assassination,109,40,69
Twitchful,kazzak,1728,rogue,assassination,72,36,36
Мастдаггер,goldrinn,1727,rogue,assassination,286,151,135
Sadgebanned,draenor,1727,rogue,assassination,49,19,30
Sumiftw,drakthul,1723,rogue,assassination,96,44,52
Kreamy,tarren-mill,1721,rogue,assassination,107,49,58
Stråt,ysondre,1719,rogue,assassination,136,59,77
Jeruna,veklor,1719,rogue,assassination,114,48,66
Gorgeousréd,aegwynn,1716,rogue,assassination,42,18,24
Kynra,culte-de-la-rive-noire,1714,rogue,assassination,35,20,15
Goshîmoshî,stormscale,1713,rogue,assassination,126,56,70
Meldbroken,tarren-mill,1709,rogue,assassination,78,39,39
Limítless,tarren-mill,1702,rogue,assassination,66,39,27
Røler,ravencrest,1702,rogue,assassination,84,37,47
Tommywright,stormscale,1701,rogue,assassination,56,29,27
Drenched,turalyon,1701,rogue,assassination,366,182,184
Lôre,blackrock,1700,rogue,assassination,59,23,36
Lastsight,burning-legion,1697,rogue,assassination,174,87,87
Altaár,dun-modr,1694,rogue,assassination,89,33,56
Moneylake,stormscale,1693,rogue,assassination,48,28,20
Rinj,antonidas,1693,rogue,assassination,89,37,52
Кайсити,gordunni,1689,rogue,assassination,84,46,38
Fìíp,drakthul,1688,rogue,assassination,104,45,59
Mazeken,kazzak,1688,rogue,assassination,53,21,32
Играючестно,howling-fjord,1686,rogue,assassination,30,19,11
Richï,outland,1686,rogue,assassination,320,152,168
Shøz,kazzak,1679,rogue,assassination,301,147,154
Killnoobs,kazzak,1675,rogue,assassination,48,24,24
Stunco,ravencrest,1674,rogue,assassination,48,23,25
Ноумингод,gordunni,1673,rogue,assassination,78,36,42
Gøldzahn,antonidas,1672,rogue,assassination,184,85,99
Ockzy,archimonde,1668,rogue,assassination,126,68,58
Awakeaf,outland,1666,rogue,assassination,146,67,79
Emergence,ravencrest,1665,rogue,assassination,54,23,31
Droomprins,stormscale,1665,rogue,assassination,66,28,38
Precious,sylvanas,1663,rogue,assassination,398,195,203
Fíìp,drakthul,1663,rogue,assassination,305,145,160
Ripgore,sylvanas,1663,rogue,assassination,76,33,43
Trollmeat,twisting-nether,1663,rogue,assassination,66,25,41
Brunhityx,ravencrest,1661,rogue,assassination,29,18,11
Monski,ravencrest,1661,rogue,assassination,66,28,38
Dådyr,silvermoon,1660,rogue,assassination,36,23,13
Ândrey,ravencrest,1657,rogue,assassination,54,31,23
Stepbrogue,tarren-mill,1655,rogue,assassination,165,86,79
Youcrymydear,outland,1654,rogue,assassination,78,35,43
Azzmodia,aegwynn,1653,rogue,assassination,48,20,28
Незблах,gordunni,1652,rogue,assassination,138,75,63
Lacusdark,draenor,1650,rogue,assassination,203,99,104
Wâter,silvermoon,1645,rogue,assassination,60,23,37
Семёнтус,gordunni,1644,rogue,assassination,96,46,50
Shikamouflé,archimonde,1643,rogue,assassination,184,93,91
Капитанпитон,howling-fjord,1643,rogue,assassination,54,24,30
Warbell,ravencrest,1643,rogue,assassination,150,64,86
Painkeeper,stormscale,1641,rogue,assassination,54,32,22
Justkiddning,blackmoore,1641,rogue,assassination,102,60,42
Форсгодх,gordunni,1640,rogue,assassination,95,38,57
Skali,tarren-mill,1639,rogue,assassination,92,45,47
Ocktwo,archimonde,1639,rogue,assassination,128,55,73
Saboteur,antonidas,1638,rogue,assassination,88,39,49
Netreck,dun-modr,1638,rogue,assassination,53,23,30
Гесху,eversong,1636,rogue,assassination,53,30,23
Совечица,gordunni,1633,rogue,assassination,54,29,25
Ghðst,stormscale,1633,rogue,assassination,41,20,21
Fatnutsac,eredar,1633,rogue,assassination,60,23,37
Sinterklaas,earthen-ring,1632,rogue,assassination,33,19,14
Загляденье,gordunni,1632,rogue,assassination,78,34,44
Yanlu,ysondre,1630,rogue,assassination,60,23,37
Kannibalex,blackrock,1627,rogue,assassination,75,35,40
Ридх,soulflayer,1627,rogue,assassination,93,43,50
Juxtapose,ravencrest,1627,rogue,assassination,66,28,38
Кэпс,blackscar,1625,rogue,assassination,66,39,27
Defiasrogue,blackmoore,1625,rogue,assassination,158,85,73
Blawann,argent-dawn,1625,rogue,assassination,48,23,25
Zerocell,kazzak,1624,rogue,assassination,218,121,97
Howfastiam,ravencrest,1624,rogue,assassination,108,55,53
Мистеркрэпс,howling-fjord,1624,rogue,assassination,47,19,28
Erdin,ravencrest,1623,rogue,assassination,36,20,16
Костялом,howling-fjord,1623,rogue,assassination,36,17,19
Uzrigu,tarren-mill,1621,rogue,assassination,54,29,25
Sid,dentarg,1621,rogue,assassination,209,111,98
Ваася,gordunni,1620,rogue,assassination,177,83,94
Лорб,howling-fjord,1619,rogue,assassination,71,34,37
Awaaylol,stormscale,1619,rogue,assassination,243,115,128
Yopti,tarren-mill,1616,rogue,assassination,167,70,97
Акиоми,gordunni,1615,rogue,assassination,119,63,56
Keeke,outland,1615,rogue,assassination,90,46,44
Shookyz,zuljin,1615,rogue,assassination,54,27,27
Iwillcapyou,twisting-nether,1614,rogue,assassination,54,25,29
Rindar,dun-modr,1613,rogue,assassination,70,38,32
Axlrows,doomhammer,1613,rogue,assassination,107,58,49
Войенх,gordunni,1612,rogue,assassination,319,155,164
Vâleera,kazzak,1612,rogue,assassination,78,36,42
Únk,dalaran,1611,rogue,assassination,63,32,31
Мипанка,gordunni,1611,rogue,assassination,76,25,51
Dían,ravencrest,1610,rogue,assassination,205,102,103
Amý,grim-batol,1610,rogue,assassination,75,36,39
Orcrogue,khadgar,1609,rogue,assassination,35,21,14
Варэль,borean-tundra,1609,rogue,assassination,411,205,206
Hopejé,ravencrest,1608,rogue,assassination,228,121,107
Ooqu,silvermoon,1607,rogue,assassination,54,30,24
Lelíth,ravencrest,1607,rogue,assassination,161,89,72
Hanzo,vashj,1607,rogue,assassination,178,82,96
Cander,kazzak,1607,rogue,assassination,107,49,58
Шмарамышь,soulflayer,1606,rogue,assassination,202,104,98
Quoicoubeh,drekthar,1606,rogue,assassination,53,27,26
Асиксх,blackscar,1604,rogue,assassination,251,133,118
Саэрас,howling-fjord,1604,rogue,assassination,54,24,30
Sotro,dun-modr,1604,rogue,assassination,130,56,74
Tiazx,outland,1603,rogue,assassination,45,23,22
Ач,gordunni,1602,rogue,assassination,78,37,41
Sadìra,echsenkessel,1602,rogue,assassination,75,35,40
Peeon,drakthul,1602,rogue,assassination,79,26,53
Nîllá,blackmoore,1600,rogue,assassination,42,18,24
Wayñe,ravencrest,1600,rogue,assassination,48,19,29
Soulshank,ragnaros,1598,rogue,assassination,30,19,11
Мелеша,blackscar,1595,rogue,assassination,59,21,38
Crenx,draenor,1591,rogue,assassination,59,20,39
Ândrey,stormscale,1584,rogue,assassination,64,34,30
Lanewuquvi,alonsus,1584,rogue,assassination,89,42,47
Piperx,ravencrest,1583,rogue,assassination,66,21,45
Hoodrogue,blackrock,1580,rogue,assassination,59,32,27
Negrim,dun-modr,1579,rogue,assassination,185,95,90
Misttrogue,hyjal,1576,rogue,assassination,72,33,39
Dirtyz,dun-modr,1572,rogue,assassination,195,107,88
ßênz,archimonde,1572,rogue,assassination,126,65,61
Kãlí,blackmoore,1570,rogue,assassination,271,135,136
Zlah,ravencrest,1570,rogue,assassination,58,22,36
Ladixy,archimonde,1568,rogue,assassination,62,21,41
Artésia,archimonde,1566,rogue,assassination,105,58,47
Стеллакокс,howling-fjord,1564,rogue,assassination,92,44,48
Рэкрейвон,gordunni,1562,rogue,assassination,48,21,27
Miiløx,silvermoon,1560,rogue,assassination,96,51,45
Knutten,wildhammer,1556,rogue,assassination,144,69,75
Dé,ragnaros,1555,rogue,assassination,119,59,60
Minjeaca,silvermoon,1552,rogue,assassination,150,72,78
Liøø,antonidas,1551,rogue,assassination,130,65,65
Åd,stormreaver,1543,rogue,assassination,60,24,36
Synergize,stormreaver,1542,rogue,assassination,281,138,143
Köna,archimonde,1539,rogue,assassination,42,17,25
Silesi,kazzak,1538,rogue,assassination,154,81,73
Vaze,ravencrest,1538,rogue,assassination,65,33,32
Ритор,deathguard,1536,rogue,assassination,72,36,36
Nÿst,khaz-modan,1536,rogue,assassination,35,17,18
Cloak,blackrock,1536,rogue,assassination,48,22,26
Myk,frostmane,1534,rogue,assassination,30,16,14
Schníttchen,antonidas,1527,rogue,assassination,47,21,26
Koreanrogue,archimonde,1525,rogue,assassination,36,21,15
Зоти,lich-king,1525,rogue,assassination,56,27,29
Shaokiz,sylvanas,1523,rogue,assassination,54,29,25
Lannon,sylvanas,1522,rogue,assassination,129,58,71
Reáper,frostwolf,1521,rogue,assassination,124,65,59
Somaliapirat,eredar,1520,rogue,assassination,36,17,19
Фуллблайнд,gordunni,1518,rogue,assassination,62,23,39
Ilrunne,silvermoon,1515,rogue,assassination,132,62,70
Flogue,area-52,1514,rogue,assassination,79,30,49
Obstechhawi,argent-dawn,1510,rogue,assassination,72,28,44
Weakrat,kult-der-verdammten,1508,rogue,assassination,36,22,14
Ñerøblacks,dun-modr,1507,rogue,assassination,30,16,14
Йа,gordunni,1506,rogue,assassination,80,41,39
Ethèrnal,twisting-nether,1506,rogue,assassination,153,73,80
Путьказаха,gordunni,1505,rogue,assassination,42,25,17
Bakalan,dun-modr,1504,rogue,assassination,48,18,30
Belsazar,azshara,1501,rogue,assassination,180,91,89
Nùgz,area-52,1498,rogue,assassination,119,65,54
Bigpeanuts,ragnaros,1497,rogue,assassination,30,21,9
Пусякиллерх,gordunni,1497,rogue,assassination,127,54,73
Diazz,aegwynn,1496,rogue,assassination,142,68,74
Stèálth,twisting-nether,1494,rogue,assassination,53,27,26
Deathlix,haomarush,1494,rogue,assassination,72,30,42
Zajiielf,eredar,1489,rogue,assassination,61,29,32
Heartripper,ravencrest,1486,rogue,assassination,105,50,55
Argapu,stormscale,1486,rogue,assassination,138,61,77
Lefthook,argent-dawn,1484,rogue,assassination,70,27,43
Mascarpone,sanguino,1482,rogue,assassination,131,64,67
Лестреа,goldrinn,1481,rogue,assassination,48,24,24
Zence,blackrock,1478,rogue,assassination,113,59,54
Трисися,gordunni,1478,rogue,assassination,66,32,34
Lipschitz,outland,1477,rogue,assassination,78,29,49
Cørek,blackhand,1475,rogue,assassination,24,16,8
Редфилд,blackscar,1472,rogue,assassination,95,49,46
Alnaddafrog,outland,1470,rogue,assassination,70,43,27
Mâriejânee,nozdormu,1469,rogue,assassination,90,52,38
Fílìp,drakthul,1468,rogue,assassination,28,19,9
Zaintsas,tarren-mill,1468,rogue,assassination,98,48,50
Nevagonagiv,archimonde,1462,rogue,assassination,36,17,19
Npkx,outland,1460,rogue,assassination,72,30,42
Ephalia,draenor,1458,rogue,assassination,291,144,147
Czêro,grim-batol,1456,rogue,assassination,47,22,25
Yvÿ,archimonde,1455,rogue,assassination,154,85,69
Xeeana,ravencrest,1453,rogue,assassination,312,158,154
Vicxx,ravencrest,1453,rogue,assassination,72,28,44
Волнорес,eversong,1451,rogue,assassination,124,62,62
Nitröx,tarren-mill,1446,rogue,assassination,83,31,52
Sneakypeeki,sylvanas,1444,rogue,assassination,41,18,23
Grzech,burning-legion,1443,rogue,assassination,82,44,38
Лёнтролль,blackscar,1441,rogue,assassination,153,75,78
Luftpumpe,blackrock,1438,rogue,assassination,69,39,30
Recondite,doomhammer,1438,rogue,assassination,86,48,38
Arkblenderx,silvermoon,1438,rogue,assassination,123,63,60
Intrix,draenor,1438,rogue,assassination,48,16,32
Intecto,twisting-nether,1437,rogue,assassination,160,85,75
Zizmo,deathwing,1435,rogue,assassination,124,56,68
Tyräel,burning-blade,1434,rogue,assassination,41,15,26
Axoic,ravencrest,1433,rogue,assassination,48,23,25
Tmpkboo,stormscale,1433,rogue,assassination,36,15,21
Ppollito,hyjal,1430,rogue,assassination,132,67,65
Reyzumi,antonidas,1430,rogue,assassination,66,31,35
Hidinginash,twisting-nether,1428,rogue,assassination,68,35,33
Дым,eversong,1426,rogue,assassination,24,15,9
Nìghtwalker,ravencrest,1426,rogue,assassination,70,34,36
Rnghero,blackmoore,1426,rogue,assassination,54,15,39
Jimmybrä,draenor,1424,rogue,assassination,34,16,18
Madiv,kazzak,1423,rogue,assassination,60,28,32
Кайдарра,eversong,1422,rogue,assassination,132,69,63
Poerta,burning-blade,1422,rogue,assassination,102,40,62
Unshaken,dun-modr,1421,rogue,assassination,66,25,41
Yokze,ravencrest,1417,rogue,assassination,169,85,84
Nællya,archimonde,1416,rogue,assassination,95,54,41
Nâtaz,eredar,1416,rogue,assassination,30,15,15
Vennomous,darkspear,1414,rogue,assassination,231,115,116
Ракфорн,howling-fjord,1413,rogue,assassination,127,71,56
Элирэй,fordragon,1413,rogue,assassination,129,61,68
Ropedrink,stormscale,1409,rogue,assassination,36,22,14
Pieksig,blackmoore,1409,rogue,assassination,131,61,70
Fálke,dun-modr,1408,rogue,assassination,66,23,43
Caská,blackhand,1405,rogue,assassination,89,39,50
Finanzamtlg,blackrock,1404,rogue,assassination,78,40,38
Аренамастерх,blackscar,1402,rogue,assassination,24,15,9
Synthaetic,draenor,1401,rogue,assassination,130,69,61
Ванэйти,gordunni,1396,rogue,assassination,108,54,54
Sneakysloth,ravencrest,1396,rogue,assassination,93,42,51
Бонасера,blackscar,1393,rogue,assassination,195,95,100
Oljebrunn,stormscale,1393,rogue,assassination,77,37,40
Breuss,elune,1393,rogue,assassination,36,16,20
Нарежудольки,howling-fjord,1393,rogue,assassination,42,15,27
Teseiga,aegwynn,1392,rogue,assassination,250,115,135
Freemmr,draenor,1391,rogue,assassination,118,61,57
Stellaä,ragnaros,1390,rogue,assassination,54,18,36
Zeuzo,xavius,1389,rogue,assassination,203,104,99
Wardrin,twisting-nether,1389,rogue,assassination,51,16,35
Soxo,dun-modr,1388,rogue,assassination,134,57,77
Траста,fordragon,1388,rogue,assassination,132,56,76
Lírìa,argent-dawn,1387,rogue,assassination,53,25,28
Givewallet,ravencrest,1385,rogue,assassination,48,25,23
Yassu,archimonde,1385,rogue,assassination,36,18,18
Erion,silvermoon,1384,rogue,assassination,210,99,111
Vanisha,outland,1381,rogue,assassination,153,76,77
Umciz,archimonde,1381,rogue,assassination,42,15,27
Roguening,tarren-mill,1381,rogue,assassination,65,23,42
Kuribo,gorgonnash,1380,rogue,assassination,42,20,22
Effectz,ravencrest,1377,rogue,assassination,155,81,74
Мечтавелена,howling-fjord,1377,rogue,assassination,195,96,99
Вудстер,blackscar,1377,rogue,assassination,41,17,24
Piñotxo,sanguino,1373,rogue,assassination,53,23,30
Ciaordel,sylvanas,1372,rogue,assassination,75,36,39
Bambush,bronze-dragonflight,1371,rogue,assassination,136,70,66
Crroustibat,dalaran,1371,rogue,assassination,72,35,37
Ynohtna,blackhand,1371,rogue,assassination,128,62,66
Pizzayamyam,aegwynn,1371,rogue,assassination,78,36,42
Хулиганнчег,galakrond,1370,rogue,assassination,39,18,21
Jsprxo,stormscale,1369,rogue,assassination,42,23,19
Crípplé,ravencrest,1369,rogue,assassination,30,15,15
Винерджи,gordunni,1369,rogue,assassination,103,51,52
Protpaladin,sylvanas,1369,rogue,assassination,123,60,63
Éllen,outland,1369,rogue,assassination,138,63,75
Lycosidae,doomhammer,1366,rogue,assassination,36,16,20
Zobrak,twisting-nether,1362,rogue,assassination,128,64,64
Candycc,burning-legion,1361,rogue,assassination,159,80,79
Síns,runetotem,1359,rogue,assassination,49,27,22
Haikyu,blackhand,1354,rogue,assassination,72,31,41
Andry,drakthul,1352,rogue,assassination,48,20,28
Cýphia,amanthul,1351,rogue,assassination,69,32,37
Education,aegwynn,1350,rogue,assassination,48,18,30
Гарднэр,soulflayer,1349,rogue,assassination,107,57,50
Sáinz,malganis,1347,rogue,assassination,112,55,57
Djnelly,stormreaver,1345,rogue,assassination,81,48,33
Axelaz,ravencrest,1344,rogue,assassination,18,14,4
Biianca,sylvanas,1342,rogue,assassination,36,15,21
Zyrogue,silvermoon,1341,rogue,assassination,24,15,9
Niapro,dun-morogh,1340,rogue,assassination,35,19,16
Shoukoub,silvermoon,1339,rogue,assassination,72,43,29
Yoruichì,kazzak,1337,rogue,assassination,42,23,19
Icedoutoak,antonidas,1337,rogue,assassination,46,24,22
Винестрий,soulflayer,1337,rogue,assassination,93,40,53
Grüeßseebach,todeswache,1337,rogue,assassination,42,18,24
Pathicus,stormreaver,1336,rogue,assassination,160,82,78
Skiff,argent-dawn,1336,rogue,assassination,53,22,31
Skrbke,tarren-mill,1335,rogue,assassination,210,110,100
Jumbovanish,tarren-mill,1335,rogue,assassination,87,42,45
Trollohlol,malganis,1334,rogue,assassination,102,53,49
Soukalamink,tarren-mill,1334,rogue,assassination,64,21,43
Ambushgirl,ravencrest,1333,rogue,assassination,153,68,85
Stabbinu,burning-legion,1332,rogue,assassination,30,14,16
Geludor,alonsus,1332,rogue,assassination,40,17,23
Nightnelly,archimonde,1331,rogue,assassination,30,14,16
Tarox,eredar,1330,rogue,assassination,143,71,72
Bensollo,tarren-mill,1330,rogue,assassination,35,16,19
Koopa,argent-dawn,1330,rogue,assassination,54,14,40
Shadôwcraft,outland,1329,rogue,assassination,81,42,39
Gløck,die-aldor,1328,rogue,assassination,64,32,32
Nuguri,blackrock,1326,rogue,assassination,75,37,38
Кэзам,soulflayer,1325,rogue,assassination,31,15,16
Xãwé,kazzak,1324,rogue,assassination,35,16,19
Gutter,sylvanas,1320,rogue,assassination,36,14,22
Эстанга,grom,1318,rogue,assassination,42,16,26
Stôrpîx,drakthul,1317,rogue,assassination,96,46,50
Markø,twisting-nether,1316,rogue,assassination,104,47,57
Jaxck,sylvanas,1314,rogue,assassination,24,14,10
Замлур,booty-bay,1314,rogue,assassination,42,23,19
Keltaru,ravencrest,1312,rogue,assassination,42,16,26
Ganzord,dun-modr,1310,rogue,assassination,47,25,22
Stonecold,twilights-hammer,1310,rogue,assassination,52,20,32
Sigleif,argent-dawn,1309,rogue,assassination,61,28,33
Watzoqt,archimonde,1307,rogue,assassination,33,15,18
Dalailamer,gorgonnash,1306,rogue,assassination,80,35,45
Войтенко,gordunni,1303,rogue,assassination,113,58,55
Rawryy,blackmoore,1303,rogue,assassination,36,17,19
Narzaván,ravencrest,1301,rogue,assassination,139,65,74
Søsaboy,nemesis,1301,rogue,assassination,64,29,35
Davotroz,dun-modr,1300,rogue,assassination,68,35,33
Zèph,outland,1300,rogue,assassination,60,30,30
Lamøerte,hyjal,1300,rogue,assassination,60,22,38
Dæadly,archimonde,1299,rogue,assassination,64,29,35
Сасасин,soulflayer,1298,rogue,assassination,155,80,75
Lùxtrà,antonidas,1298,rogue,assassination,58,28,30
Taatzz,stormscale,1295,rogue,assassination,42,23,19
Pitøu,outland,1295,rogue,assassination,150,78,72
Gadûz,kazzak,1295,rogue,assassination,44,17,27
Flawlesser,kazzak,1294,rogue,assassination,39,19,20
Патайчик,soulflayer,1294,rogue,assassination,91,44,47
Watodoo,kazzak,1293,rogue,assassination,140,67,73
Эксплис,ashenvale,1290,rogue,assassination,91,41,50
Анми,gordunni,1288,rogue,assassination,35,14,21
Loubina,silvermoon,1287,rogue,assassination,36,16,20
Petsakos,ravencrest,1287,rogue,assassination,65,25,40
Stin,blackrock,1284,rogue,assassination,77,34,43
Batsu,alleria,1276,rogue,assassination,72,30,42
Nialas,kirin-tor,1275,rogue,assassination,45,17,28
Satiiva,terokkar,1274,rogue,assassination,78,36,42
Lixht,the-maelstrom,1273,rogue,assassination,66,34,32
Mahistt,archimonde,1270,rogue,assassination,59,32,27
Rhak,malganis,1270,rogue,assassination,155,74,81
Eizan,outland,1268,rogue,assassination,111,51,60
Poughkeepsie,outland,1265,rogue,assassination,65,32,33
Shersh,hyjal,1265,rogue,assassination,36,16,20
Izze,thrall,1265,rogue,assassination,48,17,31
Akira,outland,1262,rogue,assassination,69,34,35
Sisoi,kazzak,1262,rogue,assassination,131,62,69
Tez,malganis,1262,rogue,assassination,149,66,83
Элиссенда,deathguard,1260,rogue,assassination,34,18,16
Veronkierto,stormreaver,1259,rogue,assassination,78,42,36
Amhaia,twisting-nether,1255,rogue,assassination,124,57,67
Менрэйз,gordunni,1255,rogue,assassination,54,22,32
Griveous,kazzak,1252,rogue,assassination,32,18,14
Aleary,ravencrest,1250,rogue,assassination,36,21,15
Brñ,ravencrest,1248,rogue,assassination,18,13,5
Penita,aegwynn,1248,rogue,assassination,24,14,10
Snulle,ravencrest,1248,rogue,assassination,24,13,11
Whaazz,ravencrest,1248,rogue,assassination,24,13,11
Евгенийильич,gordunni,1247,rogue,assassination,24,13,11
Pridå,thrall,1247,rogue,assassination,30,13,17
Mtb,ravencrest,1245,rogue,assassination,30,13,17
Stabdbyvegan,ragnaros,1245,rogue,assassination,79,31,48
Nojdobra,tarren-mill,1244,rogue,assassination,67,28,39
Freijasap,ravencrest,1243,rogue,assassination,30,13,17
Имилиона,blackscar,1242,rogue,assassination,61,31,30
Келгар,soulflayer,1242,rogue,assassination,63,27,36
Maedyv,magtheridon,1241,rogue,assassination,36,17,19
Synsinte,silvermoon,1240,rogue,assassination,30,16,14
Mexxn,antonidas,1240,rogue,assassination,43,20,23
Meimei,sanguino,1240,rogue,assassination,36,13,23
Dime,silvermoon,1239,rogue,assassination,90,47,43
Blacklife,sanguino,1237,rogue,assassination,57,23,34
Mewen,sanguino,1233,rogue,assassination,30,13,17
Dîspatchx,defias-brotherhood,1232,rogue,assassination,208,97,111
Raetoc,turalyon,1231,rogue,assassination,54,26,28
Horvathzu,ravencrest,1231,rogue,assassination,62,28,34
Jamesdarmody,twisting-nether,1230,rogue,assassination,52,24,28
Streetx,nethersturm,1226,rogue,assassination,48,25,23
Bauwten,ravencrest,1226,rogue,assassination,54,28,26
Abush,ravencrest,1226,rogue,assassination,65,29,36
Rahes,stormscale,1225,rogue,assassination,360,172,188
Gankbang,frostmane,1225,rogue,assassination,54,21,33
Maløcøxysse,dalaran,1224,rogue,assassination,158,69,89
Nukubu,draenor,1224,rogue,assassination,88,35,53
Areldis,drakthul,1223,rogue,assassination,38,19,19
Nopz,outland,1221,rogue,assassination,59,33,26
Noxxra,blackhand,1221,rogue,assassination,67,27,40
Mystykal,twisting-nether,1221,rogue,assassination,48,19,29
Solocarnage,hyjal,1219,rogue,assassination,102,45,57
Сайгакк,galakrond,1217,rogue,assassination,64,32,32
Dahlinska,ravencrest,1216,rogue,assassination,54,22,32
Ноубрэйкс,blackscar,1214,rogue,assassination,120,59,61
Babysteps,the-maelstrom,1212,rogue,assassination,28,15,13
Экичу,howling-fjord,1210,rogue,assassination,60,35,25
Szabina,outland,1210,rogue,assassination,24,13,11
Свёклапро,gordunni,1210,rogue,assassination,118,60,58
Runár,proudmoore,1210,rogue,assassination,28,14,14
Behind,agamaggan,1210,rogue,assassination,34,16,18
Revelith,nemesis,1209,rogue,assassination,41,19,22
Drillss,ravencrest,1209,rogue,assassination,46,14,32
Epidemic,stormscale,1207,rogue,assassination,304,147,157
Nargun,archimonde,1206,rogue,assassination,36,21,15
Ordwin,silvermoon,1205,rogue,assassination,68,29,39
Bennyweth,argent-dawn,1205,rogue,assassination,42,16,26
Gðrdø,blackrock,1204,rogue,assassination,38,16,22
Phaîne,outland,1201,rogue,assassination,36,16,20
Röllz,ysondre,1199,rogue,assassination,72,28,44
Maelithas,archimonde,1197,rogue,assassination,83,38,45
Lovetospoon,ravencrest,1196,rogue,assassination,90,51,39
Davosslol,outland,1196,rogue,assassination,36,13,23
Практикиней,grom,1195,rogue,assassination,102,50,52
Næylá,kult-der-verdammten,1195,rogue,assassination,168,81,87
Kariinthuul,aegwynn,1195,rogue,assassination,92,42,50
Lorena,ravencrest,1192,rogue,assassination,29,14,15
Madlain,jaedenar,1189,rogue,assassination,97,44,53
Jazhz,archimonde,1188,rogue,assassination,36,19,17
Комедиантт,gordunni,1188,rogue,assassination,29,15,14
Sùbzerø,archimonde,1186,rogue,assassination,23,13,10
Фиксдпс,lich-king,1185,rogue,assassination,30,13,17
Cbrook,sylvanas,1184,rogue,assassination,35,13,22
Gereon,drakthul,1183,rogue,assassination,34,15,19
Vengígodx,outland,1182,rogue,assassination,66,34,32
Shadowcralls,blackmoore,1182,rogue,assassination,47,15,32
Hallogenic,silvermoon,1181,rogue,assassination,54,24,30
Деравар,deathguard,1181,rogue,assassination,34,13,21
Darkkstep,blackmoore,1178,rogue,assassination,42,15,27
Bødýchëck,blackmoore,1177,rogue,assassination,27,15,12
Тимкок,soulflayer,1176,rogue,assassination,120,52,68
Stælf,argent-dawn,1176,rogue,assassination,52,21,31
Havox,darksorrow,1175,rogue,assassination,42,19,23
Цилана,gordunni,1173,rogue,assassination,170,87,83
Azovrouge,terokkar,1172,rogue,assassination,30,18,12
Sladen,ghostlands,1172,rogue,assassination,30,14,16
Imdma,defias-brotherhood,1170,rogue,assassination,116,64,52
Swarge,silvermoon,1157,rogue,assassination,419,205,214
Zeduxino,outland,1156,rogue,assassination,28,17,11
Фикция,greymane,1151,rogue,assassination,70,25,45
Sâtýr,ravencrest,1150,rogue,assassination,18,12,6
Djpiglet,outland,1149,rogue,assassination,18,12,6
Ravenouz,thrall,1149,rogue,assassination,24,12,12
Narsoule,ysondre,1147,rogue,assassination,82,40,42
Mewen,dun-modr,1147,rogue,assassination,36,12,24
Chalkbag,blackrock,1146,rogue,assassination,59,23,36
Unterweger,die-aldor,1145,rogue,assassination,23,13,10
Jupitor,argent-dawn,1145,rogue,assassination,150,77,73
Behörnchen,eredar,1145,rogue,assassination,59,23,36
Nightyx,blackmoore,1144,rogue,assassination,24,12,12
Носопыра,blackscar,1142,rogue,assassination,179,90,89
Bläde,outland,1141,rogue,assassination,18,12,6
Zsofia,ravencrest,1141,rogue,assassination,30,12,18
Bronxbomber,tarren-mill,1140,rogue,assassination,24,12,12
Sinoptika,draenor,1139,rogue,assassination,24,12,12
Rîg,draenor,1139,rogue,assassination,30,12,18
Nevelon,chogall,1138,rogue,assassination,188,90,98
Nàrutò,thrall,1138,rogue,assassination,112,43,69
Скулипёс,howling-fjord,1137,rogue,assassination,58,31,27
Bonejaw,tarren-mill,1137,rogue,assassination,30,14,16
Banaulikode,twisting-nether,1136,rogue,assassination,30,12,18
Kronin,arakarahm,1135,rogue,assassination,90,36,54
Finisher,sanguino,1134,rogue,assassination,48,23,25
Kuttunga,ravencrest,1134,rogue,assassination,85,39,46
Zokush,archimonde,1134,rogue,assassination,39,15,24
Dredge,kaelthas,1132,rogue,assassination,72,31,41
Vickerogue,stormreaver,1131,rogue,assassination,30,14,16
Hmwow,kazzak,1130,rogue,assassination,41,16,25
Gigarogue,defias-brotherhood,1129,rogue,assassination,53,24,29
Daggerz,outland,1128,rogue,assassination,24,12,12
Tootskie,outland,1128,rogue,assassination,126,59,67
Rxqz,ysera,1127,rogue,assassination,24,12,12
Dykumah,sanguino,1124,rogue,assassination,36,17,19
Kaigodd,twisting-nether,1123,rogue,assassination,105,63,42
Mallaurya,dalaran,1120,rogue,assassination,30,12,18
Myk,ravencrest,1119,rogue,assassination,23,12,11
Missesinvis,blackmoore,1118,rogue,assassination,25,14,11
Krimos,archimonde,1118,rogue,assassination,84,45,39
Белунчус,howling-fjord,1116,rogue,assassination,48,26,22
Iwannacry,kazzak,1114,rogue,assassination,29,12,17
Elysm,stormscale,1112,rogue,assassination,68,35,33
Vathié,twisting-nether,1112,rogue,assassination,30,12,18
Jæto,ravencrest,1110,rogue,assassination,33,17,16
Поздоровайся,howling-fjord,1110,rogue,assassination,174,85,89
Sênsus,antonidas,1110,rogue,assassination,54,21,33
Edaniel,draenor,1109,rogue,assassination,24,12,12
Donjules,silvermoon,1109,rogue,assassination,199,91,108
Whiss,blackmoore,1108,rogue,assassination,30,15,15
Rundarz,tyrande,1108,rogue,assassination,29,12,17
Psychoxygen,nemesis,1108,rogue,assassination,29,12,17
Raîzen,sargeras,1105,rogue,assassination,36,14,22
Oshä,dalaran,1102,rogue,assassination,30,13,17
Artyzoo,tarren-mill,1100,rogue,assassination,40,18,22
Elûnè,silvermoon,1097,rogue,assassination,30,14,16
Azonaticus,hyjal,1096,rogue,assassination,34,16,18
Réäpèr,sylvanas,1094,rogue,assassination,39,13,26
Ámbush,sylvanas,1092,rogue,assassination,44,13,31
Lesale,turalyon,1088,rogue,assassination,66,34,32
Sorea,twisting-nether,1087,rogue,assassination,126,61,65
Gravestam,sunstrider,1085,rogue,assassination,36,17,19
Shoshomoo,lightnings-blade,1085,rogue,assassination,27,12,15
Tulipe,kaelthas,1084,rogue,assassination,30,16,14
Horrogue,aggramar,1081,rogue,assassination,41,21,20
Kampon,sanguino,1081,rogue,assassination,40,16,24
Orochi,ravencrest,1080,rogue,assassination,48,21,27
Folzen,archimonde,1079,rogue,assassination,34,12,22
Undîsputed,blackmoore,1074,rogue,assassination,45,15,30
Rogunelf,stormreaver,1073,rogue,assassination,74,39,35
Mol,defias-brotherhood,1070,rogue,assassination,38,12,26
Laojin,kiljaeden,1069,rogue,assassination,22,12,10
Viciousvouts,frostwhisper,1068,rogue,assassination,30,15,15
Kirby,kaelthas,1066,rogue,assassination,25,12,13
Чернаясоска,eversong,1064,rogue,assassination,125,67,58
Nighteshift,silvermoon,1064,rogue,assassination,36,14,22
Giftknirps,silvermoon,1062,rogue,assassination,30,15,15
Rascall,anetheron,1059,rogue,assassination,26,13,13
Фанкироуг,soulflayer,1058,rogue,assassination,42,20,22
Utis,kazzak,1058,rogue,assassination,42,18,24
Firekry,stormscale,1057,rogue,assassination,30,12,18
Qwneêr,tarren-mill,1056,rogue,assassination,24,11,13
Undxrwrld,sylvanas,1055,rogue,assassination,18,11,7
Dezxxyox,dun-modr,1055,rogue,assassination,173,93,80
Pekszcze,ravencrest,1054,rogue,assassination,18,11,7
Аязлаая,blackscar,1054,rogue,assassination,36,11,25
Jimaal,stormscale,1051,rogue,assassination,30,11,19
Æsthaetic,silvermoon,1050,rogue,assassination,24,11,13
Azhothz,argent-dawn,1049,rogue,assassination,24,12,12
Batta,drakthul,1047,rogue,assassination,24,11,13
Йоио,howling-fjord,1047,rogue,assassination,24,11,13
Juelz,ravencrest,1047,rogue,assassination,36,11,25
Hasansabbah,twisting-nether,1045,rogue,assassination,30,11,19
Zélla,twisting-nether,1044,rogue,assassination,24,11,13
Opiïum,ysondre,1042,rogue,assassination,24,13,11
Дисхар,soulflayer,1042,rogue,assassination,34,15,19
Tubes,dun-morogh,1041,rogue,assassination,50,30,20
Boskönigt,ragnaros,1041,rogue,assassination,97,47,50
Pasarelo,dun-modr,1041,rogue,assassination,95,45,50
Ashami,genjuros,1040,rogue,assassination,33,15,18
Refundlands,kazzak,1040,rogue,assassination,37,14,23
Îüçkÿmêñ,outland,1039,rogue,assassination,18,11,7
Колдрейдж,soulflayer,1039,rogue,assassination,18,11,7
Sæqq,blackmoore,1038,rogue,assassination,54,22,32
Subyo,eredar,1038,rogue,assassination,30,11,19
Leÿji,archimonde,1038,rogue,assassination,42,15,27
Chiàntì,blackrock,1037,rogue,assassination,185,88,97
Alpinestars,dun-modr,1037,rogue,assassination,29,12,17
Гаддюка,howling-fjord,1036,rogue,assassination,56,28,28
Gloomykenny,tarren-mill,1036,rogue,assassination,24,11,13
Ядорадура,eversong,1036,rogue,assassination,24,11,13
Оскархартман,gordunni,1029,rogue,assassination,66,32,34
Rektbywomen,ravencrest,1029,rogue,assassination,38,17,21
Seleyese,draenor,1027,rogue,assassination,36,15,21
Imissmop,darkspear,1026,rogue,assassination,30,11,19
Мяуровани,eversong,1025,rogue,assassination,30,16,14
Gamôra,arygos,1022,rogue,assassination,341,166,175
Tre,eredar,1021,rogue,assassination,50,23,27
Ingesa,blackhand,1019,rogue,assassination,110,50,60
Паштетмашин,booty-bay,1017,rogue,assassination,83,44,39
Килларан,howling-fjord,1017,rogue,assassination,65,27,38
Dmfd,darksorrow,1016,rogue,assassination,343,168,175
Bandìt,ravencrest,1015,rogue,assassination,93,30,63
Айвонарак,howling-fjord,1014,rogue,assassination,36,13,23
Балуса,thermaplugg,1011,rogue,assassination,84,33,51
Alltaïr,ravencrest,1007,rogue,assassination,151,76,75
Scorpionkk,blackrock,1006,rogue,assassination,546,260,286
Лунари,blackscar,1006,rogue,assassination,107,46,61
Кэйлфрут,gordunni,1005,rogue,assassination,222,103,119
Suley,blackrock,1004,rogue,assassination,35,16,19
Engetiran,defias-brotherhood,1004,rogue,assassination,66,18,48
Клозо,galakrond,1000,rogue,assassination,29,11,18
Джоннималыш,eversong,999,rogue,assassination,66,30,36
Kuxion,zuljin,993,rogue,assassination,48,24,24
Rwaphou,ysondre,992,rogue,assassination,36,18,18
Haregan,gorgonnash,991,rogue,assassination,24,14,10
Tirgo,aegwynn,991,rogue,assassination,210,105,105
Grris,stormscale,991,rogue,assassination,22,11,11
Майндтрикс,blackscar,991,rogue,assassination,26,11,15
Zzippi,blackmoore,987,rogue,assassination,49,20,29
Gordous,ysondre,984,rogue,assassination,36,11,25
Nhox,garona,983,rogue,assassination,42,18,24
Gimzir,archimonde,982,rogue,assassination,25,11,14
Julyshadows,kazzak,974,rogue,assassination,84,38,46
Astefion,dalaran,966,rogue,assassination,54,13,41
Zóhaz,burning-legion,965,rogue,assassination,42,11,31
Veliza,twisting-nether,962,rogue,assassination,91,37,54
Shadowprank,ravencrest,960,rogue,assassination,21,10,11
Madisonivyqt,blackmoore,960,rogue,assassination,30,10,20
Ежикх,soulflayer,960,rogue,assassination,30,10,20
Ладжо,gordunni,959,rogue,assassination,30,10,20
Katakuri,stormscale,959,rogue,assassination,30,10,20
Miistermaen,outland,959,rogue,assassination,30,10,20
Løuvees,archimonde,958,rogue,assassination,88,45,43
Jústina,die-aldor,958,rogue,assassination,109,51,58
Mackíe,antonidas,958,rogue,assassination,57,24,33
Speedhackarn,jaedenar,958,rogue,assassination,24,10,14
Tallac,drekthar,958,rogue,assassination,24,10,14
Chatbann,blackrock,958,rogue,assassination,24,10,14
Dilemma,zuljin,958,rogue,assassination,24,10,14
Xalupa,dun-modr,957,rogue,assassination,24,10,14
Câ,outland,956,rogue,assassination,24,10,14
Brazi,dalaran,955,rogue,assassination,24,10,14
Grimv,frostmane,955,rogue,assassination,24,10,14
Eightball,frostmane,954,rogue,assassination,18,10,8
Gârrík,blackhand,954,rogue,assassination,18,10,8
Shènz,ysondre,954,rogue,assassination,24,10,14
Skids,ravencrest,952,rogue,assassination,18,10,8
Tênsion,silvermoon,951,rogue,assassination,18,10,8
Sørä,ragnaros,951,rogue,assassination,45,23,22
Кремдлявек,gordunni,950,rogue,assassination,47,14,33
Beistrichbob,terrordar,949,rogue,assassination,42,20,22
Gaius,zuljin,946,rogue,assassination,52,15,37
Wedgyrog,stormscale,944,rogue,assassination,125,51,74
Deadchivalry,argent-dawn,942,rogue,assassination,24,10,14
Madita,frostmourne,942,rogue,assassination,42,11,31
Mingzhu,ravencrest,941,rogue,assassination,30,10,20
Delaster,blackmoore,939,rogue,assassination,28,16,12
Tranxéne,hyjal,939,rogue,assassination,90,46,44
Kyropth,eredar,939,rogue,assassination,24,10,14
Modulok,ulduar,936,rogue,assassination,48,22,26
Bleubleute,hyjal,931,rogue,assassination,32,11,21
Eniyah,tarren-mill,927,rogue,assassination,17,10,7
Deceptio,gilneas,925,rogue,assassination,139,66,73
Lunaryel,turalyon,923,rogue,assassination,60,21,39
Sabrera,ravencrest,921,rogue,assassination,62,26,36
Yasmineskye,silvermoon,920,rogue,assassination,24,10,14
Snakeshiv,ravenholdt,919,rogue,assassination,30,15,15
Armando,amanthul,912,rogue,assassination,34,12,22
Энвитио,gordunni,910,rogue,assassination,29,16,13
Наджийа,lich-king,907,rogue,assassination,68,35,33
Pinchoto,sanguino,907,rogue,assassination,66,31,35
Макггара,soulflayer,907,rogue,assassination,170,78,92
Jupezii,stormreaver,905,rogue,assassination,17,10,7
Xlongman,blackhand,905,rogue,assassination,81,31,50
Sýn,eredar,905,rogue,assassination,34,11,23
Rohalds,silvermoon,901,rogue,assassination,32,11,21
Куррвабобер,borean-tundra,900,rogue,assassination,24,10,14
Dayrogue,doomhammer,900,rogue,assassination,42,10,32
Helax,turalyon,899,rogue,assassination,95,37,58
Márto,archimonde,896,rogue,assassination,22,10,12
Rezzi,ravencrest,895,rogue,assassination,66,32,34
Mythicog,twisting-nether,895,rogue,assassination,60,24,36
Медиивэл,deepholm,893,rogue,assassination,47,15,32
Ороти,greymane,891,rogue,assassination,20,12,8
Beggah,ulduar,890,rogue,assassination,48,11,37
Onetwo,aggra-português,889,rogue,assassination,42,19,23
Coastguard,twisting-nether,887,rogue,assassination,133,59,74
Blackone,nemesis,883,rogue,assassination,24,10,14
Вотымразь,howling-fjord,882,rogue,assassination,137,64,73
Jibril,anubarak,881,rogue,assassination,35,12,23
Вальпургина,borean-tundra,879,rogue,assassination,100,50,50
Batskcab,blackmoore,878,rogue,assassination,31,10,21
Dallrend,stormscale,875,rogue,assassination,60,22,38
Rossaporcona,nemesis,874,rogue,assassination,66,24,42
Леронда,deepholm,868,rogue,assassination,82,40,42
Прнхабочка,gordunni,865,rogue,assassination,72,35,37
Acomas,ravencrest,864,rogue,assassination,12,9,3
Skýhigh,ravencrest,864,rogue,assassination,12,9,3
Mituxararr,blackrock,864,rogue,assassination,18,9,9
Watergirlx,ravencrest,864,rogue,assassination,18,9,9
Acronia,ragnaros,864,rogue,assassination,18,9,9
Tebzr,ravencrest,864,rogue,assassination,18,9,9
Angeldarky,silvermoon,864,rogue,assassination,24,9,15
Sotri,dun-modr,864,rogue,assassination,24,9,15
Jáckz,twisting-nether,864,rogue,assassination,24,9,15
Wundgîft,blackrock,864,rogue,assassination,30,9,21
Chaotix,ragnaros,864,rogue,assassination,30,9,21
Oczku,burning-legion,864,rogue,assassination,30,9,21
Moratz,blackmoore,864,rogue,assassination,36,9,27
Лиринэлла,soulflayer,863,rogue,assassination,18,9,9
Nekhâ,hyjal,863,rogue,assassination,18,9,9
Zaxl,ravencrest,863,rogue,assassination,18,9,9
Fawkkes,la-croisade-écarlate,863,rogue,assassination,24,9,15
Chokee,blackrock,863,rogue,assassination,28,10,18
Фанфистинга,gordunni,863,rogue,assassination,36,9,27
Жесть,howling-fjord,862,rogue,assassination,18,9,9
Alicanbey,silvermoon,862,rogue,assassination,18,9,9
Parawietje,twilights-hammer,862,rogue,assassination,18,9,9
Satlol,outland,861,rogue,assassination,21,10,11
Красаа,soulflayer,861,rogue,assassination,24,9,15
Ticklzepickl,silvermoon,861,rogue,assassination,24,9,15
Doxxei,draenor,860,rogue,assassination,18,9,9
Purplereign,frostmane,860,rogue,assassination,84,40,44
Бимбабеггинз,howling-fjord,860,rogue,assassination,24,9,15
Lilze,ravencrest,859,rogue,assassination,186,87,99
Gorgok,culte-de-la-rive-noire,858,rogue,assassination,18,9,9
Wééselby,blackrock,857,rogue,assassination,24,9,15
Kinntama,twisting-nether,857,rogue,assassination,30,9,21
Norlix,ravencrest,856,rogue,assassination,18,9,9
Silksneak,kazzak,856,rogue,assassination,18,9,9
Malvaxxs,tarren-mill,856,rogue,assassination,26,9,17
Shadowspike,sanguino,855,rogue,assassination,24,9,15
Felvengeance,stormscale,855,rogue,assassination,30,9,21
Reginlief,argent-dawn,852,rogue,assassination,56,28,28
Valdengard,antonidas,852,rogue,assassination,18,9,9
Hankshaw,aegwynn,850,rogue,assassination,18,9,9
Цефира,gordunni,849,rogue,assassination,18,9,9
Inentellian,frostwolf,848,rogue,assassination,30,9,21
Blades,blackmoore,843,rogue,assassination,24,9,15
Saleanos,die-aldor,842,rogue,assassination,43,15,28
Ressputini,emeriss,841,rogue,assassination,17,9,8
Angelbeats,outland,841,rogue,assassination,22,10,12
Deragur,antonidas,833,rogue,assassination,30,13,17
Krymziàâ,hyjal,832,rogue,assassination,123,53,70
Meccura,silvermoon,831,rogue,assassination,17,9,8
Yeehaaman,stormreaver,828,rogue,assassination,24,9,15
Knockyz,khaz-modan,825,rogue,assassination,291,142,149
Tc,doomhammer,824,rogue,assassination,18,9,9
Derrieretoî,archimonde,824,rogue,assassination,30,13,17
Jacktripper,blackrock,824,rogue,assassination,51,14,37
Rougeforfun,silvermoon,822,rogue,assassination,22,9,13
Îlihad,zuljin,822,rogue,assassination,72,29,43
Sessanali,silvermoon,816,rogue,assassination,36,10,26
Подкустовный,gordunni,815,rogue,assassination,23,9,14
Aszaryn,magtheridon,814,rogue,assassination,23,9,14
Raikyo,argent-dawn,813,rogue,assassination,85,44,41
Sïdr,marécage-de-zangar,808,rogue,assassination,100,49,51
Yuffi,ysondre,803,rogue,assassination,29,11,18
Hadúr,stormscale,802,rogue,assassination,28,11,17
Kahsorog,draenor,795,rogue,assassination,26,10,16
Mores,anetheron,781,rogue,assassination,30,9,21
Sospiro,nemesis,779,rogue,assassination,22,9,13
Кейтллинн,galakrond,777,rogue,assassination,66,29,37
Qûrûm,norgannon,777,rogue,assassination,82,32,50
Пробующий,soulflayer,768,rogue,assassination,12,8,4
Кьюксе,gordunni,768,rogue,assassination,12,8,4
Ewynarog,silvermoon,768,rogue,assassination,18,8,10
Attylaria,rexxar,768,rogue,assassination,18,8,10
Silass,marécage-de-zangar,768,rogue,assassination,18,8,10
Houfyy,blackhand,768,rogue,assassination,18,8,10
Фешнподпивом,gordunni,768,rogue,assassination,21,8,13
Zwarciowa,burning-legion,768,rogue,assassination,24,8,16
Neik,dalaran,768,rogue,assassination,24,8,16
Onlyluvhurt,dun-modr,768,rogue,assassination,24,8,16
Spky,ravencrest,768,rogue,assassination,30,8,22
Babouill,ysondre,767,rogue,assassination,12,8,4
Purita,draenor,767,rogue,assassination,12,8,4
Imsweet,burning-legion,767,rogue,assassination,18,8,10
Disdane,sylvanas,767,rogue,assassination,18,8,10
Röguelol,outland,767,rogue,assassination,18,8,10
Meldee,burning-legion,767,rogue,assassination,18,8,10
Milenia,thrall,767,rogue,assassination,18,8,10
Пидтримка,gordunni,767,rogue,assassination,24,8,16
Liraia,eredar,767,rogue,assassination,24,8,16
Allydede,blackmoore,767,rogue,assassination,42,8,34
Serpez,anachronos,766,rogue,assassination,12,8,4
Nhonhonho,silvermoon,766,rogue,assassination,18,8,10
Flaskan,tarren-mill,766,rogue,assassination,18,8,10
Obsçuritý,ragnaros,765,rogue,assassination,16,9,7
Satmera,silvermoon,765,rogue,assassination,24,8,16
Kuzmin,die-aldor,765,rogue,assassination,24,8,16
Gpóínt,blackmoore,765,rogue,assassination,36,11,25
Jimzopf,eredar,762,rogue,assassination,18,8,10
Parker,frostmane,758,rogue,assassination,24,8,16
Thedarkness,sylvanas,755,rogue,assassination,18,8,10
ßè,frostmane,754,rogue,assassination,18,8,10
Gillette,guldan,752,rogue,assassination,120,45,75
Matarocho,ravencrest,751,rogue,assassination,24,8,16
Raiyqyu,archimonde,748,rogue,assassination,154,72,82
Juweetwelwie,twisting-nether,746,rogue,assassination,30,11,19
Рогнарек,blackscar,745,rogue,assassination,44,17,27
Elfikill,elune,741,rogue,assassination,102,49,53
Sombrafina,tyrande,737,rogue,assassination,54,13,41
Azkiel,archimonde,730,rogue,assassination,18,8,10
Бларефул,eversong,730,rogue,assassination,24,8,16
Якунька,soulflayer,729,rogue,assassination,23,8,15
Bondina,nemesis,727,rogue,assassination,18,8,10
Breattick,blackmoore,726,rogue,assassination,78,26,52
Azotix,archimonde,722,rogue,assassination,38,14,24
Zarina,kirin-tor,722,rogue,assassination,42,12,30
Ghøßt,outland,714,rogue,assassination,23,10,13
Durpur,sylvanas,714,rogue,assassination,23,8,15
Skuggdunkarn,draenor,706,rogue,assassination,24,9,15
Obbexd,outland,706,rogue,assassination,28,10,18
Fumai,blackmoore,701,rogue,assassination,54,19,35
Kodlak,silvermoon,696,rogue,assassination,16,8,8
Blueberry,sargeras,693,rogue,assassination,31,10,21
Ninieu,kirin-tor,686,rogue,assassination,13,8,5
Ghøstkid,blackrock,686,rogue,assassination,22,8,14
Fleshcrawl,norgannon,677,rogue,assassination,22,8,14
Doperog,antonidas,672,rogue,assassination,12,7,5
Несторина,gordunni,672,rogue,assassination,12,7,5
Voltarine,ysondre,672,rogue,assassination,12,7,5
Биокарлик,soulflayer,672,rogue,assassination,12,7,5
Bluntyblades,silvermoon,672,rogue,assassination,12,7,5
Syrn,ravencrest,672,rogue,assassination,15,8,7
Like,aegwynn,672,rogue,assassination,18,7,11
Scørp,ravencrest,672,rogue,assassination,18,7,11
Zilemjr,stormscale,672,rogue,assassination,18,7,11
Soulriver,kelthuzad,672,rogue,assassination,18,7,11
Nitroxygen,outland,672,rogue,assassination,18,7,11
Narutø,sylvanas,672,rogue,assassination,18,7,11
Ximenidriel,ravencrest,672,rogue,assassination,18,7,11
Ogc,draenor,672,rogue,assassination,18,7,11
Eeros,kazzak,672,rogue,assassination,18,7,11
Styxro,blackhand,672,rogue,assassination,18,7,11
Patryk,silvermoon,672,rogue,assassination,21,8,13
Jaqenhghar,pozzo-delleternità,672,rogue,assassination,24,7,17
Featfawkes,ragnaros,672,rogue,assassination,24,7,17
Luketherogue,twisting-nether,672,rogue,assassination,24,7,17
Rikdy,kazzak,672,rogue,assassination,30,7,23
Pizzy,ravencrest,671,rogue,assassination,12,7,5
Роггбог,howling-fjord,671,rogue,assassination,12,7,5
Verresa,sylvanas,671,rogue,assassination,12,7,5
Pookzy,blackhand,671,rogue,assassination,12,7,5
Leakara,blackrock,671,rogue,assassination,18,7,11
Zeiden,sanguino,671,rogue,assassination,18,7,11
Friter,stormscale,671,rogue,assassination,18,7,11
Oboraddon,blackrock,671,rogue,assassination,18,7,11
Sigiöl,sanguino,671,rogue,assassination,18,7,11
Nïhal,suramar,671,rogue,assassination,18,7,11
Stealthaldo,sylvanas,671,rogue,assassination,18,7,11
Renaai,defias-brotherhood,671,rogue,assassination,18,7,11
Althieves,ravencrest,671,rogue,assassination,18,7,11
Barkai,kazzak,670,rogue,assassination,18,7,11
Kokksolidd,ravencrest,670,rogue,assassination,18,7,11
Yamoshí,sanguino,670,rogue,assassination,18,7,11
Monster,kazzak,670,rogue,assassination,18,7,11
Elydriel,khaz-modan,670,rogue,assassination,24,7,17
Magmatum,draenor,669,rogue,assassination,12,7,5
Zhadowên,outland,669,rogue,assassination,12,7,5
Feucht,argent-dawn,669,rogue,assassination,18,7,11
Waltër,tyrande,669,rogue,assassination,30,7,23
Shinigamî,nemesis,668,rogue,assassination,12,7,5
Fizzkhalifa,zuljin,667,rogue,assassination,25,9,16
Jiraishin,blackmoore,666,rogue,assassination,30,7,23
Eperfej,silvermoon,666,rogue,assassination,30,7,23
Háshírama,ravencrest,665,rogue,assassination,22,8,14
Némésiss,archimonde,660,rogue,assassination,18,7,11
Зайт,howling-fjord,660,rogue,assassination,27,9,18
Twotimess,stormscale,658,rogue,assassination,12,7,5
Geovoreakos,silvermoon,657,rogue,assassination,24,7,17
Sanzoo,blackmoore,655,rogue,assassination,17,7,10
Shaklyn,antonidas,655,rogue,assassination,23,7,16
Rêdbello,dun-morogh,651,rogue,assassination,18,7,11
Джэкман,soulflayer,650,rogue,assassination,14,10,4
Quepimquepam,dun-modr,635,rogue,assassination,11,7,4
Монтанатони,eversong,624,rogue,assassination,47,7,40
Windhawkz,silvermoon,623,rogue,assassination,17,7,10
Chcksothrsty,ragnaros,622,rogue,assassination,11,7,4
Mozenn,draenor,622,rogue,assassination,15,7,8
Dizze,blackmoore,622,rogue,assassination,17,7,10
Милеса,soulflayer,620,rogue,assassination,17,7,10
Însanus,blackmoore,620,rogue,assassination,23,7,16
Darkerzx,silvermoon,617,rogue,assassination,28,9,19
Drfeelgòód,nethersturm,614,rogue,assassination,17,7,10
Soníc,kiljaeden,607,rogue,assassination,11,7,4
Флокуся,howling-fjord,599,rogue,assassination,28,10,18
Трианон,galakrond,599,rogue,assassination,22,7,15
Rîplëy,ravencrest,591,rogue,assassination,13,7,6
Voetdown,blackmoore,576,rogue,assassination,12,6,6
Myxx,ravencrest,576,rogue,assassination,12,6,6
Secaboo,eredar,576,rogue,assassination,12,6,6
Ralffy,auchindoun,576,rogue,assassination,12,6,6
Sîccarîus,ravencrest,576,rogue,assassination,12,6,6
Sachsun,outland,576,rogue,assassination,12,6,6
Tyranoxoth,stormscale,576,rogue,assassination,12,6,6
Diagnoze,silvermoon,576,rogue,assassination,12,6,6
Wrestlér,sylvanas,576,rogue,assassination,12,6,6
Mollyperph,ravencrest,576,rogue,assassination,12,6,6
Remindful,ravencrest,576,rogue,assassination,12,6,6
Flopsy,archimonde,576,rogue,assassination,12,6,6
Necroli,kazzak,576,rogue,assassination,12,6,6
Blade,stormscale,576,rogue,assassination,12,6,6
Rilodedcoach,kazzak,576,rogue,assassination,12,6,6
Аренатрюки,soulflayer,576,rogue,assassination,12,6,6
Лиргенвард,deathguard,576,rogue,assassination,12,6,6
Stâr,archimonde,576,rogue,assassination,12,6,6
Rágge,tarren-mill,576,rogue,assassination,12,6,6
Бейнс,howling-fjord,576,rogue,assassination,12,6,6
Rottemannen,stormscale,576,rogue,assassination,14,6,8
Беркьют,deepholm,576,rogue,assassination,18,6,12
Myk,argent-dawn,576,rogue,assassination,18,6,12
Blooddance,ragnaros,576,rogue,assassination,18,6,12
Zte,frostmane,576,rogue,assassination,18,6,12
Imika,argent-dawn,576,rogue,assassination,18,6,12
Сильфитт,gordunni,576,rogue,assassination,18,6,12
Dnw,ravencrest,576,rogue,assassination,18,6,12
Withoutlove,drakthul,576,rogue,assassination,18,6,12
Romiel,ravencrest,576,rogue,assassination,18,6,12
Shredbull,ravencrest,576,rogue,assassination,18,6,12
Edia,burning-legion,576,rogue,assassination,24,6,18
Nevazutu,twisting-nether,575,rogue,assassination,12,6,6
Blackmøré,argent-dawn,575,rogue,assassination,12,6,6
Peqpen,ravencrest,575,rogue,assassination,12,6,6
Rbgdowngrade,ravencrest,575,rogue,assassination,12,6,6
Керилера,eversong,575,rogue,assassination,18,6,12
Таландриель,eversong,575,rogue,assassination,18,6,12
Бомбирибом,gordunni,575,rogue,assassination,18,6,12
Invisage,grim-batol,575,rogue,assassination,18,6,12
Fkuwu,dalaran,575,rogue,assassination,24,6,18
Outofstuns,earthen-ring,574,rogue,assassination,18,7,11
Жинпес,gordunni,574,rogue,assassination,18,6,12
Letheus,stormscale,573,rogue,assassination,18,6,12
Daddschâl,blackmoore,572,rogue,assassination,15,6,9
Whiz,alexstrasza,572,rogue,assassination,21,7,14
Ranjual,blackhand,571,rogue,assassination,12,6,6
Boomboxsir,turalyon,571,rogue,assassination,12,6,6
Lovesosa,turalyon,571,rogue,assassination,12,6,6
Ninjaops,ravencrest,571,rogue,assassination,12,6,6
Berruskaa,drakthul,571,rogue,assassination,12,6,6
Kissmebaby,hyjal,571,rogue,assassination,12,6,6
Gleaming,madmortem,571,rogue,assassination,24,6,18
Симус,lich-king,568,rogue,assassination,12,6,6
Clapslap,blackmoore,565,rogue,assassination,12,6,6
Dimah,blackmoore,563,rogue,assassination,18,6,12
Phøñkðånçér,ravencrest,559,rogue,assassination,17,6,11
Lapeur,conseil-des-ombres,559,rogue,assassination,18,6,12
Elvís,chamber-of-aspects,557,rogue,assassination,18,6,12
Givilwtf,eredar,543,rogue,assassination,17,6,11
Ûltraaxx,ysondre,528,rogue,assassination,15,6,9
Snigmorder,silvermoon,528,rogue,assassination,16,6,10
Stonyhavana,ravencrest,527,rogue,assassination,11,6,5
Vaeira,ravencrest,527,rogue,assassination,17,6,11
Sjûkdøm,silvermoon,527,rogue,assassination,18,6,12
Вентури,borean-tundra,521,rogue,assassination,15,6,9
Vuuduu,frostmane,517,rogue,assassination,34,8,26
Logicalxy,ravencrest,511,rogue,assassination,10,6,4
Bamboozledx,draenor,511,rogue,assassination,11,6,5
Стронг,soulflayer,511,rogue,assassination,15,6,9
Зорго,deathguard,496,rogue,assassination,11,7,4
Ðescartes,antonidas,480,rogue,assassination,6,5,1
Pwoned,frostmourne,480,rogue,assassination,6,5,1
Fixsap,aegwynn,480,rogue,assassination,12,5,7
Anhduy,blackrock,480,rogue,assassination,12,5,7
Zajii,eredar,480,rogue,assassination,12,5,7
Aikaza,blackmoore,480,rogue,assassination,12,5,7
Backstabjr,blackmoore,480,rogue,assassination,12,5,7
Dìkcite,archimonde,480,rogue,assassination,12,5,7
Trickfulz,stormscale,480,rogue,assassination,12,5,7
Rylie,garona,480,rogue,assassination,12,5,7
Кишмякх,howling-fjord,480,rogue,assassination,12,5,7
Psg,argent-dawn,480,rogue,assassination,12,5,7
Heftychonk,doomhammer,480,rogue,assassination,12,5,7
Morgan,argent-dawn,480,rogue,assassination,12,5,7
Kendyx,kirin-tor,480,rogue,assassination,12,5,7
Cali,shendralar,480,rogue,assassination,12,5,7
Hopbóp,magtheridon,480,rogue,assassination,12,5,7
Shabakftw,twisting-nether,480,rogue,assassination,12,5,7
Kidalica,auchindoun,480,rogue,assassination,12,5,7
Hì,bronzebeard,480,rogue,assassination,12,5,7
Letmeplay,ravencrest,480,rogue,assassination,12,5,7
Darkknïght,silvermoon,480,rogue,assassination,12,5,7
Septicshiv,argent-dawn,480,rogue,assassination,12,5,7
Nippzy,twisting-nether,480,rogue,assassination,12,5,7
Эрихард,howling-fjord,480,rogue,assassination,12,5,7
Злобность,gordunni,480,rogue,assassination,12,5,7
Neskagrall,aegwynn,480,rogue,assassination,12,5,7
Calve,tarren-mill,480,rogue,assassination,12,5,7
Xeløe,hyjal,480,rogue,assassination,12,5,7
Malatang,thrall,480,rogue,assassination,12,5,7
Sholace,blackrock,480,rogue,assassination,12,5,7
Gögel,draenor,480,rogue,assassination,12,5,7
Snurry,tarren-mill,480,rogue,assassination,12,5,7
Leiemorder,twisting-nether,480,rogue,assassination,12,5,7
Lämä,stormreaver,480,rogue,assassination,12,5,7
Exiv,ragnaros,480,rogue,assassination,12,5,7
Ratkebab,silvermoon,480,rogue,assassination,14,5,9
Blooddance,outland,480,rogue,assassination,14,5,9
Republicano,cthun,480,rogue,assassination,18,5,13
Stealthi,stormscale,480,rogue,assassination,18,5,13
Exanimu,ravencrest,480,rogue,assassination,18,5,13
Søtez,ravencrest,480,rogue,assassination,18,5,13
Ра,gordunni,480,rogue,assassination,18,5,13
Kenjí,silvermoon,480,rogue,assassination,18,5,13
Тучёна,soulflayer,480,rogue,assassination,18,5,13
Ланароудсс,gordunni,480,rogue,assassination,18,5,13
Ykw,tarren-mill,480,rogue,assassination,18,5,13
Wrathed,stormreaver,480,rogue,assassination,18,5,13
Рогадачери,gordunni,480,rogue,assassination,18,5,13
Лайнэл,deathweaver,480,rogue,assassination,24,5,19
Noxxy,archimonde,480,rogue,assassination,24,5,19
Vizifyx,ravencrest,480,rogue,assassination,24,5,19
Saptember,blackhand,479,rogue,assassination,6,5,1
Хэресс,soulflayer,479,rogue,assassination,6,5,1
Tossmysaladx,silvermoon,479,rogue,assassination,12,5,7
Jaymo,saurfang,479,rogue,assassination,12,5,7
Dahlin,stormscale,479,rogue,assassination,12,5,7
Smokie,frostmourne,479,rogue,assassination,12,5,7
Darák,thrall,479,rogue,assassination,12,5,7
Shadowfangs,ravencrest,479,rogue,assassination,12,5,7
Mðnki,outland,479,rogue,assassination,12,5,7
Дамид,gordunni,479,rogue,assassination,12,5,7
Lescud,illidan,479,rogue,assassination,12,5,7
Некролз,gordunni,479,rogue,assassination,13,5,8
Darkesthonor,silvermoon,479,rogue,assassination,18,5,13
Howhigh,stormscale,479,rogue,assassination,18,5,13
Гранетанцор,blackscar,479,rogue,assassination,18,5,13
Sît,twisting-nether,479,rogue,assassination,24,5,19
Yüm,burning-blade,478,rogue,assassination,18,5,13
Dravenfoot,defias-brotherhood,477,rogue,assassination,12,5,7
Jacksoon,dun-morogh,477,rogue,assassination,18,5,13
Lubor,thrall,476,rogue,assassination,12,5,7
Magok,ysondre,476,rogue,assassination,12,5,7
Razboy,dun-morogh,475,rogue,assassination,12,5,7
Owlcat,argent-dawn,475,rogue,assassination,12,5,7
Lukkz,laughing-skull,474,rogue,assassination,12,5,7
Легион,razuvious,474,rogue,assassination,12,5,7
Coiledviper,stormscale,447,rogue,assassination,11,5,6
Diarikths,silvermoon,447,rogue,assassination,11,5,6
Deevoll,tarren-mill,447,rogue,assassination,20,6,14
Bhabì,uldaman,431,rogue,assassination,11,5,6
Rhâpsødýx,twisting-nether,426,rogue,assassination,14,6,8
Mâêl,blackmoore,426,rogue,assassination,16,6,10
Baldoh,kazzak,426,rogue,assassination,23,6,17
Vv,terokkar,420,rogue,assassination,18,6,12
Bluehell,sanguino,415,rogue,assassination,10,5,5
Horóz,antonidas,400,rogue,assassination,7,5,2
Døpegame,ravencrest,400,rogue,assassination,13,5,8
Melfîce,blackhand,384,rogue,assassination,6,4,2
Fûckínggød,outland,384,rogue,assassination,6,4,2
Imatrickster,draenor,384,rogue,assassination,6,4,2
Ebayscammer,ravencrest,384,rogue,assassination,6,4,2
Gâla,elune,384,rogue,assassination,6,4,2
Leviathann,doomhammer,384,rogue,assassination,6,4,2
Yuunr,kazzak,384,rogue,assassination,6,4,2
Bwònsàmdì,twisting-nether,384,rogue,assassination,6,4,2
Mouchess,hyjal,384,rogue,assassination,6,4,2
Eltitoedu,dun-modr,384,rogue,assassination,6,4,2
Obscuritys,nemesis,384,rogue,assassination,6,4,2
Jinxy,outland,384,rogue,assassination,6,4,2
Whosmanz,ragnaros,384,rogue,assassination,6,4,2
Vögue,burning-legion,384,rogue,assassination,6,4,2
Neyloa,kazzak,384,rogue,assassination,6,4,2
Rosk,los-errantes,384,rogue,assassination,6,4,2
Дикийминус,howling-fjord,384,rogue,assassination,6,4,2
Kalamàzoo,pozzo-delleternità,384,rogue,assassination,6,4,2
Albinå,kazzak,384,rogue,assassination,6,4,2
Sparv,jaedenar,384,rogue,assassination,6,4,2
Drâûgr,blackhand,384,rogue,assassination,6,4,2
Deadhawk,ravencrest,384,rogue,assassination,6,4,2
Áq,ravencrest,384,rogue,assassination,6,4,2
Mïkasa,ysondre,384,rogue,assassination,6,4,2
Spolly,frostwolf,384,rogue,assassination,6,4,2
Ðoppex,blackmoore,384,rogue,assassination,6,4,2
Sozzerogue,kazzak,384,rogue,assassination,6,4,2
Nineball,frostmane,384,rogue,assassination,6,4,2
Juanperez,blackhand,384,rogue,assassination,6,4,2
Чернабаев,soulflayer,384,rogue,assassination,6,4,2
Мёртвыйанарх,soulflayer,384,rogue,assassination,6,4,2
Sayianwho,ravencrest,384,rogue,assassination,6,4,2
Obernik,draenor,384,rogue,assassination,12,4,8
Níterush,eredar,384,rogue,assassination,12,4,8
Ксяосупдупао,howling-fjord,384,rogue,assassination,12,4,8
Toskle,drakthul,384,rogue,assassination,12,4,8
Артфулр,howling-fjord,384,rogue,assassination,12,4,8
Eichê,alleria,384,rogue,assassination,12,4,8
Azzerue,ysondre,384,rogue,assassination,12,4,8
Tinta,aszune,384,rogue,assassination,12,4,8
Barisso,burning-legion,384,rogue,assassination,12,4,8
Doomdagger,chamber-of-aspects,384,rogue,assassination,12,4,8
Охотникведьм,soulflayer,384,rogue,assassination,12,4,8
Norpz,aggra-português,384,rogue,assassination,12,4,8
Ddhelpra,blackrock,384,rogue,assassination,12,4,8
Sharkøo,eredar,384,rogue,assassination,12,4,8
Xanyy,bloodfeather,384,rogue,assassination,12,4,8
Zerfex,eredar,384,rogue,assassination,12,4,8
Mysmullig,ragnaros,384,rogue,assassination,12,4,8
Jevo,kazzak,384,rogue,assassination,12,4,8
Mesyo,blackhand,384,rogue,assassination,12,4,8
Xtoyo,zuljin,384,rogue,assassination,12,4,8
Doktorrog,blackrock,384,rogue,assassination,12,4,8
Röguetönerö,dun-modr,384,rogue,assassination,12,4,8
Gämèøvërkíd,archimonde,384,rogue,assassination,12,4,8
Wickness,dun-modr,384,rogue,assassination,12,4,8
Salitra,die-aldor,384,rogue,assassination,12,4,8
Bijâ,aegwynn,384,rogue,assassination,12,4,8
Kallelelel,tarren-mill,384,rogue,assassination,12,4,8
Stepkickgodx,blackmoore,384,rogue,assassination,12,4,8
Галиновна,soulflayer,384,rogue,assassination,12,4,8
Paidaki,kazzak,384,rogue,assassination,12,4,8
Lilrookie,argent-dawn,384,rogue,assassination,12,4,8
Honeycakes,ravencrest,384,rogue,assassination,12,4,8
Sunbra,hyjal,384,rogue,assassination,12,4,8
Rodjin,hyjal,384,rogue,assassination,12,4,8
Darkchomeur,archimonde,384,rogue,assassination,12,4,8
Sÿkz,hyjal,384,rogue,assassination,12,4,8
Ùmbræ,hyjal,384,rogue,assassination,12,4,8
Kïdney,stormscale,384,rogue,assassination,12,4,8
Rogiko,twisting-nether,384,rogue,assassination,12,4,8
Yakii,eredar,384,rogue,assassination,12,4,8
Achterom,tarren-mill,384,rogue,assassination,12,4,8
Izzyb,auchindoun,384,rogue,assassination,12,4,8
Otlaw,auchindoun,384,rogue,assassination,12,4,8
Ryxon,arathor,384,rogue,assassination,12,4,8
Crimatoria,rajaxx,384,rogue,assassination,12,4,8
Блимкинг,soulflayer,384,rogue,assassination,15,4,11
Sicarius,the-maelstrom,384,rogue,assassination,18,4,14
Елианора,gordunni,384,rogue,assassination,18,4,14
Mindset,eredar,384,rogue,assassination,18,4,14
Ристоврация,gordunni,384,rogue,assassination,18,4,14
Zerö,tarren-mill,384,rogue,assassination,18,4,14
Envenoman,ravencrest,384,rogue,assassination,18,4,14
Ibizà,ravencrest,384,rogue,assassination,18,4,14
Sythex,archimonde,384,rogue,assassination,18,4,14
Lïke,frostwolf,384,rogue,assassination,18,4,14
Jpi,ragnaros,384,rogue,assassination,18,4,14
Kìmèrà,nemesis,383,rogue,assassination,6,4,2
Ren,hellfire,383,rogue,assassination,6,4,2
Vexedancer,stormscale,383,rogue,assassination,6,4,2
Cusmos,twisting-nether,383,rogue,assassination,6,4,2
Tedko,dun-modr,383,rogue,assassination,6,4,2
Töbïï,sylvanas,383,rogue,assassination,12,4,8
Ppogg,pozzo-delleternità,383,rogue,assassination,12,4,8
Stumpén,darkspear,383,rogue,assassination,12,4,8
Algopyrin,ragnaros,383,rogue,assassination,12,4,8
Zhafira,magtheridon,383,rogue,assassination,12,4,8
Kyzzo,dalaran,383,rogue,assassination,12,4,8
Ксенорф,ashenvale,383,rogue,assassination,15,4,11
Kylìemirogue,blackrock,383,rogue,assassination,18,4,14
Mäkbernicc,archimonde,383,rogue,assassination,18,4,14
Ðæmøn,tarren-mill,383,rogue,assassination,24,5,19
Гоблиникс,soulflayer,382,rogue,assassination,6,4,2
Rooxeur,marécage-de-zangar,382,rogue,assassination,6,4,2
Twinkyzzö,archimonde,382,rogue,assassination,12,4,8
Møkkagnom,darkspear,381,rogue,assassination,12,4,8
Pumpy,blades-edge,381,rogue,assassination,12,4,8
Бамболейлоо,grom,381,rogue,assassination,12,4,8
Midô,dun-morogh,381,rogue,assassination,18,4,14
Easy,kult-der-verdammten,376,rogue,assassination,18,4,14
Iwilsucceed,argent-dawn,376,rogue,assassination,36,5,31
Stealtheous,arathor,367,rogue,assassination,11,4,7
Стелсочка,gordunni,351,rogue,assassination,11,4,7
Lilbubblegum,emerald-dream,351,rogue,assassination,11,4,7
Blurryfacé,frostmane,351,rogue,assassination,11,4,7
Морзо,howling-fjord,351,rogue,assassination,17,4,13
Voraq,blackhand,350,rogue,assassination,11,4,7
Teralala,kazzak,336,rogue,assassination,9,4,5
Yinyíng,ravencrest,330,rogue,assassination,15,5,10
Eljana,amanthul,322,rogue,assassination,24,7,17
Benh,ysondre,319,rogue,assassination,8,4,4
Fz,chants-éternels,319,rogue,assassination,16,5,11
Yaelynn,argent-dawn,288,rogue,assassination,6,3,3
Jackpackáge,sylvanas,288,rogue,assassination,6,3,3
Elunity,sylvanas,288,rogue,assassination,6,3,3
Blindsaplola,archimonde,288,rogue,assassination,6,3,3
Lïhtêñßërg,ravencrest,288,rogue,assassination,6,3,3
Thenotorious,shadowsong,288,rogue,assassination,6,3,3
Kaylí,kazzak,288,rogue,assassination,6,3,3
Rodént,argent-dawn,288,rogue,assassination,6,3,3
Luciferx,stormscale,288,rogue,assassination,6,3,3
Labronka,sanguino,288,rogue,assassination,6,3,3
Aska,antonidas,288,rogue,assassination,6,3,3
Râizo,archimonde,288,rogue,assassination,6,3,3
Keexy,ravencrest,288,rogue,assassination,6,3,3
Tasster,frostwolf,288,rogue,assassination,6,3,3
Releaserage,draenor,288,rogue,assassination,6,3,3
Дореан,howling-fjord,288,rogue,assassination,6,3,3
Nezukóchan,ravencrest,288,rogue,assassination,6,3,3
Mordred,stormscale,288,rogue,assassination,6,3,3
Schurok,aegwynn,288,rogue,assassination,6,3,3
Meackós,aegwynn,288,rogue,assassination,6,3,3
Lättja,hyjal,288,rogue,assassination,6,3,3
Deadraw,aegwynn,288,rogue,assassination,6,3,3
Brêêzy,die-aldor,288,rogue,assassination,6,3,3
Paxmortem,silvermoon,288,rogue,assassination,6,3,3
Lyray,die-aldor,288,rogue,assassination,6,3,3
Solomid,ravencrest,288,rogue,assassination,6,3,3
Pelana,defias-brotherhood,288,rogue,assassination,6,3,3
Cipher,elune,288,rogue,assassination,6,3,3
Олддеадроб,soulflayer,288,rogue,assassination,6,3,3
Smorcoolio,stormscale,288,rogue,assassination,6,3,3
Ацилия,galakrond,288,rogue,assassination,6,3,3
Stealthyist,darkmoon-faire,288,rogue,assassination,6,3,3
Stealthb,ravencrest,288,rogue,assassination,6,3,3
Sorashna,agamaggan,288,rogue,assassination,6,3,3
Mînd,kazzak,288,rogue,assassination,6,3,3
Zigaretz,ravencrest,288,rogue,assassination,6,3,3
Dôlf,hyjal,288,rogue,assassination,6,3,3
Blackrabbít,azshara,288,rogue,assassination,6,3,3
Чудох,gordunni,288,rogue,assassination,6,3,3
Stroògz,ysondre,288,rogue,assassination,6,3,3
Evus,ravencrest,288,rogue,assassination,6,3,3
Obliveron,dalaran,288,rogue,assassination,6,3,3
Nhara,medivh,288,rogue,assassination,6,3,3
Котянкахд,howling-fjord,288,rogue,assassination,6,3,3
Natvg,twisting-nether,288,rogue,assassination,6,3,3
Выносяшка,deathguard,288,rogue,assassination,6,3,3
Illusious,ragnaros,288,rogue,assassination,6,3,3
Jhx,antonidas,288,rogue,assassination,6,3,3
Aati,the-maelstrom,288,rogue,assassination,6,3,3
Decenty,eredar,288,rogue,assassination,6,3,3
Ultraxette,ysondre,288,rogue,assassination,6,3,3
Reaventis,ravencrest,288,rogue,assassination,6,3,3
Mazokisti,outland,288,rogue,assassination,6,3,3
Steálth,silvermoon,288,rogue,assassination,6,3,3
Ææçæçæçæ,twisting-nether,288,rogue,assassination,6,3,3
Vyllaftw,hyjal,288,rogue,assassination,10,3,7
Psybelette,khaz-modan,288,rogue,assassination,15,4,11
Anesthetics,stormscale,288,rogue,assassination,12,3,9
Sickko,stormscale,288,rogue,assassination,12,3,9
Fushimi,ravencrest,288,rogue,assassination,12,3,9
Derxx,stormscale,288,rogue,assassination,12,3,9
Маннариа,soulflayer,288,rogue,assassination,12,3,9
Seeschlange,amanthul,288,rogue,assassination,12,3,9
Eriksonn,drakthul,288,rogue,assassination,12,3,9
Yakku,drakthul,288,rogue,assassination,12,3,9
Курога,howling-fjord,288,rogue,assassination,12,3,9
Nezuko,gilneas,288,rogue,assassination,12,3,9
Bumaqt,silvermoon,288,rogue,assassination,12,3,9
Voltface,suramar,288,rogue,assassination,12,3,9
Kshero,sylvanas,288,rogue,assassination,12,3,9
Vessel,tarren-mill,288,rogue,assassination,12,3,9
Turbocandle,ravencrest,288,rogue,assassination,12,3,9
Hamer,eredar,288,rogue,assassination,12,3,9
Азунайт,ashenvale,288,rogue,assassination,12,3,9
Glust,outland,288,rogue,assassination,12,3,9
Teldã,archimonde,288,rogue,assassination,12,3,9
Radgaa,draenor,288,rogue,assassination,12,3,9
Rôst,ravencrest,288,rogue,assassination,12,3,9
Terya,ragnaros,288,rogue,assassination,12,3,9
Ryurfy,archimonde,288,rogue,assassination,12,3,9
Hardkølle,ravencrest,288,rogue,assassination,12,3,9
Highz,zenedar,288,rogue,assassination,12,3,9
Zip,alleria,288,rogue,assassination,12,3,9
Poguemahone,ravencrest,288,rogue,assassination,12,3,9
Persës,outland,288,rogue,assassination,12,3,9
Hersuub,blackmoore,288,rogue,assassination,12,3,9
Redork,twisting-nether,288,rogue,assassination,12,3,9
Smokeyx,outland,288,rogue,assassination,12,3,9
Onedance,blackrock,288,rogue,assassination,14,3,11
Memphismp,drakthul,288,rogue,assassination,18,3,15
Jáyjay,antonidas,288,rogue,assassination,18,3,15
Mxrbid,defias-brotherhood,288,rogue,assassination,18,3,15
Crittylohan,blackrock,288,rogue,assassination,18,3,15
Brícx,alleria,288,rogue,assassination,18,3,15
Minaccia,pozzo-delleternità,288,rogue,assassination,24,3,21
Willin,kazzak,287,rogue,assassination,6,3,3
Yubleeding,kazzak,287,rogue,assassination,6,3,3
Wizzo,onyxia,287,rogue,assassination,6,3,3
Умбрен,lich-king,287,rogue,assassination,6,3,3
Killboom,rexxar,287,rogue,assassination,6,3,3
Гламурятина,gordunni,287,rogue,assassination,6,3,3
Coanageta,draenor,287,rogue,assassination,6,3,3
Viperna,blackrock,287,rogue,assassination,7,3,4
Sylaba,burning-legion,287,rogue,assassination,12,3,9
Nastyrogue,burning-legion,287,rogue,assassination,12,3,9
Vendox,defias-brotherhood,287,rogue,assassination,12,3,9
Bandito,kilrogg,286,rogue,assassination,10,5,5
Фоксивнир,soulflayer,286,rogue,assassination,6,3,3
Drpsykose,tarren-mill,286,rogue,assassination,6,3,3
Mûnri,dalaran,286,rogue,assassination,6,3,3
Adewale,kazzak,286,rogue,assassination,12,3,9
Mersible,blackrock,286,rogue,assassination,12,3,9
Ecilaa,conseil-des-ombres,285,rogue,assassination,12,3,9
Bobydrift,khaz-modan,284,rogue,assassination,12,3,9
Verbb,turalyon,284,rogue,assassination,12,3,9
Layson,les-clairvoyants,271,rogue,assassination,11,3,8
Технорэйв,gordunni,271,rogue,assassination,33,4,29
Schagrath,tarren-mill,255,rogue,assassination,11,3,8
Candise,ysondre,253,rogue,assassination,11,3,8
Blckrogue,bloodfeather,240,rogue,assassination,9,3,6
Stashin,stormscale,240,rogue,assassination,10,3,7
Kejú,alleria,239,rogue,assassination,5,3,2
Stepdead,tarren-mill,239,rogue,assassination,5,3,2
Starkad,archimonde,239,rogue,assassination,5,3,2
Dmr,aegwynn,239,rogue,assassination,5,3,2
Alyzon,ravencrest,239,rogue,assassination,17,3,14
Pilliwinks,alonsus,234,rogue,assassination,8,4,4
Koteczka,burning-legion,234,rogue,assassination,15,4,11
Asdfqwerty,ravencrest,223,rogue,assassination,8,3,5
Kebabgodx,sanguino,223,rogue,assassination,8,3,5
Stunly,azjolnerub,192,rogue,assassination,4,3,1
Кашеварить,gordunni,192,rogue,assassination,6,2,4
Shroudini,ysondre,192,rogue,assassination,6,2,4
Nakosya,argent-dawn,192,rogue,assassination,6,2,4
Саулите,deathguard,192,rogue,assassination,6,2,4
Messene,hellscream,192,rogue,assassination,6,2,4
Снэбак,soulflayer,192,rogue,assassination,6,2,4
Фистим,gordunni,192,rogue,assassination,6,2,4
Киринорте,gordunni,192,rogue,assassination,6,2,4
Tajina,elune,192,rogue,assassination,6,2,4
Warrdenn,draenor,192,rogue,assassination,6,2,4
Сабстрайк,soulflayer,192,rogue,assassination,6,2,4
Isucu,burning-legion,192,rogue,assassination,6,2,4
Revisiôn,tarren-mill,192,rogue,assassination,6,2,4
Rearmer,burning-legion,192,rogue,assassination,6,2,4
Ленчюня,soulflayer,192,rogue,assassination,6,2,4
Аутянин,soulflayer,192,rogue,assassination,6,2,4
Xanders,draenor,192,rogue,assassination,6,2,4
Sycko,alakir,192,rogue,assassination,6,2,4
Habba,dragonblight,192,rogue,assassination,6,2,4
Bangerstab,draenor,192,rogue,assassination,6,2,4
Tofix,tarren-mill,192,rogue,assassination,6,2,4
Новиччокк,gordunni,192,rogue,assassination,6,2,4
Synexo,sylvanas,192,rogue,assassination,6,2,4
Теньглуши,gordunni,192,rogue,assassination,6,2,4
Crowg,drakthul,192,rogue,assassination,6,2,4
Ichiegoichie,draenor,192,rogue,assassination,6,2,4
Warbell,stormscale,192,rogue,assassination,6,2,4
Behindü,frostmane,192,rogue,assassination,6,2,4
Noilek,sylvanas,192,rogue,assassination,6,2,4
Пожилойпупь,gordunni,192,rogue,assassination,6,2,4
Нойсеен,gordunni,192,rogue,assassination,6,2,4
Enthuque,draenor,192,rogue,assassination,6,2,4
Evi,korgall,192,rogue,assassination,6,2,4
Díddz,tarren-mill,192,rogue,assassination,6,2,4
Jayrog,ysondre,192,rogue,assassination,6,2,4
Fenissa,ysondre,192,rogue,assassination,6,2,4
Шизачи,gordunni,192,rogue,assassination,6,2,4
Biokioledin,draenor,192,rogue,assassination,6,2,4
Gane,sanguino,192,rogue,assassination,6,2,4
Люняшка,booty-bay,192,rogue,assassination,6,2,4
Sokillu,nemesis,192,rogue,assassination,6,2,4
Säku,la-croisade-écarlate,192,rogue,assassination,6,2,4
Katara,antonidas,192,rogue,assassination,6,2,4
Мариалолз,gordunni,192,rogue,assassination,6,2,4
Lastkiss,aggramar,192,rogue,assassination,6,2,4
Renyth,argent-dawn,192,rogue,assassination,6,2,4
Barneý,tarren-mill,192,rogue,assassination,6,2,4
Fîst,antonidas,192,rogue,assassination,6,2,4
Shinobian,ravencrest,192,rogue,assassination,6,2,4
Lqueespack,kazzak,192,rogue,assassination,6,2,4
Rexore,ravencrest,192,rogue,assassination,6,2,4
Mobrac,silvermoon,192,rogue,assassination,6,2,4
Киу,howling-fjord,192,rogue,assassination,6,2,4
Eazmode,outland,192,rogue,assassination,6,2,4
Maximumlel,ravencrest,192,rogue,assassination,6,2,4
Aaze,kazzak,192,rogue,assassination,6,2,4
Brazzersx,antonidas,192,rogue,assassination,6,2,4
Robtherobber,kazzak,192,rogue,assassination,6,2,4
Grocco,doomhammer,192,rogue,assassination,6,2,4
Garou,blackhand,192,rogue,assassination,6,2,4
Weird,blackmoore,192,rogue,assassination,6,2,4
Henlh,turalyon,192,rogue,assassination,6,2,4
Bórgós,blackrock,192,rogue,assassination,6,2,4
Diliu,doomhammer,192,rogue,assassination,6,2,4
Reichy,ravencrest,192,rogue,assassination,6,2,4
Ðarkreign,sanguino,192,rogue,assassination,6,2,4
Kikitaklk,uldum,192,rogue,assassination,6,2,4
Ikaze,kazzak,192,rogue,assassination,6,2,4
Saix,blackrock,192,rogue,assassination,6,2,4
Юджинган,howling-fjord,192,rogue,assassination,6,2,4
Mînz,twisting-nether,192,rogue,assassination,6,2,4
Nudelholz,blackrock,192,rogue,assassination,6,2,4
Zyphion,ragnaros,192,rogue,assassination,6,2,4
Apéxx,blackrock,192,rogue,assassination,6,2,4
Fredge,stormscale,192,rogue,assassination,6,2,4
Laciecute,silvermoon,192,rogue,assassination,6,2,4
Dombyy,ragnaros,192,rogue,assassination,6,2,4
Apexpreditar,doomhammer,192,rogue,assassination,6,2,4
Eigle,archimonde,192,rogue,assassination,6,2,4
Steelyowife,archimonde,192,rogue,assassination,6,2,4
Kaamen,die-silberne-hand,192,rogue,assassination,6,2,4
Lahzurax,twisting-nether,192,rogue,assassination,6,2,4
Xeggy,turalyon,192,rogue,assassination,6,2,4
Артекрио,howling-fjord,192,rogue,assassination,6,2,4
Zømbië,kazzak,192,rogue,assassination,6,2,4
Dépressionqt,ravencrest,192,rogue,assassination,6,2,4
Grimson,kazzak,192,rogue,assassination,6,2,4
Ðelvin,dalaran,192,rogue,assassination,6,2,4
Pixeling,ravencrest,192,rogue,assassination,6,2,4
Gårónå,thrall,192,rogue,assassination,6,2,4
Silentknives,silvermoon,192,rogue,assassination,6,2,4
Kersatos,silvermoon,192,rogue,assassination,6,2,4
Bloodwraith,stormscale,192,rogue,assassination,6,2,4
Gladßreakz,dun-modr,192,rogue,assassination,6,2,4
Gkio,nordrassil,192,rogue,assassination,6,2,4
Ålleyézonme,ravencrest,192,rogue,assassination,6,2,4
Midoa,nerathor,192,rogue,assassination,6,2,4
Nàlaa,ravencrest,192,rogue,assassination,6,2,4
Niagram,dun-modr,192,rogue,assassination,6,2,4
Bickia,silvermoon,192,rogue,assassination,6,2,4
Hideout,ravencrest,192,rogue,assassination,6,2,4
Jinêxo,shattrath,192,rogue,assassination,6,2,4
Rizzardx,ravencrest,192,rogue,assassination,6,2,4
Goldenblitz,blackmoore,192,rogue,assassination,6,2,4
Jonewrld,ravencrest,192,rogue,assassination,6,2,4
Fliegenfurz,blackmoore,192,rogue,assassination,6,2,4
Fälke,dun-modr,192,rogue,assassination,6,2,4
Helcof,emerald-dream,192,rogue,assassination,6,2,4
Câptcâp,twisting-nether,192,rogue,assassination,6,2,4
Mattyc,bronze-dragonflight,192,rogue,assassination,6,2,4
Sêrgi,minahonda,192,rogue,assassination,6,2,4
Tiemyrópe,outland,192,rogue,assassination,6,2,4
Selfcut,blackmoore,192,rogue,assassination,6,2,4
Vorsix,tarren-mill,192,rogue,assassination,6,2,4
Zerukos,thrall,192,rogue,assassination,6,2,4
Иннхотеп,howling-fjord,192,rogue,assassination,6,2,4
Shúrae,blackmoore,192,rogue,assassination,6,2,4
Maxrizzx,ravencrest,192,rogue,assassination,6,2,4
Dwingvat,khaz-modan,192,rogue,assassination,6,2,4
Redrumx,outland,192,rogue,assassination,6,2,4
Venom,stormscale,192,rogue,assassination,6,2,4
Skyripper,magtheridon,192,rogue,assassination,6,2,4
Grinfester,stormscale,192,rogue,assassination,6,2,4
Xiom,thrall,192,rogue,assassination,6,2,4
Sanzsa,ravencrest,192,rogue,assassination,6,2,4
Notlikethis,twisting-nether,192,rogue,assassination,6,2,4
Breathcutter,hyjal,192,rogue,assassination,6,2,4
Hertyso,outland,192,rogue,assassination,6,2,4
Свартахейм,soulflayer,192,rogue,assassination,9,2,7
Totentánz,silvermoon,192,rogue,assassination,15,3,12
Ayatsuji,nemesis,192,rogue,assassination,12,2,10
Neirdà,hyjal,192,rogue,assassination,12,2,10
Hitogoroshi,hyjal,192,rogue,assassination,12,2,10
Vezinia,ravencrest,192,rogue,assassination,12,2,10
Naí,zuljin,192,rogue,assassination,12,2,10
Tokyotears,ravencrest,192,rogue,assassination,12,2,10
Sheyrrà,aegwynn,192,rogue,assassination,12,2,10
Dioûf,frostwolf,192,rogue,assassination,12,2,10
Mødinüs,archimonde,192,rogue,assassination,12,2,10
Hanteran,magtheridon,192,rogue,assassination,12,2,10
Phantomex,blackmoore,192,rogue,assassination,12,2,10
Cacucoxpahu,kazzak,192,rogue,assassination,12,2,10
Rasponi,ragnaros,192,rogue,assassination,12,2,10
Bolesnirogue,draenor,192,rogue,assassination,12,2,10
Sylvanshadow,nemesis,192,rogue,assassination,12,2,10
Sneakzy,sylvanas,192,rogue,assassination,12,2,10
Skilz,sylvanas,192,rogue,assassination,12,2,10
Меттерз,gordunni,192,rogue,assassination,12,2,10
Ôrígìnälnezo,drakthul,192,rogue,assassination,12,2,10
Параножей,howling-fjord,192,rogue,assassination,12,2,10
Лэйкиро,gordunni,192,rogue,assassination,12,2,10
Dalishia,blackhand,192,rogue,assassination,12,2,10
Madridistaßß,outland,192,rogue,assassination,12,2,10
Celaena,shadowsong,192,rogue,assassination,18,2,16
Coopér,argent-dawn,192,rogue,assassination,18,2,16
Nesä,hyjal,192,rogue,assassination,18,2,16
Токссиси,gordunni,191,rogue,assassination,6,2,4
Drexxo,drakthul,191,rogue,assassination,6,2,4
Nhot,kazzak,191,rogue,assassination,6,2,4
Morder,nemesis,191,rogue,assassination,6,2,4
Sneazzy,marécage-de-zangar,191,rogue,assassination,6,2,4
Thugore,thunderhorn,191,rogue,assassination,6,2,4
Arthhurra,ragnaros,191,rogue,assassination,12,2,10
Вангельм,gordunni,191,rogue,assassination,12,2,10
Viegoo,archimonde,191,rogue,assassination,18,2,16
Jëster,hyjal,190,rogue,assassination,9,3,6
Snikrot,karazhan,190,rogue,assassination,12,2,10
Murant,twisting-nether,190,rogue,assassination,12,2,10
Icyicé,kazzak,175,rogue,assassination,11,2,9
Ццианидд,gordunni,169,rogue,assassination,17,5,12
Backpaddlerx,malygos,160,rogue,assassination,10,2,8
Blindsidé,bronze-dragonflight,159,rogue,assassination,5,2,3
Dalyarrogue,twisting-nether,159,rogue,assassination,5,2,3
Nià,argent-dawn,158,rogue,assassination,10,2,8
Астерист,gordunni,142,rogue,assassination,9,2,7
Gitguduwu,tarren-mill,138,rogue,assassination,10,3,7
Shâdowfreeze,onyxia,138,rogue,assassination,22,4,18
Stickia,ysondre,96,rogue,assassination,3,2,1
Тойтаро,soulflayer,96,rogue,assassination,3,2,1
Sly,emerald-dream,96,rogue,assassination,6,1,5
Appelschorlê,eredar,96,rogue,assassination,6,1,5
Vanisshh,hyjal,96,rogue,assassination,6,1,5
Takiya,ysondre,96,rogue,assassination,6,1,5
Jamzyrogue,emerald-dream,96,rogue,assassination,6,1,5
Hàly,ravencrest,96,rogue,assassination,6,1,5
Roguy,wildhammer,96,rogue,assassination,6,1,5
Гриксон,blackscar,96,rogue,assassination,6,1,5
Janx,aegwynn,96,rogue,assassination,6,1,5
Asasina,los-errantes,96,rogue,assassination,6,1,5
Coupdegras,chamber-of-aspects,96,rogue,assassination,6,1,5
Yörgs,eredar,96,rogue,assassination,6,1,5
Buffdh,eredar,96,rogue,assassination,6,1,5
Finfcyn,burning-legion,96,rogue,assassination,6,1,5
Ravenom,sylvanas,96,rogue,assassination,6,1,5
Thiranor,cthun,96,rogue,assassination,6,1,5
Asmodal,die-nachtwache,96,rogue,assassination,6,1,5
Natkatje,azjolnerub,96,rogue,assassination,6,1,5
Метаболикх,gordunni,96,rogue,assassination,6,1,5
Ñavy,archimonde,96,rogue,assassination,6,1,5
Faso,thunderhorn,96,rogue,assassination,6,1,5
Sbx,alakir,96,rogue,assassination,6,1,5
Cappuccinoxo,blackmoore,96,rogue,assassination,6,1,5
Pfaded,steamwheedle-cartel,96,rogue,assassination,6,1,5
Msrogue,eredar,96,rogue,assassination,6,1,5
Daÿum,dalaran,96,rogue,assassination,6,1,5
Kilabre,twisting-nether,96,rogue,assassination,6,1,5
Dâlis,kazzak,96,rogue,assassination,6,1,5
Роудхог,blackscar,96,rogue,assassination,6,1,5
Goblindrill,blackmoore,96,rogue,assassination,6,1,5
Yamajinzu,blackmoore,96,rogue,assassination,6,1,5
Dachdagger,malfurion,96,rogue,assassination,6,1,5
Lorinthel,argent-dawn,96,rogue,assassination,6,1,5
Knive,marécage-de-zangar,96,rogue,assassination,6,1,5
Wøølfgang,archimonde,96,rogue,assassination,6,1,5
Ohmydotz,archimonde,96,rogue,assassination,6,1,5
Bekkz,todeswache,96,rogue,assassination,6,1,5
Guzirogue,azshara,96,rogue,assassination,6,1,5
Duo,karazhan,96,rogue,assassination,6,1,5
Zlati,blackrock,96,rogue,assassination,6,1,5
Dieschönheit,kazzak,96,rogue,assassination,6,1,5
Nexieane,ravencrest,96,rogue,assassination,6,1,5
Gílgámesh,outland,96,rogue,assassination,6,1,5
Agensix,outland,96,rogue,assassination,6,1,5
Mokmok,frostwolf,96,rogue,assassination,6,1,5
Dayanir,aggra-português,96,rogue,assassination,6,1,5
Flaycesap,blackmoore,96,rogue,assassination,6,1,5
Ðiè,frostmane,96,rogue,assassination,6,1,5
Olgabuzova,hyjal,96,rogue,assassination,6,1,5
Natillaa,dun-modr,96,rogue,assassination,6,1,5
Penetrantos,eredar,96,rogue,assassination,6,1,5
Paveli,ravencrest,96,rogue,assassination,6,1,5
Куллтро,blackscar,96,rogue,assassination,6,1,5
Mekóz,draenor,96,rogue,assassination,6,1,5
Lizwi,ragnaros,96,rogue,assassination,6,1,5
Pronna,ragnaros,96,rogue,assassination,6,1,5
Eselchen,blackmoore,96,rogue,assassination,6,1,5
Expositiv,blackmoore,96,rogue,assassination,6,1,5
Møtivate,ragnaros,96,rogue,assassination,6,1,5
Normbutt,outland,96,rogue,assassination,6,1,5
Hallowéén,turalyon,96,rogue,assassination,6,1,5
Royalflüx,grim-batol,96,rogue,assassination,6,1,5
Twoballz,doomhammer,96,rogue,assassination,6,1,5
Пондимониум,azuregos,96,rogue,assassination,6,1,5
Nelji,archimonde,96,rogue,assassination,6,1,5
Mortdorei,argent-dawn,96,rogue,assassination,6,1,5
Tyzla,blackrock,96,rogue,assassination,6,1,5
Missàh,archimonde,96,rogue,assassination,6,1,5
Roguerstam,kazzak,96,rogue,assassination,6,1,5
Deceptionz,ravencrest,96,rogue,assassination,6,1,5
Osap,kazzak,96,rogue,assassination,6,1,5
Depleter,bloodfeather,96,rogue,assassination,6,1,5
Flêxô,antonidas,96,rogue,assassination,6,1,5
Sozzerog,kazzak,96,rogue,assassination,6,1,5
Roronao,sanguino,96,rogue,assassination,6,1,5
Macix,zuljin,96,rogue,assassination,6,1,5
Социалистсс,gordunni,96,rogue,assassination,6,1,5
Пастернук,howling-fjord,96,rogue,assassination,6,1,5
Madmann,ravencrest,96,rogue,assassination,6,1,5
Иордани,gordunni,96,rogue,assassination,6,1,5
Кустедис,howling-fjord,96,rogue,assassination,6,1,5
Vexior,argent-dawn,96,rogue,assassination,6,1,5
Nerfexpected,silvermoon,96,rogue,assassination,6,1,5
Mazikeeñ,silvermoon,96,rogue,assassination,6,1,5
Chøsen,stormscale,96,rogue,assassination,6,1,5
Shåkø,tarren-mill,96,rogue,assassination,6,1,5
Freakzi,blackhand,96,rogue,assassination,6,1,5
Дизелюжн,howling-fjord,96,rogue,assassination,6,1,5
Bizzarerogue,tarren-mill,96,rogue,assassination,6,1,5
Kenko,aerie-peak,96,rogue,assassination,6,1,5
Ziqqiqt,thrall,96,rogue,assassination,6,1,5
Hendrikske,aggramar,96,rogue,assassination,6,1,5
Azryel,tarren-mill,96,rogue,assassination,6,1,5
Donowan,stormscale,96,rogue,assassination,6,1,5
Чортьяка,soulflayer,96,rogue,assassination,6,1,5
Кейнилин,gordunni,96,rogue,assassination,6,1,5
Pjotre,mannoroth,96,rogue,assassination,6,1,5
Frequenzalfa,silvermoon,96,rogue,assassination,6,1,5
Zarlen,argent-dawn,96,rogue,assassination,6,1,5
Stepbro,kelthuzad,96,rogue,assassination,6,1,5
Djkollejk,malganis,96,rogue,assassination,6,1,5
Toketje,sylvanas,96,rogue,assassination,6,1,5
Bakithekiddo,silvermoon,96,rogue,assassination,6,1,5
Héragor,illidan,96,rogue,assassination,6,1,5
Cÿlan,sylvanas,96,rogue,assassination,6,1,5
Fllowow,stormscale,96,rogue,assassination,6,1,5
Belgradex,silvermoon,96,rogue,assassination,6,1,5
Boloboc,ravencrest,96,rogue,assassination,7,1,6
Распяздяй,gordunni,96,rogue,assassination,7,1,6
Proilas,draenor,96,rogue,assassination,11,1,10
Kyoukaî,archimonde,96,rogue,assassination,12,1,11
Axidían,argent-dawn,96,rogue,assassination,12,1,11
Erenyeagerx,kazzak,96,rogue,assassination,12,1,11
Tybiereus,argent-dawn,96,rogue,assassination,12,1,11
Рестинписер,soulflayer,96,rogue,assassination,12,1,11
Barbuniarz,shadowsong,96,rogue,assassination,12,1,11
Жорий,borean-tundra,96,rogue,assassination,12,1,11
Lilninjadude,silvermoon,96,rogue,assassination,12,1,11
Engles,twisting-nether,96,rogue,assassination,12,1,11
Роророл,gordunni,96,rogue,assassination,12,1,11
Diededlmao,ragnaros,96,rogue,assassination,12,1,11
Триплсап,howling-fjord,96,rogue,assassination,12,1,11
Wxlf,ravencrest,96,rogue,assassination,12,1,11
Jawen,silvermoon,96,rogue,assassination,12,1,11
Sanguinea,minahonda,96,rogue,assassination,12,1,11
Ønlylovcindy,drekthar,96,rogue,assassination,12,1,11
Crispflake,frostwolf,96,rogue,assassination,18,1,17
Calyon,hyjal,96,rogue,assassination,18,1,17
Ravéñ,silvermoon,96,rogue,assassination,24,1,23
Vicenzo,archimonde,95,rogue,assassination,3,2,1
Belina,draenor,95,rogue,assassination,6,1,5
Аморалез,deathweaver,95,rogue,assassination,6,1,5
Вейкингдрим,gordunni,79,rogue,assassination,5,1,4
Twitch,uldaman,64,rogue,assassination,4,1,3
Nerkmind,ragnaros,64,rogue,assassination,4,1,3
Vound,tarren-mill,64,rogue,assassination,4,1,3
Elgande,stormrage,63,rogue,assassination,2,2,0
Rûzk,frostwolf,48,rogue,assassination,3,1,2
Vanquishz,arathor,48,rogue,assassination,3,1,2
Kraílyx,malorne,42,rogue,assassination,12,3,9
Хемофилия,grom,42,rogue,assassination,8,2,6
Kanilol,eredar,42,rogue,assassination,8,2,6
Nightbláde,burning-legion,42,rogue,assassination,10,2,8
Kkraken,dalaran,41,rogue,assassination,10,2,8
Sofang,colinas-pardas,31,rogue,assassination,2,1,1
Дивеас,blackscar,31,rogue,assassination,8,1,7
Abaar,defias-brotherhood,16,rogue,assassination,13,1,12
Domo,stormscale,2228,shaman,restoration,156,81,75
Zhull,ravencrest,2191,shaman,restoration,723,370,353
Chokelord,archimonde,2185,shaman,restoration,66,40,26
Shadrak,eredar,2172,shaman,restoration,102,55,47
Shamidrak,eredar,2159,shaman,restoration,114,60,54
Navajito,tarren-mill,2154,shaman,restoration,60,42,18
Hímars,ragnaros,2151,shaman,restoration,101,52,49
Gigawashed,archimonde,2145,shaman,restoration,53,38,15
Венжии,soulflayer,2144,shaman,restoration,120,61,59
Timide,ravencrest,2141,shaman,restoration,84,45,39
Мефодийшаман,howling-fjord,2139,shaman,restoration,148,92,56
Killrogge,kazzak,2135,shaman,restoration,109,78,31
Сладкийстас,soulflayer,2129,shaman,restoration,197,108,89
Daretodream,blackrock,2129,shaman,restoration,71,37,34
Chävaman,archimonde,2124,shaman,restoration,78,44,34
Терату,howling-fjord,2118,shaman,restoration,84,46,38
Valko,hellfire,2113,shaman,restoration,84,51,33
Crnine,pozzo-delleternità,2112,shaman,restoration,75,49,26
Mininini,ravencrest,2112,shaman,restoration,151,78,73
Libanô,archimonde,2112,shaman,restoration,1009,498,511
Keén,burning-legion,2103,shaman,restoration,147,82,65
Кодитян,gordunni,2100,shaman,restoration,89,48,41
Светшам,howling-fjord,2098,shaman,restoration,94,49,45
Sèfìx,tarren-mill,2094,shaman,restoration,61,33,28
Vanostbzt,kazzak,2093,shaman,restoration,94,46,48
Somethingnew,azuremyst,2090,shaman,restoration,248,122,126
Señordoge,kazzak,2079,shaman,restoration,101,56,45
Unbrokeñ,stormscale,2077,shaman,restoration,99,49,50
Иними,soulflayer,2076,shaman,restoration,485,248,237
Asynchund,ravencrest,2074,shaman,restoration,77,45,32
Benpai,eredar,2072,shaman,restoration,118,61,57
Snovii,drakthul,2067,shaman,restoration,108,54,54
Chäväman,archimonde,2059,shaman,restoration,238,119,119
Söd,dun-morogh,2058,shaman,restoration,275,145,130
Ultrahound,twisting-nether,2057,shaman,restoration,48,39,9
Светшамка,howling-fjord,2054,shaman,restoration,59,32,27
Jackypink,ragnaros,2052,shaman,restoration,309,156,153
Elmezz,aggra-português,2050,shaman,restoration,88,47,41
Wess,archimonde,2048,shaman,restoration,66,35,31
Nokster,twisting-nether,2038,shaman,restoration,230,141,89
Rheax,tarren-mill,2036,shaman,restoration,96,48,48
Дольчих,deathguard,2036,shaman,restoration,325,158,167
Nickygodx,stormscale,2032,shaman,restoration,113,60,53
Jelincic,ravencrest,2027,shaman,restoration,96,52,44
Carlitosham,eredar,2027,shaman,restoration,110,54,56
Greggyb,twisting-nether,2026,shaman,restoration,60,34,26
Keenxd,burning-legion,2026,shaman,restoration,154,83,71
Langhantel,kazzak,2017,shaman,restoration,176,107,69
Вишняблэйз,soulflayer,2011,shaman,restoration,219,118,101
Ltmsham,ravencrest,2011,shaman,restoration,102,53,49
Боунсе,howling-fjord,2008,shaman,restoration,84,40,44
Rogerscruton,blades-edge,2005,shaman,restoration,389,200,189
Swineflowing,ysondre,2004,shaman,restoration,120,63,57
Lavalavalava,blackrock,1993,shaman,restoration,447,244,203
Josë,twisting-nether,1992,shaman,restoration,191,97,94
Skillrogge,kazzak,1990,shaman,restoration,80,49,31
Panda,stormscale,1990,shaman,restoration,102,57,45
Kisshots,the-maelstrom,1985,shaman,restoration,404,207,197
Драгенхз,gordunni,1983,shaman,restoration,387,195,192
Swkx,dun-modr,1981,shaman,restoration,278,149,129
Arathoir,ravencrest,1976,shaman,restoration,96,51,45
Trbhlk,blackrock,1970,shaman,restoration,83,41,42
Zergønk,ravencrest,1969,shaman,restoration,66,42,24
Carlpeant,drakthul,1968,shaman,restoration,245,124,121
Слишкомплох,howling-fjord,1967,shaman,restoration,90,42,48
Moistpuss,kazzak,1966,shaman,restoration,126,81,45
Finaltotem,draenor,1966,shaman,restoration,132,61,71
Gargro,kazzak,1965,shaman,restoration,175,93,82
Frshprn,hyjal,1964,shaman,restoration,108,59,49
Deepwithyou,blackhand,1964,shaman,restoration,165,90,75
Слишкомпох,howling-fjord,1960,shaman,restoration,54,30,24
Trashgame,kazzak,1960,shaman,restoration,160,83,77
Sõap,tarren-mill,1957,shaman,restoration,83,51,32
Eras,ragnaros,1956,shaman,restoration,46,30,16
Shockojambo,kazzak,1954,shaman,restoration,78,37,41
Bowiè,twisting-nether,1954,shaman,restoration,78,36,42
Epsylone,kazzak,1953,shaman,restoration,101,51,50
Bobanrajovic,silvermoon,1951,shaman,restoration,54,33,21
Linkx,stormscale,1948,shaman,restoration,40,22,18
Gettingolder,kazzak,1948,shaman,restoration,80,38,42
Kalypsø,arthas,1942,shaman,restoration,106,62,44
Kreamcake,bladefist,1938,shaman,restoration,229,114,115
Twísting,tarren-mill,1931,shaman,restoration,137,75,62
Ønepåc,hyjal,1930,shaman,restoration,93,44,49
Ripperdoc,stormreaver,1930,shaman,restoration,144,68,76
Rhinoketamin,kazzak,1928,shaman,restoration,140,85,55
Dàazle,ravencrest,1928,shaman,restoration,137,64,73
Lavelover,tarren-mill,1927,shaman,restoration,66,41,25
Sprühkot,aegwynn,1927,shaman,restoration,64,37,27
Oldandslow,sylvanas,1923,shaman,restoration,72,38,34
Skreewu,outland,1923,shaman,restoration,144,69,75
Скарфэйсх,soulflayer,1921,shaman,restoration,108,60,48
Fersok,zuljin,1919,shaman,restoration,60,32,28
Wíllz,ravencrest,1919,shaman,restoration,66,33,33
Цукерок,soulflayer,1914,shaman,restoration,149,87,62
Karlurban,outland,1913,shaman,restoration,85,37,48
Holytidezx,aegwynn,1912,shaman,restoration,52,34,18
Mýthaz,archimonde,1910,shaman,restoration,84,59,25
Carpetmaster,ragnaros,1910,shaman,restoration,69,34,35
Sugarfreé,ragnaros,1908,shaman,restoration,54,30,24
Рамаксбосс,gordunni,1907,shaman,restoration,60,38,22
Lunarsloths,hyjal,1907,shaman,restoration,54,33,21
Westide,conseil-des-ombres,1905,shaman,restoration,66,35,31
Sentûn,blackrock,1901,shaman,restoration,186,95,91
Elwynnpolice,argent-dawn,1900,shaman,restoration,142,70,72
Онеоне,deathweaver,1899,shaman,restoration,83,48,35
Vivaldi,varimathras,1899,shaman,restoration,56,29,27
Котенокмур,soulflayer,1899,shaman,restoration,48,20,28
Aioñ,kazzak,1896,shaman,restoration,110,56,54
Кенкерх,gordunni,1896,shaman,restoration,138,65,73
Urzza,stormscale,1895,shaman,restoration,42,36,6
Askagain,sylvanas,1895,shaman,restoration,58,32,26
Hexewar,kazzak,1895,shaman,restoration,181,98,83
Garuga,dun-morogh,1893,shaman,restoration,60,33,27
Boruggshaman,kazzak,1892,shaman,restoration,72,35,37
Holytidez,aegwynn,1891,shaman,restoration,66,34,32
Fotmherøqtx,ravencrest,1890,shaman,restoration,378,193,185
Icecrêam,auchindoun,1889,shaman,restoration,52,26,26
Hexe,kazzak,1887,shaman,restoration,105,52,53
Shaloxe,silvermoon,1885,shaman,restoration,53,28,25
Fufupartyxx,blackrock,1883,shaman,restoration,60,37,23
Брфф,gordunni,1882,shaman,restoration,48,26,22
Aboveaverage,stormscale,1881,shaman,restoration,72,28,44
Krugx,draenor,1875,shaman,restoration,81,41,40
Jazzcore,twisting-nether,1872,shaman,restoration,41,25,16
Эоя,howling-fjord,1872,shaman,restoration,260,136,124
Dêblâzê,thrall,1869,shaman,restoration,84,46,38
Elmezz,outland,1867,shaman,restoration,54,33,21
Ize,sylvanas,1867,shaman,restoration,281,157,124
Кодишам,howling-fjord,1866,shaman,restoration,52,29,23
Iloveléa,ravencrest,1866,shaman,restoration,131,72,59
Owrly,stormscale,1866,shaman,restoration,148,71,77
Epsy,magtheridon,1865,shaman,restoration,92,60,32
Tallyx,ravencrest,1864,shaman,restoration,131,62,69
Вавувоух,howling-fjord,1863,shaman,restoration,54,27,27
Tidepog,ravencrest,1863,shaman,restoration,102,49,53
Neou,archimonde,1863,shaman,restoration,66,31,35
Shànnón,kazzak,1862,shaman,restoration,47,23,24
Cherepaha,stormscale,1861,shaman,restoration,94,45,49
Jawje,tarren-mill,1860,shaman,restoration,108,53,55
Мефодийшама,howling-fjord,1860,shaman,restoration,192,93,99
Lontarita,tarren-mill,1858,shaman,restoration,36,27,9
Sethrøllins,hyjal,1857,shaman,restoration,138,67,71
Thunderrock,stormreaver,1856,shaman,restoration,266,128,138
Yachiru,sylvanas,1854,shaman,restoration,73,59,14
Porkzzila,aggra-português,1854,shaman,restoration,101,61,40
Милфшама,blackscar,1853,shaman,restoration,512,260,252
Kïllard,archimonde,1852,shaman,restoration,134,65,69
Xelgrin,silvermoon,1852,shaman,restoration,112,54,58
Ghettero,ragnaros,1851,shaman,restoration,39,25,14
Inspektør,kazzak,1851,shaman,restoration,77,46,31
Smightys,kazzak,1851,shaman,restoration,60,32,28
Snusy,stormscale,1851,shaman,restoration,48,24,24
Slimthug,sylvanas,1850,shaman,restoration,33,20,13
Yarali,argent-dawn,1850,shaman,restoration,66,35,31
Wyrolink,ragnaros,1850,shaman,restoration,72,36,36
Natasz,burning-legion,1849,shaman,restoration,224,122,102
Трс,razuvious,1847,shaman,restoration,275,142,133
Numbs,tarren-mill,1846,shaman,restoration,48,24,24
Zaru,sanguino,1846,shaman,restoration,63,31,32
Ujasdaddy,stormscale,1844,shaman,restoration,48,29,19
Waramors,eredar,1841,shaman,restoration,185,96,89
Wernøz,archimonde,1841,shaman,restoration,92,43,49
Harmony,outland,1839,shaman,restoration,66,44,22
Shamolili,stormscale,1839,shaman,restoration,165,86,79
Akwa,stormscale,1839,shaman,restoration,44,20,24
Bezixx,ravencrest,1838,shaman,restoration,222,126,96
Cellfury,kazzak,1837,shaman,restoration,46,36,10
Johncoltrane,archimonde,1837,shaman,restoration,150,93,57
Twkupe,tarren-mill,1837,shaman,restoration,42,24,18
Allysidewtf,archimonde,1836,shaman,restoration,56,36,20
Brownbear,stormscale,1836,shaman,restoration,179,97,82
Hydrolîc,blackrock,1833,shaman,restoration,84,50,34
Batmanmain,twisting-nether,1833,shaman,restoration,53,31,22
Gorbagh,zuluhed,1833,shaman,restoration,66,35,31
Mysterqt,nemesis,1833,shaman,restoration,48,24,24
Morkyy,thrall,1832,shaman,restoration,56,31,25
Тубалкайн,soulflayer,1832,shaman,restoration,54,28,26
Kongx,blackhand,1832,shaman,restoration,232,119,113
Abujalta,stormscale,1832,shaman,restoration,48,22,26
Reidzls,kazzak,1831,shaman,restoration,42,23,19
Peeps,archimonde,1831,shaman,restoration,60,30,30
Adrixxøn,burning-legion,1831,shaman,restoration,66,27,39
Shamuunn,ravencrest,1830,shaman,restoration,54,28,26
Wisplola,ravencrest,1829,shaman,restoration,101,42,59
Велоун,soulflayer,1828,shaman,restoration,86,44,42
Hexalicius,sylvanas,1828,shaman,restoration,78,38,40
Rostislav,ravencrest,1827,shaman,restoration,59,31,28
Cæsífer,blackrock,1827,shaman,restoration,113,50,63
Fitnessdavid,ravencrest,1826,shaman,restoration,53,29,24
Lexxthree,blackrock,1824,shaman,restoration,64,33,31
Ikeadamen,alakir,1824,shaman,restoration,78,38,40
Awcchampion,stormscale,1822,shaman,restoration,350,191,159
Centralc,twisting-nether,1820,shaman,restoration,47,28,19
Бомжмувис,howling-fjord,1819,shaman,restoration,30,19,11
Igly,antonidas,1819,shaman,restoration,60,31,29
Totembaws,blackmoore,1819,shaman,restoration,90,44,46
Icecrêam,stormreaver,1816,shaman,restoration,65,31,34
Donv,blackmoore,1815,shaman,restoration,48,30,18
Bladeyx,ragnaros,1815,shaman,restoration,243,135,108
Faric,draenor,1815,shaman,restoration,54,30,24
Sûckmytotem,ragnaros,1815,shaman,restoration,72,35,37
Turbohulk,blackrock,1815,shaman,restoration,55,25,30
Prîce,blackmoore,1813,shaman,restoration,54,32,22
Ixxmre,blackrock,1813,shaman,restoration,189,104,85
Mymylo,archimonde,1813,shaman,restoration,48,25,23
Defibrillata,blackrock,1813,shaman,restoration,513,267,246
Jawj,tarren-mill,1813,shaman,restoration,107,48,59
Bummexx,twisting-nether,1812,shaman,restoration,102,59,43
Bunyie,ragnaros,1812,shaman,restoration,90,48,42
Mjollnier,stormscale,1812,shaman,restoration,79,41,38
Нойзблок,gordunni,1811,shaman,restoration,36,19,17
Natty,ravencrest,1810,shaman,restoration,151,96,55
Reinu,ragnaros,1809,shaman,restoration,137,74,63
Wawawoowee,archimonde,1809,shaman,restoration,132,71,61
Yannkee,ravencrest,1809,shaman,restoration,78,39,39
Remony,pozzo-delleternità,1808,shaman,restoration,128,83,45
Qoekke,uldum,1808,shaman,restoration,48,28,20
Fuzzynuts,ravencrest,1808,shaman,restoration,132,74,58
Necrodog,blackrock,1807,shaman,restoration,78,49,29
Crymemore,stormscale,1807,shaman,restoration,77,41,36
Thefirebird,blackhand,1807,shaman,restoration,178,92,86
Namestaljka,stormscale,1805,shaman,restoration,30,19,11
Дочьшефа,gordunni,1805,shaman,restoration,60,36,24
Wíwi,kazzak,1805,shaman,restoration,86,47,39
Firestormx,drakthul,1803,shaman,restoration,106,71,35
Fee,silvermoon,1803,shaman,restoration,45,25,20
Bloodvaron,zuljin,1803,shaman,restoration,176,90,86
Voodoonerd,twisting-nether,1803,shaman,restoration,47,24,23
Lilalime,arthas,1803,shaman,restoration,54,25,29
Apexe,outland,1803,shaman,restoration,106,41,65
Variablelol,outland,1802,shaman,restoration,118,73,45
Bigdamshear,outland,1802,shaman,restoration,60,31,29
Meöw,nemesis,1802,shaman,restoration,274,140,134
Lilililil,sanguino,1802,shaman,restoration,733,372,361
Taste,cthun,1802,shaman,restoration,70,32,38
Мвнз,soulflayer,1802,shaman,restoration,96,43,53
Мимигор,razuvious,1801,shaman,restoration,35,27,8
Nstéa,zuljin,1801,shaman,restoration,48,28,20
Kiansham,silvermoon,1801,shaman,restoration,47,26,21
Shockjob,kazzak,1801,shaman,restoration,50,26,24
Колбаскофф,gordunni,1801,shaman,restoration,77,39,38
Squixi,tarren-mill,1799,shaman,restoration,66,36,30
Beoka,dun-modr,1798,shaman,restoration,57,28,29
Bjoernwaldur,outland,1797,shaman,restoration,100,48,52
Tâkeda,blackmoore,1795,shaman,restoration,166,82,84
Purgerkìng,tarren-mill,1791,shaman,restoration,36,24,12
Alanus,draenor,1791,shaman,restoration,324,161,163
Shiranoye,blackrock,1790,shaman,restoration,162,84,78
Stylia,twisting-nether,1788,shaman,restoration,84,47,37
Nimbs,tarren-mill,1788,shaman,restoration,54,29,25
Мвнзх,gordunni,1787,shaman,restoration,96,45,51
Djtidex,conseil-des-ombres,1784,shaman,restoration,54,29,25
Pogchampz,nemesis,1784,shaman,restoration,42,21,21
Incredibade,stormscale,1782,shaman,restoration,66,32,34
Bytheway,aegwynn,1778,shaman,restoration,303,142,161
Nübs,aegwynn,1778,shaman,restoration,161,75,86
Bezixx,argent-dawn,1776,shaman,restoration,218,112,106
Pstpstpsst,azjolnerub,1774,shaman,restoration,53,25,28
Shøckxy,blackrock,1773,shaman,restoration,66,30,36
Sheargodx,blackmoore,1771,shaman,restoration,48,25,23
Cylantarus,blackrock,1771,shaman,restoration,205,105,100
Elmie,outland,1770,shaman,restoration,40,24,16
Szellento,darksorrow,1769,shaman,restoration,96,47,49
Simiann,outland,1768,shaman,restoration,42,29,13
Ларкуш,howling-fjord,1766,shaman,restoration,176,93,83
Orcshaman,khadgar,1766,shaman,restoration,84,42,42
Traickosham,eredar,1764,shaman,restoration,54,40,14
Awumbahway,outland,1764,shaman,restoration,168,91,77
Daubidaubi,kazzak,1763,shaman,restoration,140,87,53
Zanezu,stormscale,1763,shaman,restoration,203,106,97
Bstr,frostmane,1763,shaman,restoration,60,30,30
Ihealbro,blackrock,1762,shaman,restoration,66,41,25
Tether,twisting-nether,1760,shaman,restoration,71,43,28
Дыркавауре,soulflayer,1760,shaman,restoration,97,44,53
Lsdhero,stormscale,1759,shaman,restoration,30,21,9
Scriptx,blackmoore,1759,shaman,restoration,42,25,17
Invadé,stormscale,1759,shaman,restoration,42,23,19
Reäz,archimonde,1758,shaman,restoration,156,77,79
Kyogre,auchindoun,1756,shaman,restoration,132,71,61
Teldatwo,archimonde,1755,shaman,restoration,71,42,29
Teldathree,archimonde,1755,shaman,restoration,457,236,221
Кхуздуфар,blackscar,1754,shaman,restoration,60,26,34
Ghostlights,doomhammer,1752,shaman,restoration,122,52,70
Cynthila,stormreaver,1749,shaman,restoration,54,34,20
Learningsham,destromath,1749,shaman,restoration,48,29,19
Brokgar,ragnaros,1749,shaman,restoration,49,29,20
Dmgaddict,kazzak,1747,shaman,restoration,78,46,32
Bzglsnkh,ravencrest,1747,shaman,restoration,69,31,38
Hexur,archimonde,1746,shaman,restoration,86,49,37
Tùiðhânâ,ravencrest,1746,shaman,restoration,302,157,145
Shoqt,les-sentinelles,1744,shaman,restoration,48,28,20
Andarà,hyjal,1744,shaman,restoration,74,41,33
Shneems,twisting-nether,1741,shaman,restoration,199,113,86
Karakoram,ysondre,1741,shaman,restoration,155,82,73
Dubìff,hyjal,1740,shaman,restoration,39,26,13
Exhale,archimonde,1740,shaman,restoration,246,141,105
Shivanea,blackrock,1740,shaman,restoration,48,24,24
Rottulos,stormrage,1739,shaman,restoration,65,35,30
Kraksham,ravencrest,1739,shaman,restoration,142,75,67
Sniege,outland,1738,shaman,restoration,36,23,13
Imbatlys,blackmoore,1738,shaman,restoration,42,24,18
Squixi,ravencrest,1738,shaman,restoration,59,33,26
Gønuts,sylvanas,1738,shaman,restoration,132,71,61
Jenkem,hyjal,1738,shaman,restoration,138,72,66
Adroda,kazzak,1738,shaman,restoration,258,128,130
Smøul,sanguino,1738,shaman,restoration,72,31,41
Nestre,kazzak,1737,shaman,restoration,113,53,60
Bìnary,ravencrest,1737,shaman,restoration,60,27,33
Ðomestos,stormscale,1734,shaman,restoration,66,27,39
Ewrecked,frostwhisper,1733,shaman,restoration,56,33,23
Totoswich,tarren-mill,1733,shaman,restoration,77,43,34
Purgeluxe,aegwynn,1733,shaman,restoration,125,65,60
Vakamme,draenor,1733,shaman,restoration,66,28,38
Helloiamdoni,ravencrest,1730,shaman,restoration,130,73,57
Windfúhrèr,tarren-mill,1729,shaman,restoration,72,31,41
Rexatar,blackrock,1728,shaman,restoration,320,168,152
Meneswave,blackhand,1728,shaman,restoration,96,47,49
Teldarian,archimonde,1727,shaman,restoration,42,22,20
Агентхолинки,gordunni,1726,shaman,restoration,24,18,6
Melliüg,ysondre,1726,shaman,restoration,102,62,40
Wamarï,draenor,1726,shaman,restoration,108,63,45
Shockmelone,blackrock,1726,shaman,restoration,284,140,144
Bullezno,kazzak,1725,shaman,restoration,111,66,45
Phaynozx,cthun,1725,shaman,restoration,114,47,67
Còób,ravencrest,1725,shaman,restoration,67,27,40
Midgetfizzle,kazzak,1724,shaman,restoration,471,232,239
Arslos,twisting-nether,1723,shaman,restoration,30,24,6
Socialfailur,archimonde,1722,shaman,restoration,30,18,12
Agnøt,khaz-modan,1722,shaman,restoration,120,70,50
Baßy,archimonde,1721,shaman,restoration,60,28,32
Higgy,stormscale,1720,shaman,restoration,41,25,16
Тафельшпиц,soulflayer,1720,shaman,restoration,109,53,56
Artîe,archimonde,1720,shaman,restoration,54,23,31
Kurreshm,stormreaver,1720,shaman,restoration,60,25,35
Eddiemorphin,kazzak,1719,shaman,restoration,95,59,36
Wibra,nagrand,1719,shaman,restoration,60,34,26
Nailos,dun-modr,1718,shaman,restoration,187,97,90
Bmbx,archimonde,1718,shaman,restoration,686,338,348
Qobq,ravencrest,1717,shaman,restoration,24,18,6
Tommin,silvermoon,1716,shaman,restoration,54,27,27
Rhageist,blackmoore,1716,shaman,restoration,66,26,40
Snickersx,blackrock,1715,shaman,restoration,180,100,80
Thornyberrý,outland,1715,shaman,restoration,42,23,19
Pickett,tarren-mill,1715,shaman,restoration,76,34,42
Whiskiy,kazzak,1714,shaman,restoration,35,24,11
Mltx,twilights-hammer,1714,shaman,restoration,44,19,25
Hexmeqt,frostwolf,1713,shaman,restoration,167,94,73
Lillink,stormscale,1712,shaman,restoration,63,33,30
Jps,gorgonnash,1711,shaman,restoration,168,87,81
Dôppel,archimonde,1711,shaman,restoration,42,21,21
Sadfemecraft,aggramar,1710,shaman,restoration,518,260,258
Vioception,blackrock,1710,shaman,restoration,64,27,37
Radjus,kazzak,1709,shaman,restoration,54,23,31
Watchmetotem,stormscale,1707,shaman,restoration,60,36,24
Hieronesaa,stormreaver,1707,shaman,restoration,42,21,21
Nizzarrathur,argent-dawn,1706,shaman,restoration,30,18,12
Lavalovers,draenor,1706,shaman,restoration,66,39,27
Океансекса,soulflayer,1704,shaman,restoration,36,24,12
Alnaddaf,outland,1704,shaman,restoration,72,39,33
Connecting,hyjal,1704,shaman,restoration,39,21,18
Alëxx,hyjal,1704,shaman,restoration,115,55,60
Djtomp,kazzak,1704,shaman,restoration,54,25,29
Viinny,dun-modr,1704,shaman,restoration,126,56,70
Vajaele,twisting-nether,1703,shaman,restoration,131,65,66
Бунтх,howling-fjord,1702,shaman,restoration,86,42,44
Rapedtide,thrall,1701,shaman,restoration,142,68,74
Kontza,argent-dawn,1700,shaman,restoration,34,19,15
Lexos,ravencrest,1699,shaman,restoration,72,42,30
Mefl,tarren-mill,1699,shaman,restoration,101,52,49
Makkalisse,kazzak,1698,shaman,restoration,36,23,13
Nexian,kazzak,1698,shaman,restoration,89,53,36
Ominos,stormscale,1698,shaman,restoration,54,30,24
Torxii,antonidas,1698,shaman,restoration,315,169,146
Bomjspomoiki,outland,1697,shaman,restoration,47,24,23
Koruga,frostwolf,1696,shaman,restoration,82,47,35
Pacio,alakir,1696,shaman,restoration,657,341,316
Fatmikex,stormreaver,1696,shaman,restoration,72,30,42
Ганинапална,soulflayer,1696,shaman,restoration,60,24,36
Eurocad,draenor,1694,shaman,restoration,60,29,31
Holyshamixz,dun-modr,1694,shaman,restoration,70,32,38
Dóómhammer,jaedenar,1693,shaman,restoration,142,74,68
Bombasthicc,ravencrest,1693,shaman,restoration,66,31,35
Mustabrutus,tarren-mill,1692,shaman,restoration,71,35,36
Levarázsol,outland,1691,shaman,restoration,132,71,61
Wacomtablet,kazzak,1690,shaman,restoration,24,18,6
Palfe,khaz-modan,1689,shaman,restoration,356,176,180
Darnast,draenor,1689,shaman,restoration,118,53,65
Bountiti,dun-modr,1687,shaman,restoration,42,23,19
Goeller,stormscale,1687,shaman,restoration,54,29,25
Benlewis,twisting-nether,1687,shaman,restoration,54,23,31
Okrall,twisting-nether,1685,shaman,restoration,48,27,21
Thabolter,burning-legion,1685,shaman,restoration,42,22,20
Typhoeus,ragnaros,1685,shaman,restoration,52,25,27
Виелетта,gordunni,1684,shaman,restoration,30,18,12
Átòmíc,eredar,1684,shaman,restoration,36,18,18
Bioleta,twisting-nether,1684,shaman,restoration,167,74,93
Heatti,doomhammer,1684,shaman,restoration,48,21,27
Snogane,ravencrest,1682,shaman,restoration,50,32,18
Kutcher,aegwynn,1682,shaman,restoration,54,32,22
Shamdude,archimonde,1682,shaman,restoration,53,28,25
Skrewu,stormscale,1682,shaman,restoration,109,55,54
Urshak,alleria,1681,shaman,restoration,106,61,45
Statikznba,outland,1680,shaman,restoration,47,24,23
Thyroideus,argent-dawn,1679,shaman,restoration,414,222,192
Googleme,veklor,1679,shaman,restoration,94,45,49
Totemdog,blackmoore,1678,shaman,restoration,60,37,23
Monstacookie,stormreaver,1678,shaman,restoration,102,54,48
Sinzzu,ragnaros,1678,shaman,restoration,436,216,220
Jamienisme,ravencrest,1678,shaman,restoration,65,29,36
Likê,aegwynn,1677,shaman,restoration,36,25,11
Fapmasterz,eredar,1677,shaman,restoration,66,32,34
Mbembe,blackhand,1676,shaman,restoration,72,37,35
Horïons,dalaran,1675,shaman,restoration,60,31,29
Icanbreathe,ravencrest,1675,shaman,restoration,51,26,25
Yararsiz,twisting-nether,1675,shaman,restoration,422,209,213
Ibostemad,doomhammer,1675,shaman,restoration,89,43,46
Htagagain,archimonde,1674,shaman,restoration,36,21,15
Shamrockx,outland,1674,shaman,restoration,101,45,56
Zorcs,silvermoon,1673,shaman,restoration,326,167,159
Startdie,kazzak,1673,shaman,restoration,306,150,156
Jochenzulauf,blackrock,1672,shaman,restoration,154,89,65
Wyrt,burning-legion,1672,shaman,restoration,48,24,24
Árés,sanguino,1672,shaman,restoration,89,44,45
Mysapphie,kazzak,1672,shaman,restoration,46,22,24
Warpig,alakir,1670,shaman,restoration,148,79,69
Infinitetide,doomhammer,1670,shaman,restoration,42,20,22
Есперадох,blackscar,1668,shaman,restoration,99,45,54
Loltotem,outland,1666,shaman,restoration,42,26,16
Sanamaxx,colinas-pardas,1666,shaman,restoration,62,36,26
Shoxý,draenor,1666,shaman,restoration,84,44,40
Thrallmom,ravencrest,1666,shaman,restoration,42,19,23
Cahyr,ravencrest,1665,shaman,restoration,41,23,18
Bolg,veklor,1665,shaman,restoration,60,29,31
Mishoshamana,tarren-mill,1664,shaman,restoration,30,20,10
Linknvm,thrall,1664,shaman,restoration,243,147,96
Nøraa,ravencrest,1664,shaman,restoration,54,27,27
Powerhq,thrall,1663,shaman,restoration,100,55,45
Brandiløve,nemesis,1663,shaman,restoration,36,19,17
Сёмапурж,howling-fjord,1663,shaman,restoration,124,65,59
Teckan,tarren-mill,1663,shaman,restoration,48,24,24
Boltkesh,draenor,1662,shaman,restoration,36,24,12
Spiritbreak,kazzak,1661,shaman,restoration,34,23,11
Coldlean,haomarush,1660,shaman,restoration,396,203,193
Чинанрук,howling-fjord,1659,shaman,restoration,197,96,101
Triplewhoppa,thrall,1659,shaman,restoration,123,57,66
Lahey,draenor,1658,shaman,restoration,175,88,87
Questionable,antonidas,1658,shaman,restoration,115,54,61
Snobas,kazzak,1657,shaman,restoration,41,18,23
Вилкойвухо,howling-fjord,1655,shaman,restoration,110,42,68
Elliesham,kazzak,1654,shaman,restoration,41,25,16
Faridstreng,blackmoore,1654,shaman,restoration,150,83,67
Bâbbub,tarren-mill,1654,shaman,restoration,51,28,23
Luckymê,blackrock,1654,shaman,restoration,146,69,77
Kalhoznik,ravencrest,1653,shaman,restoration,36,18,18
Sondra,shendralar,1653,shaman,restoration,69,31,38
Earthhulk,thrall,1652,shaman,restoration,158,88,70
Dadan,ravencrest,1651,shaman,restoration,55,37,18
Tolatide,blackhand,1650,shaman,restoration,33,18,15
Rckfeller,burning-legion,1650,shaman,restoration,126,58,68
Mentaldead,draenor,1649,shaman,restoration,54,32,22
Tentacruel,sylvanas,1649,shaman,restoration,133,74,59
Ssalceliv,stormscale,1649,shaman,restoration,35,18,17
Tôrcal,hyjal,1649,shaman,restoration,48,21,27
Feizhousa,outland,1649,shaman,restoration,50,21,29
Atomstrom,frostwolf,1647,shaman,restoration,74,41,33
Gromaburst,stormscale,1647,shaman,restoration,48,24,24
Спиритл,blackscar,1646,shaman,restoration,45,30,15
Zelent,thrall,1646,shaman,restoration,42,24,18
Fridafrog,malganis,1646,shaman,restoration,278,150,128
Jaxsh,blackmoore,1646,shaman,restoration,47,22,25
Enzymex,sanguino,1646,shaman,restoration,84,34,50
Sanktyx,blackhand,1645,shaman,restoration,76,39,37
Coöld,archimonde,1645,shaman,restoration,42,21,21
Hugox,outland,1645,shaman,restoration,1040,508,532
Héxdóctór,ravencrest,1644,shaman,restoration,92,50,42
Splashgodx,frostwolf,1643,shaman,restoration,53,30,23
Ryukay,twisting-nether,1643,shaman,restoration,42,20,22
Jíkkz,aegwynn,1642,shaman,restoration,102,47,55
Bonshaman,ahnqiraj,1642,shaman,restoration,120,55,65
Снупдоггидог,howling-fjord,1642,shaman,restoration,54,22,32
Naômy,kazzak,1641,shaman,restoration,128,66,62
Icytide,kazzak,1641,shaman,restoration,90,42,48
Threnesham,kazzak,1640,shaman,restoration,198,95,103
Dmgccbot,outland,1639,shaman,restoration,92,41,51
Foxy,alakir,1638,shaman,restoration,126,66,60
Wildgust,tarren-mill,1638,shaman,restoration,46,24,22
Maestralink,aegwynn,1638,shaman,restoration,47,24,23
Ibicc,twisting-nether,1638,shaman,restoration,184,92,92
Кикподхвост,soulflayer,1638,shaman,restoration,102,49,53
Kissmepls,tarren-mill,1638,shaman,restoration,50,22,28
Крепкийтотем,soulflayer,1636,shaman,restoration,73,47,26
Bîlunder,arygos,1636,shaman,restoration,137,66,71
Tenken,khaz-modan,1635,shaman,restoration,46,26,20
Rxs,thunderhorn,1635,shaman,restoration,54,28,26
Healeugene,ravencrest,1635,shaman,restoration,85,44,41
Fourtwogodx,kazzak,1634,shaman,restoration,54,36,18
Skottkärrà,ravencrest,1634,shaman,restoration,36,24,12
Prizærn,tarren-mill,1634,shaman,restoration,153,72,81
Rokxa,burning-legion,1633,shaman,restoration,102,56,46
Blowxd,aegwynn,1633,shaman,restoration,259,137,122
Totembeard,frostmourne,1633,shaman,restoration,42,22,20
Shamansh,draenor,1632,shaman,restoration,88,55,33
Madytz,eredar,1632,shaman,restoration,83,46,37
Ugard,burning-legion,1632,shaman,restoration,148,79,69
Absot,dun-morogh,1632,shaman,restoration,95,49,46
Rdsanityproc,kazzak,1632,shaman,restoration,78,40,38
Louiesham,outland,1631,shaman,restoration,47,26,21
Nyfario,marécage-de-zangar,1631,shaman,restoration,42,22,20
Kharvo,draenor,1631,shaman,restoration,88,43,45
Sweetpea,antonidas,1631,shaman,restoration,90,42,48
Mjukiz,tarren-mill,1630,shaman,restoration,362,201,161
Fuzzywaagh,silvermoon,1630,shaman,restoration,178,95,83
Alroq,blackrock,1630,shaman,restoration,44,23,21
Évileye,silvermoon,1630,shaman,restoration,60,31,29
Seall,lightnings-blade,1630,shaman,restoration,42,20,22
Dgshîtdwarf,ravencrest,1630,shaman,restoration,72,33,39
Arshak,stormscale,1630,shaman,restoration,80,36,44
Dhozeg,silvermoon,1629,shaman,restoration,96,59,37
Realiz,ysondre,1629,shaman,restoration,42,20,22
Draáx,ravencrest,1628,shaman,restoration,30,19,11
Vioceptîon,blackrock,1627,shaman,restoration,60,45,15
Søtêx,ravencrest,1627,shaman,restoration,35,23,12
Elombrion,destromath,1626,shaman,restoration,102,63,39
Xclusiveqt,archimonde,1626,shaman,restoration,30,17,13
Shäman,burning-blade,1626,shaman,restoration,139,70,69
Papaver,zirkel-des-cenarius,1626,shaman,restoration,48,19,29
Amnéshaman,ysondre,1625,shaman,restoration,72,37,35
Shamimüll,twisting-nether,1624,shaman,restoration,42,29,13
Tarchoanvahg,ragnaros,1624,shaman,restoration,77,43,34
Pepegahex,blackmoore,1624,shaman,restoration,36,20,16
Xhanon,kazzak,1624,shaman,restoration,36,20,16
Kilazz,twisting-nether,1624,shaman,restoration,86,45,41
Хэйзл,ashenvale,1624,shaman,restoration,152,79,73
Labûche,chogall,1623,shaman,restoration,36,24,12
Svetosham,wildhammer,1623,shaman,restoration,53,28,25
Shocklet,twisting-nether,1622,shaman,restoration,36,29,7
Zhulnaar,hyjal,1622,shaman,restoration,108,63,45
Алексроуди,gordunni,1621,shaman,restoration,24,20,4
Wernøzer,archimonde,1621,shaman,restoration,36,22,14
Putzè,blackrock,1621,shaman,restoration,81,48,33
Helloimblue,blackmoore,1621,shaman,restoration,30,17,13
Zulcham,sargeras,1621,shaman,restoration,46,25,21
Nellytko,aegwynn,1621,shaman,restoration,87,44,43
Upisi,burning-legion,1621,shaman,restoration,225,113,112
Ðenlos,destromath,1621,shaman,restoration,352,176,176
Var,varimathras,1620,shaman,restoration,66,39,27
Palarins,dalaran,1620,shaman,restoration,30,17,13
Murmaiderz,draenor,1620,shaman,restoration,266,142,124
Тотемо,gordunni,1620,shaman,restoration,42,21,21
Shamerific,magtheridon,1620,shaman,restoration,61,30,31
Lechii,stormscale,1619,shaman,restoration,119,63,56
Littletrall,outland,1619,shaman,restoration,287,146,141
Yakee,doomhammer,1619,shaman,restoration,62,29,33
Spruehkot,aegwynn,1618,shaman,restoration,30,18,12
Drlovkexgodx,stormscale,1618,shaman,restoration,36,19,17
Tupato,kazzak,1618,shaman,restoration,110,57,53
Tow,der-rat-von-dalaran,1617,shaman,restoration,54,36,18
Tjpimp,draenor,1617,shaman,restoration,65,39,26
Ксмо,gordunni,1617,shaman,restoration,40,24,16
Пекубулких,soulflayer,1617,shaman,restoration,48,28,20
Itselectric,ravencrest,1617,shaman,restoration,217,116,101
Zalamlól,kazzak,1616,shaman,restoration,33,21,12
Тагхорн,soulflayer,1616,shaman,restoration,68,40,28
Jazzrod,stormscale,1616,shaman,restoration,396,207,189
Qoleck,aegwynn,1615,shaman,restoration,42,22,20
Navarx,blackmoore,1615,shaman,restoration,214,110,104
Incase,burning-legion,1615,shaman,restoration,82,41,41
Keisser,ravencrest,1615,shaman,restoration,78,39,39
Charquanda,argent-dawn,1615,shaman,restoration,84,41,43
Xenuz,nemesis,1615,shaman,restoration,42,20,22
Maelynda,argent-dawn,1614,shaman,restoration,42,18,24
Giuliah,ravencrest,1613,shaman,restoration,36,17,19
Kfcmanagerzz,archimonde,1613,shaman,restoration,41,19,22
Iphosham,twisting-nether,1612,shaman,restoration,48,21,27
Djosershamy,draenor,1611,shaman,restoration,117,56,61
Dimront,gorgonnash,1610,shaman,restoration,36,20,16
Turboeddy,blackmoore,1610,shaman,restoration,246,131,115
Monamour,twisting-nether,1609,shaman,restoration,36,22,14
Shamiinn,ravencrest,1609,shaman,restoration,30,17,13
Wotan,ysondre,1609,shaman,restoration,60,33,27
Hexbeforesex,kazzak,1609,shaman,restoration,484,248,236
Averya,blackmoore,1609,shaman,restoration,100,50,50
Aeknor,ravencrest,1609,shaman,restoration,48,24,24
Blowlips,argent-dawn,1609,shaman,restoration,42,17,25
Shmanw,kazzak,1608,shaman,restoration,99,56,43
Кайрн,gordunni,1608,shaman,restoration,68,37,31
Sehn,arathor,1608,shaman,restoration,42,21,21
Juyina,ravencrest,1608,shaman,restoration,91,45,46
Louler,ragnaros,1608,shaman,restoration,219,105,114
Voodoluudo,korgall,1608,shaman,restoration,42,20,22
Pøwertoto,dalaran,1608,shaman,restoration,120,56,64
Инкуль,howling-fjord,1608,shaman,restoration,60,28,32
Marrakei,aegwynn,1608,shaman,restoration,83,34,49
Wolkî,aegwynn,1608,shaman,restoration,56,22,34
Kemh,nemesis,1607,shaman,restoration,42,20,22
Ezilol,blackhand,1606,shaman,restoration,77,46,31
Kuxoriu,stormscale,1606,shaman,restoration,152,82,70
Kuis,sanguino,1606,shaman,restoration,100,49,51
Greenswag,drakthul,1605,shaman,restoration,48,31,17
Hypéra,kazzak,1605,shaman,restoration,216,112,104
Skanda,frostwolf,1604,shaman,restoration,24,17,7
Balthasa,blackhand,1604,shaman,restoration,30,18,12
Хужик,gordunni,1604,shaman,restoration,36,21,15
Nonotsikaan,blackhand,1604,shaman,restoration,78,45,33
Chéatèr,bloodfeather,1604,shaman,restoration,225,121,104
Xtremeshaman,blackmoore,1604,shaman,restoration,48,25,23
Schamaster,antonidas,1604,shaman,restoration,120,59,61
Ridemytotem,blackrock,1604,shaman,restoration,45,21,24
Soffsittaren,kazzak,1604,shaman,restoration,40,18,22
Shamanash,kazzak,1604,shaman,restoration,82,34,48
Imedicineman,tarren-mill,1603,shaman,restoration,41,29,12
Thog,drakthul,1603,shaman,restoration,177,91,86
Jkoreanx,archimonde,1603,shaman,restoration,78,31,47
Lebis,outland,1602,shaman,restoration,60,35,25
Glak,draenor,1602,shaman,restoration,69,38,31
Khroni,tarren-mill,1602,shaman,restoration,66,35,31
Техношмель,howling-fjord,1601,shaman,restoration,92,45,47
Xortortle,stormscale,1600,shaman,restoration,35,19,16
Ohatzu,blackhand,1600,shaman,restoration,112,60,52
Uzze,drakthul,1600,shaman,restoration,132,63,69
Sixtyone,stormscale,1599,shaman,restoration,87,49,38
Noneedshaman,stormscale,1599,shaman,restoration,41,21,20
Huux,blackmoore,1598,shaman,restoration,89,45,44
Martuscielöl,drakthul,1598,shaman,restoration,88,32,56
Greenone,stormscale,1597,shaman,restoration,35,20,15
Daykên,kazzak,1597,shaman,restoration,104,51,53
Отчима,howling-fjord,1596,shaman,restoration,208,109,99
Zinjk,nemesis,1596,shaman,restoration,448,227,221
Waterwendy,blackrock,1595,shaman,restoration,86,53,33
Groundcslol,kazzak,1595,shaman,restoration,62,35,27
Nervii,stormscale,1592,shaman,restoration,42,27,15
Mydpsrbad,stormscale,1592,shaman,restoration,160,89,71
Melàniewalsh,archimonde,1591,shaman,restoration,148,79,69
Yegera,stormscale,1591,shaman,restoration,59,31,28
Tartorno,antonidas,1591,shaman,restoration,118,54,64
Bahane,frostwolf,1589,shaman,restoration,122,61,61
Kãrthala,blackhand,1589,shaman,restoration,42,19,23
Hohedichte,amanthul,1588,shaman,restoration,30,17,13
Indeed,frostmourne,1586,shaman,restoration,66,35,31
Paidactor,kazzak,1586,shaman,restoration,239,126,113
Superthomas,archimonde,1584,shaman,restoration,89,41,48
Purgecleave,dalvengyr,1584,shaman,restoration,48,20,28
Kuhnedy,blackrock,1583,shaman,restoration,263,139,124
Otuschsham,blackmoore,1583,shaman,restoration,78,33,45
Вардоус,soulflayer,1582,shaman,restoration,30,17,13
Лескас,howling-fjord,1582,shaman,restoration,280,153,127
Stormdrágon,kazzak,1582,shaman,restoration,203,102,101
Nêôô,blackrock,1582,shaman,restoration,71,30,41
Dawop,ravencrest,1581,shaman,restoration,54,26,28
Nqz,ysondre,1580,shaman,restoration,91,52,39
Thald,ragnaros,1580,shaman,restoration,173,94,79
Wåvex,archimonde,1580,shaman,restoration,223,110,113
Sérx,sanguino,1580,shaman,restoration,191,90,101
Ранняяпташка,soulflayer,1579,shaman,restoration,42,21,21
Shamoobob,archimonde,1579,shaman,restoration,42,19,23
Størmbringer,aegwynn,1576,shaman,restoration,30,18,12
Лешам,soulflayer,1576,shaman,restoration,72,37,35
Muril,argent-dawn,1576,shaman,restoration,60,28,32
Smørbar,kazzak,1575,shaman,restoration,185,111,74
Niesel,ravencrest,1575,shaman,restoration,78,40,38
Horokeu,blackrock,1574,shaman,restoration,107,57,50
Végàs,ysondre,1574,shaman,restoration,78,34,44
Aesa,dun-modr,1573,shaman,restoration,54,30,24
Neovim,trollbane,1573,shaman,restoration,92,47,45
Emika,archimonde,1573,shaman,restoration,75,35,40
Viallinen,stormreaver,1572,shaman,restoration,54,22,32
Боргирх,soulflayer,1572,shaman,restoration,42,17,25
Tremorka,ravencrest,1571,shaman,restoration,36,26,10
Kocaina,kazzak,1571,shaman,restoration,30,19,11
Drumx,aegwynn,1571,shaman,restoration,48,28,20
Joinonlyfanz,blackrock,1571,shaman,restoration,48,20,28
Tonda,stormscale,1570,shaman,restoration,28,18,10
Jenyo,alakir,1570,shaman,restoration,110,58,52
Porkzzilá,aggra-português,1569,shaman,restoration,30,19,11
Kyraw,tarren-mill,1568,shaman,restoration,44,22,22
Reezex,silvermoon,1567,shaman,restoration,146,78,68
Гоэл,ashenvale,1567,shaman,restoration,207,97,110
Valgrosh,sylvanas,1566,shaman,restoration,52,31,21
Shockair,frostwolf,1566,shaman,restoration,115,54,61
Fjås,stormscale,1565,shaman,restoration,68,36,32
Basz,aegwynn,1565,shaman,restoration,35,18,17
Másàfî,tarren-mill,1565,shaman,restoration,44,22,22
Riptider,draenor,1565,shaman,restoration,54,25,29
Firenanajkm,dun-modr,1564,shaman,restoration,100,53,47
Blakelivelyx,blackrock,1564,shaman,restoration,42,17,25
Naargie,outland,1563,shaman,restoration,215,121,94
Annoying,archimonde,1563,shaman,restoration,43,23,20
Razzuan,kazzak,1563,shaman,restoration,97,46,51
Bullfox,aszune,1563,shaman,restoration,120,55,65
Noulol,aegwynn,1563,shaman,restoration,77,35,42
Pacho,alakir,1563,shaman,restoration,48,21,27
Esher,frostwolf,1563,shaman,restoration,115,48,67
Zwergmann,blackrock,1562,shaman,restoration,90,52,38
Glücksbarren,die-aldor,1562,shaman,restoration,54,27,27
Mamacitá,eredar,1562,shaman,restoration,542,258,284
Ebøbøla,terokkar,1562,shaman,restoration,261,123,138
Shamandoino,wildhammer,1562,shaman,restoration,282,129,153
Lilcake,ravencrest,1561,shaman,restoration,72,38,34
Koraél,dun-modr,1561,shaman,restoration,96,39,57
Yomuchacha,dun-modr,1560,shaman,restoration,148,72,76
Тотембот,soulflayer,1560,shaman,restoration,78,36,42
Radrizzle,tichondrius,1559,shaman,restoration,66,36,30
Shammychris,argent-dawn,1559,shaman,restoration,48,21,27
Лёнянефор,howling-fjord,1558,shaman,restoration,35,18,17
Miikkas,blackhand,1557,shaman,restoration,42,25,17
Aébi,dalaran,1557,shaman,restoration,60,34,26
Cobbel,argent-dawn,1557,shaman,restoration,168,92,76
Orcié,twisting-nether,1557,shaman,restoration,35,19,16
Lavjar,stormscale,1557,shaman,restoration,81,34,47
Totemjuggler,ragnaros,1556,shaman,restoration,112,73,39
Nosql,draenor,1556,shaman,restoration,40,22,18
Ðevi,ravencrest,1556,shaman,restoration,53,28,25
Eksi,ahnqiraj,1556,shaman,restoration,94,47,47
Lzzo,ravencrest,1555,shaman,restoration,42,24,18
Anöuchkâ,ysondre,1555,shaman,restoration,216,107,109
Shøckbot,blackhand,1555,shaman,restoration,48,23,25
Shakhdan,archimonde,1554,shaman,restoration,72,32,40
Mypakypa,outland,1553,shaman,restoration,104,50,54
Banilikum,tarren-mill,1553,shaman,restoration,104,49,55
Навылет,soulflayer,1552,shaman,restoration,54,31,23
Idroptotems,drakthul,1552,shaman,restoration,36,19,17
Хексорсгодх,howling-fjord,1551,shaman,restoration,54,35,19
Zimoneris,blackmoore,1551,shaman,restoration,36,17,19
Grende,sylvanas,1551,shaman,restoration,65,24,41
Vickeshaman,stormreaver,1550,shaman,restoration,85,42,43
Cleansing,nemesis,1549,shaman,restoration,52,37,15
Shmøn,outland,1549,shaman,restoration,42,20,22
Ripstorm,sylvanas,1549,shaman,restoration,139,64,75
Kvolt,ysondre,1549,shaman,restoration,42,18,24
Cuzzer,drakthul,1548,shaman,restoration,109,59,50
Кичисанчик,howling-fjord,1548,shaman,restoration,168,78,90
Туурукк,soulflayer,1548,shaman,restoration,66,27,39
Amyst,aegwynn,1547,shaman,restoration,40,25,15
Yemo,alonsus,1547,shaman,restoration,243,132,111
Rhun,garona,1547,shaman,restoration,303,163,140
Machmacan,argent-dawn,1547,shaman,restoration,183,93,90
Puffeh,emeriss,1547,shaman,restoration,42,17,25
Vallhur,burning-legion,1546,shaman,restoration,198,102,96
Reilah,drakthul,1546,shaman,restoration,66,33,33
Сорит,blackscar,1546,shaman,restoration,299,149,150
Rejax,blackmoore,1546,shaman,restoration,84,38,46
Иоч,soulflayer,1545,shaman,restoration,105,56,49
Blamy,auchindoun,1545,shaman,restoration,40,20,20
Лехадабстеп,deathguard,1545,shaman,restoration,84,40,44
Bonraptor,kirin-tor,1544,shaman,restoration,59,33,26
Есю,howling-fjord,1544,shaman,restoration,40,22,18
Greatørc,tarren-mill,1544,shaman,restoration,106,57,49
Korvsnärten,outland,1544,shaman,restoration,237,109,128
Xogor,kazzak,1544,shaman,restoration,88,39,49
Beastmodex,eredar,1543,shaman,restoration,276,140,136
Stupbpes,gorgonnash,1543,shaman,restoration,96,45,51
Reitar,burning-blade,1543,shaman,restoration,120,50,70
Zilheal,ysondre,1542,shaman,restoration,106,41,65
Warianis,ravencrest,1539,shaman,restoration,116,67,49
Kelvok,kazzak,1539,shaman,restoration,78,42,36
Denastyo,nemesis,1539,shaman,restoration,89,44,45
Optitem,hyjal,1538,shaman,restoration,83,57,26
Bredex,doomhammer,1538,shaman,restoration,59,30,29
Àbs,archimonde,1538,shaman,restoration,178,90,88
Неерззул,soulflayer,1538,shaman,restoration,77,32,45
Shamins,outland,1537,shaman,restoration,178,101,77
Biggiebig,ravencrest,1536,shaman,restoration,168,91,77
Sørum,grim-batol,1536,shaman,restoration,48,17,31
Nintotemxo,stormscale,1535,shaman,restoration,101,53,48
Cakedeux,grim-batol,1535,shaman,restoration,645,328,317
Apocadwarf,auchindoun,1534,shaman,restoration,161,87,74
Sêrø,eredar,1534,shaman,restoration,54,25,29
Junpi,shattered-hand,1534,shaman,restoration,135,61,74
Тандерфак,ashenvale,1533,shaman,restoration,50,23,27
Cuzzherø,drakthul,1532,shaman,restoration,144,76,68
Velkin,thrall,1532,shaman,restoration,237,124,113
Kataclysm,nemesis,1532,shaman,restoration,83,43,40
Хъюстэн,gordunni,1532,shaman,restoration,54,27,27
Xayy,twisting-nether,1530,shaman,restoration,30,18,12
Setac,stormscale,1530,shaman,restoration,63,31,32
Tllz,kargath,1529,shaman,restoration,90,58,32
Hastabasta,sylvanas,1529,shaman,restoration,87,37,50
Pädagogeig,antonidas,1528,shaman,restoration,66,36,30
Waldo,blackmoore,1528,shaman,restoration,30,16,14
Шсаваннх,blackscar,1528,shaman,restoration,171,84,87
Vemvardetsom,stormreaver,1527,shaman,restoration,149,79,70
Atwâ,ravencrest,1526,shaman,restoration,62,37,25
Mcktavish,silvermoon,1526,shaman,restoration,145,75,70
Rake,teldrassil,1526,shaman,restoration,95,47,48
Ninetzj,tarren-mill,1525,shaman,restoration,60,28,32
Gützli,blackmoore,1525,shaman,restoration,99,40,59
Mìcrøs,thrall,1524,shaman,restoration,77,41,36
Gjernhard,stormreaver,1524,shaman,restoration,78,38,40
Muddy,argent-dawn,1524,shaman,restoration,42,18,24
Navezi,twisting-nether,1523,shaman,restoration,150,92,58
Чанголист,soulflayer,1523,shaman,restoration,114,54,60
Ugáa,malganis,1523,shaman,restoration,102,41,61
Remkoo,blackrock,1522,shaman,restoration,30,20,10
Thorenal,blackmoore,1521,shaman,restoration,79,44,35
Thunderson,daggerspine,1521,shaman,restoration,588,299,289
Фоэксген,deathguard,1520,shaman,restoration,70,43,27
Sixinchwilly,outland,1520,shaman,restoration,66,39,27
Wryte,echsenkessel,1519,shaman,restoration,30,16,14
Redomsh,stormreaver,1519,shaman,restoration,157,73,84
Hobblefoot,stormscale,1519,shaman,restoration,36,16,20
Schain,eredar,1518,shaman,restoration,36,24,12
Turbobaboon,hyjal,1518,shaman,restoration,157,88,69
Mcbloob,kazzak,1518,shaman,restoration,157,81,76
Kekke,uldum,1517,shaman,restoration,30,16,14
Zetricek,drakthul,1516,shaman,restoration,113,46,67
Friski,silvermoon,1515,shaman,restoration,30,17,13
Stateside,outland,1514,shaman,restoration,42,16,26
Khattla,outland,1513,shaman,restoration,368,197,171
Lyricks,outland,1513,shaman,restoration,160,75,85
Mvvp,stormscale,1512,shaman,restoration,96,50,46
Costakislolz,twisting-nether,1511,shaman,restoration,33,23,10
Дагод,booty-bay,1511,shaman,restoration,84,53,31
Bloodseeker,tarren-mill,1511,shaman,restoration,53,29,24
Crazypop,outland,1511,shaman,restoration,130,69,61
Imtoohighq,archimonde,1511,shaman,restoration,105,49,56
Pjotrasmus,mannoroth,1511,shaman,restoration,42,17,25
Pinácoladáqt,stormscale,1511,shaman,restoration,48,17,31
Джонпсинаа,gordunni,1510,shaman,restoration,63,36,27
Ophís,ambossar,1509,shaman,restoration,74,35,39
Bénathon,ravencrest,1508,shaman,restoration,69,43,26
Jackpotx,tarren-mill,1508,shaman,restoration,110,68,42
Umbraverfaa,twisting-nether,1508,shaman,restoration,132,72,60
Bananis,outland,1508,shaman,restoration,30,16,14
Shambulancex,tarren-mill,1508,shaman,restoration,78,39,39
Seasick,frostmane,1507,shaman,restoration,121,59,62
Tvättpåse,tarren-mill,1506,shaman,restoration,34,20,14
Schamfxx,blackrock,1506,shaman,restoration,166,85,81
Vaaggu,stormreaver,1506,shaman,restoration,48,19,29
Лисёнокцарь,gordunni,1506,shaman,restoration,42,16,26
Dáínn,outland,1505,shaman,restoration,89,49,40
Phobophobia,archimonde,1505,shaman,restoration,136,70,66
Vaizii,silvermoon,1505,shaman,restoration,53,26,27
Froslack,zuljin,1504,shaman,restoration,100,50,50
Patuljak,outland,1503,shaman,restoration,139,75,64
Threshðld,dun-modr,1502,shaman,restoration,42,21,21
Багсбанних,soulflayer,1502,shaman,restoration,126,54,72
Роджермур,howling-fjord,1501,shaman,restoration,42,21,21
Booga,tarren-mill,1501,shaman,restoration,68,31,37
Гошатотем,soulflayer,1501,shaman,restoration,41,17,24
Pokspoks,stormscale,1501,shaman,restoration,42,16,26
Hopper,sylvanas,1500,shaman,restoration,285,144,141
Nassîî,antonidas,1500,shaman,restoration,146,61,85
Cannotdoit,burning-legion,1499,shaman,restoration,59,32,27
Diix,archimonde,1498,shaman,restoration,111,50,61
Брбртолетчик,soulflayer,1498,shaman,restoration,36,16,20
Shamvicx,draenor,1497,shaman,restoration,36,23,13
Blackone,destromath,1496,shaman,restoration,36,20,16
Ïllïïllïï,shadowsong,1496,shaman,restoration,36,20,16
Buchânan,archimonde,1496,shaman,restoration,47,16,31
Kasálla,aegwynn,1494,shaman,restoration,51,24,27
Kardris,nemesis,1493,shaman,restoration,76,32,44
Theshammy,vashj,1492,shaman,restoration,84,45,39
Discoranger,ravencrest,1492,shaman,restoration,540,268,272
Elendig,blackmoore,1491,shaman,restoration,179,104,75
Exolnard,twisting-nether,1491,shaman,restoration,238,116,122
Skullår,tarren-mill,1490,shaman,restoration,66,33,33
Phoenííx,twisting-nether,1490,shaman,restoration,473,224,249
Milara,anachronos,1489,shaman,restoration,42,16,26
Gronash,sunstrider,1488,shaman,restoration,60,37,23
Crasherz,sanguino,1488,shaman,restoration,91,51,40
Geminate,stormscale,1488,shaman,restoration,75,42,33
Kalaris,stormscale,1488,shaman,restoration,36,20,16
Sunysham,darkmoon-faire,1488,shaman,restoration,83,44,39
Straehne,malganis,1488,shaman,restoration,118,58,60
Imshocky,burning-legion,1487,shaman,restoration,157,87,70
Märthalouise,twisting-nether,1487,shaman,restoration,73,30,43
Apaorkaxyz,ragnaros,1486,shaman,restoration,446,220,226
Kacamaz,twisting-nether,1486,shaman,restoration,117,54,63
Akukuu,kazzak,1485,shaman,restoration,48,26,22
Bumblebeec,tarren-mill,1485,shaman,restoration,72,36,36
Hyflex,alakir,1485,shaman,restoration,47,19,28
Elshimano,ravencrest,1484,shaman,restoration,30,18,12
Vælcya,archimonde,1484,shaman,restoration,84,41,43
Waterboi,blackmoore,1484,shaman,restoration,104,48,56
Dojarat,silvermoon,1482,shaman,restoration,170,96,74
Shemanrolf,outland,1482,shaman,restoration,134,67,67
Starterkit,ravencrest,1482,shaman,restoration,66,25,41
Nogag,kazzak,1481,shaman,restoration,121,59,62
Dremlok,burning-legion,1480,shaman,restoration,24,16,8
Criæ,blackrock,1480,shaman,restoration,36,23,13
Reparagos,sanguino,1480,shaman,restoration,37,22,15
Tonnii,tarren-mill,1480,shaman,restoration,106,52,54
Mèshuggáh,ravencrest,1480,shaman,restoration,42,19,23
Vorkanyx,ysondre,1479,shaman,restoration,153,79,74
Clickmeh,runetotem,1479,shaman,restoration,95,47,48
Vladimitch,chogall,1478,shaman,restoration,30,19,11
Шиока,borean-tundra,1478,shaman,restoration,188,103,85
Zoolza,kirin-tor,1476,shaman,restoration,100,44,56
Awwey,stormscale,1475,shaman,restoration,30,22,8
Goodieesham,burning-blade,1475,shaman,restoration,66,39,27
Sucøre,die-nachtwache,1475,shaman,restoration,88,45,43
Нитрочка,soulflayer,1475,shaman,restoration,105,53,52
Aliatës,sanguino,1475,shaman,restoration,50,25,25
Shpankproof,kazzak,1475,shaman,restoration,48,23,25
Overlewd,chamber-of-aspects,1474,shaman,restoration,51,25,26
Èxé,stormscale,1474,shaman,restoration,74,36,38
Damex,thunderhorn,1474,shaman,restoration,161,69,92
Shameari,sylvanas,1473,shaman,restoration,24,19,5
Shman,blackrock,1473,shaman,restoration,100,54,46
Vengatrox,antonidas,1473,shaman,restoration,191,102,89
Onionz,stormreaver,1473,shaman,restoration,42,21,21
Jarona,twisting-nether,1473,shaman,restoration,444,218,226
Froschlöffel,mannoroth,1472,shaman,restoration,23,17,6
Gadula,burning-legion,1472,shaman,restoration,40,21,19
Cleptocracy,draenor,1472,shaman,restoration,35,18,17
Zûgzûg,ragnaros,1472,shaman,restoration,70,34,36
Pprx,tarren-mill,1472,shaman,restoration,42,19,23
Deadstill,ysondre,1471,shaman,restoration,60,32,28
Ivøryz,arthas,1471,shaman,restoration,114,60,54
Bordellgast,thrall,1471,shaman,restoration,101,51,50
Eniesz,archimonde,1471,shaman,restoration,143,71,72
Loreleya,ravencrest,1471,shaman,restoration,99,48,51
Crysisx,sanguino,1471,shaman,restoration,34,16,18
Ôrgi,drakthul,1471,shaman,restoration,60,24,36
Gehrké,silvermoon,1470,shaman,restoration,38,24,14
Kilasqo,drakthul,1470,shaman,restoration,29,16,13
Carëx,anubarak,1470,shaman,restoration,68,37,31
Ilovejamie,sylvanas,1470,shaman,restoration,60,31,29
Hjod,outland,1469,shaman,restoration,309,154,155
Denyx,blackmoore,1469,shaman,restoration,264,128,136
Zakuun,kazzak,1469,shaman,restoration,188,83,105
Kêêqo,blackrock,1468,shaman,restoration,48,23,25
Sawseig,tarren-mill,1467,shaman,restoration,33,18,15
Greenfatding,kazzak,1467,shaman,restoration,36,19,17
Andról,stormscale,1467,shaman,restoration,54,25,29
Rokatotem,ysondre,1466,shaman,restoration,81,39,42
Flowèn,twisting-nether,1465,shaman,restoration,146,77,69
Redoms,stormreaver,1465,shaman,restoration,240,120,120
Vaweñ,ravencrest,1465,shaman,restoration,83,35,48
Antey,ravencrest,1464,shaman,restoration,221,116,105
Ünknownz,archimonde,1464,shaman,restoration,71,37,34
Okdar,stormscale,1463,shaman,restoration,96,56,40
Sebubu,twisting-nether,1463,shaman,restoration,68,34,34
Hàrdstûkgødx,uldaman,1463,shaman,restoration,42,19,23
Lazerboy,twisting-nether,1463,shaman,restoration,110,49,61
Abercrômbx,blackmoore,1462,shaman,restoration,99,50,49
Courtney,sylvanas,1462,shaman,restoration,240,114,126
Shuzman,emeriss,1461,shaman,restoration,133,63,70
Pakxø,malganis,1461,shaman,restoration,200,91,109
Laskopivo,doomhammer,1459,shaman,restoration,195,99,96
Духсалата,grom,1459,shaman,restoration,89,43,46
Yasharshammy,tarren-mill,1459,shaman,restoration,60,28,32
Lumirecia,shadowsong,1459,shaman,restoration,54,25,29
Nonnative,stormscale,1459,shaman,restoration,84,37,47
Grris,tarren-mill,1459,shaman,restoration,48,16,32
Diosberi,tichondrius,1458,shaman,restoration,24,18,6
Lariralol,malorne,1458,shaman,restoration,97,56,41
Vuls,blackmoore,1457,shaman,restoration,216,119,97
Коляхекс,gordunni,1455,shaman,restoration,88,48,40
Шарюпокд,soulflayer,1455,shaman,restoration,48,24,24
Yois,nemesis,1454,shaman,restoration,108,61,47
Georgieboi,sylvanas,1454,shaman,restoration,53,29,24
Onkens,ravencrest,1454,shaman,restoration,81,43,38
Gards,sylvanas,1454,shaman,restoration,91,45,46
Zlingx,auchindoun,1454,shaman,restoration,48,22,26
Octon,dun-modr,1454,shaman,restoration,191,87,104
Ethixx,outland,1454,shaman,restoration,106,48,58
Enharvest,stormscale,1453,shaman,restoration,58,34,24
Khraajsy,sylvanas,1452,shaman,restoration,30,19,11
Ларисашерсть,blackscar,1452,shaman,restoration,47,26,21
Dóminatrix,ravencrest,1452,shaman,restoration,40,22,18
Collînna,aegwynn,1452,shaman,restoration,116,58,58
Sdkpwns,draenor,1451,shaman,restoration,63,33,30
Артёмлобов,gordunni,1450,shaman,restoration,77,37,40
Cheerz,ravencrest,1450,shaman,restoration,42,20,22
Groundingbtw,tarren-mill,1449,shaman,restoration,62,30,32
Pilinham,aggra-português,1449,shaman,restoration,80,32,48
Lickbuthole,stormreaver,1447,shaman,restoration,46,28,18
Arigolds,twilights-hammer,1447,shaman,restoration,29,16,13
Nanetvåsanai,jaedenar,1447,shaman,restoration,53,29,24
Davihla,grim-batol,1447,shaman,restoration,84,41,43
Gspót,twisting-nether,1447,shaman,restoration,98,47,51
Чаиро,howling-fjord,1447,shaman,restoration,41,16,25
Tuorak,eredar,1446,shaman,restoration,30,16,14
Eisei,stormscale,1446,shaman,restoration,90,47,43
Lustmasterx,grim-batol,1446,shaman,restoration,497,249,248
Plutonx,stormscale,1446,shaman,restoration,111,54,57
Craisaz,nemesis,1446,shaman,restoration,163,68,95
Schamazon,tarren-mill,1445,shaman,restoration,75,40,35
Selrin,blackrock,1445,shaman,restoration,231,118,113
Bigfatjay,stormscale,1444,shaman,restoration,63,33,30
Whitefoxy,stormscale,1443,shaman,restoration,181,91,90
Rawillman,kazzak,1442,shaman,restoration,30,19,11
Xintenggege,silvermoon,1442,shaman,restoration,91,46,45
Kaminarí,antonidas,1442,shaman,restoration,74,32,42
Corintho,blackmoore,1441,shaman,restoration,82,48,34
Zeewzblast,silvermoon,1441,shaman,restoration,30,16,14
Johnblånn,stormscale,1441,shaman,restoration,342,179,163
Quizx,blackrock,1441,shaman,restoration,84,39,45
Schweízer,blackrock,1441,shaman,restoration,102,45,57
Zombilyk,burning-legion,1441,shaman,restoration,53,23,30
Crmx,blackrock,1441,shaman,restoration,120,52,68
Zaránd,ragnaros,1440,shaman,restoration,66,34,32
Shocktastic,blackmoore,1440,shaman,restoration,118,55,63
Berly,stormscale,1439,shaman,restoration,24,15,9
Lingz,auchindoun,1439,shaman,restoration,54,30,24
Shyrel,burning-legion,1439,shaman,restoration,276,141,135
Xánin,thrall,1439,shaman,restoration,92,46,46
Helloitsmee,thrall,1439,shaman,restoration,40,20,20
Zergonk,twisting-nether,1438,shaman,restoration,24,15,9
Nyzo,tarren-mill,1438,shaman,restoration,30,15,15
Grapetokruml,blackmoore,1437,shaman,restoration,24,15,9
Kunsum,twisting-nether,1437,shaman,restoration,87,37,50
Roineé,draenor,1436,shaman,restoration,30,15,15
Амальтейх,soulflayer,1436,shaman,restoration,78,34,44
Emochka,ravencrest,1435,shaman,restoration,130,60,70
Healelele,frostwolf,1435,shaman,restoration,36,15,21
Enchancement,ragnaros,1434,shaman,restoration,24,15,9
Ronell,argent-dawn,1434,shaman,restoration,179,91,88
Jimtrespies,dun-modr,1434,shaman,restoration,121,61,60
Arigato,eonar,1434,shaman,restoration,58,29,29
Strïvïse,ysondre,1434,shaman,restoration,47,22,25
Kataretic,kazzak,1433,shaman,restoration,24,17,7
Meeq,deathwing,1433,shaman,restoration,31,19,12
Enïgma,sylvanas,1433,shaman,restoration,166,89,77
Zaiyoxgodx,thrall,1433,shaman,restoration,49,26,23
Raznys,defias-brotherhood,1433,shaman,restoration,42,15,27
Nayromino,blackrock,1432,shaman,restoration,49,28,21
Elamentaly,draenor,1432,shaman,restoration,96,54,42
Wylly,aegwynn,1432,shaman,restoration,174,95,79
Linkedink,tarren-mill,1432,shaman,restoration,35,19,16
Chimp,lightnings-blade,1432,shaman,restoration,37,20,17
Ludiböris,kazzak,1432,shaman,restoration,59,28,31
Thornos,ragnaros,1432,shaman,restoration,64,21,43
Frecky,blackhand,1431,shaman,restoration,36,23,13
Skrimisher,draenor,1431,shaman,restoration,83,45,38
Mendiing,kazzak,1431,shaman,restoration,63,30,33
Kaptt,twisting-nether,1431,shaman,restoration,36,15,21
Mouraïne,eredar,1430,shaman,restoration,350,180,170
Thesenate,blackmoore,1430,shaman,restoration,76,30,46
Bufuxx,kazzak,1429,shaman,restoration,42,24,18
Orcshaman,the-maelstrom,1428,shaman,restoration,74,40,34
Драмшам,howling-fjord,1428,shaman,restoration,42,19,23
Шоплифтер,gordunni,1427,shaman,restoration,48,27,21
Cømedian,ragnaros,1427,shaman,restoration,107,59,48
Mightgethexd,tarren-mill,1427,shaman,restoration,45,24,21
Nøný,gorgonnash,1427,shaman,restoration,102,51,51
Pcr,archimonde,1427,shaman,restoration,111,53,58
Shamytomight,tarren-mill,1426,shaman,restoration,96,48,48
Izir,archimonde,1426,shaman,restoration,375,180,195
Tahsus,blackmoore,1425,shaman,restoration,53,36,17
Ctpukek,ysondre,1425,shaman,restoration,174,98,76
Kalvei,draenor,1425,shaman,restoration,65,33,32
Zulsham,sargeras,1425,shaman,restoration,131,64,67
Lvj,blackrock,1425,shaman,restoration,54,26,28
Drohx,ysondre,1425,shaman,restoration,78,36,42
Pòcho,kazzak,1425,shaman,restoration,144,64,80
Éjsiy,drakthul,1424,shaman,restoration,96,43,53
Ptiloup,varimathras,1423,shaman,restoration,48,22,26
Ярусскийй,howling-fjord,1422,shaman,restoration,277,134,143
Lastaltforev,kazzak,1422,shaman,restoration,98,47,51
Katwio,hyjal,1422,shaman,restoration,61,29,32
Monstermunch,ravencrest,1422,shaman,restoration,154,71,83
Prøxxy,ravencrest,1422,shaman,restoration,45,20,25
Táyy,stormscale,1421,shaman,restoration,37,21,16
Ishkadar,twisting-nether,1421,shaman,restoration,99,48,51
Îolar,aegwynn,1421,shaman,restoration,120,57,63
Wôdân,blackrock,1421,shaman,restoration,103,47,56
Nêmônin,perenolde,1420,shaman,restoration,55,31,24
Yaamooshii,burning-legion,1420,shaman,restoration,149,81,68
Кислаябуба,howling-fjord,1420,shaman,restoration,190,90,100
Fernashaman,aggra-português,1419,shaman,restoration,77,41,36
Kaffekask,stormscale,1419,shaman,restoration,42,21,21
Gnackbretzn,eredar,1419,shaman,restoration,155,77,78
Вуфпуф,borean-tundra,1419,shaman,restoration,84,39,45
Stormfreg,quelthalas,1419,shaman,restoration,42,16,26
Начилибосе,gordunni,1418,shaman,restoration,447,230,217
Малекулакота,soulflayer,1417,shaman,restoration,82,39,43
Тирануксис,blackscar,1416,shaman,restoration,161,87,74
Aliatoos,ravencrest,1416,shaman,restoration,58,31,27
Swedishmeat,kazzak,1416,shaman,restoration,224,118,106
Cuchullaín,blackmoore,1416,shaman,restoration,90,46,44
Бэкдафакапп,blackscar,1416,shaman,restoration,72,26,46
Winøxiide,archimonde,1415,shaman,restoration,29,16,13
Djxyoloswag,silvermoon,1415,shaman,restoration,153,72,81
Dewasham,blackrock,1415,shaman,restoration,54,25,29
Sarkathi,kazzak,1415,shaman,restoration,77,33,44
Goldhand,ravencrest,1415,shaman,restoration,69,24,45
Energized,twilights-hammer,1414,shaman,restoration,97,56,41
Ironmack,outland,1414,shaman,restoration,60,32,28
Брайбах,howling-fjord,1414,shaman,restoration,49,26,23
Robcurly,blackmoore,1414,shaman,restoration,30,15,15
Quïzzly,ragnaros,1414,shaman,restoration,72,31,41
Adzkímo,tarren-mill,1414,shaman,restoration,36,15,21
Deadwoodz,tarren-mill,1413,shaman,restoration,214,111,103
Bumbersham,stormscale,1413,shaman,restoration,168,83,85
Dergat,pozzo-delleternità,1412,shaman,restoration,44,21,23
Smukkere,twisting-nether,1410,shaman,restoration,24,15,9
Bigayak,blackrock,1409,shaman,restoration,46,27,19
Aceofraphy,thrall,1409,shaman,restoration,161,71,90
Voitek,sargeras,1408,shaman,restoration,85,36,49
Elijaá,nordrassil,1407,shaman,restoration,211,116,95
Miesepeter,mannoroth,1407,shaman,restoration,111,57,54
Jessijames,outland,1404,shaman,restoration,26,18,8
Kanox,ysondre,1404,shaman,restoration,70,39,31
Dzseksz,ragnaros,1404,shaman,restoration,83,46,37
Shago,archimonde,1404,shaman,restoration,160,78,82
Bresidendo,frostwhisper,1404,shaman,restoration,119,54,65
Гарантийный,lich-king,1404,shaman,restoration,36,15,21
Bloodburst,stormscale,1403,shaman,restoration,160,92,68
Durekk,tarren-mill,1403,shaman,restoration,90,48,42
Sîggý,eredar,1403,shaman,restoration,36,16,20
Okø,marécage-de-zangar,1402,shaman,restoration,44,25,19
Nadashami,outland,1402,shaman,restoration,95,51,44
Братишкапинг,soulflayer,1402,shaman,restoration,136,72,64
Swahilishock,the-maelstrom,1402,shaman,restoration,42,18,24
Heyzal,aegwynn,1402,shaman,restoration,44,18,26
Roverlos,blackrock,1401,shaman,restoration,159,86,73
Mclóvín,twisting-nether,1401,shaman,restoration,42,21,21
Xerinas,eredar,1401,shaman,restoration,171,69,102
Shrekcho,twisting-nether,1400,shaman,restoration,70,44,26
Skreppa,kazzak,1400,shaman,restoration,72,42,30
Тромрел,blackscar,1400,shaman,restoration,59,34,25
Nextlvlplz,draenor,1400,shaman,restoration,127,68,59
Мокос,howling-fjord,1400,shaman,restoration,60,20,40
Trustlemac,onyxia,1399,shaman,restoration,50,30,20
Shamhingo,stormscale,1399,shaman,restoration,112,49,63
Horiq,kazzak,1399,shaman,restoration,42,15,27
Tèysh,ysondre,1398,shaman,restoration,145,74,71
Zapconi,burning-legion,1398,shaman,restoration,36,15,21
Виспепешам,gordunni,1397,shaman,restoration,438,219,219
Homsin,stormscale,1397,shaman,restoration,38,18,20
Shamatto,nemesis,1397,shaman,restoration,92,43,49
Guccisham,ravencrest,1397,shaman,restoration,60,26,34
Gyaros,zenedar,1395,shaman,restoration,24,15,9
Whatsup,aggramar,1395,shaman,restoration,93,49,44
Numdog,stormreaver,1395,shaman,restoration,29,15,14
Cjay,dunemaul,1394,shaman,restoration,46,26,20
Aeldrid,argent-dawn,1394,shaman,restoration,54,30,24
Noxazar,kazzak,1394,shaman,restoration,120,54,66
Tallzie,ravencrest,1392,shaman,restoration,58,28,30
Mogzu,blackmoore,1392,shaman,restoration,35,16,19
Chunkss,argent-dawn,1392,shaman,restoration,90,36,54
Shamantistik,ravencrest,1391,shaman,restoration,24,15,9
Brzzbrzz,blackmoore,1391,shaman,restoration,36,22,14
Гвинневра,azuregos,1391,shaman,restoration,153,89,64
Energised,alonsus,1391,shaman,restoration,90,45,45
Räyznx,nozdormu,1390,shaman,restoration,30,18,12
Гарибаз,blackscar,1390,shaman,restoration,36,20,16
Sjamanisme,silvermoon,1390,shaman,restoration,114,60,54
Odiuum,draenor,1390,shaman,restoration,228,114,114
Газгольдерх,razuvious,1390,shaman,restoration,136,64,72
Wokaa,twisting-nether,1389,shaman,restoration,24,15,9
Rugludalli,dragonblight,1388,shaman,restoration,24,15,9
Deesbi,khaz-modan,1388,shaman,restoration,28,16,12
Shamanlynx,ravencrest,1388,shaman,restoration,147,82,65
Ghorall,ragnaros,1388,shaman,restoration,77,42,35
Lsdx,silvermoon,1388,shaman,restoration,116,56,60
Aliates,sanguino,1388,shaman,restoration,36,16,20
Kwitnac,silvermoon,1387,shaman,restoration,42,24,18
Showman,archimonde,1387,shaman,restoration,653,329,324
Kekerrot,ragnaros,1386,shaman,restoration,152,89,63
Spaceboy,archimonde,1386,shaman,restoration,42,19,23
Кразтор,howling-fjord,1385,shaman,restoration,197,93,104
Gâldwyn,dalaran,1385,shaman,restoration,36,15,21
Geneazytwo,silvermoon,1384,shaman,restoration,32,19,13
Marrondevil,blackhand,1384,shaman,restoration,29,16,13
Seyfüce,archimonde,1383,shaman,restoration,77,43,34
Phêbz,archimonde,1383,shaman,restoration,93,48,45
Фридомх,gordunni,1383,shaman,restoration,35,17,18
Назульчике,razuvious,1383,shaman,restoration,83,40,43
Insanebölt,ravencrest,1383,shaman,restoration,41,17,24
Çøynx,aegwynn,1382,shaman,restoration,40,16,24
Magma,kazzak,1381,shaman,restoration,36,22,14
Totemproffs,twisting-nether,1381,shaman,restoration,54,28,26
Fluuges,tarren-mill,1381,shaman,restoration,95,46,49
Cevas,argent-dawn,1380,shaman,restoration,96,55,41
Shimmyja,draenor,1380,shaman,restoration,117,60,57
Saamira,pozzo-delleternità,1380,shaman,restoration,84,41,43
Pasjeop,ravencrest,1380,shaman,restoration,53,21,32
Klouds,stormscale,1380,shaman,restoration,78,30,48
Erdenseele,blackmoore,1379,shaman,restoration,23,16,7
Jojos,eredar,1379,shaman,restoration,30,16,14
Fenoménes,drakthul,1378,shaman,restoration,88,44,44
Boneyka,ragnaros,1378,shaman,restoration,146,65,81
Hexnøsex,twisting-nether,1378,shaman,restoration,48,21,27
Hexnøs262E08,twisting-nether,1378,shaman,restoration,48,21,27
Bliksem,tarren-mill,1377,shaman,restoration,30,15,15
Tingyspanky,twisting-nether,1377,shaman,restoration,57,22,35
Ironkraw,stormscale,1377,shaman,restoration,90,33,57
Karrisha,tarren-mill,1376,shaman,restoration,48,29,19
Axemodels,archimonde,1376,shaman,restoration,32,16,16
Zenjo,the-maelstrom,1376,shaman,restoration,60,23,37
Megumín,darksorrow,1375,shaman,restoration,36,21,15
Tauridus,blackrock,1375,shaman,restoration,54,27,27
Kickmeheal,dalaran,1375,shaman,restoration,167,83,84
Grumhild,blackmoore,1375,shaman,restoration,122,52,70
Tiborr,burning-legion,1375,shaman,restoration,81,26,55
Breadtotem,tarren-mill,1374,shaman,restoration,141,66,75
Amaizin,stormscale,1373,shaman,restoration,90,45,45
Guulth,dun-modr,1373,shaman,restoration,33,15,18
Læh,archimonde,1373,shaman,restoration,120,52,68
Alàstor,kazzak,1372,shaman,restoration,93,46,47
Slingz,auchindoun,1372,shaman,restoration,60,26,34
Zallyy,tarren-mill,1371,shaman,restoration,113,60,53
Shamnox,blackrock,1371,shaman,restoration,89,47,42
Goodmañ,eonar,1371,shaman,restoration,194,96,98
Neddeadlyo,outland,1371,shaman,restoration,41,20,21
Porke,moonglade,1370,shaman,restoration,30,15,15
Zneegel,ragnaros,1370,shaman,restoration,36,16,20
Testoshaman,ravencrest,1369,shaman,restoration,29,15,14
Sparklemufin,draenor,1369,shaman,restoration,33,16,17
Psychototem,twisting-nether,1368,shaman,restoration,120,38,82
Purgérkíng,silvermoon,1367,shaman,restoration,56,28,28
Althayr,blackmoore,1367,shaman,restoration,70,29,41
Hephaisto,defias-brotherhood,1366,shaman,restoration,66,40,26
Moowfmoo,ragnaros,1366,shaman,restoration,39,16,23
Stortvloed,twisting-nether,1365,shaman,restoration,48,23,25
Kasjer,ravencrest,1365,shaman,restoration,36,17,19
Lupisregina,silvermoon,1365,shaman,restoration,41,19,22
Pocahøntas,archimonde,1365,shaman,restoration,74,30,44
Mjahex,stormscale,1364,shaman,restoration,108,55,53
Bendimina,chogall,1363,shaman,restoration,54,34,20
Hulcky,grim-batol,1363,shaman,restoration,48,27,21
Agatiø,dun-modr,1363,shaman,restoration,55,29,26
Acidtrip,hyjal,1363,shaman,restoration,48,24,24
Ëlfapatakÿ,uldum,1363,shaman,restoration,51,25,26
Caliqueños,sanguino,1363,shaman,restoration,60,26,34
Mystycos,burning-legion,1362,shaman,restoration,48,19,29
Vodoochild,hyjal,1361,shaman,restoration,257,125,132
Перегной,ashenvale,1360,shaman,restoration,195,96,99
Akrobata,silvermoon,1360,shaman,restoration,180,83,97
Gunhyld,hyjal,1360,shaman,restoration,71,32,39
Jotashaman,sanguino,1360,shaman,restoration,69,31,38
Blixtlasse,magtheridon,1360,shaman,restoration,43,19,24
Thuknala,tarren-mill,1359,shaman,restoration,133,75,58
Abx,draenor,1359,shaman,restoration,54,28,26
Æcex,eredar,1358,shaman,restoration,33,15,18
Salmôn,twisting-nether,1358,shaman,restoration,42,15,27
Ærthgød,stormscale,1357,shaman,restoration,55,35,20
Glopper,ravencrest,1356,shaman,restoration,113,52,61
Götveren,eredar,1356,shaman,restoration,53,22,31
Hexius,drakthul,1355,shaman,restoration,24,15,9
Weraeth,drakthul,1355,shaman,restoration,221,123,98
Badkidney,alakir,1355,shaman,restoration,108,60,48
Soraiyaqt,kult-der-verdammten,1354,shaman,restoration,41,24,17
Ruvxy,twisting-nether,1354,shaman,restoration,65,38,27
Subaki,die-aldor,1354,shaman,restoration,58,32,26
Puresham,twisting-nether,1353,shaman,restoration,114,54,60
Vanquïsh,archimonde,1353,shaman,restoration,48,21,27
Mestgonee,draenor,1352,shaman,restoration,66,31,35
Mcgrêgor,aegwynn,1352,shaman,restoration,45,20,25
Krovogor,silvermoon,1351,shaman,restoration,60,34,26
Anakkynu,sylvanas,1351,shaman,restoration,55,27,28
Daboó,vashj,1350,shaman,restoration,115,63,52
Devastru,ravencrest,1350,shaman,restoration,78,35,43
Cadierno,argent-dawn,1349,shaman,restoration,30,18,12
Jävlajävel,draenor,1349,shaman,restoration,142,83,59
Ketzersend,alleria,1349,shaman,restoration,66,36,30
Finula,twisting-nether,1348,shaman,restoration,42,20,22
Stòrmbreakèr,nemesis,1348,shaman,restoration,161,73,88
Volvíc,tichondrius,1348,shaman,restoration,60,22,38
Alishie,outland,1347,shaman,restoration,129,69,60
Дердан,soulflayer,1347,shaman,restoration,84,42,42
Stylix,tarren-mill,1347,shaman,restoration,99,47,52
Zevissh,outland,1346,shaman,restoration,54,28,26
Ricid,nerathor,1346,shaman,restoration,49,22,27
Lynox,ragnaros,1345,shaman,restoration,78,48,30
Ошибся,deathguard,1345,shaman,restoration,132,72,60
Giulia,culte-de-la-rive-noire,1345,shaman,restoration,226,121,105
Schläck,outland,1345,shaman,restoration,48,23,25
Flikus,aggra-português,1345,shaman,restoration,54,21,33
Wealey,drakthul,1344,shaman,restoration,145,71,74
Сновидений,soulflayer,1344,shaman,restoration,49,23,26
Invade,darkspear,1343,shaman,restoration,18,14,4
Erepmad,ravencrest,1343,shaman,restoration,24,14,10
Teldariane,archimonde,1343,shaman,restoration,24,14,10
Bkid,archimonde,1343,shaman,restoration,71,32,39
Henchtotem,draenor,1342,shaman,restoration,56,31,25
Ònlìgrøvè,kazzak,1342,shaman,restoration,259,123,136
Denchdwarf,silvermoon,1342,shaman,restoration,30,14,16
Aldron,tirion,1341,shaman,restoration,81,45,36
Thunda,stormreaver,1341,shaman,restoration,36,15,21
Xoxoheal,eredar,1341,shaman,restoration,66,26,40
Jéhil,hyjal,1340,shaman,restoration,42,22,20
Intoxed,sylvanas,1340,shaman,restoration,120,62,58
Gaelic,frostmourne,1340,shaman,restoration,122,59,63
Schnessert,silvermoon,1340,shaman,restoration,36,16,20
Schïps,kirin-tor,1339,shaman,restoration,54,31,23
Maburst,silvermoon,1339,shaman,restoration,30,17,13
Thecallviper,blackmoore,1339,shaman,restoration,162,78,84
Leykosh,ravencrest,1338,shaman,restoration,24,14,10
Reyja,draenor,1338,shaman,restoration,42,24,18
Djuncraft,aegwynn,1338,shaman,restoration,36,18,18
Krolhok,hyjal,1338,shaman,restoration,30,14,16
Qjie,argent-dawn,1337,shaman,restoration,301,163,138
Lillkrutarn,tarren-mill,1336,shaman,restoration,24,16,8
Shapperdin,darksorrow,1336,shaman,restoration,24,14,10
Reticlol,kazzak,1336,shaman,restoration,30,14,16
Chamika,dentarg,1336,shaman,restoration,60,24,36
Freizeitler,antonidas,1335,shaman,restoration,78,37,41
Lorko,twisting-nether,1335,shaman,restoration,30,14,16
Dreamon,culte-de-la-rive-noire,1334,shaman,restoration,24,14,10
Vaelox,kazzak,1334,shaman,restoration,30,14,16
Lickmytôtem,frostmane,1334,shaman,restoration,33,15,18
Mzlp,sunstrider,1333,shaman,restoration,18,14,4
Ongewasgone,defias-brotherhood,1333,shaman,restoration,30,16,14
Grimn,burning-legion,1333,shaman,restoration,110,55,55
Windberg,ysondre,1333,shaman,restoration,30,14,16
Nephylim,grim-batol,1333,shaman,restoration,48,22,26
Onlytides,doomhammer,1332,shaman,restoration,144,64,80
Милыйдед,gordunni,1332,shaman,restoration,42,14,28
Istenes,frostwolf,1331,shaman,restoration,24,14,10
Amatero,drakthul,1331,shaman,restoration,61,34,27
Хотдевил,gordunni,1331,shaman,restoration,59,32,27
Bíìerlip,twisting-nether,1331,shaman,restoration,77,39,38
Kashnar,tarren-mill,1330,shaman,restoration,28,16,12
Lilshamano,ravencrest,1330,shaman,restoration,389,210,179
Shôk,ravencrest,1330,shaman,restoration,92,48,44
Касьянкочка,blackscar,1330,shaman,restoration,36,14,22
Andrewbéelko,drakthul,1329,shaman,restoration,24,14,10
Râpzz,aegwynn,1329,shaman,restoration,42,16,26
Honollulu,drakthul,1328,shaman,restoration,54,32,22
Knasta,malygos,1328,shaman,restoration,69,40,29
Kemmi,dalaran,1328,shaman,restoration,30,14,16
Jarvís,gilneas,1327,shaman,restoration,50,19,31
Egí,azshara,1327,shaman,restoration,53,19,34
Draredemolen,archimonde,1326,shaman,restoration,29,14,15
Rustfeather,sanguino,1326,shaman,restoration,30,14,16
Zenzua,twisting-nether,1325,shaman,restoration,47,29,18
Bíllý,onyxia,1325,shaman,restoration,51,28,23
Obêlixx,blackmoore,1325,shaman,restoration,120,62,58
Guayotta,sanguino,1325,shaman,restoration,92,36,56
Eero,darksorrow,1324,shaman,restoration,24,16,8
Регбисто,soulflayer,1324,shaman,restoration,89,44,45
Mansquidgoat,darksorrow,1323,shaman,restoration,33,22,11
Murmelï,stormreaver,1323,shaman,restoration,165,83,82
Cloovster,magtheridon,1323,shaman,restoration,36,17,19
Schaname,rajaxx,1323,shaman,restoration,30,14,16
Brassefrasse,shattered-hand,1322,shaman,restoration,57,30,27
Woade,silvermoon,1322,shaman,restoration,84,43,41
Shamaam,burning-legion,1322,shaman,restoration,79,38,41
Кураж,howling-fjord,1322,shaman,restoration,52,21,31
Tonifo,nemesis,1321,shaman,restoration,59,34,25
Maestro,spinebreaker,1321,shaman,restoration,30,17,13
Lerosh,twisting-nether,1321,shaman,restoration,60,33,27
Beardling,auchindoun,1321,shaman,restoration,48,26,22
Mjöllnir,blackrock,1321,shaman,restoration,108,56,52
Flameshock,tarren-mill,1321,shaman,restoration,54,23,31
Sadkick,twisting-nether,1320,shaman,restoration,24,14,10
Foximus,blackhand,1320,shaman,restoration,133,68,65
Modder,ragnaros,1320,shaman,restoration,30,14,16
Razeroø,ysondre,1318,shaman,restoration,85,45,40
Nybz,sylvanas,1318,shaman,restoration,162,83,79
Виртуосгодх,soulflayer,1318,shaman,restoration,104,50,54
Spitta,ysondre,1318,shaman,restoration,60,24,36
Dregú,draenor,1317,shaman,restoration,105,58,47
Zantam,ravencrest,1317,shaman,restoration,108,52,56
Shinds,archimonde,1317,shaman,restoration,84,37,47
Baldmommy,tarren-mill,1316,shaman,restoration,18,14,4
Chéonz,nethersturm,1316,shaman,restoration,96,50,46
Suze,hellfire,1316,shaman,restoration,102,49,53
Yzeldan,hyjal,1315,shaman,restoration,354,195,159
Pyxton,kazzak,1315,shaman,restoration,48,26,22
Lavafrans,kazzak,1314,shaman,restoration,36,22,14
Shamhaara,blackrock,1314,shaman,restoration,78,39,39
Hakunax,twisting-nether,1314,shaman,restoration,53,24,29
Littledorf,ravencrest,1313,shaman,restoration,153,80,73
Жижелье,howling-fjord,1312,shaman,restoration,128,68,60
Kbakasham,ravencrest,1312,shaman,restoration,56,27,29
Keräx,cthun,1311,shaman,restoration,24,14,10
Шаманутый,gordunni,1311,shaman,restoration,97,52,45
Ххвхд,soulflayer,1310,shaman,restoration,84,45,39
Ampaniaristo,sylvanas,1310,shaman,restoration,108,49,59
Skoddy,blackmoore,1308,shaman,restoration,61,31,30
Shamingu,arathor,1308,shaman,restoration,152,77,75
Outerspace,silvermoon,1308,shaman,restoration,129,64,65
Ephase,burning-blade,1308,shaman,restoration,67,25,42
Elvalya,archimonde,1307,shaman,restoration,23,14,9
Bandiitti,darksorrow,1307,shaman,restoration,24,14,10
Tâvôry,aegwynn,1307,shaman,restoration,89,36,53
Feumble,archimonde,1307,shaman,restoration,54,20,34
Bluesteel,bladefist,1306,shaman,restoration,74,28,46
Thaarley,blackmoore,1305,shaman,restoration,34,22,12
Shafallen,tarren-mill,1305,shaman,restoration,40,24,16
Kamamura,frostwolf,1305,shaman,restoration,54,26,28
Durek,aerie-peak,1304,shaman,restoration,24,14,10
Shammynox,draenor,1304,shaman,restoration,48,26,22
Shioni,ravencrest,1304,shaman,restoration,169,80,89
Rone,burning-blade,1303,shaman,restoration,36,19,17
Laykablue,blackhand,1303,shaman,restoration,55,26,29
Baboss,blutkessel,1302,shaman,restoration,77,40,37
Crymere,chamber-of-aspects,1302,shaman,restoration,343,173,170
Дымоквглазах,howling-fjord,1301,shaman,restoration,52,28,24
Cudntreskobe,kazzak,1301,shaman,restoration,46,24,22
Reechiks,outland,1301,shaman,restoration,30,14,16
Morrtes,burning-legion,1300,shaman,restoration,25,18,7
Chilliajin,tarren-mill,1300,shaman,restoration,107,49,58
Wtsfeetpics,dragonblight,1300,shaman,restoration,73,27,46
Шаеман,soulflayer,1298,shaman,restoration,36,20,16
Brigantino,burning-legion,1298,shaman,restoration,116,61,55
Iziisham,outland,1298,shaman,restoration,103,53,50
Alisàn,teldrassil,1298,shaman,restoration,252,123,129
Dpgsevenk,kazzak,1297,shaman,restoration,53,30,23
Qjx,blackrock,1297,shaman,restoration,30,16,14
Shamvandamme,kazzak,1297,shaman,restoration,56,21,35
Northodox,outland,1296,shaman,restoration,50,25,25
Бладих,howling-fjord,1295,shaman,restoration,321,158,163
Rhakhatheckh,nemesis,1295,shaman,restoration,58,26,32
Bomboclat,azjolnerub,1294,shaman,restoration,129,67,62
Beyp,sylvanas,1294,shaman,restoration,103,52,51
Try,zuluhed,1294,shaman,restoration,42,21,21
Bluefacebaby,nemesis,1294,shaman,restoration,212,102,110
Tâu,frostwolf,1293,shaman,restoration,27,15,12
Mwnci,anachronos,1293,shaman,restoration,195,105,90
Foxtér,burning-blade,1293,shaman,restoration,54,28,26
Alteredstate,twisting-nether,1292,shaman,restoration,36,16,20
Колосх,howling-fjord,1292,shaman,restoration,60,26,34
Riverwin,silvermoon,1291,shaman,restoration,66,42,24
Asaakira,blackmoore,1291,shaman,restoration,75,45,30
Fethiroth,sylvanas,1291,shaman,restoration,149,79,70
Быковат,booty-bay,1291,shaman,restoration,212,111,101
Формацепт,ashenvale,1291,shaman,restoration,197,100,97
Bèx,twisting-nether,1291,shaman,restoration,60,29,31
Mcslammer,kazzak,1291,shaman,restoration,48,22,26
Ironspine,sylvanas,1290,shaman,restoration,47,24,23
Fünkchn,zuluhed,1290,shaman,restoration,100,51,49
Zujaz,stormscale,1289,shaman,restoration,30,14,16
Shamanaman,stormscale,1287,shaman,restoration,24,14,10
Jimmybuffett,kazzak,1287,shaman,restoration,127,66,61
Xamic,twisting-nether,1287,shaman,restoration,81,38,43
Пит,goldrinn,1287,shaman,restoration,42,19,23
Yxi,blackmoore,1286,shaman,restoration,54,32,22
Kneggebrot,blackmoore,1286,shaman,restoration,96,39,57
Jänis,ragnaros,1286,shaman,restoration,40,16,24
Soger,mannoroth,1286,shaman,restoration,68,27,41
He,twisting-nether,1285,shaman,restoration,78,42,36
Сквиртолог,borean-tundra,1285,shaman,restoration,45,24,21
Бичпак,howling-fjord,1285,shaman,restoration,114,56,58
Totemglad,drakthul,1284,shaman,restoration,27,15,12
Orcinterface,tarren-mill,1284,shaman,restoration,176,85,91
Quiec,kazzak,1284,shaman,restoration,115,46,69
Kryuxs,blackrock,1283,shaman,restoration,102,50,52
Slowtem,draenor,1283,shaman,restoration,119,58,61
Eomsham,magtheridon,1283,shaman,restoration,33,15,18
Ferome,kazzak,1282,shaman,restoration,96,49,47
Adonalsium,sylvanas,1282,shaman,restoration,77,39,38
Panicblast,stormscale,1281,shaman,restoration,50,29,21
Kuddjah,twisting-nether,1280,shaman,restoration,95,49,46
Zarschu,burning-legion,1280,shaman,restoration,54,18,36
Thurgaden,nemesis,1279,shaman,restoration,66,45,21
Эртирон,howling-fjord,1279,shaman,restoration,383,200,183
Justweirdaf,blackmoore,1279,shaman,restoration,33,16,17
Morty,tarren-mill,1279,shaman,restoration,59,27,32
Викодиншама,howling-fjord,1278,shaman,restoration,68,37,31
Chaminoune,sargeras,1278,shaman,restoration,48,21,27
Kraugug,archimonde,1277,shaman,restoration,44,24,20
Bedouín,draenor,1277,shaman,restoration,132,69,63
Laïnàà,archimonde,1277,shaman,restoration,101,51,50
Lethz,hyjal,1277,shaman,restoration,30,15,15
Deaslow,hyjal,1276,shaman,restoration,40,25,15
Praise,auchindoun,1275,shaman,restoration,83,39,44
Samantouz,archimonde,1275,shaman,restoration,150,70,80
Silko,wrathbringer,1275,shaman,restoration,92,42,50
Draugrinns,tarren-mill,1274,shaman,restoration,30,15,15
Voodz,nathrezim,1274,shaman,restoration,67,30,37
Semrix,blackhand,1273,shaman,restoration,170,80,90
Buböta,sanguino,1273,shaman,restoration,44,17,27
Санрэйн,soulflayer,1272,shaman,restoration,65,37,28
Leccyavenue,twisting-nether,1272,shaman,restoration,99,43,56
Sleyter,sanguino,1272,shaman,restoration,38,16,22
Lorthargol,chamber-of-aspects,1272,shaman,restoration,42,17,25
Шайнинлайт,soulflayer,1271,shaman,restoration,107,42,65
Yslìn,khaz-modan,1271,shaman,restoration,41,14,27
Idkteam,stormscale,1270,shaman,restoration,30,15,15
Parkroy,draenor,1270,shaman,restoration,84,37,47
Nabo,archimonde,1270,shaman,restoration,52,22,30
Flambusier,hyjal,1269,shaman,restoration,297,163,134
Nwäar,archimonde,1269,shaman,restoration,148,72,76
Lk,twilights-hammer,1268,shaman,restoration,27,15,12
Nazgréll,tarren-mill,1268,shaman,restoration,157,84,73
Максибончик,soulflayer,1268,shaman,restoration,125,63,62
Gauss,agamaggan,1268,shaman,restoration,37,18,19
Shamtrix,drakthul,1268,shaman,restoration,89,41,48
Skenflewds,alakir,1268,shaman,restoration,160,70,90
Diya,karazhan,1268,shaman,restoration,132,57,75
Mehboul,hyjal,1267,shaman,restoration,28,14,14
Stormcaster,argent-dawn,1267,shaman,restoration,70,34,36
Orchal,defias-brotherhood,1267,shaman,restoration,75,36,39
Oscar,khaz-modan,1267,shaman,restoration,48,23,25
Shamanmode,twisting-nether,1267,shaman,restoration,66,28,38
Наладчик,gordunni,1266,shaman,restoration,34,24,10
Goreflame,argent-dawn,1266,shaman,restoration,91,50,41
Smyke,magtheridon,1265,shaman,restoration,126,73,53
Bierfrisch,ravencrest,1265,shaman,restoration,29,14,15
Storqix,drakthul,1265,shaman,restoration,305,145,160
Yuliy,arathor,1265,shaman,restoration,126,59,67
Furïas,hyjal,1265,shaman,restoration,48,22,26
Mitica,ravencrest,1265,shaman,restoration,53,24,29
Wayoa,defias-brotherhood,1264,shaman,restoration,24,18,6
Asumix,illidan,1264,shaman,restoration,124,61,63
Horiun,sanguino,1263,shaman,restoration,67,32,35
Laftershamy,cthun,1263,shaman,restoration,42,14,28
Iamnyka,blackrock,1262,shaman,restoration,108,58,50
Kéimohansio,draenor,1262,shaman,restoration,468,225,243
Kelshaj,thrall,1262,shaman,restoration,33,15,18
Azifox,hyjal,1260,shaman,restoration,25,14,11
Leunam,draenor,1260,shaman,restoration,58,30,28
Rookwave,eredar,1260,shaman,restoration,46,21,25
Onethousand,antonidas,1259,shaman,restoration,100,53,47
Düsterlotus,dalvengyr,1259,shaman,restoration,235,123,112
Proxysham,the-maelstrom,1258,shaman,restoration,52,32,20
Kaletore,ragnaros,1258,shaman,restoration,98,54,44
Munjar,korgall,1257,shaman,restoration,30,15,15
Lidinsham,draenor,1257,shaman,restoration,42,19,23
Binslagala,zuljin,1254,shaman,restoration,24,16,8
Säphïr,hyjal,1254,shaman,restoration,46,25,21
Pomegranate,arthas,1254,shaman,restoration,56,23,33
Shamaxwell,blackhand,1253,shaman,restoration,24,16,8
Chartersham,silvermoon,1252,shaman,restoration,18,14,4
Gushgush,draenor,1252,shaman,restoration,48,28,20
Ogrilza,uldaman,1252,shaman,restoration,136,74,62
Tilixs,draenor,1252,shaman,restoration,87,32,55
Фистинктотем,soulflayer,1250,shaman,restoration,122,62,60
Áchilleus,kazzak,1250,shaman,restoration,104,47,57
Lolafløres,dun-modr,1249,shaman,restoration,59,42,17
Mosterx,stormscale,1249,shaman,restoration,93,54,39
Eduorde,silvermoon,1249,shaman,restoration,88,45,43
Милжон,soulflayer,1248,shaman,restoration,212,119,93
Loppish,silvermoon,1248,shaman,restoration,177,95,82
Крэгнор,gordunni,1248,shaman,restoration,210,105,105
Frankx,stormscale,1248,shaman,restoration,74,30,44
Isak,ravencrest,1248,shaman,restoration,54,21,33
Nightrâin,kazzak,1247,shaman,restoration,49,23,26
Mandoloriana,sylvanas,1247,shaman,restoration,108,50,58
Bruvling,stormscale,1247,shaman,restoration,30,13,17
Kilnius,archimonde,1246,shaman,restoration,18,13,5
Musham,blackrock,1246,shaman,restoration,18,13,5
Lunarsloth,hyjal,1246,shaman,restoration,24,13,11
Healfûll,stormscale,1246,shaman,restoration,30,16,14
Fußpilzmann,blackmoore,1246,shaman,restoration,193,99,94
Shamanet,kazzak,1246,shaman,restoration,47,21,26
Pyrotoad,blackmoore,1246,shaman,restoration,30,13,17
Руикси,howling-fjord,1246,shaman,restoration,30,13,17
Løktarøgàr,archimonde,1246,shaman,restoration,38,16,22
Повор,soulflayer,1246,shaman,restoration,75,30,45
Новогор,soulflayer,1245,shaman,restoration,90,47,43
Sorcerus,burning-legion,1245,shaman,restoration,251,118,133
Зачикинимся,howling-fjord,1245,shaman,restoration,36,13,23
Alexmiamosch,thrall,1244,shaman,restoration,87,53,34
Thuns,stormscale,1243,shaman,restoration,41,24,17
Watashij,outland,1243,shaman,restoration,69,36,33
Lindemánn,blackhand,1243,shaman,restoration,88,32,56
Barbebiendur,archimonde,1242,shaman,restoration,30,13,17
Raincaller,archimonde,1242,shaman,restoration,82,32,50
Anlaki,silvermoon,1241,shaman,restoration,18,13,5
Akainu,nazjatar,1241,shaman,restoration,24,13,11
Dréa,draenor,1241,shaman,restoration,24,13,11
Kìra,darkmoon-faire,1241,shaman,restoration,65,34,31
Mêkyra,blackmoore,1241,shaman,restoration,146,70,76
Sáltý,ravencrest,1241,shaman,restoration,30,14,16
Djschamihaar,blackrock,1240,shaman,restoration,18,13,5
Volwerin,blackhand,1240,shaman,restoration,24,13,11
Hexftw,khaz-modan,1240,shaman,restoration,24,13,11
Lavacummer,blackmoore,1240,shaman,restoration,83,42,41
Dwarfofwar,ravencrest,1240,shaman,restoration,149,73,76
Ríko,argent-dawn,1240,shaman,restoration,88,43,45
Celphboss,draenor,1240,shaman,restoration,31,14,17
Contraire,blackrock,1240,shaman,restoration,30,13,17
Mazuh,twisting-nether,1239,shaman,restoration,24,14,10
Snugzqt,tarren-mill,1239,shaman,restoration,154,81,73
Måke,stormscale,1238,shaman,restoration,24,13,11
Ðøminantx,stormscale,1238,shaman,restoration,61,30,31
Herru,blackrock,1237,shaman,restoration,24,13,11
Shadowmove,bronzebeard,1237,shaman,restoration,24,13,11
Thenasil,stormscale,1237,shaman,restoration,136,69,67
Tenny,haomarush,1237,shaman,restoration,78,31,47
Nimos,drakthul,1237,shaman,restoration,36,13,23
Obadai,nemesis,1236,shaman,restoration,36,13,23
Fulminare,ravencrest,1235,shaman,restoration,83,42,41
Senfury,culte-de-la-rive-noire,1235,shaman,restoration,36,17,19
Tosaá,antonidas,1235,shaman,restoration,48,22,26
Scàráth,eredar,1235,shaman,restoration,69,27,42
Корольшомен,gordunni,1234,shaman,restoration,24,14,10
Tiddles,arathor,1234,shaman,restoration,24,13,11
Stivishamy,blackmoore,1234,shaman,restoration,58,30,28
Thundertail,ragnaros,1234,shaman,restoration,42,15,27
Женяшилдх,howling-fjord,1233,shaman,restoration,41,23,18
Coacine,ravencrest,1233,shaman,restoration,36,20,16
Shasto,draenor,1233,shaman,restoration,30,13,17
Asschick,outland,1233,shaman,restoration,36,13,23
Дисмон,ashenvale,1232,shaman,restoration,120,63,57
Magizey,defias-brotherhood,1231,shaman,restoration,18,13,5
Kyaz,ravencrest,1231,shaman,restoration,30,15,15
Totembse,silvermoon,1231,shaman,restoration,42,17,25
Carnágé,blackrock,1230,shaman,restoration,48,27,21
Zapymon,draenor,1230,shaman,restoration,48,21,27
Mystico,sanguino,1229,shaman,restoration,70,29,41
Zìik,draenor,1229,shaman,restoration,36,13,23
Rakân,ysondre,1229,shaman,restoration,36,13,23
Makaria,emerald-dream,1228,shaman,restoration,285,137,148
Sugardad,khaz-modan,1228,shaman,restoration,189,90,99
Натаро,soulflayer,1228,shaman,restoration,30,13,17
Wildos,zuljin,1228,shaman,restoration,54,21,33
Punjabi,nemesis,1228,shaman,restoration,42,16,26
Tuba,ragnaros,1227,shaman,restoration,81,47,34
Heltjettad,frostmane,1227,shaman,restoration,64,30,34
Эрутеон,deathguard,1227,shaman,restoration,185,83,102
Devosham,blackrock,1226,shaman,restoration,114,60,54
Illninô,blackrock,1226,shaman,restoration,27,14,13
Thordahr,hyjal,1226,shaman,restoration,53,19,34
Enzopotenzo,blackrock,1225,shaman,restoration,140,64,76
Amrgl,earthen-ring,1225,shaman,restoration,126,54,72
Clearwaters,tarren-mill,1225,shaman,restoration,40,14,26
Cismine,twisting-nether,1224,shaman,restoration,30,13,17
Линейджер,soulflayer,1224,shaman,restoration,42,15,27
Avattar,twisting-nether,1223,shaman,restoration,36,21,15
Electrífied,outland,1223,shaman,restoration,108,42,66
Shevarra,silvermoon,1222,shaman,restoration,228,121,107
Kavyzyoyo,twisting-nether,1222,shaman,restoration,71,31,40
Пончо,booty-bay,1221,shaman,restoration,146,77,69
Сёмабро,ashenvale,1221,shaman,restoration,951,487,464
Huldi,kazzak,1220,shaman,restoration,75,42,33
Турбопушкин,soulflayer,1220,shaman,restoration,36,13,23
Dinosaurer,outland,1219,shaman,restoration,18,13,5
Nîckîî,aegwynn,1219,shaman,restoration,55,29,26
Madtotem,blackrock,1219,shaman,restoration,36,14,22
Anyxxia,aegwynn,1219,shaman,restoration,56,21,35
Lycburst,twisting-nether,1219,shaman,restoration,36,13,23
Rinn,frostmane,1219,shaman,restoration,58,20,38
Индигула,soulflayer,1219,shaman,restoration,59,18,41
Ulfom,silvermoon,1218,shaman,restoration,100,51,49
Виндфюрер,deathguard,1217,shaman,restoration,66,32,34
Shèshe,uldaman,1216,shaman,restoration,54,30,24
Shamone,stormreaver,1216,shaman,restoration,41,20,21
Lopetitchat,chogall,1216,shaman,restoration,87,42,45
Kiiaser,sanguino,1216,shaman,restoration,70,33,37
Юляукраинка,gordunni,1216,shaman,restoration,55,24,31
Sickbrain,silvermoon,1216,shaman,restoration,45,19,26
Bïgdaddy,twisting-nether,1216,shaman,restoration,54,20,34
Biztor,jaedenar,1215,shaman,restoration,82,45,37
Gerethor,burning-legion,1215,shaman,restoration,64,32,32
Panicsc,twisting-nether,1215,shaman,restoration,454,225,229
Kèlls,la-croisade-écarlate,1215,shaman,restoration,60,27,33
Oprawinfury,ravencrest,1215,shaman,restoration,48,20,28
Гарришаман,soulflayer,1214,shaman,restoration,23,13,10
Lupinola,kazzak,1214,shaman,restoration,36,19,17
Bullit,zuljin,1214,shaman,restoration,134,65,69
Merkàba,pozzo-delleternità,1214,shaman,restoration,115,54,61
Cidonijs,aszune,1214,shaman,restoration,34,13,21
Rúberg,shadowsong,1213,shaman,restoration,42,20,22
Grimnyr,onyxia,1213,shaman,restoration,42,17,25
Captaínduck,garrosh,1212,shaman,restoration,235,127,108
Kãitse,silvermoon,1212,shaman,restoration,42,20,22
Bluelasso,ysondre,1212,shaman,restoration,42,15,27
Macchiavelli,blades-edge,1211,shaman,restoration,167,75,92
Syøx,blackmoore,1210,shaman,restoration,30,18,12
Kundi,nazjatar,1210,shaman,restoration,42,21,21
Джусипуси,gordunni,1210,shaman,restoration,60,25,35
Mazu,spinebreaker,1210,shaman,restoration,77,30,47
Cred,the-venture-co,1210,shaman,restoration,48,18,30
Croku,thrall,1209,shaman,restoration,138,74,64
Kickvando,blackmoore,1209,shaman,restoration,44,22,22
Moonbotico,blackrock,1207,shaman,restoration,145,72,73
Síqú,blackmoore,1207,shaman,restoration,62,29,33
Xetri,ragnaros,1206,shaman,restoration,41,22,19
Thundersioux,ravencrest,1206,shaman,restoration,143,74,69
Morttes,burning-legion,1205,shaman,restoration,27,14,13
Doriana,dalaran,1205,shaman,restoration,149,68,81
Kivra,burning-legion,1205,shaman,restoration,137,59,78
Rawtex,draenor,1205,shaman,restoration,68,24,44
Bispi,blackmoore,1204,shaman,restoration,31,15,16
Mosler,thunderhorn,1204,shaman,restoration,89,42,47
Undin,burning-legion,1202,shaman,restoration,114,64,50
Icozy,stormscale,1202,shaman,restoration,51,27,24
Shamandeadly,aggra-português,1202,shaman,restoration,36,19,17
Elwynn,terenas,1202,shaman,restoration,47,18,29
Mya,frostwolf,1201,shaman,restoration,29,14,15
Roxxo,frostwolf,1200,shaman,restoration,30,16,14
Phineaph,theradras,1200,shaman,restoration,66,34,32
Patlangoi,outland,1200,shaman,restoration,266,130,136
Klamen,kazzak,1200,shaman,restoration,36,17,19
Blöödfist,drakthul,1200,shaman,restoration,35,14,21
Нолькастов,soulflayer,1199,shaman,restoration,17,13,4
Oladoda,archimonde,1199,shaman,restoration,23,13,10
Pwccey,drakthul,1199,shaman,restoration,90,35,55
Leakk,twisting-nether,1198,shaman,restoration,31,15,16
Teccatwo,outland,1198,shaman,restoration,100,48,52
Jimkopf,eredar,1197,shaman,restoration,72,36,36
Corbo,ysondre,1196,shaman,restoration,126,68,58
Bruhin,ravencrest,1196,shaman,restoration,96,44,52
Jellyg,outland,1196,shaman,restoration,29,13,16
Chamon,grim-batol,1195,shaman,restoration,42,19,23
Fragolias,malygos,1194,shaman,restoration,36,18,18
Рангурэн,fordragon,1194,shaman,restoration,30,15,15
Vonneuman,draenor,1194,shaman,restoration,102,47,55
Gorël,sinstralis,1193,shaman,restoration,90,48,42
Nakenfeigy,stormreaver,1192,shaman,restoration,67,34,33
Hóonda,twisting-nether,1191,shaman,restoration,24,13,11
Fatotato,outland,1191,shaman,restoration,36,13,23
Malamadre,antonidas,1191,shaman,restoration,48,17,31
Khazburn,hyjal,1191,shaman,restoration,42,13,29
Gruggosh,argent-dawn,1187,shaman,restoration,24,13,11
Conor,kult-der-verdammten,1187,shaman,restoration,60,29,31
Axéron,blackhand,1187,shaman,restoration,54,25,29
Дохаку,booty-bay,1187,shaman,restoration,29,13,16
Xavií,blackmoore,1186,shaman,restoration,53,19,34
Манрото,soulflayer,1185,shaman,restoration,27,18,9
Saviothewise,aggra-português,1185,shaman,restoration,30,19,11
Iltis,nazjatar,1185,shaman,restoration,58,24,34
Vermu,silvermoon,1184,shaman,restoration,32,20,12
Kuiji,stormreaver,1184,shaman,restoration,154,84,70
Narvalus,throkferoth,1184,shaman,restoration,40,21,19
Spørc,ragnaros,1184,shaman,restoration,160,79,81
Линчон,soulflayer,1184,shaman,restoration,42,20,22
Csiribä,ragnaros,1183,shaman,restoration,45,19,26
Oldrym,blackrock,1183,shaman,restoration,64,25,39
Rêêza,blackhand,1182,shaman,restoration,72,38,34
Brandbombe,frostwolf,1181,shaman,restoration,26,14,12
Târrocke,nethersturm,1181,shaman,restoration,54,24,30
Shexy,the-maelstrom,1181,shaman,restoration,72,25,47
Nanolasso,anubarak,1181,shaman,restoration,38,13,25
Bigschamlipp,blackhand,1180,shaman,restoration,23,13,10
Shehullk,ravencrest,1180,shaman,restoration,28,15,13
Honorqi,sylvanas,1180,shaman,restoration,111,44,67
Bigrambo,draenor,1179,shaman,restoration,89,48,41
Darnok,quelthalas,1178,shaman,restoration,66,32,34
Thundrkrakn,blackhand,1177,shaman,restoration,77,39,38
Kyran,sunstrider,1177,shaman,restoration,26,13,13
Bonks,darksorrow,1177,shaman,restoration,30,13,17
Koggaion,kazzak,1177,shaman,restoration,95,36,59
Shacharcaspi,blackmoore,1177,shaman,restoration,55,20,35
Xabat,nemesis,1176,shaman,restoration,24,14,10
Kvekkis,argent-dawn,1175,shaman,restoration,30,17,13
Alcam,twisting-nether,1175,shaman,restoration,104,45,59
Titavio,twisting-nether,1174,shaman,restoration,48,22,26
Buzzingsham,tarren-mill,1173,shaman,restoration,98,48,50
Baelee,sylvanas,1173,shaman,restoration,151,72,79
Аскирия,soulflayer,1173,shaman,restoration,36,13,23
Zkalman,kazzak,1169,shaman,restoration,41,22,19
Tegellera,ravencrest,1168,shaman,restoration,53,27,26
Rhastasha,archimonde,1168,shaman,restoration,42,18,24
Vijaya,eredar,1166,shaman,restoration,19,13,6
Harptwo,eredar,1166,shaman,restoration,101,50,51
Chadshaman,antonidas,1166,shaman,restoration,91,37,54
Akimboo,kilrogg,1166,shaman,restoration,48,18,30
Kongapenes,tarren-mill,1165,shaman,restoration,42,23,19
Везериан,gordunni,1165,shaman,restoration,35,15,20
Raytastic,aegwynn,1164,shaman,restoration,36,18,18
Gundersen,stormscale,1164,shaman,restoration,36,16,20
Manitus,sylvanas,1162,shaman,restoration,139,66,73
Ekstrakiks,ravencrest,1161,shaman,restoration,52,21,31
Shamikàze,silvermoon,1160,shaman,restoration,88,55,33
Pituu,tarren-mill,1158,shaman,restoration,36,15,21
Styllz,uldaman,1158,shaman,restoration,55,21,34
Cromosoma,dun-modr,1157,shaman,restoration,92,53,39
Shinui,twisting-nether,1157,shaman,restoration,51,26,25
Mostachin,dun-modr,1155,shaman,restoration,64,28,36
Strikerz,aggra-português,1154,shaman,restoration,56,32,24
Терату,gordunni,1152,shaman,restoration,24,12,12
Invades,shattered-hand,1152,shaman,restoration,24,12,12
Sgf,stormscale,1152,shaman,restoration,111,48,63
Enviø,ravencrest,1151,shaman,restoration,12,12,0
Snackerella,blackrock,1151,shaman,restoration,18,12,6
Exesemrone,uldaman,1151,shaman,restoration,18,12,6
Oningodx,drakthul,1151,shaman,restoration,30,12,18
Souqixo,drakthul,1150,shaman,restoration,18,12,6
Dorxt,chogall,1150,shaman,restoration,18,12,6
Sparkygrill,eredar,1150,shaman,restoration,24,12,12
Hérépilé,dalaran,1150,shaman,restoration,24,12,12
Фатнир,soulflayer,1150,shaman,restoration,24,12,12
Flandersx,ravencrest,1150,shaman,restoration,24,12,12
Chimey,frostmane,1150,shaman,restoration,24,12,12
Lolalovexo,kazzak,1150,shaman,restoration,30,14,16
Wieszcz,kazzak,1150,shaman,restoration,122,53,69
Killatotem,kazzak,1150,shaman,restoration,30,12,18
Shàyâ,ysondre,1149,shaman,restoration,24,12,12
Ампулаикс,gordunni,1149,shaman,restoration,24,12,12
Rëazx,archimonde,1149,shaman,restoration,24,12,12
Woopiedoopie,silvermoon,1149,shaman,restoration,24,12,12
Аркенстоун,soulflayer,1148,shaman,restoration,24,12,12
Kaherad,antonidas,1148,shaman,restoration,72,33,39
Pépón,dun-modr,1148,shaman,restoration,42,17,25
Xêra,burning-legion,1147,shaman,restoration,22,13,9
Evííl,tarren-mill,1147,shaman,restoration,30,12,18
Kärríegold,blackrock,1146,shaman,restoration,18,12,6
Lemontea,burning-blade,1146,shaman,restoration,174,83,91
Graoulelou,hyjal,1145,shaman,restoration,24,12,12
Komodski,kazzak,1145,shaman,restoration,24,12,12
Dominatorix,xavius,1144,shaman,restoration,19,12,7
Alexialul,silvermoon,1144,shaman,restoration,24,12,12
Unraedorc,twisting-nether,1144,shaman,restoration,30,12,18
Kuse,anubarak,1144,shaman,restoration,30,12,18
Drman,shattered-hand,1143,shaman,restoration,60,33,27
Görgûtz,illidan,1143,shaman,restoration,24,13,11
Чойсе,deathguard,1143,shaman,restoration,24,12,12
Lynesse,ragnaros,1142,shaman,restoration,18,12,6
Jáckdaniels,twisting-nether,1142,shaman,restoration,28,14,14
Yasunari,sanguino,1142,shaman,restoration,60,23,37
Lumière,alonsus,1141,shaman,restoration,24,12,12
Trünk,arathi,1141,shaman,restoration,66,21,45
Кезара,razuvious,1140,shaman,restoration,66,32,34
Canhealu,nemesis,1139,shaman,restoration,361,181,180
Coxshamanic,draenor,1139,shaman,restoration,36,12,24
Ayusham,ravencrest,1138,shaman,restoration,24,12,12
Clips,frostmane,1138,shaman,restoration,30,12,18
Baarona,neptulon,1137,shaman,restoration,30,16,14
Masham,darkspear,1137,shaman,restoration,30,12,18
Scamander,draenor,1137,shaman,restoration,38,14,24
Khanokekw,twisting-nether,1136,shaman,restoration,142,76,66
Дрекрош,howling-fjord,1136,shaman,restoration,365,171,194
Paniio,stormscale,1136,shaman,restoration,72,31,41
Bogatyrk,twisting-nether,1134,shaman,restoration,23,13,10
Gárdzsúlió,ragnaros,1134,shaman,restoration,24,12,12
Xerijan,pozzo-delleternità,1134,shaman,restoration,134,65,69
Actic,garrosh,1134,shaman,restoration,48,19,29
Sciamanò,nemesis,1133,shaman,restoration,18,12,6
Stormred,blackmoore,1133,shaman,restoration,36,19,17
Ironbeard,daggerspine,1133,shaman,restoration,82,41,41
Stormque,blackhand,1133,shaman,restoration,248,116,132
Mälaa,ysondre,1133,shaman,restoration,30,12,18
Шаманнутая,gordunni,1133,shaman,restoration,30,12,18
Sërka,cthun,1133,shaman,restoration,56,20,36
Nozòmi,defias-brotherhood,1132,shaman,restoration,30,12,18
Omgodofwar,burning-blade,1132,shaman,restoration,90,33,57
Mearu,bronze-dragonflight,1129,shaman,restoration,94,56,38
Морпат,soulflayer,1129,shaman,restoration,70,38,32
Zyrou,arthas,1128,shaman,restoration,24,12,12
Jiaan,burning-legion,1127,shaman,restoration,24,13,11
Profylax,arathor,1127,shaman,restoration,54,27,27
Gondrim,blackmoore,1127,shaman,restoration,35,17,18
Xilquid,darksorrow,1126,shaman,restoration,51,19,32
ßasìkz,hyjal,1126,shaman,restoration,59,12,47
Garifus,dun-modr,1125,shaman,restoration,198,105,93
Bigwa,dun-morogh,1124,shaman,restoration,59,37,22
Poggsham,twisting-nether,1124,shaman,restoration,80,37,43
Sakulis,ravencrest,1124,shaman,restoration,31,13,18
Vimra,blackhand,1124,shaman,restoration,59,21,38
Кислыйсоус,gordunni,1123,shaman,restoration,84,44,40
Ivaccineyou,blackmoore,1123,shaman,restoration,30,15,15
Vulkân,silvermoon,1123,shaman,restoration,56,25,31
Shámpaín,outland,1123,shaman,restoration,67,29,38
Førcemajeure,kazzak,1121,shaman,restoration,24,12,12
Avadokadavra,kazzak,1120,shaman,restoration,65,31,34
Størmbølt,draenor,1120,shaman,restoration,114,49,65
Nesjâ,blackhand,1120,shaman,restoration,30,12,18
Эйвуа,gordunni,1119,shaman,restoration,131,66,65
Temeres,drakthul,1119,shaman,restoration,30,15,15
Blíngen,ravencrest,1117,shaman,restoration,60,35,25
Shinigamy,kazzak,1117,shaman,restoration,199,106,93
Nazantìa,hyjal,1116,shaman,restoration,65,33,32
Щцц,soulflayer,1115,shaman,restoration,36,12,24
Checkpoint,defias-brotherhood,1114,shaman,restoration,90,47,43
Fairgewalt,blackhand,1113,shaman,restoration,26,13,13
Aveet,kazzak,1113,shaman,restoration,24,12,12
Таззикшок,soulflayer,1113,shaman,restoration,171,78,93
Понбарон,gordunni,1113,shaman,restoration,46,19,27
Suntpraf,kazzak,1113,shaman,restoration,47,19,28
Hayvack,hyjal,1112,shaman,restoration,56,28,28
Olînours,archimonde,1112,shaman,restoration,42,21,21
Magmera,argent-dawn,1112,shaman,restoration,200,92,108
Elunaxcc,eredar,1111,shaman,restoration,73,38,35
Soramat,aegwynn,1111,shaman,restoration,29,12,17
Thopeur,ysondre,1111,shaman,restoration,48,14,34
Akuha,dun-modr,1110,shaman,restoration,44,13,31
Shakgor,draenor,1108,shaman,restoration,90,50,40
Karash,twisting-nether,1108,shaman,restoration,42,16,26
Alø,blackrock,1106,shaman,restoration,42,18,24
Walmartorc,kazzak,1105,shaman,restoration,27,13,14
Jecastyle,sanguino,1105,shaman,restoration,32,15,17
Aénéas,twisting-nether,1105,shaman,restoration,42,15,27
Maflas,dun-modr,1104,shaman,restoration,69,37,32
Gotreck,zuljin,1104,shaman,restoration,42,15,27
Kuubskii,ravencrest,1100,shaman,restoration,29,12,17
Alvastis,moonglade,1099,shaman,restoration,42,16,26
Jhaky,dun-modr,1099,shaman,restoration,36,13,23
Джамандх,blackscar,1097,shaman,restoration,69,30,39
Floki,emerald-dream,1096,shaman,restoration,39,13,26
Zerwurster,thrall,1094,shaman,restoration,60,30,30
Rusbeermen,silvermoon,1094,shaman,restoration,47,13,34
Tomtefaan,sylvanas,1093,shaman,restoration,36,19,17
Alakan,saurfang,1093,shaman,restoration,140,65,75
Shøckz,azjolnerub,1092,shaman,restoration,48,28,20
Sizzurp,mugthol,1092,shaman,restoration,66,26,40
Xoxoxoxoa,twisting-nether,1091,shaman,restoration,118,47,71
Walgon,blackhand,1091,shaman,restoration,76,27,49
Randomshamx,ravencrest,1090,shaman,restoration,37,15,22
Bosskwtt,kazzak,1087,shaman,restoration,28,13,15
Arabesk,arygos,1087,shaman,restoration,114,51,63
Lapou,archimonde,1087,shaman,restoration,36,12,24
Wunse,doomhammer,1086,shaman,restoration,30,12,18
Mufzo,draenor,1086,shaman,restoration,47,16,31
Adubsham,tarren-mill,1085,shaman,restoration,17,12,5
Kévinn,draenor,1085,shaman,restoration,20,12,8
Assyrià,ravencrest,1085,shaman,restoration,58,25,33
Sneggels,wrathbringer,1083,shaman,restoration,74,35,39
Mantoon,doomhammer,1083,shaman,restoration,72,32,40
Spartecøbra,dalaran,1083,shaman,restoration,36,16,20
Smö,kazzak,1082,shaman,restoration,30,15,15
Arienus,turalyon,1081,shaman,restoration,22,12,10
Aviearn,ragnaros,1081,shaman,restoration,74,37,37
Bennycooch,silvermoon,1081,shaman,restoration,107,42,65
Qyo,throkferoth,1080,shaman,restoration,65,38,27
Ntaris,blackmoore,1080,shaman,restoration,22,12,10
Чоколав,howling-fjord,1079,shaman,restoration,108,56,52
Жуксик,greymane,1078,shaman,restoration,73,26,47
Sarenity,hellfire,1077,shaman,restoration,59,29,30
Woew,tarren-mill,1076,shaman,restoration,24,12,12
Hunorth,stormscale,1075,shaman,restoration,64,28,36
Rórekk,aegwynn,1074,shaman,restoration,42,18,24
Pakasschami,frostwolf,1071,shaman,restoration,26,13,13
Mintyfresh,alakir,1070,shaman,restoration,25,12,13
Demelena,silvermoon,1069,shaman,restoration,296,154,142
Holshammy,nemesis,1069,shaman,restoration,96,40,56
Towokk,kazzak,1067,shaman,restoration,72,41,31
Quîn,defias-brotherhood,1066,shaman,restoration,102,48,54
Xari,earthen-ring,1066,shaman,restoration,67,28,39
Nftkal,emerald-dream,1065,shaman,restoration,100,45,55
Шабыч,deathguard,1064,shaman,restoration,24,13,11
Elosenx,magtheridon,1064,shaman,restoration,30,16,14
Blautorkel,amanthul,1064,shaman,restoration,65,27,38
Zuggerberg,defias-brotherhood,1063,shaman,restoration,33,12,21
Ariekanarie,ravencrest,1062,shaman,restoration,90,46,44
Jeezy,blackhand,1062,shaman,restoration,72,26,46
Hikigane,marécage-de-zangar,1061,shaman,restoration,54,20,34
Lowhpqt,blackrock,1059,shaman,restoration,26,17,9
Milfishake,frostwolf,1056,shaman,restoration,24,11,13
Rôwdy,kazzak,1056,shaman,restoration,24,11,13
Banmagic,hyjal,1056,shaman,restoration,24,11,13
Лисёноклорд,gordunni,1056,shaman,restoration,24,11,13
Snoopfrog,dun-morogh,1056,shaman,restoration,53,22,31
Recov,draenor,1056,shaman,restoration,28,11,17
Thaw,sylvanas,1056,shaman,restoration,30,11,19
Zuly,grim-batol,1055,shaman,restoration,18,11,7
Diaminya,tarren-mill,1055,shaman,restoration,18,11,7
Yashëa,ysondre,1055,shaman,restoration,18,11,7
Doubleshamz,the-maelstrom,1055,shaman,restoration,18,11,7
Drmanathan,garona,1055,shaman,restoration,18,11,7
Khàlyne,archimonde,1055,shaman,restoration,18,11,7
Vulkan,kirin-tor,1055,shaman,restoration,54,25,29
Qwázú,silvermoon,1055,shaman,restoration,24,11,13
Icecold,grim-batol,1055,shaman,restoration,24,11,13
Wintradezki,tarren-mill,1055,shaman,restoration,24,11,13
Blipster,tarren-mill,1055,shaman,restoration,24,11,13
Lanzatotems,dun-modr,1055,shaman,restoration,93,42,51
Moeschi,blackrock,1054,shaman,restoration,18,11,7
Эксициум,soulflayer,1054,shaman,restoration,18,11,7
Ixthus,varimathras,1054,shaman,restoration,24,11,13
Blóúb,blackmoore,1054,shaman,restoration,24,11,13
Mêrowinger,blackhand,1054,shaman,restoration,24,11,13
Mckoy,kazzak,1054,shaman,restoration,24,11,13
Elshamino,ravencrest,1054,shaman,restoration,24,11,13
Sheherezeday,aegwynn,1053,shaman,restoration,18,11,7
Flokinette,chogall,1053,shaman,restoration,24,11,13
Salatmayoo,alakir,1053,shaman,restoration,27,12,15
Kswíss,outland,1052,shaman,restoration,21,13,8
Ehrling,ysondre,1052,shaman,restoration,125,64,61
Hesitant,kazzak,1052,shaman,restoration,24,11,13
Nùggets,garona,1052,shaman,restoration,24,11,13
Kókucs,ragnaros,1052,shaman,restoration,24,11,13
Papskalla,ravencrest,1052,shaman,restoration,30,11,19
Давняя,grom,1052,shaman,restoration,30,11,19
Zourià,archimonde,1052,shaman,restoration,30,11,19
Rouwa,korgall,1051,shaman,restoration,18,11,7
Kelvok,silvermoon,1051,shaman,restoration,18,11,7
Fivezax,tarren-mill,1051,shaman,restoration,90,47,43
Zackboing,thrall,1051,shaman,restoration,75,38,37
Lòómit,anetheron,1051,shaman,restoration,89,43,46
Brâshô,frostwolf,1051,shaman,restoration,63,29,34
Gungo,deathwing,1051,shaman,restoration,24,11,13
Leafplsx,blackrock,1051,shaman,restoration,30,11,19
Тирона,howling-fjord,1051,shaman,restoration,30,11,19
Fläskdoris,tarren-mill,1051,shaman,restoration,30,11,19
Ampz,boulderfist,1051,shaman,restoration,65,23,42
Kíkjo,aegwynn,1050,shaman,restoration,18,11,7
Iwaa,dalaran,1050,shaman,restoration,24,11,13
Оперочек,howling-fjord,1050,shaman,restoration,42,12,30
Kissaru,antonidas,1049,shaman,restoration,18,11,7
Pumbat,lothar,1049,shaman,restoration,18,11,7
Haginathor,twisting-nether,1049,shaman,restoration,100,53,47
Phenototem,blackhand,1049,shaman,restoration,24,11,13
Nakertaako,kazzak,1049,shaman,restoration,24,11,13
Lamarrus,malganis,1049,shaman,restoration,30,11,19
Cottoneyejoe,alexstrasza,1049,shaman,restoration,36,11,25
Esal,blackrock,1048,shaman,restoration,18,11,7
Lechirurgien,elune,1048,shaman,restoration,175,88,87
Ibkdalen,stormscale,1048,shaman,restoration,110,55,55
Zahké,stormscale,1048,shaman,restoration,24,11,13
Shamoek,argent-dawn,1048,shaman,restoration,48,20,28
Narache,defias-brotherhood,1048,shaman,restoration,34,12,22
Bakuga,ragnaros,1047,shaman,restoration,18,11,7
Dobbi,dethecus,1047,shaman,restoration,24,12,12
Thrallash,blackhand,1047,shaman,restoration,42,12,30
Tyralià,draenor,1046,shaman,restoration,18,11,7
Wakka,wildhammer,1046,shaman,restoration,121,61,60
Nafay,lordaeron,1046,shaman,restoration,96,45,51
Анашишка,borean-tundra,1046,shaman,restoration,30,11,19
Daklickshamy,blackmoore,1045,shaman,restoration,24,11,13
Fwoxyuwu,argent-dawn,1044,shaman,restoration,24,11,13
Thaun,blackrock,1043,shaman,restoration,46,21,25
Silktotems,kazzak,1043,shaman,restoration,90,38,52
Omeletteoeuf,silvermoon,1042,shaman,restoration,24,13,11
Umgrall,archimonde,1042,shaman,restoration,66,27,39
Вашнюхтоптал,howling-fjord,1040,shaman,restoration,54,31,23
Xfiles,garona,1039,shaman,restoration,24,11,13
Syreer,silvermoon,1038,shaman,restoration,32,14,18
Милыйдорогой,soulflayer,1038,shaman,restoration,44,18,26
Hazufel,kaelthas,1037,shaman,restoration,64,29,35
Slutie,stormscale,1036,shaman,restoration,23,11,12
Флафен,howling-fjord,1035,shaman,restoration,30,15,15
Manolaz,kazzak,1035,shaman,restoration,24,11,13
Zherøn,tyrande,1035,shaman,restoration,24,11,13
Eliteblood,kazzak,1034,shaman,restoration,30,21,9
Gadoway,hyjal,1034,shaman,restoration,24,11,13
Снобу,gordunni,1034,shaman,restoration,24,11,13
Jotuna,argent-dawn,1034,shaman,restoration,30,12,18
Brutalxl,tarren-mill,1034,shaman,restoration,35,13,22
Koholona,malygos,1033,shaman,restoration,55,28,27
Dikwijls,ravencrest,1031,shaman,restoration,24,11,13
Arles,dun-modr,1031,shaman,restoration,30,12,18
Drogskull,sanguino,1030,shaman,restoration,18,11,7
Mambokïngs,sanguino,1030,shaman,restoration,38,14,24
Patites,twisting-nether,1029,shaman,restoration,54,31,23
Moglibard,grim-batol,1028,shaman,restoration,18,11,7
Schamos,kiljaeden,1028,shaman,restoration,36,12,24
Shockshacks,kazzak,1027,shaman,restoration,120,51,69
Abuzay,medivh,1026,shaman,restoration,18,11,7
Babyshamy,kazzak,1026,shaman,restoration,24,11,13
Joniks,stormscale,1026,shaman,restoration,114,51,63
Deesham,blackmoore,1026,shaman,restoration,32,12,20
Thunderboom,emerald-dream,1026,shaman,restoration,30,11,19
Ashmaul,outland,1025,shaman,restoration,60,30,30
Gigasham,azjolnerub,1025,shaman,restoration,82,39,43
Лялори,gordunni,1025,shaman,restoration,60,28,32
Zordox,zirkel-des-cenarius,1024,shaman,restoration,40,13,27
Ухмылк,azuregos,1023,shaman,restoration,255,137,118
Ипа,thermaplugg,1023,shaman,restoration,59,16,43
Aiuto,archimonde,1022,shaman,restoration,24,11,13
Hexinreflect,silvermoon,1021,shaman,restoration,96,41,55
Worthless,quelthalas,1020,shaman,restoration,77,30,47
Chaotikos,ravencrest,1019,shaman,restoration,163,99,64
Магмарончик,gordunni,1017,shaman,restoration,60,24,36
Darkwaters,archimonde,1017,shaman,restoration,29,11,18
Mantits,stormscale,1016,shaman,restoration,20,12,8
Snidge,magtheridon,1016,shaman,restoration,48,28,20
Nozer,arathor,1011,shaman,restoration,56,31,25
Мезонет,soulflayer,1011,shaman,restoration,30,16,14
Muhsketier,wrathbringer,1010,shaman,restoration,165,78,87
Cukkerberg,ragnaros,1010,shaman,restoration,48,19,29
Protv,ravencrest,1009,shaman,restoration,54,31,23
Mikah,frostwhisper,1007,shaman,restoration,21,13,8
Jøw,dun-modr,1007,shaman,restoration,96,57,39
Stkk,ravencrest,1007,shaman,restoration,152,76,76
Blainehammer,arathor,1006,shaman,restoration,30,12,18
Saamjai,turalyon,1005,shaman,restoration,30,17,13
Samant,neptulon,1004,shaman,restoration,72,36,36
Parabrisas,argent-dawn,1004,shaman,restoration,23,11,12
Symy,draenor,1002,shaman,restoration,69,31,38
Луперккаль,soulflayer,1002,shaman,restoration,38,12,26
Thunderjax,laughing-skull,1001,shaman,restoration,58,29,29
Darkkshammy,silvermoon,1001,shaman,restoration,24,12,12
Muntark,thrall,1001,shaman,restoration,33,11,22
Soyungordoqt,sanguino,1000,shaman,restoration,20,12,8
Polystrath,silvermoon,1000,shaman,restoration,76,37,39
Xpone,blackrock,1000,shaman,restoration,54,26,28
Jaéto,ravencrest,1000,shaman,restoration,54,26,28
Cmzyy,ravencrest,998,shaman,restoration,30,11,19
Isenth,ravencrest,998,shaman,restoration,71,25,46
Valdraxx,ravencrest,997,shaman,restoration,207,104,103
Grøzel,illidan,997,shaman,restoration,23,11,12
Xenda,blackrock,997,shaman,restoration,36,16,20
Totemkin,stormscale,997,shaman,restoration,84,21,63
Manush,aszune,996,shaman,restoration,42,17,25
Skunazo,sanguino,995,shaman,restoration,18,14,4
Рёнтар,howling-fjord,994,shaman,restoration,56,25,31
Hacyria,archimonde,993,shaman,restoration,60,35,25
Kanuw,kilrogg,993,shaman,restoration,75,41,34
Altesh,die-todeskrallen,992,shaman,restoration,22,11,11
Kledorchick,twisting-nether,992,shaman,restoration,69,15,54
Trixsham,ragnaros,990,shaman,restoration,29,13,16
Saarroo,ravencrest,990,shaman,restoration,143,62,81
Vitraanc,kazzak,990,shaman,restoration,30,13,17
Gharn,sanguino,990,shaman,restoration,28,11,17
Buffsham,kazzak,990,shaman,restoration,34,12,22
Neverqueue,defias-brotherhood,989,shaman,restoration,28,11,17
Grîzzou,les-clairvoyants,988,shaman,restoration,54,29,25
Qusek,turalyon,988,shaman,restoration,344,175,169
Sáàd,ravencrest,987,shaman,restoration,22,11,11
Aurelindae,silvermoon,986,shaman,restoration,52,22,30
Paola,kazzak,983,shaman,restoration,30,12,18
Begeshaman,sylvanas,981,shaman,restoration,508,239,269
Сорнинай,soulflayer,981,shaman,restoration,107,48,59
Дартарион,gordunni,980,shaman,restoration,86,39,47
Shamaray,stormscale,980,shaman,restoration,26,11,15
Здрахарь,howling-fjord,980,shaman,restoration,40,15,25
Teada,aegwynn,980,shaman,restoration,34,12,22
Noriqt,kazzak,975,shaman,restoration,19,11,8
Ambrosioss,kazzak,975,shaman,restoration,30,17,13
Varion,tichondrius,974,shaman,restoration,51,25,26
Athèna,blutkessel,973,shaman,restoration,25,11,14
Shadî,kiljaeden,972,shaman,restoration,33,14,19
Quòr,antonidas,971,shaman,restoration,89,46,43
Schamannen,outland,970,shaman,restoration,43,23,20
Robgon,aggra-português,970,shaman,restoration,88,45,43
Shàwyn,sylvanas,968,shaman,restoration,29,11,18
Sakoon,twisting-nether,966,shaman,restoration,30,12,18
Gnomekiller,alonsus,961,shaman,restoration,42,12,30
Çårlëspûýøl,dun-modr,960,shaman,restoration,12,10,2
Çare,drakthul,960,shaman,restoration,18,10,8
Öyama,sinstralis,960,shaman,restoration,18,10,8
Gotta,dethecus,960,shaman,restoration,18,10,8
Pank,kazzak,960,shaman,restoration,18,10,8
Shamounf,archimonde,960,shaman,restoration,18,10,8
Irônmaxx,antonidas,960,shaman,restoration,24,10,14
Blyxuhm,argent-dawn,959,shaman,restoration,12,10,2
Aylookitsgam,magtheridon,959,shaman,restoration,12,10,2
Hyperieon,antonidas,959,shaman,restoration,12,10,2
Sunjay,frostwolf,959,shaman,restoration,12,10,2
Kaátori,eredar,959,shaman,restoration,12,10,2
Ðtxkeks,onyxia,959,shaman,restoration,13,10,3
Bauch,tichondrius,959,shaman,restoration,18,10,8
Lurkmon,twisting-nether,959,shaman,restoration,18,10,8
Ånny,blackmoore,959,shaman,restoration,18,10,8
Frise,archimonde,959,shaman,restoration,24,12,12
Cellae,guldan,959,shaman,restoration,210,101,109
Daseus,malygos,959,shaman,restoration,75,36,39
Balúr,thrall,959,shaman,restoration,24,10,14
Халльбьерн,howling-fjord,959,shaman,restoration,24,10,14
Loay,blackrock,959,shaman,restoration,24,10,14
Orcgasm,draenor,959,shaman,restoration,30,10,20
Tsugu,kazzak,959,shaman,restoration,30,10,20
Jilyu,blackmoore,958,shaman,restoration,18,10,8
Páracetamol,blackmoore,958,shaman,restoration,18,10,8
Shamanistick,grim-batol,958,shaman,restoration,18,10,8
Weandras,draenor,958,shaman,restoration,24,10,14
Maïtregïms,archimonde,958,shaman,restoration,26,10,16
Arîya,blackrock,958,shaman,restoration,33,11,22
Tinyboiler,stormscale,958,shaman,restoration,30,10,20
Alikir,outland,958,shaman,restoration,30,10,20
Nerdshammyx,tarren-mill,957,shaman,restoration,12,10,2
Dewasham,blackmoore,957,shaman,restoration,24,10,14
Stardawg,runetotem,957,shaman,restoration,25,10,15
Xentic,kazzak,956,shaman,restoration,24,10,14
Eleir,draenor,956,shaman,restoration,24,10,14
Rotuluss,stormrage,956,shaman,restoration,24,10,14
Bajslys,kazzak,956,shaman,restoration,24,10,14
Drakahaar,burning-blade,956,shaman,restoration,30,10,20
Ультрамаринь,soulflayer,955,shaman,restoration,18,10,8
Totemtri,thrall,955,shaman,restoration,18,10,8
Cølo,ravencrest,955,shaman,restoration,42,10,32
Zulwin,hyjal,954,shaman,restoration,18,10,8
Skeltar,gilneas,954,shaman,restoration,233,103,130
Shagrax,anubarak,954,shaman,restoration,24,10,14
Aquatusk,twisting-nether,953,shaman,restoration,24,10,14
Zídané,antonidas,953,shaman,restoration,24,10,14
Myscarface,draenor,953,shaman,restoration,24,10,14
Slytho,blackmoore,953,shaman,restoration,30,10,20
Shockster,sunstrider,952,shaman,restoration,24,11,13
Ascìughino,nemesis,952,shaman,restoration,24,10,14
Xadishaman,blackrock,951,shaman,restoration,18,10,8
Rixxa,stormscale,951,shaman,restoration,30,11,19
Shámpain,antonidas,950,shaman,restoration,18,10,8
Mcdz,blackrock,950,shaman,restoration,128,62,66
Deevill,grim-batol,949,shaman,restoration,30,10,20
Mycameltotem,ravencrest,948,shaman,restoration,32,14,18
Deeblu,nemesis,948,shaman,restoration,54,19,35
Schachlik,amanthul,947,shaman,restoration,37,21,16
Exereon,ravencrest,947,shaman,restoration,18,10,8
Fashess,sunstrider,946,shaman,restoration,30,14,16
Similar,the-maelstrom,946,shaman,restoration,30,12,18
Màverìck,nemesis,945,shaman,restoration,30,10,20
Autarky,silvermoon,944,shaman,restoration,30,10,20
Ганона,howling-fjord,943,shaman,restoration,105,42,63
Hemsihammer,ysondre,940,shaman,restoration,65,28,37
Эрэвия,gordunni,939,shaman,restoration,24,13,11
Chokeonme,blackrock,939,shaman,restoration,108,58,50
Boombaalasch,blackmoore,937,shaman,restoration,88,41,47
Тутулиб,howling-fjord,937,shaman,restoration,42,10,32
Skylá,blackrock,936,shaman,restoration,70,30,40
Dupeng,blackrock,936,shaman,restoration,24,10,14
Дрфэка,soulflayer,934,shaman,restoration,57,18,39
Mìshä,archimonde,932,shaman,restoration,18,10,8
Earthliving,zuljin,931,shaman,restoration,30,10,20
Bullvai,dun-morogh,929,shaman,restoration,74,34,40
Sélená,antonidas,928,shaman,restoration,39,23,16
Elemental,silvermoon,927,shaman,restoration,40,13,27
Briindead,archimonde,925,shaman,restoration,18,10,8
Schamhaarion,malfurion,924,shaman,restoration,16,11,5
Broner,ravencrest,922,shaman,restoration,124,63,61
Marranota,cthun,921,shaman,restoration,27,12,15
Asashi,blackhand,917,shaman,restoration,23,12,11
Poglavica,dragonmaw,917,shaman,restoration,35,10,25
Dasce,sylvanas,916,shaman,restoration,42,16,26
Thym,argent-dawn,913,shaman,restoration,180,76,104
Ntø,ravencrest,912,shaman,restoration,15,11,4
Imbalainen,draenor,910,shaman,restoration,21,11,10
Jabena,draenor,910,shaman,restoration,106,48,58
Brondila,shadowsong,909,shaman,restoration,21,10,11
Wagaluu,ravencrest,908,shaman,restoration,23,10,13
Yeháw,kazzak,906,shaman,restoration,16,12,4
Shyyfu,kazzak,906,shaman,restoration,63,28,35
Rooske,draenor,904,shaman,restoration,17,10,7
Kircos,blackrock,904,shaman,restoration,27,11,16
Suculenta,zuljin,902,shaman,restoration,47,22,25
Ninfómano,sanguino,901,shaman,restoration,36,10,26
Georgianaa,skullcrusher,900,shaman,restoration,84,40,44
Büffler,thrall,900,shaman,restoration,55,21,34
Nexolok,alleria,899,shaman,restoration,60,32,28
Алимика,deathguard,899,shaman,restoration,30,15,15
Goldva,outland,897,shaman,restoration,127,66,61
Thunderberg,antonidas,896,shaman,restoration,30,12,18
Notlinus,argent-dawn,895,shaman,restoration,14,10,4
Derbedigger,blackmoore,895,shaman,restoration,21,11,10
Мке,howling-fjord,894,shaman,restoration,35,14,21
Thorkaizen,runetotem,893,shaman,restoration,23,10,13
Hyoshin,kirin-tor,889,shaman,restoration,256,119,137
Smotis,blackrock,889,shaman,restoration,32,13,19
Shammster,drakthul,888,shaman,restoration,28,10,18
Rageasha,silvermoon,887,shaman,restoration,48,25,23
Ominouslove,twisting-nether,887,shaman,restoration,113,52,61
Veinia,stormreaver,880,shaman,restoration,60,22,38
Vukroth,argent-dawn,879,shaman,restoration,72,34,38
Hañìaránì,draenor,877,shaman,restoration,15,11,4
Zeidek,nemesis,873,shaman,restoration,84,43,41
Yàra,throkferoth,871,shaman,restoration,118,57,61
Shiliwhip,the-maelstrom,864,shaman,restoration,12,9,3
Enviø,sylvanas,864,shaman,restoration,12,9,3
Raintlordx,twisting-nether,864,shaman,restoration,18,9,9
Shounx,hyjal,864,shaman,restoration,18,9,9
Феанорситх,gordunni,864,shaman,restoration,18,9,9
Coldain,zuljin,864,shaman,restoration,18,9,9
Defonceboby,archimonde,864,shaman,restoration,18,9,9
Tebzs,ravencrest,864,shaman,restoration,18,9,9
Metamorflord,ravencrest,864,shaman,restoration,18,9,9
Penatus,outland,864,shaman,restoration,18,9,9
Lêêmo,outland,864,shaman,restoration,18,9,9
Khâlyne,archimonde,864,shaman,restoration,18,9,9
Dmns,antonidas,864,shaman,restoration,18,9,9
Shamecaja,blackmoore,864,shaman,restoration,21,10,11
Happyjuice,silvermoon,864,shaman,restoration,24,9,15
Drakamaa,ravencrest,864,shaman,restoration,24,9,15
Isaiahjonesx,stormscale,863,shaman,restoration,12,9,3
Gorrissen,sylvanas,863,shaman,restoration,12,9,3
Fupx,the-maelstrom,863,shaman,restoration,18,9,9
Schludri,kult-der-verdammten,863,shaman,restoration,18,9,9
Yrikame,dun-modr,863,shaman,restoration,18,9,9
Ceìra,blackrock,863,shaman,restoration,18,9,9
Bobaléh,ravencrest,863,shaman,restoration,18,9,9
Zyphiz,twisting-nether,863,shaman,restoration,24,9,15
Thanasiss,kazzak,863,shaman,restoration,24,9,15
Loktarogar,sunstrider,863,shaman,restoration,24,9,15
Ruffin,stormscale,863,shaman,restoration,24,9,15
Mauî,twisting-nether,863,shaman,restoration,30,9,21
Naphe,ysondre,863,shaman,restoration,30,9,21
Spammail,argent-dawn,862,shaman,restoration,12,9,3
Mtndewman,tarren-mill,862,shaman,restoration,12,9,3
Aredin,ysera,862,shaman,restoration,12,9,3
Бронепароход,soulflayer,862,shaman,restoration,12,9,3
Totemlover,draenor,862,shaman,restoration,18,9,9
Электро,thermaplugg,862,shaman,restoration,18,9,9
Алтезка,blackscar,862,shaman,restoration,18,9,9
Zapyboye,grim-batol,862,shaman,restoration,18,9,9
Slasket,bloodscalp,862,shaman,restoration,24,9,15
Yánux,aegwynn,861,shaman,restoration,12,9,3
Эндипёсель,ashenvale,861,shaman,restoration,12,9,3
Shamanopaf,tarren-mill,861,shaman,restoration,18,9,9
Pàn,alleria,861,shaman,restoration,18,9,9
Matsudah,ragnaros,861,shaman,restoration,18,9,9
Тераккот,blackscar,861,shaman,restoration,18,9,9
Boljin,conseil-des-ombres,861,shaman,restoration,24,9,15
Zippidizap,ulduar,861,shaman,restoration,24,9,15
Amu,ravencrest,860,shaman,restoration,18,9,9
Sonii,outland,860,shaman,restoration,21,10,11
Pomaranc,kazzak,860,shaman,restoration,24,9,15
Kosur,kazzak,859,shaman,restoration,18,9,9
Cristhor,nemesis,859,shaman,restoration,18,9,9
Zuvx,ravencrest,859,shaman,restoration,24,9,15
Sunsham,illidan,858,shaman,restoration,18,9,9
Fapwap,sylvanas,857,shaman,restoration,18,9,9
Fatyoe,eredar,857,shaman,restoration,18,9,9
Bandyy,magtheridon,857,shaman,restoration,24,9,15
Nashashuk,runetotem,856,shaman,restoration,30,9,21
Foringal,thunderhorn,855,shaman,restoration,18,9,9
Gleggy,turalyon,854,shaman,restoration,12,9,3
Moltenblade,drakthul,854,shaman,restoration,12,9,3
Tidors,burning-legion,854,shaman,restoration,18,9,9
Killhorn,malganis,853,shaman,restoration,48,20,28
Kinxold,blackrock,852,shaman,restoration,18,9,9
Naindefer,uldaman,852,shaman,restoration,24,9,15
Turbokrapka,tarren-mill,851,shaman,restoration,18,9,9
Picklechris,tarren-mill,851,shaman,restoration,24,10,14
Notwhoheals,executus,851,shaman,restoration,24,9,15
Psyforce,argent-dawn,850,shaman,restoration,12,9,3
Bubidilasso,twisting-nether,850,shaman,restoration,30,9,21
Aguitas,sanguino,849,shaman,restoration,22,10,12
Elemsegara,arakarahm,849,shaman,restoration,36,9,27
Deviantsham,tarren-mill,848,shaman,restoration,109,38,71
Koothe,dun-modr,847,shaman,restoration,18,10,8
Турелька,blackscar,846,shaman,restoration,31,11,20
Таск,eversong,846,shaman,restoration,31,10,21
Barabáx,blackrock,845,shaman,restoration,86,31,55
Quigon,burning-legion,844,shaman,restoration,72,34,38
Snublefar,stormscale,843,shaman,restoration,14,11,3
Darkstrong,alakir,842,shaman,restoration,18,9,9
Duodin,defias-brotherhood,839,shaman,restoration,18,9,9
Psychobarbie,outland,835,shaman,restoration,28,12,16
Awsum,nozdormu,835,shaman,restoration,127,51,76
Майайс,gordunni,831,shaman,restoration,17,9,8
Zaelyz,archimonde,831,shaman,restoration,20,10,10
Jeqs,twisting-nether,830,shaman,restoration,14,10,4
Southpaw,kult-der-verdammten,830,shaman,restoration,36,11,25
Stormzug,twisting-nether,826,shaman,restoration,20,10,10
Xâôs,blackmoore,826,shaman,restoration,24,10,14
Madrävëngodx,ragnaros,826,shaman,restoration,29,9,20
Kebandar,stormscale,825,shaman,restoration,48,20,28
Pfannakuacha,alleria,824,shaman,restoration,14,10,4
Thce,burning-legion,824,shaman,restoration,48,22,26
Foxfyre,tarren-mill,823,shaman,restoration,29,12,17
Hittheswitch,archimonde,822,shaman,restoration,44,10,34
Killeras,deathwing,819,shaman,restoration,66,29,37
Glóbal,sylvanas,815,shaman,restoration,15,10,5
Aspên,archimonde,815,shaman,restoration,17,9,8
Bathala,dun-modr,815,shaman,restoration,24,10,14
Télapou,ragnaros,813,shaman,restoration,17,9,8
Шаманчонушка,thermaplugg,810,shaman,restoration,62,24,38
Crixuss,argent-dawn,809,shaman,restoration,17,9,8
Джагрум,greymane,809,shaman,restoration,39,9,30
Nonstrum,ragnaros,808,shaman,restoration,23,10,13
Neejtjak,ravencrest,808,shaman,restoration,25,10,15
Greenguard,argent-dawn,806,shaman,restoration,122,44,78
Nøxylol,veklor,805,shaman,restoration,28,10,18
Avajana,silvermoon,798,shaman,restoration,30,9,21
Läskilehmä,darksorrow,797,shaman,restoration,22,9,13
Prem,turalyon,795,shaman,restoration,119,40,79
Alekaris,burning-blade,794,shaman,restoration,36,9,27
Smugleaf,frostmane,793,shaman,restoration,30,9,21
Pesantë,silvermoon,791,shaman,restoration,23,10,13
Waskoelement,archimonde,786,shaman,restoration,58,31,27
Abøriginal,kazzak,783,shaman,restoration,11,9,2
Zhead,aggramar,775,shaman,restoration,22,11,11
Isìs,norgannon,775,shaman,restoration,198,78,120
Ongedierte,tarren-mill,774,shaman,restoration,18,10,8
Hugzy,argent-dawn,773,shaman,restoration,35,9,26
Ranenmuija,outland,768,shaman,restoration,12,8,4
Драмкул,soulflayer,768,shaman,restoration,12,8,4
Alorrii,tarren-mill,768,shaman,restoration,12,8,4
Roglam,blackmoore,768,shaman,restoration,12,8,4
Vibesham,outland,768,shaman,restoration,12,8,4
Stàrzz,eredar,768,shaman,restoration,12,8,4
Vërÿßåðxd,silvermoon,768,shaman,restoration,12,8,4
Vulthog,draenor,768,shaman,restoration,12,8,4
Ivnashaman,drakthul,768,shaman,restoration,12,8,4
Yacuzwerg,blackrock,768,shaman,restoration,12,8,4
Toteemikylpy,argent-dawn,768,shaman,restoration,12,8,4
Onrègleçanow,ravencrest,768,shaman,restoration,12,8,4
Экспл,ashenvale,768,shaman,restoration,18,8,10
Pip,outland,768,shaman,restoration,18,8,10
Djsheargødx,twisting-nether,768,shaman,restoration,18,8,10
Linkxz,sylvanas,768,shaman,restoration,18,8,10
Shamzou,eldrethalas,768,shaman,restoration,18,8,10
Tobbey,tarren-mill,768,shaman,restoration,18,8,10
Mèåtbåll,ravencrest,768,shaman,restoration,18,8,10
Dosenöffner,gorgonnash,768,shaman,restoration,21,9,12
Wierdo,ragnaros,768,shaman,restoration,29,11,18
Diffrinity,tarren-mill,768,shaman,restoration,24,8,16
Сядьнатотем,gordunni,768,shaman,restoration,24,8,16
Epawl,kazzak,768,shaman,restoration,27,8,19
Pooga,archimonde,768,shaman,restoration,30,8,22
Pissflinger,tarren-mill,767,shaman,restoration,12,8,4
Brimley,emerald-dream,767,shaman,restoration,12,8,4
Hooki,archimonde,767,shaman,restoration,12,8,4
Karezza,azjolnerub,767,shaman,restoration,12,8,4
Vanikz,ravencrest,767,shaman,restoration,12,8,4
Berasham,dalaran,767,shaman,restoration,12,8,4
Айскримтрак,gordunni,767,shaman,restoration,12,8,4
Svarozyc,azuremyst,767,shaman,restoration,18,8,10
Zappyhog,turalyon,767,shaman,restoration,18,8,10
Quinlàn,ravencrest,767,shaman,restoration,18,8,10
Inyra,eredar,767,shaman,restoration,18,8,10
Piz,ravencrest,767,shaman,restoration,22,9,13
Roycee,ragnaros,767,shaman,restoration,24,8,16
Blauperle,eredar,767,shaman,restoration,30,8,22
Robbie,dentarg,766,shaman,restoration,12,8,4
Mynutz,outland,766,shaman,restoration,12,8,4
Finetime,blackmoore,766,shaman,restoration,12,8,4
Jasishammy,kazzak,766,shaman,restoration,12,8,4
Джоукх,howling-fjord,766,shaman,restoration,12,8,4
Подосиновик,fordragon,766,shaman,restoration,12,8,4
Dälon,thrall,766,shaman,restoration,24,8,16
Bruho,mazrigos,766,shaman,restoration,24,8,16
Mvrik,argent-dawn,765,shaman,restoration,18,8,10
Indennacken,blackmoore,765,shaman,restoration,24,8,16
Shalisazzar,dentarg,765,shaman,restoration,30,8,22
Tarkxi,sylvanas,764,shaman,restoration,18,8,10
Chamasombre,hyjal,764,shaman,restoration,18,8,10
Shamantaa,draenor,764,shaman,restoration,18,8,10
Hurik,sylvanas,764,shaman,restoration,24,8,16
Raphaeey,blackrock,764,shaman,restoration,31,8,23
Eveeöe,outland,763,shaman,restoration,18,8,10
Eponà,gilneas,763,shaman,restoration,24,8,16
Jogabonita,kaelthas,761,shaman,restoration,18,8,10
Eaglhex,silvermoon,760,shaman,restoration,24,8,16
Kiwhonia,archimonde,757,shaman,restoration,18,8,10
Teoaka,haomarush,756,shaman,restoration,42,14,28
Bolski,stormreaver,755,shaman,restoration,24,8,16
Доргорн,grom,754,shaman,restoration,17,9,8
Záppie,nagrand,753,shaman,restoration,31,17,14
Thrallallero,pozzo-delleternità,753,shaman,restoration,18,8,10
Æxæxæxæxæxæ,kazzak,751,shaman,restoration,24,8,16
Øzy,sanguino,749,shaman,restoration,14,8,6
Amarök,nerzhul,749,shaman,restoration,18,8,10
Whaowhao,nemesis,749,shaman,restoration,22,9,13
Prettyhooves,alleria,749,shaman,restoration,59,21,38
Maab,arathor,749,shaman,restoration,23,8,15
Espigas,uldum,746,shaman,restoration,23,8,15
Дарьюша,fordragon,744,shaman,restoration,12,8,4
Penumbrah,kazzak,742,shaman,restoration,242,88,154
Nakeddwarf,silvermoon,738,shaman,restoration,24,8,16
Jocãsta,silvermoon,735,shaman,restoration,20,9,11
Ayesapik,dalaran,729,shaman,restoration,118,58,60
Jakesmistake,stormscale,727,shaman,restoration,17,11,6
Trusthor,kult-der-verdammten,727,shaman,restoration,42,16,26
Агмень,howling-fjord,717,shaman,restoration,39,8,31
Gerlo,thrall,716,shaman,restoration,37,15,22
Stolen,skullcrusher,712,shaman,restoration,15,9,6
Lauree,terokkar,710,shaman,restoration,23,9,14
Lillitthya,elune,707,shaman,restoration,92,37,55
Kamichami,sanguino,707,shaman,restoration,27,9,18
Rayitoss,tyrande,707,shaman,restoration,31,9,22
Jodel,tarren-mill,704,shaman,restoration,16,8,8
Thangog,ragnaros,703,shaman,restoration,16,8,8
Карбонатрикс,soulflayer,703,shaman,restoration,16,8,8
Тотемвуман,soulflayer,703,shaman,restoration,22,8,14
Katzubushi,pozzo-delleternità,701,shaman,restoration,62,17,45
Bobmcpleb,kazzak,700,shaman,restoration,20,8,12
Cumulichan,ragnaros,687,shaman,restoration,11,8,3
Damacz,deathwing,684,shaman,restoration,37,9,28
Shufflenpc,twisting-nether,672,shaman,restoration,12,7,5
Drahka,kazzak,672,shaman,restoration,12,7,5
Qicholardon,archimonde,672,shaman,restoration,12,7,5
Blackbeardxd,stormscale,672,shaman,restoration,12,7,5
Spiirit,tarren-mill,672,shaman,restoration,12,7,5
Nansmasher,draenor,672,shaman,restoration,12,7,5
Тимтярра,gordunni,672,shaman,restoration,12,7,5
Prepegahex,blackmoore,672,shaman,restoration,12,7,5
Popopopopor,archimonde,672,shaman,restoration,12,7,5
Vaîjîn,aegwynn,672,shaman,restoration,12,7,5
Winshear,twisting-nether,672,shaman,restoration,12,7,5
Mxi,blackmoore,672,shaman,restoration,12,7,5
Tjocknacke,tarren-mill,672,shaman,restoration,12,7,5
Natblidaa,silvermoon,672,shaman,restoration,12,7,5
Hagridheals,silvermoon,672,shaman,restoration,12,7,5
Skitshamanx,draenor,672,shaman,restoration,12,7,5
Sümsük,twisting-nether,672,shaman,restoration,12,7,5
Marjorie,archimonde,672,shaman,restoration,12,7,5
Tracademics,stormscale,672,shaman,restoration,12,7,5
Iamshamon,kazzak,672,shaman,restoration,12,7,5
Minimove,shattered-hand,672,shaman,restoration,12,7,5
Shonbelly,argent-dawn,672,shaman,restoration,12,7,5
Goldou,archimonde,672,shaman,restoration,12,7,5
Ashish,outland,672,shaman,restoration,12,7,5
Nezug,ysondre,672,shaman,restoration,12,7,5
Chatbanned,blackmoore,672,shaman,restoration,18,7,11
Nosno,ravencrest,672,shaman,restoration,18,7,11
Ráekwon,frostmourne,672,shaman,restoration,18,7,11
Sháme,azjolnerub,672,shaman,restoration,18,7,11
Канамаш,borean-tundra,672,shaman,restoration,18,7,11
Vann,the-shatar,672,shaman,restoration,18,7,11
Agrok,jaedenar,672,shaman,restoration,18,7,11
Horkxina,frostmourne,672,shaman,restoration,18,7,11
Glasha,ragnaros,672,shaman,restoration,18,7,11
Zulylol,outland,672,shaman,restoration,18,7,11
Крэйвхх,howling-fjord,672,shaman,restoration,18,7,11
Йодаримару,howling-fjord,672,shaman,restoration,18,7,11
Horcsog,ravencrest,672,shaman,restoration,18,7,11
Rompich,culte-de-la-rive-noire,672,shaman,restoration,18,7,11
Raiden,aegwynn,672,shaman,restoration,18,7,11
Kimsshaman,ragnaros,672,shaman,restoration,18,7,11
Reinssay,ysondre,672,shaman,restoration,18,7,11
Mílénâqt,aegwynn,672,shaman,restoration,18,7,11
Totemchief,stormscale,672,shaman,restoration,24,7,17
Theodorix,silvermoon,672,shaman,restoration,24,7,17
Cragouz,archimonde,672,shaman,restoration,24,7,17
Moschamane,blackrock,672,shaman,restoration,24,7,17
Insînîus,archimonde,672,shaman,restoration,30,7,23
Starpior,stormscale,672,shaman,restoration,30,7,23
Djrastasham,stormscale,672,shaman,restoration,42,7,35
Restocow,thrall,671,shaman,restoration,12,7,5
Bgw,doomhammer,671,shaman,restoration,12,7,5
Sshrredderr,the-maelstrom,671,shaman,restoration,12,7,5
Lorifah,draenor,671,shaman,restoration,12,7,5
Grosgourdin,la-croisade-écarlate,671,shaman,restoration,12,7,5
Sozetwo,tarren-mill,671,shaman,restoration,12,7,5
Powercolor,aegwynn,671,shaman,restoration,12,7,5
Frozenshield,ravencrest,671,shaman,restoration,12,7,5
Gimzx,magtheridon,671,shaman,restoration,12,7,5
Bbc,dalaran,671,shaman,restoration,12,7,5
Healhooper,hyjal,671,shaman,restoration,12,7,5
Акаи,gordunni,671,shaman,restoration,12,7,5
Brocksamson,dentarg,671,shaman,restoration,14,7,7
Shâdôwlîght,antonidas,671,shaman,restoration,18,7,11
Schneenase,kragjin,671,shaman,restoration,18,7,11
Rasajin,blackmoore,671,shaman,restoration,18,7,11
Дикрус,gordunni,671,shaman,restoration,18,7,11
Элементаликс,ashenvale,671,shaman,restoration,18,7,11
Jedsham,stormscale,671,shaman,restoration,18,7,11
Deadshammyx,ravencrest,671,shaman,restoration,18,7,11
Nïshä,twisting-nether,671,shaman,restoration,18,7,11
Rampenissen,azjolnerub,671,shaman,restoration,18,7,11
Skullføck,argent-dawn,671,shaman,restoration,21,8,13
Unleashme,sylvanas,671,shaman,restoration,24,7,17
Dreadness,runetotem,671,shaman,restoration,24,7,17
Mòónz,kazzak,671,shaman,restoration,24,7,17
Eaglesteaam,silvermoon,671,shaman,restoration,26,7,19
Gorod,confrérie-du-thorium,670,shaman,restoration,12,7,5
Инкарнатор,deathguard,670,shaman,restoration,12,7,5
Jollyhip,stormscale,670,shaman,restoration,12,7,5
Totemeistér,silvermoon,670,shaman,restoration,12,7,5
Plùx,antonidas,670,shaman,restoration,12,7,5
Sinrsizakbil,silvermoon,670,shaman,restoration,12,7,5
Bjorhuk,ravencrest,670,shaman,restoration,12,7,5
Shamsrag,draenor,670,shaman,restoration,12,7,5
Стамма,borean-tundra,670,shaman,restoration,12,7,5
Thyeori,stormscale,670,shaman,restoration,18,7,11
Lokkum,blackhand,670,shaman,restoration,18,7,11
Irachal,rexxar,670,shaman,restoration,18,7,11
Archsha,burning-legion,670,shaman,restoration,18,7,11
Schamike,tichondrius,670,shaman,restoration,18,7,11
Nonie,arthas,670,shaman,restoration,18,7,11
Vey,hyjal,670,shaman,restoration,18,7,11
Lxâ,hyjal,670,shaman,restoration,24,7,17
Aluweckerl,eredar,670,shaman,restoration,24,7,17
Elementalwiz,ravencrest,670,shaman,restoration,24,7,17
Nevertilt,argent-dawn,669,shaman,restoration,12,7,5
Thormarg,archimonde,669,shaman,restoration,18,7,11
Бьерн,deepholm,669,shaman,restoration,24,7,17
Simph,uldum,669,shaman,restoration,24,7,17
Nynuken,silvermoon,669,shaman,restoration,30,7,23
Dantheshaman,draenor,669,shaman,restoration,30,7,23
Boyboi,magtheridon,668,shaman,restoration,12,7,5
Raikage,elune,668,shaman,restoration,18,7,11
Gelaende,thrall,668,shaman,restoration,18,7,11
Sorontar,twisting-nether,668,shaman,restoration,18,7,11
Bloggurt,tarren-mill,668,shaman,restoration,18,7,11
Weho,kazzak,668,shaman,restoration,18,7,11
Iebaznis,draenor,667,shaman,restoration,12,7,5
Qoshi,archimonde,667,shaman,restoration,18,7,11
Millacki,blackrock,667,shaman,restoration,18,7,11
Mørwayn,ysondre,667,shaman,restoration,24,7,17
Zelgore,frostwhisper,666,shaman,restoration,18,7,11
Frosthamer,ragnaros,665,shaman,restoration,12,7,5
Darthshox,outland,665,shaman,restoration,22,8,14
Ftsckpower,blackhand,665,shaman,restoration,24,7,17
Windvortex,nemesis,664,shaman,restoration,12,7,5
Emansh,twisting-nether,664,shaman,restoration,24,7,17
Barean,ravencrest,664,shaman,restoration,24,7,17
Raketenrieke,blackrock,659,shaman,restoration,25,12,13
Bogmagnus,the-maelstrom,659,shaman,restoration,39,13,26
Hulkogank,marécage-de-zangar,653,shaman,restoration,18,7,11
Lausimhaus,blackrock,649,shaman,restoration,22,10,12
Xgoodlifelu,ragnaros,639,shaman,restoration,23,7,16
Arcura,twisting-nether,638,shaman,restoration,17,7,10
Nojiko,blackrock,638,shaman,restoration,17,7,10
Mortret,jaedenar,638,shaman,restoration,28,7,21
Hanumanas,kazzak,636,shaman,restoration,20,8,12
Drakhrar,pozzo-delleternità,633,shaman,restoration,14,8,6
Habibe,the-maelstrom,623,shaman,restoration,15,8,7
Chîllkrötè,blackmoore,618,shaman,restoration,12,8,4
Енотикусь,soulflayer,618,shaman,restoration,12,8,4
Disharmony,outland,618,shaman,restoration,12,8,4
Cgjúng,ravencrest,618,shaman,restoration,16,8,8
Randomuwu,stormscale,616,shaman,restoration,22,8,14
Elesmelly,draenor,608,shaman,restoration,19,8,11
Zugars,aszune,606,shaman,restoration,11,7,4
Couldar,stormscale,606,shaman,restoration,19,7,12
Shamowiz,draenor,605,shaman,restoration,17,7,10
Bullthunder,alakir,601,shaman,restoration,20,7,13
Trillebelly,outland,591,shaman,restoration,11,7,4
Nacenty,eredar,587,shaman,restoration,13,7,6
Deepai,drakthul,576,shaman,restoration,6,6,0
Imdarat,hyjal,576,shaman,restoration,6,6,0
Djalx,kazzak,576,shaman,restoration,6,6,0
Lerra,zirkel-des-cenarius,576,shaman,restoration,6,6,0
Øxxgødx,blackrock,576,shaman,restoration,6,6,0
Lazarevich,thrall,576,shaman,restoration,6,6,0
Oldveteran,eredar,576,shaman,restoration,6,6,0
Хоупосх,gordunni,576,shaman,restoration,12,6,6
Chudygôdx,drakthul,576,shaman,restoration,12,6,6
Артэкриошам,soulflayer,576,shaman,restoration,12,6,6
Groquick,dalaran,576,shaman,restoration,12,6,6
Karthak,malganis,576,shaman,restoration,12,6,6
Ысч,ashenvale,576,shaman,restoration,12,6,6
Lmnn,ravencrest,576,shaman,restoration,12,6,6
Wckdz,chants-éternels,576,shaman,restoration,12,6,6
Mästerruv,the-maelstrom,576,shaman,restoration,12,6,6
Fugsham,ravencrest,576,shaman,restoration,12,6,6
Lortihalsen,outland,576,shaman,restoration,12,6,6
Rhêz,kazzak,576,shaman,restoration,12,6,6
Embodiment,blackrock,576,shaman,restoration,12,6,6
Ambuu,kazzak,576,shaman,restoration,12,6,6
Hablibubli,kazzak,576,shaman,restoration,12,6,6
Khidon,silvermoon,576,shaman,restoration,12,6,6
Kilninshape,archimonde,576,shaman,restoration,12,6,6
Saymynamee,ragnaros,576,shaman,restoration,12,6,6
Холинкаалло,deathguard,576,shaman,restoration,12,6,6
Goodevening,tarren-mill,576,shaman,restoration,12,6,6
Enoughh,the-maelstrom,576,shaman,restoration,12,6,6
Thatstheswag,blackmoore,576,shaman,restoration,12,6,6
Занзазз,ashenvale,576,shaman,restoration,12,6,6
Povecategla,grim-batol,576,shaman,restoration,12,6,6
Чиллаут,howling-fjord,576,shaman,restoration,12,6,6
Grathril,aegwynn,576,shaman,restoration,12,6,6
Cardeâ,blackhand,576,shaman,restoration,12,6,6
Runbrorun,hyjal,576,shaman,restoration,12,6,6
Nuashoar,argent-dawn,576,shaman,restoration,12,6,6
Lågertha,sanguino,576,shaman,restoration,12,6,6
Kameltotem,balnazzar,576,shaman,restoration,12,6,6
Cutzeh,archimonde,576,shaman,restoration,12,6,6
Hamgroof,blackrock,576,shaman,restoration,12,6,6
Tusseladden,tarren-mill,576,shaman,restoration,12,6,6
Bigdaddyxo,tarren-mill,576,shaman,restoration,12,6,6
Gamixy,magtheridon,576,shaman,restoration,12,6,6
Kaluna,outland,576,shaman,restoration,12,6,6
Oroastbeef,archimonde,576,shaman,restoration,12,6,6
Gamixyx,magtheridon,576,shaman,restoration,12,6,6
Juicyy,ravencrest,576,shaman,restoration,12,6,6
Chamanox,dalaran,576,shaman,restoration,12,6,6
Sunnyisup,sylvanas,576,shaman,restoration,12,6,6
Lifestorm,hyjal,576,shaman,restoration,18,6,12
Joeashock,ragnaros,576,shaman,restoration,18,6,12
Ulchabhán,draenor,576,shaman,restoration,18,6,12
Salaithen,alakir,576,shaman,restoration,18,6,12
Embèr,silvermoon,576,shaman,restoration,18,6,12
Skelli,blackrock,576,shaman,restoration,18,6,12
Dramakur,blackmoore,576,shaman,restoration,18,6,12
Птеросшам,howling-fjord,576,shaman,restoration,18,6,12
Nmac,stormscale,576,shaman,restoration,18,6,12
Tropvieux,dalaran,576,shaman,restoration,18,6,12
Flùffy,nemesis,576,shaman,restoration,18,6,12
Shoar,twisting-nether,576,shaman,restoration,18,6,12
Mëowth,ragnaros,576,shaman,restoration,18,6,12
Yolzan,kazzak,576,shaman,restoration,18,6,12
Hogmodig,tarren-mill,576,shaman,restoration,18,6,12
Soyun,frostwhisper,576,shaman,restoration,18,6,12
Maybeyes,twisting-nether,576,shaman,restoration,18,6,12
Kioterasham,conseil-des-ombres,576,shaman,restoration,18,6,12
Rihi,twisting-nether,576,shaman,restoration,18,6,12
Patsham,wildhammer,576,shaman,restoration,18,6,12
Podoroschnik,blackmoore,576,shaman,restoration,18,6,12
Reallygdnewb,silvermoon,576,shaman,restoration,18,6,12
Hofmann,dentarg,575,shaman,restoration,12,6,6
Sjearthen,defias-brotherhood,575,shaman,restoration,12,6,6
Chaudronnier,ysondre,575,shaman,restoration,12,6,6
Безрукан,howling-fjord,575,shaman,restoration,12,6,6
Mortly,draenor,575,shaman,restoration,12,6,6
Bufi,sanguino,575,shaman,restoration,12,6,6
Shazefin,twisting-nether,575,shaman,restoration,12,6,6
Vascodagama,twisting-nether,575,shaman,restoration,12,6,6
Grytha,argent-dawn,575,shaman,restoration,12,6,6
Sikro,frostwolf,575,shaman,restoration,12,6,6
Hyamala,chamber-of-aspects,575,shaman,restoration,12,6,6
Qona,emerald-dream,575,shaman,restoration,12,6,6
Ghoraddu,drakthul,575,shaman,restoration,12,6,6
Хардринк,gordunni,575,shaman,restoration,12,6,6
Karlsensham,stormscale,575,shaman,restoration,12,6,6
Flurpz,outland,575,shaman,restoration,12,6,6
Nannook,twisting-nether,575,shaman,restoration,12,6,6
Aesonis,kazzak,575,shaman,restoration,14,6,8
Kandrox,blackmoore,575,shaman,restoration,18,6,12
Bruzzla,kiljaeden,575,shaman,restoration,18,6,12
Liferqt,nemesis,575,shaman,restoration,18,6,12
Hexyladý,ravencrest,575,shaman,restoration,18,6,12
Archiviert,blackmoore,575,shaman,restoration,24,6,18
Bichcore,nemesis,575,shaman,restoration,24,6,18
Wtbtoes,ravencrest,575,shaman,restoration,24,6,18
Bepinfame,pozzo-delleternità,575,shaman,restoration,30,6,24
Nizty,tarren-mill,575,shaman,restoration,36,6,30
Tidushears,thrall,574,shaman,restoration,12,6,6
Serrix,burning-legion,574,shaman,restoration,18,6,12
Bacca,stormscale,574,shaman,restoration,18,6,12
Musii,argent-dawn,574,shaman,restoration,18,6,12
Андеритс,gordunni,574,shaman,restoration,24,6,18
Vilfin,ysondre,573,shaman,restoration,12,6,6
Muschi,culte-de-la-rive-noire,573,shaman,restoration,16,7,9
Amnistia,ragnaros,573,shaman,restoration,18,6,12
Omnivamp,kazzak,573,shaman,restoration,18,6,12
Róbbàn,agamaggan,573,shaman,restoration,18,6,12
Shammzy,mannoroth,573,shaman,restoration,24,6,18
Nisity,draenor,572,shaman,restoration,12,6,6
Drizzird,argent-dawn,572,shaman,restoration,18,6,12
Seor,kazzak,572,shaman,restoration,18,6,12
Veita,sylvanas,571,shaman,restoration,12,6,6
Louvreparis,frostwolf,570,shaman,restoration,12,6,6
Geishablue,defias-brotherhood,570,shaman,restoration,18,6,12
Alïsyo,nemesis,570,shaman,restoration,18,6,12
Enco,kilrogg,568,shaman,restoration,12,6,6
Bunnîe,kazzak,565,shaman,restoration,18,6,12
Triplezug,archimonde,558,shaman,restoration,11,6,5
Fessel,auchindoun,558,shaman,restoration,18,6,12
Durek,sylvanas,551,shaman,restoration,19,8,11
Грейсаша,howling-fjord,545,shaman,restoration,26,9,17
Professorzap,silvermoon,544,shaman,restoration,10,7,3
Xørd,ysondre,543,shaman,restoration,23,6,17
Divazena,drakthul,542,shaman,restoration,11,6,5
Cotêaz,thrall,541,shaman,restoration,16,6,10
Gq,auchindoun,541,shaman,restoration,17,6,11
Ghafo,norgannon,540,shaman,restoration,11,6,5
Zourhia,garona,528,shaman,restoration,9,6,3
Whibbler,ravencrest,528,shaman,restoration,21,7,14
Myndro,varimathras,527,shaman,restoration,11,6,5
Nockedly,ragnaros,527,shaman,restoration,21,7,14
Surund,die-nachtwache,526,shaman,restoration,15,6,9
Splis,ravencrest,522,shaman,restoration,16,7,9
Corlysvelary,doomhammer,521,shaman,restoration,26,8,18
Asstroy,sanguino,520,shaman,restoration,16,7,9
Luckybeast,ravencrest,515,shaman,restoration,20,7,13
Purgeer,blackmoore,511,shaman,restoration,11,6,5
Ozzlac,thrall,511,shaman,restoration,17,6,11
Nasym,ragnaros,511,shaman,restoration,22,6,16
Ub,garona,480,shaman,restoration,6,5,1
Nøfap,kazzak,480,shaman,restoration,6,5,1
Myloxxtwo,outland,480,shaman,restoration,6,5,1
Joeexotictv,tarren-mill,480,shaman,restoration,6,5,1
Лартисс,howling-fjord,480,shaman,restoration,6,5,1
Vønhørk,dalaran,480,shaman,restoration,6,5,1
Souldicer,twilights-hammer,480,shaman,restoration,6,5,1
Kookaboo,blackrock,480,shaman,restoration,6,5,1
Êvø,draenor,480,shaman,restoration,6,5,1
Kæyci,blackmoore,480,shaman,restoration,6,5,1
Shamsteaks,thrall,480,shaman,restoration,6,5,1
Dastarus,archimonde,480,shaman,restoration,6,5,1
Qwauzinator,silvermoon,480,shaman,restoration,6,5,1
Keiro,burning-blade,480,shaman,restoration,6,5,1
Pierredollar,outland,480,shaman,restoration,6,5,1
Fenixshaman,die-aldor,480,shaman,restoration,9,6,3
Shamania,grim-batol,480,shaman,restoration,12,5,7
Qishwilu,ravencrest,480,shaman,restoration,12,5,7
Stibs,silvermoon,480,shaman,restoration,12,5,7
Eggshock,ravencrest,480,shaman,restoration,12,5,7
Zougzy,uldaman,480,shaman,restoration,12,5,7
Sojee,ysondre,480,shaman,restoration,12,5,7
Саулос,howling-fjord,480,shaman,restoration,12,5,7
Nariad,ravencrest,480,shaman,restoration,12,5,7
Shakghul,laughing-skull,480,shaman,restoration,12,5,7
Lontarsdaddy,twisting-nether,480,shaman,restoration,12,5,7
Jakeir,auchindoun,480,shaman,restoration,12,5,7
Shamarco,nemesis,480,shaman,restoration,12,5,7
Burrowabuser,nemesis,480,shaman,restoration,12,5,7
Boltar,die-aldor,480,shaman,restoration,12,5,7
Biçi,steamwheedle-cartel,480,shaman,restoration,12,5,7
Bloopp,stormscale,480,shaman,restoration,12,5,7
Kempfer,blackrock,480,shaman,restoration,12,5,7
Kuisix,sanguino,480,shaman,restoration,12,5,7
Tooltip,tarren-mill,480,shaman,restoration,12,5,7
Vyrá,onyxia,480,shaman,restoration,12,5,7
Tzhads,stormscale,480,shaman,restoration,12,5,7
Windie,drakthul,480,shaman,restoration,12,5,7
Daboo,the-venture-co,480,shaman,restoration,12,5,7
Ñx,ravencrest,480,shaman,restoration,12,5,7
Ravenshock,bloodfeather,480,shaman,restoration,12,5,7
Riptidegodx,archimonde,480,shaman,restoration,12,5,7
Markboymint,earthen-ring,480,shaman,restoration,12,5,7
Aslansütü,eredar,480,shaman,restoration,12,5,7
Nevagonalink,archimonde,480,shaman,restoration,12,5,7
Søljar,draenor,480,shaman,restoration,12,5,7
Meeredia,aegwynn,480,shaman,restoration,12,5,7
Totemiclol,aegwynn,480,shaman,restoration,12,5,7
Medistød,draenor,480,shaman,restoration,12,5,7
Rahku,hyjal,480,shaman,restoration,12,5,7
Egor,alakir,480,shaman,restoration,12,5,7
Mbx,ravencrest,480,shaman,restoration,12,5,7
Cynmaticsx,kargath,480,shaman,restoration,12,5,7
Roastbeef,blackrock,480,shaman,restoration,12,5,7
Nerowinger,stormscale,480,shaman,restoration,12,5,7
Uanl,stormscale,480,shaman,restoration,12,5,7
Sliiderr,draenor,480,shaman,restoration,12,5,7
Ræi,drakthul,480,shaman,restoration,12,5,7
Tigo,tarren-mill,480,shaman,restoration,12,5,7
Häbitz,blackrock,480,shaman,restoration,12,5,7
Libano,archimonde,480,shaman,restoration,12,5,7
Thiazar,hyjal,480,shaman,restoration,12,5,7
Trolldy,outland,480,shaman,restoration,12,5,7
Jeffreyson,burning-legion,480,shaman,restoration,12,5,7
Demeri,blackrock,480,shaman,restoration,12,5,7
Zæus,ragnaros,480,shaman,restoration,12,5,7
Babybele,archimonde,480,shaman,restoration,12,5,7
Athankatouch,draenor,480,shaman,restoration,12,5,7
Swark,stormscale,480,shaman,restoration,12,5,7
Ørøçhý,outland,480,shaman,restoration,12,5,7
Kïtten,tarren-mill,480,shaman,restoration,12,5,7
Ulumulu,frostwolf,480,shaman,restoration,14,5,9
Peremptor,alleria,480,shaman,restoration,18,5,13
Ghanex,tarren-mill,480,shaman,restoration,18,5,13
Swart,hyjal,480,shaman,restoration,18,5,13
Faìnt,stormscale,480,shaman,restoration,18,5,13
Aùrn,sylvanas,480,shaman,restoration,18,5,13
Kjumbe,silvermoon,480,shaman,restoration,18,5,13
Krayton,tarren-mill,480,shaman,restoration,18,5,13
Ignifius,nerathor,480,shaman,restoration,18,5,13
Elepumper,outland,480,shaman,restoration,18,5,13
Korfenal,draenor,480,shaman,restoration,18,5,13
ßiggie,garona,480,shaman,restoration,18,5,13
Кенниарт,howling-fjord,480,shaman,restoration,18,5,13
Селфлессх,soulflayer,480,shaman,restoration,18,5,13
Gurtøg,ysondre,480,shaman,restoration,20,5,15
Mickshagger,aegwynn,480,shaman,restoration,21,5,16
Nêgan,ravencrest,480,shaman,restoration,22,5,17
Savan,darkspear,480,shaman,restoration,24,5,19
Peaksh,stormscale,480,shaman,restoration,24,5,19
Gwûn,outland,479,shaman,restoration,10,6,4
Bloodfist,drakthul,479,shaman,restoration,12,5,7
Babyboomz,bronze-dragonflight,479,shaman,restoration,12,5,7
Happyfart,thrall,479,shaman,restoration,12,5,7
Hydrototem,archimonde,479,shaman,restoration,12,5,7
Joaléine,khaz-modan,479,shaman,restoration,12,5,7
Kyousek,drakthul,479,shaman,restoration,12,5,7
Caters,baelgun,479,shaman,restoration,12,5,7
Кауги,howling-fjord,479,shaman,restoration,12,5,7
Sakar,auchindoun,479,shaman,restoration,12,5,7
Schamibeton,antonidas,479,shaman,restoration,12,5,7
Rúnar,proudmoore,479,shaman,restoration,12,5,7
Donnerbubele,aegwynn,479,shaman,restoration,12,5,7
Scoobsz,thrall,479,shaman,restoration,15,5,10
Gepetto,tarren-mill,479,shaman,restoration,18,5,13
Gorgath,dunemaul,479,shaman,restoration,18,5,13
Íss,cthun,479,shaman,restoration,18,5,13
Menhir,ysondre,479,shaman,restoration,20,5,15
Zogthor,hyjal,479,shaman,restoration,24,5,19
Дбр,howling-fjord,479,shaman,restoration,26,5,21
Deimyan,tarren-mill,478,shaman,restoration,12,5,7
Rebekca,twisting-nether,478,shaman,restoration,18,5,13
Erscreamiko,zuljin,477,shaman,restoration,24,5,19
Зултира,gordunni,477,shaman,restoration,30,5,25
Халн,greymane,476,shaman,restoration,12,5,7
Porch,doomhammer,476,shaman,restoration,12,5,7
Wanryoku,kaelthas,472,shaman,restoration,12,5,7
Clickzy,draenor,463,shaman,restoration,18,6,12
Kajirin,shattrath,463,shaman,restoration,17,5,12
Shamanarama,sylvanas,463,shaman,restoration,23,5,18
Tøøpåc,hyjal,462,shaman,restoration,13,6,7
Rngo,blackrock,447,shaman,restoration,11,5,6
Heothix,outland,447,shaman,restoration,11,5,6
Shinäla,twisting-nether,447,shaman,restoration,11,5,6
Marcöø,argent-dawn,447,shaman,restoration,16,6,10
Iast,frostwolf,447,shaman,restoration,14,5,9
Xclusivqt,archimonde,447,shaman,restoration,17,5,12
Diapasøn,kaelthas,446,shaman,restoration,17,5,12
Zysham,silvermoon,445,shaman,restoration,11,5,6
Kortgat,kilrogg,431,shaman,restoration,17,5,12
Òff,tarren-mill,426,shaman,restoration,8,6,2
Shamakerr,tarren-mill,426,shaman,restoration,17,7,10
Äppelpaj,earthen-ring,426,shaman,restoration,15,6,9
Блэкмаршал,howling-fjord,423,shaman,restoration,20,6,14
Etabeta,shattered-hand,415,shaman,restoration,8,5,3
Ulrichh,twisting-nether,415,shaman,restoration,8,5,3
Rosox,blackmoore,415,shaman,restoration,14,5,9
Ravd,outland,384,shaman,restoration,6,4,2
Mole,jaedenar,384,shaman,restoration,6,4,2
Konrád,thunderhorn,384,shaman,restoration,6,4,2
Salsissimous,azjolnerub,384,shaman,restoration,6,4,2
Líya,silvermoon,384,shaman,restoration,6,4,2
Purgelord,tarren-mill,384,shaman,restoration,6,4,2
Tiocà,pozzo-delleternità,384,shaman,restoration,6,4,2
Imdax,hyjal,384,shaman,restoration,6,4,2
Громкеш,howling-fjord,384,shaman,restoration,6,4,2
Пакни,gordunni,384,shaman,restoration,6,4,2
Prup,tarren-mill,384,shaman,restoration,6,4,2
Berzærker,ravencrest,384,shaman,restoration,6,4,2
Stormjvj,twisting-nether,384,shaman,restoration,6,4,2
Grimdonut,argent-dawn,384,shaman,restoration,6,4,2
Hamuksha,nerathor,384,shaman,restoration,6,4,2
Showtime,eredar,384,shaman,restoration,6,4,2
Xinsû,kazzak,384,shaman,restoration,6,4,2
Vscx,blackmoore,384,shaman,restoration,6,4,2
Tairuny,nazjatar,384,shaman,restoration,6,4,2
Boiblaster,argent-dawn,384,shaman,restoration,6,4,2
Carlpeant,blackrock,384,shaman,restoration,6,4,2
Gapingass,frostmane,384,shaman,restoration,6,4,2
Bluetide,ravencrest,384,shaman,restoration,6,4,2
Амг,booty-bay,384,shaman,restoration,6,4,2
Leyliner,blackhand,384,shaman,restoration,6,4,2
Nry,blackmoore,384,shaman,restoration,6,4,2
Peano,frostwolf,384,shaman,restoration,6,4,2
Dooky,frostwolf,384,shaman,restoration,6,4,2
Tommybanger,kazzak,384,shaman,restoration,6,4,2
Pagnishm,tarren-mill,384,shaman,restoration,6,4,2
Thrasymachos,silvermoon,384,shaman,restoration,6,4,2
Ouestu,kazzak,384,shaman,restoration,6,4,2
Chadhealer,thrall,384,shaman,restoration,6,4,2
Говард,soulflayer,384,shaman,restoration,6,4,2
Laserra,sylvanas,384,shaman,restoration,6,4,2
Фредуизли,howling-fjord,384,shaman,restoration,6,4,2
Thriveqt,nemesis,384,shaman,restoration,6,4,2
Johnnysîns,blackhand,384,shaman,restoration,6,4,2
Waterboy,tarren-mill,384,shaman,restoration,6,4,2
Chiio,draenor,384,shaman,restoration,6,4,2
Bandulski,twisting-nether,384,shaman,restoration,6,4,2
Toasterbread,kazzak,384,shaman,restoration,6,4,2
Kundt,dalaran,384,shaman,restoration,6,4,2
Yozgatlilan,aegwynn,384,shaman,restoration,6,4,2
Minisham,drakthul,384,shaman,restoration,6,4,2
Dräpàrn,sylvanas,384,shaman,restoration,6,4,2
Beefblaster,guldan,384,shaman,restoration,6,4,2
Рояльстарик,howling-fjord,384,shaman,restoration,9,5,4
Snowflakexsx,draenor,384,shaman,restoration,8,4,4
Pandatrials,turalyon,384,shaman,restoration,22,8,14
Criticalx,eredar,384,shaman,restoration,15,5,10
Kelonar,aegwynn,384,shaman,restoration,12,4,8
Stoitchkov,archimonde,384,shaman,restoration,12,4,8
Mystraas,khaz-modan,384,shaman,restoration,12,4,8
Bubullesham,kirin-tor,384,shaman,restoration,12,4,8
Smahamtwo,stormscale,384,shaman,restoration,12,4,8
Mammyshammy,twisting-nether,384,shaman,restoration,12,4,8
Aeriis,twisting-nether,384,shaman,restoration,12,4,8
Staxoman,daggerspine,384,shaman,restoration,12,4,8
Tteïl,archimonde,384,shaman,restoration,12,4,8
Kerfo,ragnaros,384,shaman,restoration,12,4,8
Runeshock,turalyon,384,shaman,restoration,12,4,8
Sempaihentai,draenor,384,shaman,restoration,12,4,8
Tahrox,blackmoore,384,shaman,restoration,12,4,8
Amrik,blackmoore,384,shaman,restoration,12,4,8
Shockingfish,grim-batol,384,shaman,restoration,12,4,8
Moosavi,kazzak,384,shaman,restoration,12,4,8
Terkx,blackmoore,384,shaman,restoration,12,4,8
Proccazu,draenor,384,shaman,restoration,12,4,8
Agatons,twisting-nether,384,shaman,restoration,12,4,8
Kuyamii,blackrock,384,shaman,restoration,12,4,8
Degoblin,draenor,384,shaman,restoration,12,4,8
Девлиниум,fordragon,384,shaman,restoration,12,4,8
Enkou,blackmoore,384,shaman,restoration,12,4,8
Magermáyn,magtheridon,384,shaman,restoration,12,4,8
Энхай,azuregos,384,shaman,restoration,12,4,8
Меготип,deathweaver,384,shaman,restoration,12,4,8
Shds,blackmoore,384,shaman,restoration,12,4,8
Ishin,burning-legion,384,shaman,restoration,12,4,8
Lavababe,blackmoore,384,shaman,restoration,12,4,8
Жарюшашлыки,blackscar,384,shaman,restoration,12,4,8
Maluch,burning-legion,384,shaman,restoration,12,4,8
Lêss,ysondre,384,shaman,restoration,12,4,8
Saksyl,zuljin,384,shaman,restoration,12,4,8
Abdegor,burning-legion,384,shaman,restoration,12,4,8
Totemcil,silvermoon,384,shaman,restoration,12,4,8
Serasol,sylvanas,384,shaman,restoration,12,4,8
Shamdren,outland,384,shaman,restoration,12,4,8
Lanze,blackrock,384,shaman,restoration,12,4,8
Stormreach,ragnaros,384,shaman,restoration,18,4,14
Natsukiko,anubarak,384,shaman,restoration,18,4,14
Belroc,ravencrest,384,shaman,restoration,18,4,14
Taurusham,stormscale,384,shaman,restoration,18,4,14
Xalinio,ravencrest,384,shaman,restoration,18,4,14
Ohheck,outland,384,shaman,restoration,18,4,14
Dartagnón,blackhand,384,shaman,restoration,24,4,20
Shamaní,sporeggar,383,shaman,restoration,6,4,2
Aléxan,blackmoore,383,shaman,restoration,6,4,2
Ljube,kazzak,383,shaman,restoration,6,4,2
Marnius,ravencrest,383,shaman,restoration,6,4,2
Wioda,silvermoon,383,shaman,restoration,6,4,2
Herdaar,argent-dawn,383,shaman,restoration,12,4,8
Zokah,emeriss,383,shaman,restoration,12,4,8
Arixxë,twisting-nether,383,shaman,restoration,12,4,8
Sleyvarian,chamber-of-aspects,383,shaman,restoration,12,4,8
Bumbummann,blackmoore,383,shaman,restoration,12,4,8
Cisd,tarren-mill,383,shaman,restoration,12,4,8
Илюшамашина,gordunni,383,shaman,restoration,18,4,14
Doomkiss,silvermoon,383,shaman,restoration,18,4,14
Кара,gordunni,383,shaman,restoration,18,4,14
Ulfuz,silvermoon,383,shaman,restoration,24,4,20
Raiñdrops,silvermoon,382,shaman,restoration,6,4,2
Avatarroku,blackhand,382,shaman,restoration,12,4,8
Koko,frostwhisper,382,shaman,restoration,12,4,8
Slippyjim,azshara,382,shaman,restoration,12,4,8
Tiamât,culte-de-la-rive-noire,382,shaman,restoration,18,4,14
Zeiger,minahonda,381,shaman,restoration,24,4,20
Shamtime,aegwynn,371,shaman,restoration,24,7,17
Mikesinatra,tarren-mill,367,shaman,restoration,11,4,7
Pinguman,stormscale,351,shaman,restoration,8,5,3
Zboubii,archimonde,351,shaman,restoration,17,4,13
Triskantza,dun-modr,351,shaman,restoration,17,4,13
Natureabuser,kazzak,336,shaman,restoration,11,5,6
Voltyum,zuljin,336,shaman,restoration,9,4,5
Grübxxgg,frostmane,335,shaman,restoration,17,4,13
Antikahraman,blackrock,330,shaman,restoration,8,5,3
Schamimen,malganis,330,shaman,restoration,20,5,15
Fleurnoîr,confrérie-du-thorium,321,shaman,restoration,23,8,15
Schamitwo,twisting-nether,319,shaman,restoration,5,4,1
Murog,dalaran,319,shaman,restoration,8,4,4
ßreoxxi,blackmoore,319,shaman,restoration,15,4,11
Soulsh,die-ewige-wacht,288,shaman,restoration,6,3,3
Vilrath,tarren-mill,288,shaman,restoration,6,3,3
Бриз,blackscar,288,shaman,restoration,6,3,3
Eré,archimonde,288,shaman,restoration,6,3,3
Kyndra,chamber-of-aspects,288,shaman,restoration,6,3,3
Cocojojo,hyjal,288,shaman,restoration,6,3,3
Bharudor,antonidas,288,shaman,restoration,6,3,3
Jäckö,archimonde,288,shaman,restoration,6,3,3
Гарантииный,lich-king,288,shaman,restoration,6,3,3
Horizons,the-maelstrom,288,shaman,restoration,6,3,3
Shimshám,ravencrest,288,shaman,restoration,6,3,3
Bingo,tarren-mill,288,shaman,restoration,6,3,3
Votie,tarren-mill,288,shaman,restoration,6,3,3
Ticutashaman,argent-dawn,288,shaman,restoration,6,3,3
Аалрия,goldrinn,288,shaman,restoration,6,3,3
Cøkka,hyjal,288,shaman,restoration,6,3,3
Istedgrill,tarren-mill,288,shaman,restoration,6,3,3
Ragnesch,aegwynn,288,shaman,restoration,6,3,3
Windrate,burning-blade,288,shaman,restoration,6,3,3
Shamamamin,argent-dawn,288,shaman,restoration,6,3,3
Origins,archimonde,288,shaman,restoration,6,3,3
Blboz,grim-batol,288,shaman,restoration,6,3,3
Solotov,bronzebeard,288,shaman,restoration,6,3,3
Ханикс,blackscar,288,shaman,restoration,6,3,3
Anûbîs,gorgonnash,288,shaman,restoration,6,3,3
Kalinn,sylvanas,288,shaman,restoration,6,3,3
Bronin,sylvanas,288,shaman,restoration,6,3,3
Totemboyuk,tarren-mill,288,shaman,restoration,6,3,3
Ранкодин,soulflayer,288,shaman,restoration,6,3,3
Chainbeef,blackmoore,288,shaman,restoration,6,3,3
Intèrfectá,aegwynn,288,shaman,restoration,6,3,3
Bûttâ,archimonde,288,shaman,restoration,6,3,3
Видсон,soulflayer,288,shaman,restoration,6,3,3
Шамкасамка,gordunni,288,shaman,restoration,6,3,3
Моралсидней,blackscar,288,shaman,restoration,6,3,3
Lightningrod,ravencrest,288,shaman,restoration,6,3,3
Вэллкомм,gordunni,288,shaman,restoration,6,3,3
Nshamanx,sylvanas,288,shaman,restoration,6,3,3
Kubelwagen,ravencrest,288,shaman,restoration,6,3,3
Crazywitcho,archimonde,288,shaman,restoration,6,3,3
Tenror,ragnaros,288,shaman,restoration,6,3,3
Xzãnti,tarren-mill,288,shaman,restoration,6,3,3
Watchmyshøkz,aegwynn,288,shaman,restoration,6,3,3
Frostpunk,tarren-mill,288,shaman,restoration,6,3,3
Majinbeb,hyjal,288,shaman,restoration,6,3,3
Pokeher,stormscale,288,shaman,restoration,6,3,3
Tezeret,silvermoon,288,shaman,restoration,6,3,3
Fromhaven,doomhammer,288,shaman,restoration,6,3,3
Beefvindaloo,kazzak,288,shaman,restoration,6,3,3
Омегануб,howling-fjord,288,shaman,restoration,6,3,3
Azùk,kazzak,288,shaman,restoration,6,3,3
Whyisitspicy,kazzak,288,shaman,restoration,6,3,3
Néférú,thrall,288,shaman,restoration,6,3,3
Eradasgf,kazzak,288,shaman,restoration,6,3,3
Rkeev,blackrock,288,shaman,restoration,6,3,3
Xiphoideus,draenor,288,shaman,restoration,6,3,3
Shockndawe,kazzak,288,shaman,restoration,6,3,3
Downiesham,kazzak,288,shaman,restoration,6,3,3
Klösbräda,stormscale,288,shaman,restoration,6,3,3
Tarzh,dalaran,288,shaman,restoration,6,3,3
Snakeeyéss,kazzak,288,shaman,restoration,6,3,3
Rna,ragnaros,288,shaman,restoration,6,3,3
Trampala,draenor,288,shaman,restoration,6,3,3
Eslu,blackhand,288,shaman,restoration,6,3,3
Ýípìÿøû,dun-modr,288,shaman,restoration,6,3,3
Елемчикх,gordunni,288,shaman,restoration,6,3,3
Odiin,sanguino,288,shaman,restoration,6,3,3
Shohmon,silvermoon,288,shaman,restoration,6,3,3
Enzain,outland,288,shaman,restoration,6,3,3
Stinkyfînger,draenor,288,shaman,restoration,6,3,3
Gemexi,kazzak,288,shaman,restoration,6,3,3
Thaemond,draenor,288,shaman,restoration,6,3,3
Ironblacka,dun-modr,288,shaman,restoration,6,3,3
Haract,outland,288,shaman,restoration,6,3,3
Surge,darksorrow,288,shaman,restoration,6,3,3
Yarvin,draenor,288,shaman,restoration,6,3,3
Calamito,ragnaros,288,shaman,restoration,6,3,3
Nohealtilt,stormscale,288,shaman,restoration,6,3,3
Baconbaus,stormscale,288,shaman,restoration,6,3,3
Oldmanrena,stormscale,288,shaman,restoration,6,3,3
Dévus,stormscale,288,shaman,restoration,6,3,3
Abalenn,kazzak,288,shaman,restoration,6,3,3
Shamanshow,eredar,288,shaman,restoration,6,3,3
Medari,onyxia,288,shaman,restoration,6,3,3
Misstremmers,outland,288,shaman,restoration,6,3,3
Kimunamatata,draenor,288,shaman,restoration,6,3,3
Richtigfies,kazzak,288,shaman,restoration,6,3,3
Høwl,twisting-nether,288,shaman,restoration,7,3,4
Lilmac,defias-brotherhood,288,shaman,restoration,10,4,6
Nemuderune,grim-batol,288,shaman,restoration,8,3,5
Noxl,gorgonnash,288,shaman,restoration,12,3,9
Ríleyx,twisting-nether,288,shaman,restoration,12,3,9
Wurrzág,outland,288,shaman,restoration,12,3,9
Zamn,silvermoon,288,shaman,restoration,12,3,9
Schamanskaya,antonidas,288,shaman,restoration,12,3,9
Flameshock,area-52,288,shaman,restoration,12,3,9
Wåe,outland,288,shaman,restoration,12,3,9
Scharmany,blackhand,288,shaman,restoration,12,3,9
Hagelbrakan,stormscale,288,shaman,restoration,12,3,9
Ðiezz,ysondre,288,shaman,restoration,12,3,9
Carthis,silvermoon,288,shaman,restoration,12,3,9
Belsazar,frostwolf,288,shaman,restoration,12,3,9
Billburr,aegwynn,288,shaman,restoration,12,3,9
Muckerg,kazzak,288,shaman,restoration,12,3,9
Zronk,blackhand,288,shaman,restoration,12,3,9
Myks,sylvanas,288,shaman,restoration,12,3,9
Mahoni,malganis,288,shaman,restoration,12,3,9
Kuzsham,archimonde,288,shaman,restoration,12,3,9
Huibäm,eredar,288,shaman,restoration,12,3,9
Kraznan,silvermoon,288,shaman,restoration,12,3,9
Shammyenh,burning-legion,288,shaman,restoration,12,3,9
Thrallotido,sanguino,288,shaman,restoration,12,3,9
Thorsteinar,kazzak,288,shaman,restoration,12,3,9
Shamgott,silvermoon,288,shaman,restoration,12,3,9
Cpthex,draenor,288,shaman,restoration,12,3,9
Foxhug,kazzak,288,shaman,restoration,12,3,9
Афтршок,soulflayer,288,shaman,restoration,12,3,9
Rennji,argent-dawn,288,shaman,restoration,12,3,9
Abordoga,twisting-nether,288,shaman,restoration,12,3,9
Geifmeat,kazzak,288,shaman,restoration,12,3,9
Keb,gorgonnash,288,shaman,restoration,12,3,9
Nixxy,magtheridon,288,shaman,restoration,12,3,9
Thísisrestø,sanguino,288,shaman,restoration,12,3,9
Idropwftotem,twilights-hammer,288,shaman,restoration,12,3,9
Magicflames,draenor,288,shaman,restoration,12,3,9
Legended,tarren-mill,288,shaman,restoration,12,3,9
Kiliathsham,silvermoon,288,shaman,restoration,12,3,9
Yukmôuth,stormscale,288,shaman,restoration,13,3,10
Oggyoggyoggy,outland,288,shaman,restoration,18,3,15
Cirøsham,ravencrest,288,shaman,restoration,18,3,15
Dontdothat,tarren-mill,288,shaman,restoration,18,3,15
Mitochondria,drakthul,288,shaman,restoration,18,3,15
Dumbasha,ravencrest,288,shaman,restoration,18,3,15
Haono,khaz-modan,288,shaman,restoration,18,3,15
Shankka,ragnaros,288,shaman,restoration,18,3,15
Shaminista,ravencrest,288,shaman,restoration,24,3,21
Tidecrash,kazzak,287,shaman,restoration,6,3,3
Seam,aggra-português,287,shaman,restoration,6,3,3
Кронакай,blackscar,287,shaman,restoration,12,3,9
Rbghêâl,blackrock,287,shaman,restoration,18,3,15
Leftand,arathor,287,shaman,restoration,18,3,15
Präsi,die-aldor,287,shaman,restoration,18,3,15
Kaithor,blackrock,286,shaman,restoration,12,3,9
Mimsy,hyjal,285,shaman,restoration,12,3,9
Янешаманка,goldrinn,285,shaman,restoration,12,3,9
Dxtreame,outland,276,shaman,restoration,19,6,13
Shâm,kazzak,271,shaman,restoration,11,3,8
Valuriya,blackhand,269,shaman,restoration,11,3,8
Calmlizard,ragnaros,256,shaman,restoration,10,3,7
Localicious,ragnaros,255,shaman,restoration,11,3,8
Crazypurgeqt,arathor,255,shaman,restoration,17,3,14
Yang,der-rat-von-dalaran,240,shaman,restoration,9,4,5
Hâromm,twisting-nether,239,shaman,restoration,5,3,2
Flávy,senjin,239,shaman,restoration,5,3,2
Silden,thrall,234,shaman,restoration,10,5,5
Æxs,archimonde,234,shaman,restoration,8,4,4
Yukîmøn,hyjal,234,shaman,restoration,11,4,7
Guccishadezz,blackmoore,234,shaman,restoration,17,5,12
Ikó,kazzak,234,shaman,restoration,22,6,16
Drøgøs,dun-modr,234,shaman,restoration,18,4,14
Fettbrot,garrosh,232,shaman,restoration,27,4,23
Verynicê,blackhand,206,shaman,restoration,13,3,10
Фарраон,deathguard,192,shaman,restoration,10,4,6
Reverse,xavius,192,shaman,restoration,6,2,4
Chaac,bloodscalp,192,shaman,restoration,6,2,4
Traice,sargeras,192,shaman,restoration,6,2,4
Greylink,blackhand,192,shaman,restoration,6,2,4
Бинграех,howling-fjord,192,shaman,restoration,6,2,4
Narevoqi,madmortem,192,shaman,restoration,6,2,4
Kevox,malganis,192,shaman,restoration,6,2,4
Kossborax,blackhand,192,shaman,restoration,6,2,4
Mordshamanx,draenor,192,shaman,restoration,6,2,4
Jsham,blackmoore,192,shaman,restoration,6,2,4
Shialebôf,sylvanas,192,shaman,restoration,6,2,4
Nachtary,blackmoore,192,shaman,restoration,6,2,4
Totemino,silvermoon,192,shaman,restoration,6,2,4
Отхо,deathguard,192,shaman,restoration,6,2,4
Basegrandpa,ravencrest,192,shaman,restoration,6,2,4
Xalh,ysondre,192,shaman,restoration,6,2,4
Джейджона,soulflayer,192,shaman,restoration,6,2,4
Biggucci,sylvanas,192,shaman,restoration,6,2,4
Voodude,blackrock,192,shaman,restoration,6,2,4
Messedmyself,outland,192,shaman,restoration,6,2,4
Doflamingo,aszune,192,shaman,restoration,6,2,4
Pumanii,silvermoon,192,shaman,restoration,6,2,4
Aewyla,silvermoon,192,shaman,restoration,6,2,4
Sablolix,ravencrest,192,shaman,restoration,6,2,4
Mecherä,sanguino,192,shaman,restoration,6,2,4
Shamfromohio,ravencrest,192,shaman,restoration,6,2,4
Arkalôl,hyjal,192,shaman,restoration,6,2,4
Skuid,twisting-nether,192,shaman,restoration,6,2,4
Akylä,varimathras,192,shaman,restoration,6,2,4
Sarmsgang,stormscale,192,shaman,restoration,6,2,4
Ikdra,medivh,192,shaman,restoration,6,2,4
Fuchserl,aegwynn,192,shaman,restoration,6,2,4
Rolftheswine,defias-brotherhood,192,shaman,restoration,6,2,4
Shupp,stormscale,192,shaman,restoration,6,2,4
Sëídhr,arathi,192,shaman,restoration,6,2,4
Пучмек,gordunni,192,shaman,restoration,6,2,4
Renátosz,ragnaros,192,shaman,restoration,6,2,4
Fakeyy,draenor,192,shaman,restoration,6,2,4
Nassîî,blackhand,192,shaman,restoration,6,2,4
Sàs,zuljin,192,shaman,restoration,6,2,4
Crãnk,sylvanas,192,shaman,restoration,6,2,4
Nainpulsïf,hyjal,192,shaman,restoration,6,2,4
Лавовыйдед,gordunni,192,shaman,restoration,6,2,4
Smorclelx,khadgar,192,shaman,restoration,6,2,4
Gevitomeraw,sylvanas,192,shaman,restoration,6,2,4
Olmaz,ravencrest,192,shaman,restoration,6,2,4
Kilosham,silvermoon,192,shaman,restoration,6,2,4
Spoko,hyjal,192,shaman,restoration,6,2,4
Wiev,blackmoore,192,shaman,restoration,6,2,4
Chêlëx,silvermoon,192,shaman,restoration,6,2,4
Spiritualx,argent-dawn,192,shaman,restoration,6,2,4
Bram,aggra-português,192,shaman,restoration,6,2,4
Shamanheirlo,ravencrest,192,shaman,restoration,6,2,4
Matsish,sylvanas,192,shaman,restoration,6,2,4
Cyklopx,ravencrest,192,shaman,restoration,6,2,4
Schmamane,blutkessel,192,shaman,restoration,6,2,4
Cetegusx,ravencrest,192,shaman,restoration,6,2,4
Hapkin,defias-brotherhood,192,shaman,restoration,6,2,4
Naneunsanai,jaedenar,192,shaman,restoration,6,2,4
Hìrnfrost,blackrock,192,shaman,restoration,6,2,4
Jacquisham,archimonde,192,shaman,restoration,6,2,4
Демианна,eversong,192,shaman,restoration,6,2,4
Spaltbart,blackmoore,192,shaman,restoration,6,2,4
Nopurge,thrall,192,shaman,restoration,6,2,4
Kikbokser,kazzak,192,shaman,restoration,6,2,4
Æxæxæxæxæxæx,kazzak,192,shaman,restoration,6,2,4
Barnameco,outland,192,shaman,restoration,6,2,4
Mikhey,archimonde,192,shaman,restoration,6,2,4
Nutqt,archimonde,192,shaman,restoration,6,2,4
Fjoêlnir,blackmoore,192,shaman,restoration,6,2,4
Bavalurst,doomhammer,192,shaman,restoration,6,2,4
Joshan,frostmourne,192,shaman,restoration,6,2,4
Elektrikci,silvermoon,192,shaman,restoration,6,2,4
Swineflay,kirin-tor,192,shaman,restoration,6,2,4
Shôcopan,los-errantes,192,shaman,restoration,6,2,4
Kärmá,lightbringer,192,shaman,restoration,6,2,4
Zinlay,tarren-mill,192,shaman,restoration,6,2,4
Nuarishaman,kazzak,192,shaman,restoration,6,2,4
Høtgødx,blackrock,192,shaman,restoration,6,2,4
Shalolx,twisting-nether,192,shaman,restoration,6,2,4
Kolbászlelkü,ragnaros,192,shaman,restoration,6,2,4
Wahya,stormscale,192,shaman,restoration,6,2,4
Урахарочка,soulflayer,192,shaman,restoration,6,2,4
Agorasiya,frostwolf,192,shaman,restoration,6,2,4
Pebble,blackrock,192,shaman,restoration,6,2,4
Berascendz,argent-dawn,192,shaman,restoration,6,2,4
Bluéshirtguy,blackhand,192,shaman,restoration,6,2,4
Anteja,kazzak,192,shaman,restoration,6,2,4
Sanxon,blackrock,192,shaman,restoration,6,2,4
Khayac,ravencrest,192,shaman,restoration,6,2,4
Kàji,tarren-mill,192,shaman,restoration,6,2,4
Pûrge,tarren-mill,192,shaman,restoration,6,2,4
Фикстар,soulflayer,192,shaman,restoration,6,2,4
Djerba,nordrassil,192,shaman,restoration,6,2,4
Colonoscoper,ravencrest,192,shaman,restoration,6,2,4
Lexus,nordrassil,192,shaman,restoration,6,2,4
Cultotem,kazzak,192,shaman,restoration,6,2,4
Ranian,frostwolf,192,shaman,restoration,9,2,7
Нерфнерф,howling-fjord,192,shaman,restoration,9,2,7
Aylíne,hyjal,192,shaman,restoration,20,4,16
Dvärgenkajsa,stormreaver,192,shaman,restoration,10,2,8
Seifero,burning-legion,192,shaman,restoration,10,2,8
Thunderjudge,twisting-nether,192,shaman,restoration,12,2,10
Zeltron,grim-batol,192,shaman,restoration,12,2,10
Cptnkirby,malganis,192,shaman,restoration,12,2,10
Ezpz,frostmourne,192,shaman,restoration,12,2,10
Caméltótem,kazzak,192,shaman,restoration,12,2,10
Imbahlink,draenor,192,shaman,restoration,12,2,10
Samisu,blackmoore,192,shaman,restoration,12,2,10
Pästïs,hyjal,192,shaman,restoration,12,2,10
Delvanjus,blackrock,192,shaman,restoration,12,2,10
Epicoverlord,tarren-mill,192,shaman,restoration,12,2,10
Haskor,ysondre,192,shaman,restoration,12,2,10
Gïzmö,tarren-mill,192,shaman,restoration,12,2,10
Shampad,la-croisade-écarlate,192,shaman,restoration,12,2,10
Zënga,kazzak,192,shaman,restoration,12,2,10
Hornynikita,silvermoon,192,shaman,restoration,12,2,10
Frizzysizzy,tarren-mill,192,shaman,restoration,12,2,10
Ekxr,kazzak,192,shaman,restoration,12,2,10
Fatflop,sylvanas,192,shaman,restoration,12,2,10
Dagdush,blackhand,192,shaman,restoration,12,2,10
Silliponni,emerald-dream,192,shaman,restoration,12,2,10
Zennex,tarren-mill,192,shaman,restoration,12,2,10
Elarae,blackrock,192,shaman,restoration,12,2,10
Walterwhite,blackrock,192,shaman,restoration,12,2,10
Satá,blackmoore,192,shaman,restoration,12,2,10
Nuekx,sanguino,192,shaman,restoration,12,2,10
Onii,alleria,192,shaman,restoration,12,2,10
Hájoon,tarren-mill,192,shaman,restoration,12,2,10
Fëhn,krasus,192,shaman,restoration,12,2,10
Yolototem,drakthul,192,shaman,restoration,15,2,13
Tûrbø,ravencrest,192,shaman,restoration,18,2,16
Wuchtzwerg,terrordar,192,shaman,restoration,18,2,16
Kobeye,thrall,191,shaman,restoration,6,2,4
Андумиэль,soulflayer,190,shaman,restoration,12,2,10
Krootox,sunstrider,170,shaman,restoration,18,4,14
Zhangliyi,ravencrest,169,shaman,restoration,9,5,4
Iddoz,outland,159,shaman,restoration,14,3,11
Wolfshade,aggra-português,144,shaman,restoration,9,2,7
Fleyas,kazzak,138,shaman,restoration,10,5,5
Siyina,draenor,138,shaman,restoration,9,4,5
Artsu,argent-dawn,138,shaman,restoration,11,4,7
Flamboyantly,sylvanas,138,shaman,restoration,9,3,6
Ruzgork,nerzhul,138,shaman,restoration,9,3,6
Volstorm,ysondre,138,shaman,restoration,12,3,9
Shamshady,kazzak,138,shaman,restoration,12,3,9
Sörén,lothar,138,shaman,restoration,13,3,10
Guqin,ravencrest,138,shaman,restoration,23,3,20
Cardenus,los-errantes,137,shaman,restoration,15,3,12
Feetsniffax,outland,128,shaman,restoration,4,2,2
Крто,thermaplugg,128,shaman,restoration,4,2,2
Belldandý,archimonde,128,shaman,restoration,4,2,2
Healníx,ravencrest,96,shaman,restoration,3,2,1
Jawoburst,antonidas,96,shaman,restoration,6,1,5
Casinoaddict,tarren-mill,96,shaman,restoration,6,1,5
Earthvixen,ravencrest,96,shaman,restoration,6,1,5
Ragnarökaren,stormscale,96,shaman,restoration,6,1,5
Maahrquz,tarren-mill,96,shaman,restoration,6,1,5
Despérado,archimonde,96,shaman,restoration,6,1,5
Троллюшка,soulflayer,96,shaman,restoration,6,1,5
Jukelis,kazzak,96,shaman,restoration,6,1,5
Fosterzz,ravencrest,96,shaman,restoration,6,1,5
Ilovédogs,tarren-mill,96,shaman,restoration,6,1,5
Kimpa,minahonda,96,shaman,restoration,6,1,5
Irondandy,archimonde,96,shaman,restoration,6,1,5
Cupído,malganis,96,shaman,restoration,6,1,5
Jaeslin,tarren-mill,96,shaman,restoration,6,1,5
Zekmvp,tarren-mill,96,shaman,restoration,6,1,5
Efdemin,blackmoore,96,shaman,restoration,6,1,5
Thundervick,stormscale,96,shaman,restoration,6,1,5
Neterö,la-croisade-écarlate,96,shaman,restoration,6,1,5
Lekyzx,archimonde,96,shaman,restoration,6,1,5
Nurychic,twisting-nether,96,shaman,restoration,6,1,5
Акер,deathguard,96,shaman,restoration,6,1,5
Trendilla,malganis,96,shaman,restoration,6,1,5
Driftal,laughing-skull,96,shaman,restoration,6,1,5
Greenbo,burning-blade,96,shaman,restoration,6,1,5
Neugasaman,ragnaros,96,shaman,restoration,6,1,5
Lothepus,balnazzar,96,shaman,restoration,6,1,5
Getahex,draenor,96,shaman,restoration,6,1,5
Stonetone,silvermoon,96,shaman,restoration,6,1,5
Elementss,stormscale,96,shaman,restoration,6,1,5
Absinthoxid,taerar,96,shaman,restoration,6,1,5
Grillfleîsch,azshara,96,shaman,restoration,6,1,5
Proxjj,stormscale,96,shaman,restoration,6,1,5
Róosham,silvermoon,96,shaman,restoration,6,1,5
Anieszka,malganis,96,shaman,restoration,6,1,5
Ниарата,greymane,96,shaman,restoration,6,1,5
Miscoj,zuljin,96,shaman,restoration,6,1,5
Zimzalabling,kazzak,96,shaman,restoration,6,1,5
Найспацан,gordunni,96,shaman,restoration,6,1,5
Nucika,ragnaros,96,shaman,restoration,6,1,5
Daykor,chamber-of-aspects,96,shaman,restoration,6,1,5
Shockqt,todeswache,96,shaman,restoration,6,1,5
Apax,blackrock,96,shaman,restoration,6,1,5
Cavemencomp,malganis,96,shaman,restoration,6,1,5
Podvodnicata,stormscale,96,shaman,restoration,6,1,5
Púrgé,outland,96,shaman,restoration,6,1,5
Сатангодхх,howling-fjord,96,shaman,restoration,6,1,5
Cy,aszune,96,shaman,restoration,6,1,5
Trymytotems,drakthul,96,shaman,restoration,6,1,5
Chênoya,blackrock,96,shaman,restoration,6,1,5
Smorcxx,kazzak,96,shaman,restoration,6,1,5
Bymajor,dalaran,96,shaman,restoration,6,1,5
Atuza,antonidas,96,shaman,restoration,6,1,5
Вещун,deathguard,96,shaman,restoration,6,1,5
Poliez,outland,96,shaman,restoration,6,1,5
Moonlanced,aegwynn,96,shaman,restoration,6,1,5
Крузмвп,blackscar,96,shaman,restoration,6,1,5
Utto,thrall,96,shaman,restoration,6,1,5
Elchivo,blackrock,96,shaman,restoration,6,1,5
Eclaîr,thrall,96,shaman,restoration,6,1,5
Swepx,ravencrest,96,shaman,restoration,6,1,5
Aguero,aegwynn,96,shaman,restoration,6,1,5
Reflux,outland,96,shaman,restoration,6,1,5
Xrc,sylvanas,96,shaman,restoration,6,1,5
Shanyi,aerie-peak,96,shaman,restoration,6,1,5
Apolomaeuz,frostwolf,96,shaman,restoration,6,1,5
Weldarion,ragnaros,96,shaman,restoration,6,1,5
Ader,outland,96,shaman,restoration,6,1,5
Металорд,howling-fjord,96,shaman,restoration,6,1,5
Bjerknes,draenor,96,shaman,restoration,6,1,5
Cheatcodes,blackhand,96,shaman,restoration,6,1,5
Especialista,uldum,96,shaman,restoration,6,1,5
Valgash,khadgar,96,shaman,restoration,6,1,5
Сагура,gordunni,96,shaman,restoration,6,1,5
Zethh,antonidas,96,shaman,restoration,6,1,5
Dvrg,antonidas,96,shaman,restoration,6,1,5
Renamedagain,twisting-nether,96,shaman,restoration,6,1,5
Diabolous,drakthul,96,shaman,restoration,6,1,5
Hotstorm,bronzebeard,96,shaman,restoration,6,1,5
Zaxis,bronzebeard,96,shaman,restoration,6,1,5
Fuchifu,eredar,96,shaman,restoration,6,1,5
Kostex,rexxar,96,shaman,restoration,6,1,5
Rôhâr,stormscale,96,shaman,restoration,6,1,5
Cptcutíe,antonidas,96,shaman,restoration,6,1,5
Rahuna,darksorrow,96,shaman,restoration,6,1,5
Dashakk,frostwhisper,96,shaman,restoration,6,1,5
Yuimhi,sanguino,96,shaman,restoration,7,1,6
Schockbunny,blackrock,96,shaman,restoration,17,2,15
Karpsham,stormscale,96,shaman,restoration,12,1,11
Ikeaboy,eredar,96,shaman,restoration,12,1,11
Garulf,twisting-nether,96,shaman,restoration,12,1,11
Porre,zuljin,96,shaman,restoration,12,1,11
Freeleys,ravencrest,96,shaman,restoration,12,1,11
Lootqrwa,ragnaros,96,shaman,restoration,12,1,11
Anstra,colinas-pardas,96,shaman,restoration,12,1,11
Топмахвелл,soulflayer,96,shaman,restoration,12,1,11
Namrdak,quelthalas,96,shaman,restoration,12,1,11
Dewriyl,doomhammer,96,shaman,restoration,12,1,11
Xicez,sanguino,96,shaman,restoration,12,1,11
Rohek,tarren-mill,96,shaman,restoration,18,1,17
Grumpystorm,agamaggan,96,shaman,restoration,18,1,17
Kvelertak,guldan,96,shaman,restoration,18,1,17
Hairball,turalyon,95,shaman,restoration,6,2,4
Bursthand,sanguino,95,shaman,restoration,12,2,10
Twotwozero,defias-brotherhood,95,shaman,restoration,6,1,5
Taiki,sylvanas,90,shaman,restoration,13,4,9
Kungachunga,pozzo-delleternità,79,shaman,restoration,5,1,4
Apád,ragnaros,79,shaman,restoration,5,1,4
Nowái,tarren-mill,64,shaman,restoration,4,1,3
Destrosoul,kazzak,64,shaman,restoration,4,1,3
Drê,daggerspine,64,shaman,restoration,4,1,3
Kirïss,hyjal,48,shaman,restoration,3,1,2
Smokingtotem,alakir,48,shaman,restoration,9,1,8
Buildthewall,archimonde,42,shaman,restoration,8,3,5
Ånný,blackmoore,42,shaman,restoration,11,3,8
Srøgg,archimonde,42,shaman,restoration,9,2,7
Egart,stormscale,42,shaman,restoration,9,2,7
Ninffø,dun-modr,42,shaman,restoration,22,4,18
Shammez,ravencrest,42,shaman,restoration,11,2,9
Oyuun,rajaxx,42,shaman,restoration,17,3,14
Zulululul,burning-blade,42,shaman,restoration,14,2,12
Søpse,stormscale,42,shaman,restoration,15,2,13
Guzzelinare,tarren-mill,2415,shaman,elemental,78,51,27
Elejizz,kazzak,2385,shaman,elemental,156,88,68
Rngo,blackrock,2366,shaman,elemental,120,73,47
Yëë,kazzak,2362,shaman,elemental,105,73,32
Euprâ,archimonde,2362,shaman,elemental,275,145,130
Dody,silvermoon,2342,shaman,elemental,112,77,35
Rungozvs,blackrock,2330,shaman,elemental,142,78,64
Jåime,ravencrest,2322,shaman,elemental,78,51,27
Shrmful,dun-modr,2319,shaman,elemental,113,74,39
Qualitydoge,kazzak,2314,shaman,elemental,84,52,32
Nyed,hyjal,2313,shaman,elemental,256,137,119
Eupra,archimonde,2312,shaman,elemental,175,96,79
Silden,thrall,2303,shaman,elemental,121,72,49
Shiggenbasta,kazzak,2300,shaman,elemental,102,60,42
Matmodir,hyjal,2290,shaman,elemental,144,79,65
Reibanit,twisting-nether,2284,shaman,elemental,147,86,61
Drshock,blackmoore,2281,shaman,elemental,167,88,79
Nevershearx,blackrock,2269,shaman,elemental,96,56,40
Маигваза,soulflayer,2258,shaman,elemental,78,53,25
Baldcreep,blackrock,2254,shaman,elemental,60,41,19
Dakyele,ravencrest,2252,shaman,elemental,113,61,52
Lexila,doomhammer,2249,shaman,elemental,813,420,393
Proccit,blackrock,2226,shaman,elemental,90,50,40
Rungõo,blackrock,2215,shaman,elemental,252,136,116
Theglue,kilrogg,2212,shaman,elemental,72,42,30
Blyatifulday,malganis,2196,shaman,elemental,114,64,50
Edshearen,stormscale,2195,shaman,elemental,270,143,127
Plazmorc,stormscale,2191,shaman,elemental,89,53,36
Kenaz,outland,2190,shaman,elemental,97,54,43
Mcmxcvi,ravencrest,2187,shaman,elemental,178,101,77
Houmpf,hyjal,2184,shaman,elemental,96,53,43
Autopanne,malganis,2177,shaman,elemental,84,53,31
Ghostwolfgg,archimonde,2176,shaman,elemental,144,77,67
Space,stormscale,2176,shaman,elemental,138,72,66
Connecting,hyjal,2171,shaman,elemental,108,56,52
Båkka,ysondre,2170,shaman,elemental,78,47,31
Bärtigeberta,aegwynn,2170,shaman,elemental,102,54,48
Uselesslaso,sanguino,2168,shaman,elemental,135,69,66
Tommybanger,kazzak,2158,shaman,elemental,75,49,26
Шутках,gordunni,2157,shaman,elemental,60,34,26
Shamanazor,twisting-nether,2153,shaman,elemental,66,41,25
Tornado,ravencrest,2150,shaman,elemental,205,113,92
Haumx,blackrock,2143,shaman,elemental,195,105,90
Trickful,kazzak,2138,shaman,elemental,66,45,21
Billybatman,argent-dawn,2134,shaman,elemental,108,70,38
Lavaole,blackrock,2130,shaman,elemental,84,43,41
Monsuunibaba,tarren-mill,2126,shaman,elemental,111,63,48
Ryysham,ravencrest,2123,shaman,elemental,176,99,77
Woof,culte-de-la-rive-noire,2117,shaman,elemental,90,48,42
Eyi,ambossar,2116,shaman,elemental,152,80,72
Ìløvêxÿú,ravencrest,2115,shaman,elemental,182,101,81
Fugekiyogan,archimonde,2112,shaman,elemental,101,53,48
Bigschamlipp,blackhand,2111,shaman,elemental,73,51,22
Exxco,aegwynn,2111,shaman,elemental,83,51,32
Smorchamp,sanguino,2104,shaman,elemental,102,50,52
Jelvin,tarren-mill,2101,shaman,elemental,162,87,75
Blackyx,cthun,2100,shaman,elemental,164,95,69
Бпокбастэр,gordunni,2098,shaman,elemental,87,50,37
Wisplol,ravencrest,2097,shaman,elemental,370,191,179
Mèåtbåll,ravencrest,2083,shaman,elemental,89,54,35
Jøhnnwick,archimonde,2082,shaman,elemental,89,48,41
Shåmssagat,kazzak,2075,shaman,elemental,66,38,28
Blushx,blackhand,2075,shaman,elemental,48,25,23
Pleasehealme,ravencrest,2067,shaman,elemental,42,33,9
Macroburst,archimonde,2065,shaman,elemental,65,41,24
Raintlordx,twisting-nether,2060,shaman,elemental,42,36,6
Dsgrc,tarren-mill,2059,shaman,elemental,126,65,61
Starelement,draenor,2059,shaman,elemental,120,58,62
Agrero,auchindoun,2058,shaman,elemental,198,103,95
Qzhex,twisting-nether,2056,shaman,elemental,56,41,15
Zimoneris,blackmoore,2050,shaman,elemental,80,46,34
Jøhnwick,ysondre,2050,shaman,elemental,102,50,52
Matmonai,hyjal,2044,shaman,elemental,98,47,51
Suldarissham,aegwynn,2036,shaman,elemental,47,28,19
Satisfya,ambossar,2034,shaman,elemental,292,154,138
Йодаримару,howling-fjord,2032,shaman,elemental,83,44,39
Nyzo,tarren-mill,2032,shaman,elemental,96,50,46
Шоу,gordunni,2027,shaman,elemental,90,48,42
Lavayoshi,kazzak,2026,shaman,elemental,72,48,24
Iavalavalava,tarren-mill,2025,shaman,elemental,96,46,50
Matmons,hyjal,2015,shaman,elemental,124,59,65
Thriveqt,nemesis,2015,shaman,elemental,108,50,58
Élé,twisting-nether,2009,shaman,elemental,114,59,55
Millesabords,dun-morogh,2004,shaman,elemental,60,37,23
Punished,blackrock,2000,shaman,elemental,107,62,45
Rottulos,stormrage,2000,shaman,elemental,60,33,27
Leccyavenue,twisting-nether,2000,shaman,elemental,224,121,103
Teslashock,outland,1999,shaman,elemental,107,61,46
Firella,the-maelstrom,1999,shaman,elemental,64,36,28
Novoz,ysondre,1996,shaman,elemental,143,79,64
Eledelede,blackhand,1990,shaman,elemental,84,42,42
Suldaro,aegwynn,1984,shaman,elemental,77,41,36
Nowmack,archimonde,1983,shaman,elemental,60,34,26
Eppîx,lightnings-blade,1982,shaman,elemental,100,50,50
Nykhara,sanguino,1981,shaman,elemental,108,58,50
Tâsty,blackmoore,1980,shaman,elemental,63,36,27
Naskezz,kazzak,1980,shaman,elemental,287,148,139
Elegodx,ravencrest,1980,shaman,elemental,149,74,75
Айвимэдисон,howling-fjord,1979,shaman,elemental,88,49,39
Fellatia,baelgun,1978,shaman,elemental,108,74,34
Bloodseeker,tarren-mill,1976,shaman,elemental,72,41,31
Kailash,defias-brotherhood,1974,shaman,elemental,90,44,46
Nokster,twisting-nether,1969,shaman,elemental,243,132,111
Murdá,ravencrest,1969,shaman,elemental,96,45,51
Bzezz,archimonde,1968,shaman,elemental,66,36,30
Shiranoye,blackrock,1965,shaman,elemental,96,46,50
Preshear,twisting-nether,1963,shaman,elemental,47,34,13
Könsneutral,tarren-mill,1962,shaman,elemental,71,40,31
Langedinho,stormscale,1959,shaman,elemental,321,159,162
Pipousham,blackhand,1954,shaman,elemental,47,26,21
Pheazka,outland,1950,shaman,elemental,71,37,34
Lavalars,blackhand,1949,shaman,elemental,66,37,29
Feetenjoyerx,kazzak,1944,shaman,elemental,110,57,53
Psyku,outland,1941,shaman,elemental,48,25,23
Dräpàrn,sylvanas,1940,shaman,elemental,72,40,32
Thyeori,stormscale,1940,shaman,elemental,90,43,47
Obryss,tarren-mill,1939,shaman,elemental,54,30,24
Pxsquals,ravencrest,1937,shaman,elemental,184,99,85
Shocknrun,sylvanas,1937,shaman,elemental,111,59,52
Blush,blackhand,1936,shaman,elemental,51,23,28
Хеллбат,howling-fjord,1934,shaman,elemental,74,43,31
Raknoxye,blackrock,1931,shaman,elemental,48,38,10
Smashz,stormscale,1930,shaman,elemental,133,79,54
Kiirín,drakthul,1929,shaman,elemental,72,39,33
Valgø,twisting-nether,1927,shaman,elemental,292,161,131
Agreró,auchindoun,1919,shaman,elemental,69,44,25
Borbor,argent-dawn,1916,shaman,elemental,58,31,27
Lilmarco,stormreaver,1916,shaman,elemental,84,43,41
Millevolt,emerald-dream,1915,shaman,elemental,48,27,21
Штормкрашер,howling-fjord,1914,shaman,elemental,150,80,70
Çð,ravencrest,1909,shaman,elemental,36,20,16
Barbarra,stormscale,1909,shaman,elemental,62,34,28
Twists,sylvanas,1906,shaman,elemental,66,40,26
Sajma,silvermoon,1903,shaman,elemental,69,48,21
Trixxsham,twisting-nether,1902,shaman,elemental,36,25,11
Тандерхх,howling-fjord,1902,shaman,elemental,42,25,17
Roskan,archimonde,1902,shaman,elemental,89,46,43
Starpior,stormscale,1901,shaman,elemental,144,74,70
Kärríegold,blackrock,1900,shaman,elemental,649,329,320
Vanrake,ravencrest,1899,shaman,elemental,285,157,128
Kilazz,twisting-nether,1897,shaman,elemental,66,35,31
Onceinalife,ambossar,1895,shaman,elemental,582,293,289
Shocktrippz,stormscale,1892,shaman,elemental,114,67,47
Earthhulk,thrall,1892,shaman,elemental,126,74,52
Replicusele,doomhammer,1891,shaman,elemental,48,32,16
Зэстус,soulflayer,1891,shaman,elemental,233,129,104
Дашажмихекс,howling-fjord,1891,shaman,elemental,90,46,44
Iraterrørist,kazzak,1889,shaman,elemental,56,28,28
Mjorè,twisting-nether,1888,shaman,elemental,275,134,141
Totemlié,ravencrest,1887,shaman,elemental,42,27,15
Cïgänää,archimonde,1885,shaman,elemental,85,44,41
Rotuluss,stormrage,1884,shaman,elemental,64,44,20
Yiiro,argent-dawn,1884,shaman,elemental,91,49,42
Xtremeshaman,blackmoore,1882,shaman,elemental,42,30,12
Tukino,burning-legion,1880,shaman,elemental,31,21,10
Nerdshockz,blackhand,1878,shaman,elemental,116,57,59
Horizons,the-maelstrom,1875,shaman,elemental,48,31,17
Hurik,sylvanas,1872,shaman,elemental,62,37,25
Regnever,draenor,1862,shaman,elemental,185,90,95
Wørldrúiner,kazzak,1859,shaman,elemental,48,33,15
Midgetnatty,ravencrest,1858,shaman,elemental,94,51,43
Haltothunder,dalaran,1858,shaman,elemental,72,34,38
Nekhros,sargeras,1854,shaman,elemental,247,128,119
Gungo,deathwing,1853,shaman,elemental,60,29,31
Flanax,hyjal,1852,shaman,elemental,78,44,34
Enamo,blackrock,1850,shaman,elemental,65,34,31
Volcanò,outland,1850,shaman,elemental,312,158,154
Acces,stormscale,1848,shaman,elemental,140,86,54
ßakingsoda,tarren-mill,1848,shaman,elemental,83,46,37
Visboer,stormscale,1847,shaman,elemental,36,22,14
Knastele,silvermoon,1846,shaman,elemental,36,27,9
Tellý,blackmoore,1846,shaman,elemental,53,31,22
Totemtilda,tarren-mill,1846,shaman,elemental,54,30,24
Hothand,thrall,1844,shaman,elemental,54,26,28
Øwlïshâm,archimonde,1843,shaman,elemental,89,43,46
Реалайзер,blackscar,1841,shaman,elemental,54,32,22
Sèfìx,tarren-mill,1840,shaman,elemental,41,23,18
Jouzu,ragnaros,1840,shaman,elemental,63,33,30
Procc,nordrassil,1839,shaman,elemental,54,35,19
Dwarfracial,blackrock,1837,shaman,elemental,36,23,13
Ejx,arthas,1836,shaman,elemental,94,50,44
Ungabungha,stormscale,1835,shaman,elemental,199,113,86
Doyah,eredar,1834,shaman,elemental,54,33,21
Sayokô,grim-batol,1834,shaman,elemental,48,28,20
Bambustic,kazzak,1833,shaman,elemental,41,25,16
Инимал,deathweaver,1830,shaman,elemental,54,30,24
Retuu,uldaman,1829,shaman,elemental,54,30,24
Crazyshaman,ravencrest,1829,shaman,elemental,53,26,27
Херург,soulflayer,1828,shaman,elemental,48,24,24
Slogic,tarren-mill,1828,shaman,elemental,71,34,37
Crespó,alakir,1827,shaman,elemental,54,25,29
Paulbaniel,alonsus,1827,shaman,elemental,114,52,62
Transcendent,malorne,1826,shaman,elemental,84,63,21
Hazardhenry,argent-dawn,1826,shaman,elemental,42,30,12
Breezzkingg,twisting-nether,1826,shaman,elemental,92,54,38
Nëllaqt,archimonde,1826,shaman,elemental,78,41,37
Sourens,twisting-nether,1826,shaman,elemental,92,48,44
Блокбастзр,gordunni,1826,shaman,elemental,187,91,96
Deepdamp,blackrock,1825,shaman,elemental,46,31,15
Drshockit,blackrock,1825,shaman,elemental,38,24,14
Exesemrone,uldaman,1825,shaman,elemental,66,39,27
Kæzx,blackrock,1822,shaman,elemental,78,45,33
Mehboul,hyjal,1822,shaman,elemental,66,36,30
Unluckyvault,nemesis,1822,shaman,elemental,74,34,40
Kronoxd,tarren-mill,1822,shaman,elemental,92,42,50
Georgewhat,defias-brotherhood,1821,shaman,elemental,173,87,86
Oneßuttøn,ravencrest,1821,shaman,elemental,102,48,54
Vandouille,archimonde,1820,shaman,elemental,45,29,16
Domflux,ravencrest,1820,shaman,elemental,415,221,194
Mikecrybaby,tarren-mill,1816,shaman,elemental,114,64,50
Komodski,kazzak,1814,shaman,elemental,48,26,22
Achtungblitz,blackrock,1813,shaman,elemental,42,33,9
Ronfroggo,kazzak,1812,shaman,elemental,64,38,26
Pooch,archimonde,1811,shaman,elemental,99,54,45
Korvsnärten,outland,1811,shaman,elemental,87,46,41
Psÿkz,kazzak,1811,shaman,elemental,90,42,48
Jamzyshaman,emerald-dream,1810,shaman,elemental,42,27,15
Ангустиа,galakrond,1810,shaman,elemental,53,33,20
Hugox,outland,1810,shaman,elemental,82,48,34
Atiix,eredar,1810,shaman,elemental,125,70,55
Хэйзл,ashenvale,1809,shaman,elemental,168,99,69
Faridstreng,blackmoore,1808,shaman,elemental,66,42,24
Chamel,draenor,1808,shaman,elemental,30,19,11
Ztraz,blackhand,1808,shaman,elemental,50,27,23
Ânuk,blackrock,1808,shaman,elemental,272,141,131
Palfe,khaz-modan,1808,shaman,elemental,103,51,52
Ehlaina,outland,1806,shaman,elemental,30,19,11
Rokxa,burning-legion,1806,shaman,elemental,54,27,27
Suirz,dun-modr,1805,shaman,elemental,83,53,30
Kapplos,gorgonnash,1805,shaman,elemental,59,31,28
Garythos,drakthul,1802,shaman,elemental,30,19,11
Лескас,howling-fjord,1802,shaman,elemental,60,33,27
Glibbins,sylvanas,1801,shaman,elemental,41,24,17
Owrly,stormscale,1801,shaman,elemental,407,202,205
Amuñ,hyjal,1800,shaman,elemental,48,33,15
Spajry,drakthul,1800,shaman,elemental,54,35,19
Koiru,argent-dawn,1796,shaman,elemental,54,34,20
Карбонатрикс,soulflayer,1796,shaman,elemental,106,59,47
Lavalava,blackmoore,1795,shaman,elemental,280,148,132
Lsdx,silvermoon,1793,shaman,elemental,126,68,58
Boiblaster,argent-dawn,1790,shaman,elemental,33,26,7
Anqe,twisting-nether,1790,shaman,elemental,142,72,70
Elexuz,blackrock,1789,shaman,elemental,108,64,44
Djlavaburst,malganis,1789,shaman,elemental,407,203,204
Fabslx,archimonde,1787,shaman,elemental,241,115,126
Sunsong,twisting-nether,1784,shaman,elemental,144,80,64
Voydetesto,sanguino,1783,shaman,elemental,96,46,50
Cismine,twisting-nether,1782,shaman,elemental,54,35,19
Shootinguard,kazzak,1781,shaman,elemental,48,29,19
Drainergødx,ragnaros,1781,shaman,elemental,78,47,31
Autopanne,draenor,1780,shaman,elemental,42,28,14
Pitsamestari,frostmane,1780,shaman,elemental,128,71,57
Avatarbaelon,silvermoon,1780,shaman,elemental,134,64,70
Hailele,argent-dawn,1777,shaman,elemental,60,45,15
Wátermélon,stormscale,1776,shaman,elemental,78,48,30
Lafia,blackrock,1775,shaman,elemental,253,130,123
Davinshhe,kazzak,1775,shaman,elemental,96,44,52
Suntaria,stormscale,1775,shaman,elemental,54,24,30
Çð,twisting-nether,1772,shaman,elemental,47,28,19
Burstraze,tarren-mill,1771,shaman,elemental,65,34,31
Vivaldi,varimathras,1770,shaman,elemental,148,73,75
Totemlyhot,blackrock,1768,shaman,elemental,72,42,30
Spruehkot,aegwynn,1767,shaman,elemental,33,22,11
Obesisham,outland,1767,shaman,elemental,140,66,74
Tasoro,sanguino,1767,shaman,elemental,94,43,51
Tølkian,dalaran,1766,shaman,elemental,60,25,35
Deeck,ravencrest,1765,shaman,elemental,119,75,44
Jacklupin,ravencrest,1765,shaman,elemental,90,42,48
Farùk,ravencrest,1763,shaman,elemental,45,29,16
Fahrlos,eredar,1762,shaman,elemental,78,36,42
Anøüchkä,ysondre,1761,shaman,elemental,118,66,52
Pieski,stormscale,1759,shaman,elemental,69,33,36
Sykx,hyjal,1758,shaman,elemental,77,44,33
Ulrichh,twisting-nether,1758,shaman,elemental,84,41,43
Hanakô,grim-batol,1756,shaman,elemental,48,27,21
Lianitus,tarren-mill,1756,shaman,elemental,129,60,69
Gojõ,dun-modr,1755,shaman,elemental,66,33,33
Xelphia,frostmane,1755,shaman,elemental,101,46,55
Savan,darkspear,1754,shaman,elemental,90,45,45
Rokils,ravencrest,1753,shaman,elemental,54,25,29
Blastersondy,outland,1752,shaman,elemental,85,48,37
Thorleíf,silvermoon,1751,shaman,elemental,138,70,68
Smorclelx,khadgar,1750,shaman,elemental,182,93,89
Stickix,malganis,1746,shaman,elemental,89,46,43
Adamyo,stormscale,1744,shaman,elemental,149,75,74
Кирагаз,gordunni,1743,shaman,elemental,192,100,92
Healyoa,blackmoore,1741,shaman,elemental,279,135,144
Prêxy,kazzak,1740,shaman,elemental,97,46,51
Cloony,khaz-modan,1738,shaman,elemental,86,55,31
Elektron,malganis,1738,shaman,elemental,196,104,92
Lavabelly,twisting-nether,1738,shaman,elemental,241,120,121
Earthtjockis,ragnaros,1738,shaman,elemental,63,29,34
Volhalo,blackmoore,1737,shaman,elemental,36,22,14
Lavatherapy,grim-batol,1737,shaman,elemental,120,65,55
Lavaproc,burning-legion,1736,shaman,elemental,245,122,123
Шумноватт,howling-fjord,1736,shaman,elemental,66,31,35
Machmacan,argent-dawn,1733,shaman,elemental,120,73,47
Mishoshamana,tarren-mill,1733,shaman,elemental,95,54,41
Schamaster,antonidas,1731,shaman,elemental,45,22,23
Nalaadu,stormscale,1729,shaman,elemental,96,50,46
Hanatopikeur,grim-batol,1728,shaman,elemental,35,19,16
Aspên,archimonde,1727,shaman,elemental,66,33,33
Gschmack,blackrock,1727,shaman,elemental,60,29,31
Козаностро,howling-fjord,1726,shaman,elemental,42,27,15
Fullavaids,grim-batol,1725,shaman,elemental,51,27,24
Daubidaubi,kazzak,1722,shaman,elemental,39,26,13
Grapefruit,blackmoore,1722,shaman,elemental,30,18,12
Köona,archimonde,1720,shaman,elemental,30,21,9
Qwilfish,blackmoore,1717,shaman,elemental,123,68,55
Naphe,ysondre,1717,shaman,elemental,77,40,37
Shammyammy,tarren-mill,1716,shaman,elemental,183,103,80
Testpapi,twisting-nether,1716,shaman,elemental,146,81,65
Gramkar,stormscale,1716,shaman,elemental,64,34,30
Neotrax,outland,1715,shaman,elemental,143,78,65
Eleurii,burning-blade,1715,shaman,elemental,126,67,59
Tao,stormscale,1715,shaman,elemental,51,22,29
Гивми,blackscar,1714,shaman,elemental,103,54,49
Djclydecarry,stormscale,1711,shaman,elemental,112,61,51
Mércander,kazzak,1711,shaman,elemental,115,57,58
Nöyrä,argent-dawn,1710,shaman,elemental,36,25,11
Cylantarus,blackrock,1705,shaman,elemental,36,25,11
Fakehex,blackrock,1704,shaman,elemental,104,59,45
Xatis,aegwynn,1703,shaman,elemental,24,19,5
Lantbruk,twisting-nether,1703,shaman,elemental,49,28,21
Silverpanne,silvermoon,1701,shaman,elemental,30,21,9
Мэморисс,gordunni,1701,shaman,elemental,58,29,29
Rokils,tarren-mill,1699,shaman,elemental,36,24,12
Basiletta,hyjal,1697,shaman,elemental,61,43,18
Bumblebetuna,stormscale,1696,shaman,elemental,80,45,35
Äijä,chromaggus,1696,shaman,elemental,107,55,52
Máui,korgall,1695,shaman,elemental,180,98,82
Porthex,kazzak,1694,shaman,elemental,84,47,37
Bûsta,ravencrest,1694,shaman,elemental,108,51,57
Sakkmaballz,stormscale,1694,shaman,elemental,62,29,33
Nînadobrevx,stormscale,1692,shaman,elemental,69,39,30
Kraksham,ravencrest,1690,shaman,elemental,24,18,6
Koífish,ravencrest,1690,shaman,elemental,54,32,22
Афтршок,soulflayer,1690,shaman,elemental,105,55,50
Daemp,draenor,1689,shaman,elemental,30,22,8
Azùk,kazzak,1689,shaman,elemental,30,21,9
Stromdi,azshara,1689,shaman,elemental,40,24,16
Dreanar,ragnaros,1689,shaman,elemental,30,18,12
Zaledria,argent-dawn,1687,shaman,elemental,124,68,56
Braíntas,norgannon,1687,shaman,elemental,102,48,54
Muscade,silvermoon,1686,shaman,elemental,78,45,33
Nobrac,rajaxx,1685,shaman,elemental,36,18,18
Ðreamz,kaelthas,1685,shaman,elemental,48,23,25
Stormseven,emeriss,1685,shaman,elemental,41,19,22
Sáàd,ravencrest,1681,shaman,elemental,42,20,22
Hxml,aegwynn,1680,shaman,elemental,66,39,27
Mcbloob,kazzak,1680,shaman,elemental,102,55,47
Mendiing,kazzak,1680,shaman,elemental,36,19,17
Seriux,twisting-nether,1679,shaman,elemental,72,44,28
Naathir,magtheridon,1678,shaman,elemental,40,26,14
Boomfanboy,tarren-mill,1677,shaman,elemental,45,20,25
Kwanah,kaelthas,1676,shaman,elemental,48,24,24
Xereús,kazzak,1676,shaman,elemental,107,51,56
Sgroppino,stormscale,1676,shaman,elemental,47,22,25
Kohnân,hyjal,1675,shaman,elemental,84,42,42
Naorgot,uldaman,1675,shaman,elemental,213,102,111
Dawop,ravencrest,1674,shaman,elemental,85,48,37
Lokasakke,tarren-mill,1674,shaman,elemental,40,22,18
Swåf,ravencrest,1674,shaman,elemental,42,18,24
Кислаябуба,howling-fjord,1672,shaman,elemental,48,21,27
Solosüper,ravencrest,1671,shaman,elemental,114,53,61
Chênoya,blackrock,1671,shaman,elemental,120,54,66
Klicken,tarren-mill,1670,shaman,elemental,29,19,10
Tvådje,silvermoon,1669,shaman,elemental,78,46,32
Brokenguyman,defias-brotherhood,1669,shaman,elemental,43,24,19
Cuddleball,moonglade,1669,shaman,elemental,48,25,23
Ogrodi,burning-legion,1668,shaman,elemental,150,79,71
Liluzivert,mannoroth,1668,shaman,elemental,137,71,66
Theodorix,silvermoon,1668,shaman,elemental,48,23,25
Hanakokô,grim-batol,1666,shaman,elemental,36,20,16
Windspêaker,outland,1666,shaman,elemental,35,19,16
Huyø,stormscale,1666,shaman,elemental,150,71,79
Guuguugaga,silvermoon,1665,shaman,elemental,52,34,18
Gammeldunder,shattered-hand,1665,shaman,elemental,115,51,64
Tempest,kul-tiras,1662,shaman,elemental,90,58,32
Vamali,draenor,1662,shaman,elemental,65,31,34
Sheamanus,ravencrest,1661,shaman,elemental,173,96,77
Snusyy,ravencrest,1660,shaman,elemental,32,18,14
Elrayitos,shendralar,1659,shaman,elemental,114,63,51
Crysenshocks,blackrock,1659,shaman,elemental,126,69,57
Ogkûshgödx,sylvanas,1658,shaman,elemental,42,24,18
Shamzoran,dentarg,1658,shaman,elemental,35,20,15
Vorteas,burning-blade,1658,shaman,elemental,42,23,19
Rawside,thrall,1658,shaman,elemental,52,26,26
Rolftheswine,defias-brotherhood,1656,shaman,elemental,36,23,13
Электро,thermaplugg,1654,shaman,elemental,71,34,37
Zengã,kazzak,1653,shaman,elemental,118,55,63
Shantero,draenor,1652,shaman,elemental,93,49,44
Schamistyle,blackhand,1652,shaman,elemental,48,20,28
Malybou,ysondre,1651,shaman,elemental,36,18,18
Wylly,aegwynn,1650,shaman,elemental,150,79,71
Obrijames,tarren-mill,1649,shaman,elemental,42,22,20
Kankxx,stormscale,1647,shaman,elemental,36,21,15
Bredex,doomhammer,1644,shaman,elemental,36,19,17
Exereon,ravencrest,1644,shaman,elemental,72,35,37
Thazra,zirkel-des-cenarius,1643,shaman,elemental,95,54,41
Ezala,blackhand,1642,shaman,elemental,102,56,46
Oldaang,ravencrest,1640,shaman,elemental,142,86,56
Urshak,alleria,1639,shaman,elemental,36,24,12
Jodel,tarren-mill,1639,shaman,elemental,54,29,25
Zaarok,voljin,1639,shaman,elemental,91,41,50
Mamacitá,eredar,1639,shaman,elemental,69,28,41
Waâagh,kirin-tor,1638,shaman,elemental,90,53,37
Mö,ragnaros,1638,shaman,elemental,395,212,183
Mezzoblu,sanguino,1638,shaman,elemental,216,112,104
Slit,quelthalas,1638,shaman,elemental,48,20,28
Reignisover,silvermoon,1637,shaman,elemental,51,32,19
Wàve,stormscale,1637,shaman,elemental,90,45,45
Wlãdoo,archimonde,1636,shaman,elemental,32,22,10
Томёрк,gordunni,1636,shaman,elemental,174,90,84
Aviciix,sanguino,1636,shaman,elemental,148,70,78
Poosnortgodx,ravencrest,1635,shaman,elemental,42,23,19
Shourx,ravencrest,1634,shaman,elemental,89,42,47
Thorsteinar,kazzak,1632,shaman,elemental,82,44,38
Proccq,twisting-nether,1632,shaman,elemental,34,18,16
Androck,tarren-mill,1631,shaman,elemental,124,76,48
Tteïl,archimonde,1631,shaman,elemental,96,51,45
Terobux,culte-de-la-rive-noire,1631,shaman,elemental,40,18,22
Xenødyl,argent-dawn,1630,shaman,elemental,139,76,63
Végàs,ysondre,1629,shaman,elemental,84,41,43
Ттраал,eversong,1628,shaman,elemental,24,17,7
Migahh,stormscale,1628,shaman,elemental,47,27,20
Rrtyui,twisting-nether,1628,shaman,elemental,30,17,13
Элвандер,howling-fjord,1628,shaman,elemental,54,28,26
Чойсе,deathguard,1628,shaman,elemental,190,91,99
Cakedeux,grim-batol,1628,shaman,elemental,45,20,25
Xorron,archimonde,1627,shaman,elemental,219,103,116
Elemefayo,outland,1626,shaman,elemental,108,63,45
Крушам,gordunni,1626,shaman,elemental,65,35,30
Leavemeàlone,ysondre,1625,shaman,elemental,18,17,1
Orcshaman,the-maelstrom,1625,shaman,elemental,87,50,37
Шамвкроксах,howling-fjord,1625,shaman,elemental,36,19,17
Hotsincezero,archimonde,1624,shaman,elemental,101,60,41
Thëtis,chogall,1624,shaman,elemental,86,48,38
Мистеркутёж,gordunni,1624,shaman,elemental,318,163,155
Procbly,tarren-mill,1623,shaman,elemental,30,17,13
Касикандрэра,soulflayer,1623,shaman,elemental,533,277,256
Zaelot,blackrock,1623,shaman,elemental,59,29,30
Jâydizzle,draenor,1623,shaman,elemental,171,79,92
Krubacabra,stormscale,1622,shaman,elemental,42,23,19
Zæus,ragnaros,1622,shaman,elemental,42,20,22
Museum,khaz-modan,1621,shaman,elemental,91,52,39
Лартисс,howling-fjord,1619,shaman,elemental,78,39,39
Esal,blackrock,1618,shaman,elemental,55,31,24
Zest,hyjal,1617,shaman,elemental,93,44,49
Waaghbozz,eredar,1616,shaman,elemental,108,61,47
Dumpaman,frostmane,1615,shaman,elemental,90,48,42
Kristhebrave,twisting-nether,1615,shaman,elemental,126,65,61
Blüëy,ravencrest,1614,shaman,elemental,24,17,7
Stíckíx,malganis,1614,shaman,elemental,28,18,10
Meangreen,stormscale,1613,shaman,elemental,63,34,29
Nitronigi,malganis,1612,shaman,elemental,42,17,25
Krahg,garona,1611,shaman,elemental,63,38,25
Tiji,eredar,1611,shaman,elemental,62,37,25
Torxii,antonidas,1611,shaman,elemental,65,30,35
Naturexz,silvermoon,1608,shaman,elemental,38,22,16
Jehae,archimonde,1608,shaman,elemental,30,17,13
Bâllz,anetheron,1606,shaman,elemental,266,139,127
Simppe,stormreaver,1606,shaman,elemental,120,62,58
Jímmy,frostwhisper,1605,shaman,elemental,72,45,27
Namè,kazzak,1604,shaman,elemental,72,38,34
Зиленый,soulflayer,1604,shaman,elemental,42,22,20
Sniffix,ysondre,1604,shaman,elemental,195,101,94
Shámonn,twisting-nether,1604,shaman,elemental,92,46,46
Sbangx,nemesis,1603,shaman,elemental,36,18,18
Kemurus,kazzak,1602,shaman,elemental,119,62,57
Byma,burning-legion,1601,shaman,elemental,30,21,9
Шаманнутая,gordunni,1601,shaman,elemental,71,43,28
Murmelï,stormreaver,1601,shaman,elemental,66,37,29
Saóri,zuljin,1601,shaman,elemental,33,18,15
Kapïtão,aggra-português,1600,shaman,elemental,54,28,26
Zeuclo,ysondre,1599,shaman,elemental,42,31,11
Manaphi,arthas,1599,shaman,elemental,68,35,33
Dzielnysham,silvermoon,1597,shaman,elemental,80,42,38
Elkyrie,alakir,1596,shaman,elemental,119,63,56
Zënga,kazzak,1595,shaman,elemental,48,29,19
Djogg,sunstrider,1595,shaman,elemental,42,19,23
Aureo,dun-modr,1593,shaman,elemental,52,26,26
Isvk,ravencrest,1592,shaman,elemental,73,37,36
Microb,blackmoore,1591,shaman,elemental,124,63,61
Johncoltrane,archimonde,1589,shaman,elemental,30,23,7
Ohhmm,ravencrest,1589,shaman,elemental,41,20,21
Fattmorte,hyjal,1588,shaman,elemental,33,22,11
Biccon,silvermoon,1588,shaman,elemental,36,19,17
Sheherezeday,aegwynn,1588,shaman,elemental,105,47,58
Wilson,twisting-nether,1586,shaman,elemental,54,30,24
Zðhan,azshara,1586,shaman,elemental,55,27,28
Bèx,twisting-nether,1585,shaman,elemental,127,65,62
Targoel,blackmoore,1585,shaman,elemental,181,87,94
Axahavregryn,kazzak,1584,shaman,elemental,90,50,40
Гудлаик,soulflayer,1584,shaman,elemental,70,38,32
Gúîtårgøð,sanguino,1584,shaman,elemental,60,27,33
Lavaz,blackmoore,1584,shaman,elemental,198,89,109
Mariomental,draenor,1583,shaman,elemental,109,48,61
Sinirli,ravencrest,1581,shaman,elemental,66,34,32
Nyxoqtx,draenor,1578,shaman,elemental,60,38,22
Robofat,ravencrest,1577,shaman,elemental,92,49,43
Takkenuma,hyjal,1577,shaman,elemental,87,44,43
Headthirst,ragnaros,1576,shaman,elemental,62,33,29
Bigfrigid,outland,1576,shaman,elemental,102,47,55
Brugdar,tarren-mill,1574,shaman,elemental,42,28,14
Леланай,blackscar,1574,shaman,elemental,68,36,32
Morama,silvermoon,1574,shaman,elemental,48,24,24
Makaria,emerald-dream,1574,shaman,elemental,161,76,85
Stormcallér,auchindoun,1574,shaman,elemental,42,19,23
Thebomber,guldan,1573,shaman,elemental,72,30,42
Incredibade,stormscale,1572,shaman,elemental,42,24,18
Ryhèn,stormscale,1572,shaman,elemental,86,45,41
Blízzilassø,malygos,1572,shaman,elemental,179,93,86
Wulkanus,drakthul,1572,shaman,elemental,42,18,24
Fotmglad,blackrock,1571,shaman,elemental,66,29,37
Aldonatello,blackrock,1570,shaman,elemental,222,122,100
Mistahbeard,stormscale,1569,shaman,elemental,54,32,22
Valunii,lordaeron,1566,shaman,elemental,279,136,143
Batan,kazzak,1566,shaman,elemental,89,41,48
Skyróxx,blackrock,1564,shaman,elemental,64,32,32
Тессельхоф,howling-fjord,1564,shaman,elemental,46,23,23
Faydasizsham,twisting-nether,1559,shaman,elemental,86,48,38
Minasa,saurfang,1559,shaman,elemental,163,76,87
Òoòoòoòoòoòo,silvermoon,1559,shaman,elemental,54,24,30
Yøøii,nemesis,1558,shaman,elemental,30,18,12
Harod,suramar,1558,shaman,elemental,72,37,35
Hapkin,defias-brotherhood,1558,shaman,elemental,54,27,27
Едрёна,blackscar,1558,shaman,elemental,40,19,21
Junpi,shattered-hand,1557,shaman,elemental,166,85,81
Hotis,onyxia,1556,shaman,elemental,363,180,183
Вавувоух,howling-fjord,1556,shaman,elemental,41,19,22
Пакни,gordunni,1554,shaman,elemental,36,17,19
Виспепешам,gordunni,1552,shaman,elemental,78,39,39
Shibol,ravencrest,1552,shaman,elemental,109,52,57
Ukkz,silvermoon,1552,shaman,elemental,71,30,41
Gurupan,tarren-mill,1550,shaman,elemental,48,26,22
Shareed,zuluhed,1550,shaman,elemental,60,32,28
Думсия,gordunni,1550,shaman,elemental,114,58,56
Akukuu,kazzak,1548,shaman,elemental,126,59,67
Аэрофоб,soulflayer,1547,shaman,elemental,36,22,14
Ruvxy,twisting-nether,1546,shaman,elemental,45,28,17
Roxxo,frostwolf,1544,shaman,elemental,107,59,48
Diaba,sylvanas,1543,shaman,elemental,78,45,33
Twiva,silvermoon,1543,shaman,elemental,82,47,35
Экслайнер,deathweaver,1543,shaman,elemental,119,58,61
Shambulançe,silvermoon,1542,shaman,elemental,30,22,8
Pharmie,ravencrest,1539,shaman,elemental,29,17,12
Smort,frostwolf,1539,shaman,elemental,48,24,24
Belsazar,frostwolf,1539,shaman,elemental,72,33,39
Бендера,grom,1537,shaman,elemental,58,30,28
Haarold,sylvanas,1537,shaman,elemental,36,18,18
Aylar,zenedar,1537,shaman,elemental,54,26,28
Крайфолл,gordunni,1535,shaman,elemental,101,70,31
Милфшама,blackscar,1535,shaman,elemental,78,38,40
Preciousxo,auchindoun,1535,shaman,elemental,47,22,25
Brøkenclass,ravencrest,1534,shaman,elemental,18,16,2
ßounce,twisting-nether,1534,shaman,elemental,30,17,13
Despérado,archimonde,1534,shaman,elemental,78,44,34
Grende,sylvanas,1534,shaman,elemental,69,37,32
Elevlach,drakthul,1534,shaman,elemental,49,21,28
Thald,ragnaros,1533,shaman,elemental,42,23,19
Pórçé,shattered-hand,1529,shaman,elemental,234,125,109
Canjo,aegwynn,1529,shaman,elemental,87,44,43
Milotem,ysondre,1528,shaman,elemental,84,38,46
Kønat,blackmoore,1528,shaman,elemental,42,19,23
Doneteasy,blackrock,1527,shaman,elemental,158,85,73
Chrached,kargath,1527,shaman,elemental,42,21,21
Dòrfy,silvermoon,1527,shaman,elemental,36,16,20
Homesickx,blackrock,1526,shaman,elemental,53,28,25
Sházz,dun-modr,1524,shaman,elemental,94,46,48
Nachtary,blackmoore,1523,shaman,elemental,106,55,51
Zimtmann,teldrassil,1521,shaman,elemental,36,22,14
Uselesstwo,archimonde,1520,shaman,elemental,30,16,14
Couldar,stormscale,1518,shaman,elemental,138,75,63
Navyblue,sylvanas,1518,shaman,elemental,48,24,24
Ронхот,soulflayer,1516,shaman,elemental,96,38,58
Plebzgodxkto,nemesis,1513,shaman,elemental,49,29,20
Zna,archimonde,1513,shaman,elemental,94,48,46
Shamanisme,twisting-nether,1511,shaman,elemental,62,32,30
Løun,archimonde,1511,shaman,elemental,114,57,57
Ulfax,argent-dawn,1509,shaman,elemental,118,57,61
Äshar,archimonde,1506,shaman,elemental,64,37,27
Balfalor,antonidas,1506,shaman,elemental,44,18,26
Тыщатристах,howling-fjord,1505,shaman,elemental,56,38,18
Sûckmytotem,ragnaros,1504,shaman,elemental,29,16,13
Obêlixx,blackmoore,1503,shaman,elemental,54,24,30
Deazypurge,blackrock,1502,shaman,elemental,36,22,14
Даринтор,gordunni,1501,shaman,elemental,95,49,46
Dawzed,hyjal,1500,shaman,elemental,110,60,50
Motorbreath,silvermoon,1500,shaman,elemental,249,127,122
Lêmberger,eredar,1498,shaman,elemental,60,34,26
Kankaku,sanguino,1498,shaman,elemental,54,27,27
Baxstarxz,stormscale,1497,shaman,elemental,42,19,23
Nosno,ravencrest,1495,shaman,elemental,53,27,26
Cudge,arathor,1493,shaman,elemental,54,34,20
Ласара,eversong,1491,shaman,elemental,66,28,38
Vladraxes,draenor,1490,shaman,elemental,72,45,27
Coñfrico,tarren-mill,1490,shaman,elemental,117,61,56
Groundedx,ravencrest,1489,shaman,elemental,47,27,20
Индигула,soulflayer,1488,shaman,elemental,259,135,124
Gagné,hyjal,1487,shaman,elemental,32,17,15
Chinozukems,sanguino,1487,shaman,elemental,150,73,77
Gomoth,kazzak,1486,shaman,elemental,36,20,16
Shockmelone,blackrock,1486,shaman,elemental,63,29,34
Eyowassup,ragnaros,1485,shaman,elemental,48,26,22
Voltyum,zuljin,1485,shaman,elemental,139,60,79
Aesstras,hyjal,1482,shaman,elemental,85,44,41
Nuve,stormscale,1481,shaman,elemental,94,47,47
Vallhur,burning-legion,1480,shaman,elemental,48,27,21
Haasshaman,ravencrest,1480,shaman,elemental,121,50,71
Eðualc,hyjal,1479,shaman,elemental,47,25,22
Дестройбэйби,gordunni,1479,shaman,elemental,180,95,85
Тмх,ashenvale,1479,shaman,elemental,112,58,54
Agamo,silvermoon,1478,shaman,elemental,78,42,36
Myngo,thrall,1478,shaman,elemental,54,29,25
Baarona,neptulon,1478,shaman,elemental,87,45,42
Shaakez,kazzak,1476,shaman,elemental,35,17,18
Ринфан,fordragon,1474,shaman,elemental,112,53,59
Сепич,gordunni,1473,shaman,elemental,84,49,35
Crazypop,outland,1472,shaman,elemental,36,19,17
Pomegranate,arthas,1471,shaman,elemental,78,31,47
Hothex,tarren-mill,1469,shaman,elemental,52,21,31
Shamatto,nemesis,1467,shaman,elemental,88,47,41
Скиц,gordunni,1467,shaman,elemental,90,48,42
Sunraiser,blackmoore,1466,shaman,elemental,133,74,59
Mouraïne,eredar,1466,shaman,elemental,30,16,14
Nolawii,ragnaros,1465,shaman,elemental,119,64,55
Hairypotter,rajaxx,1463,shaman,elemental,83,44,39
Yang,der-rat-von-dalaran,1462,shaman,elemental,30,19,11
Kimpa,minahonda,1462,shaman,elemental,120,67,53
Bigrambo,draenor,1462,shaman,elemental,77,38,39
Zoomar,tarren-mill,1462,shaman,elemental,102,46,56
Rennji,argent-dawn,1461,shaman,elemental,161,78,83
Cleandann,stormscale,1461,shaman,elemental,88,42,46
Vulcainn,marécage-de-zangar,1460,shaman,elemental,105,68,37
Бурехлест,howling-fjord,1460,shaman,elemental,54,34,20
Fúth,ysondre,1459,shaman,elemental,70,35,35
Berzer,ragnaros,1459,shaman,elemental,48,22,26
Amanishama,twisting-nether,1458,shaman,elemental,141,76,65
Teccatwo,outland,1458,shaman,elemental,58,31,27
Maruno,stormscale,1457,shaman,elemental,83,44,39
Гексанол,soulflayer,1457,shaman,elemental,58,30,28
Cracklord,outland,1456,shaman,elemental,48,26,22
Olawizard,draenor,1456,shaman,elemental,161,84,77
Maahm,dalaran,1456,shaman,elemental,91,46,45
Electronova,magtheridon,1455,shaman,elemental,131,63,68
Grimtol,magtheridon,1455,shaman,elemental,47,20,27
Гоэл,ashenvale,1454,shaman,elemental,30,19,11
Vulkân,silvermoon,1454,shaman,elemental,74,41,33
Шамвкроксах,gordunni,1454,shaman,elemental,60,30,30
Ralokar,blackrock,1453,shaman,elemental,102,52,50
Alwaysangry,silvermoon,1453,shaman,elemental,84,41,43
Ríleyx,twisting-nether,1451,shaman,elemental,89,57,32
Gorpdorp,ravencrest,1451,shaman,elemental,195,101,94
Thordes,forscherliga,1451,shaman,elemental,91,40,51
Kuzsham,archimonde,1450,shaman,elemental,87,50,37
Anubisll,hyjal,1449,shaman,elemental,76,39,37
Lavastriker,archimonde,1448,shaman,elemental,380,195,185
Turbokrapka,tarren-mill,1447,shaman,elemental,70,25,45
Champïx,archimonde,1444,shaman,elemental,364,180,184
Мэйзии,howling-fjord,1443,shaman,elemental,60,26,34
Orcmain,turalyon,1442,shaman,elemental,69,25,44
Iicks,blackrock,1441,shaman,elemental,132,73,59
Faeldar,sanguino,1441,shaman,elemental,109,52,57
Stormzug,twisting-nether,1441,shaman,elemental,50,21,29
Whome,aegwynn,1440,shaman,elemental,60,34,26
Essneces,burning-legion,1440,shaman,elemental,83,38,45
Lizoo,ravencrest,1439,shaman,elemental,18,15,3
Dregú,draenor,1439,shaman,elemental,48,28,20
Hemradi,blackmoore,1438,shaman,elemental,48,28,20
Sypnosz,sanguino,1438,shaman,elemental,57,18,39
Смоуктли,howling-fjord,1436,shaman,elemental,65,37,28
Realiz,ysondre,1436,shaman,elemental,46,25,21
Fleischer,stormscale,1436,shaman,elemental,36,15,21
Newsham,draenor,1436,shaman,elemental,36,15,21
Luchø,drakthul,1435,shaman,elemental,24,15,9
Kabà,aegwynn,1435,shaman,elemental,79,44,35
Ædshearan,blackmoore,1434,shaman,elemental,60,30,30
Rexonaone,silvermoon,1434,shaman,elemental,42,15,27
Berusham,ravencrest,1433,shaman,elemental,91,45,46
Ашьф,gordunni,1433,shaman,elemental,39,17,22
Skrbkic,tarren-mill,1429,shaman,elemental,91,48,43
Клоуннашаме,gordunni,1428,shaman,elemental,67,39,28
Unangemessen,silvermoon,1428,shaman,elemental,112,63,49
Xalh,ysondre,1428,shaman,elemental,59,31,28
Sojee,ysondre,1428,shaman,elemental,124,62,62
Tiborr,burning-legion,1427,shaman,elemental,24,15,9
Zëngä,outland,1426,shaman,elemental,60,29,31
Талиесин,grom,1425,shaman,elemental,82,48,34
Ulfuz,silvermoon,1425,shaman,elemental,34,18,16
Totemkahmun,kazzak,1425,shaman,elemental,63,28,35
Drækthør,thrall,1424,shaman,elemental,52,28,24
Highfaî,tarren-mill,1423,shaman,elemental,18,15,3
Альтегро,blackscar,1423,shaman,elemental,85,46,39
Alfang,turalyon,1423,shaman,elemental,173,86,87
Parkroy,draenor,1422,shaman,elemental,30,19,11
Pakwa,drakthul,1420,shaman,elemental,46,22,24
Easyplay,kazzak,1420,shaman,elemental,37,16,21
Chøurøx,hyjal,1419,shaman,elemental,61,35,26
Konodíoda,nemesis,1419,shaman,elemental,50,21,29
Alèks,forscherliga,1418,shaman,elemental,107,62,45
Pvpshaman,aszune,1418,shaman,elemental,41,20,21
Noyá,argent-dawn,1417,shaman,elemental,148,79,69
Magnetoe,ravencrest,1417,shaman,elemental,163,81,82
Legended,tarren-mill,1415,shaman,elemental,30,15,15
Djbruggìe,bloodhoof,1415,shaman,elemental,66,31,35
Reburdacoxis,sanguino,1412,shaman,elemental,30,15,15
Healocalypse,azuremyst,1411,shaman,elemental,54,31,23
Azh,twisting-nether,1411,shaman,elemental,34,18,16
Pandamoniumm,moonglade,1411,shaman,elemental,48,25,23
Inh,blackrock,1411,shaman,elemental,30,15,15
Gandalito,haomarush,1410,shaman,elemental,48,23,25
Djent,outland,1409,shaman,elemental,93,49,44
Smooz,silvermoon,1409,shaman,elemental,117,60,57
Бумбумпаузр,borean-tundra,1409,shaman,elemental,75,29,46
Lampard,magtheridon,1407,shaman,elemental,35,19,16
Сосмыслом,howling-fjord,1407,shaman,elemental,96,48,48
Gensehaut,aegwynn,1407,shaman,elemental,48,22,26
Flubberman,blackrock,1405,shaman,elemental,62,32,30
Zanyun,burning-legion,1405,shaman,elemental,56,21,35
Ludo,lothar,1404,shaman,elemental,52,32,20
Файербурст,soulflayer,1404,shaman,elemental,48,26,22
Torouk,rashgarroth,1402,shaman,elemental,96,47,49
Rekhtar,burning-legion,1401,shaman,elemental,163,89,74
Ong,anubarak,1400,shaman,elemental,51,34,17
Støya,archimonde,1400,shaman,elemental,48,18,30
Athul,theradras,1399,shaman,elemental,49,24,25
Urinja,outland,1397,shaman,elemental,72,40,32
Märthalouise,twisting-nether,1396,shaman,elemental,35,18,17
Superkee,kazzak,1395,shaman,elemental,520,270,250
Rharhahra,archimonde,1393,shaman,elemental,66,23,43
Enzain,outland,1389,shaman,elemental,44,26,18
Shôcopan,los-errantes,1389,shaman,elemental,165,75,90
Руннольв,galakrond,1388,shaman,elemental,48,24,24
Rakzhaza,blackmoore,1387,shaman,elemental,88,45,43
Jönayy,dun-modr,1386,shaman,elemental,30,17,13
Jumbototem,tarren-mill,1385,shaman,elemental,90,56,34
Rohknar,ragnaros,1383,shaman,elemental,54,29,25
Salvadr,zuljin,1383,shaman,elemental,33,15,18
Shkook,archimonde,1383,shaman,elemental,70,31,39
Furrymane,blackmoore,1382,shaman,elemental,51,27,24
Лукаджун,howling-fjord,1380,shaman,elemental,24,17,7
Treizelol,ysondre,1379,shaman,elemental,72,43,29
Screwd,defias-brotherhood,1377,shaman,elemental,84,47,37
Zbysiu,ravencrest,1373,shaman,elemental,123,68,55
Ragash,shattered-halls,1371,shaman,elemental,66,35,31
Nibirû,archimonde,1369,shaman,elemental,36,20,16
Scot,blackhand,1369,shaman,elemental,107,53,54
Ragnadim,silvermoon,1368,shaman,elemental,42,15,27
Damntrolls,blackmoore,1367,shaman,elemental,34,16,18
Краоми,soulflayer,1365,shaman,elemental,42,24,18
Xhahal,hyjal,1364,shaman,elemental,30,21,9
Elshifotrem,throkferoth,1361,shaman,elemental,124,66,58
Apolomaeuz,frostwolf,1361,shaman,elemental,107,56,51
Lilyvanlit,outland,1359,shaman,elemental,35,19,16
Whizjy,sanguino,1359,shaman,elemental,30,15,15
Novka,eredar,1358,shaman,elemental,89,43,46
Девлиниум,fordragon,1356,shaman,elemental,53,28,25
Ghortus,magtheridon,1355,shaman,elemental,30,15,15
Утебяпожар,blackscar,1355,shaman,elemental,51,17,34
Monstermunch,ravencrest,1355,shaman,elemental,52,17,35
Vivaki,dun-morogh,1352,shaman,elemental,43,18,25
Carusø,thrall,1344,shaman,elemental,79,47,32
Shamoga,kazzak,1342,shaman,elemental,18,15,3
Zeúz,the-maelstrom,1341,shaman,elemental,18,14,4
Buzz,stormscale,1341,shaman,elemental,48,14,34
Alëxx,hyjal,1340,shaman,elemental,24,14,10
Charliiejoh,stormscale,1340,shaman,elemental,141,71,70
Xesti,twisting-nether,1340,shaman,elemental,193,97,96
Itsallrng,stormscale,1340,shaman,elemental,30,14,16
Iddoz,outland,1339,shaman,elemental,30,14,16
Джуньбургерх,gordunni,1338,shaman,elemental,54,28,26
Sshaasam,tarren-mill,1337,shaman,elemental,24,14,10
Sgf,stormscale,1336,shaman,elemental,193,94,99
Shamanns,lordaeron,1336,shaman,elemental,256,122,134
Supersham,ragnaros,1336,shaman,elemental,36,14,22
Fâro,dun-modr,1335,shaman,elemental,41,18,23
Grumpystorm,agamaggan,1332,shaman,elemental,24,14,10
Dreadness,runetotem,1331,shaman,elemental,31,14,17
Lechirurgien,elune,1330,shaman,elemental,252,128,124
Ankzul,exodar,1330,shaman,elemental,144,67,77
Xiomora,argent-dawn,1330,shaman,elemental,39,18,21
Tidetös,doomhammer,1329,shaman,elemental,30,17,13
Антиниеми,soulflayer,1329,shaman,elemental,54,21,33
Squirtstorm,ravencrest,1329,shaman,elemental,56,18,38
Шиока,borean-tundra,1328,shaman,elemental,42,24,18
Nerekiclej,ravencrest,1327,shaman,elemental,47,23,24
Roxìe,blackmoore,1326,shaman,elemental,30,20,10
Ironbuttrfly,magtheridon,1326,shaman,elemental,48,27,21
Kirak,anetheron,1326,shaman,elemental,219,109,110
Apád,ragnaros,1325,shaman,elemental,42,23,19
Fosterzz,ravencrest,1322,shaman,elemental,51,27,24
Blitzproc,ysondre,1321,shaman,elemental,33,15,18
Джанндис,booty-bay,1321,shaman,elemental,42,19,23
Tanjîrø,archimonde,1320,shaman,elemental,24,14,10
Elothar,earthen-ring,1319,shaman,elemental,24,14,10
Крто,thermaplugg,1319,shaman,elemental,245,129,116
Zalitz,sanguino,1317,shaman,elemental,103,56,47
Atixz,blackmoore,1317,shaman,elemental,36,17,19
Ananasen,eonar,1311,shaman,elemental,96,49,47
Yezu,medivh,1311,shaman,elemental,102,48,54
Zmech,chamber-of-aspects,1309,shaman,elemental,30,14,16
Kärdyo,archimonde,1309,shaman,elemental,35,14,21
Beven,stormscale,1308,shaman,elemental,42,17,25
Bangou,archimonde,1306,shaman,elemental,180,89,91
Дваллинн,gordunni,1303,shaman,elemental,36,14,22
Vajinga,aerie-peak,1302,shaman,elemental,54,30,24
Glorfidel,turalyon,1302,shaman,elemental,167,80,87
Dahryana,azjolnerub,1302,shaman,elemental,42,20,22
Quartodebue,nemesis,1301,shaman,elemental,39,16,23
Hboni,chamber-of-aspects,1299,shaman,elemental,30,15,15
Mív,outland,1297,shaman,elemental,75,35,40
Runetera,ravencrest,1296,shaman,elemental,23,17,6
Rhonix,blackmoore,1295,shaman,elemental,27,15,12
Destructør,norgannon,1295,shaman,elemental,84,42,42
Umbraverfaa,twisting-nether,1294,shaman,elemental,48,26,22
Dropdattotem,stormscale,1292,shaman,elemental,54,23,31
Blancc,kazzak,1291,shaman,elemental,108,57,51
Ishokyou,thrall,1291,shaman,elemental,114,54,60
Griins,ravencrest,1289,shaman,elemental,36,20,16
Shamíz,draenor,1287,shaman,elemental,87,49,38
Peaksh,stormscale,1287,shaman,elemental,36,16,20
Десперо,gordunni,1286,shaman,elemental,38,21,17
Saqerr,kazzak,1286,shaman,elemental,89,36,53
Brassefrasse,shattered-hand,1283,shaman,elemental,38,18,20
Mélb,eredar,1282,shaman,elemental,78,40,38
Tiamât,culte-de-la-rive-noire,1280,shaman,elemental,125,66,59
Tiqle,blackmoore,1279,shaman,elemental,131,64,67
Malkabaserka,draenor,1278,shaman,elemental,60,31,29
Xfiles,garona,1278,shaman,elemental,48,24,24
Jagblade,neptulon,1277,shaman,elemental,94,53,41
Zaappyboii,azjolnerub,1277,shaman,elemental,44,20,24
Stoîc,stormscale,1277,shaman,elemental,42,14,28
Rhastafarian,stormscale,1276,shaman,elemental,42,20,22
Gameblast,thunderhorn,1273,shaman,elemental,46,28,18
Dðt,stormscale,1273,shaman,elemental,186,96,90
Denadrios,blackhand,1273,shaman,elemental,172,81,91
Totempoo,the-maelstrom,1272,shaman,elemental,36,19,17
Unding,azshara,1272,shaman,elemental,66,20,46
Onlyfansmod,uldum,1270,shaman,elemental,117,53,64
Саг,gordunni,1269,shaman,elemental,54,23,31
Znakhara,burning-legion,1267,shaman,elemental,38,17,21
Zakuun,kazzak,1267,shaman,elemental,44,14,30
Zham,kul-tiras,1266,shaman,elemental,60,24,36
Boxo,frostwolf,1263,shaman,elemental,130,73,57
Raigetsu,kazzak,1263,shaman,elemental,68,34,34
Tehpielover,bladefist,1262,shaman,elemental,46,24,22
Magath,nethersturm,1262,shaman,elemental,81,42,39
Mosterx,stormscale,1258,shaman,elemental,36,21,15
Штормбайт,azuregos,1258,shaman,elemental,30,17,13
Élémentyum,archimonde,1258,shaman,elemental,66,28,38
Leash,blackmoore,1257,shaman,elemental,30,14,16
Chouppi,la-croisade-écarlate,1257,shaman,elemental,48,15,33
Цет,soulflayer,1255,shaman,elemental,23,15,8
Mynutz,outland,1255,shaman,elemental,54,18,36
Эгриок,howling-fjord,1254,shaman,elemental,36,20,16
Oprawinfury,ravencrest,1250,shaman,elemental,35,15,20
Ðãvê,veknilash,1249,shaman,elemental,44,19,25
Сарцек,howling-fjord,1248,shaman,elemental,90,50,40
Blackyx,dun-modr,1247,shaman,elemental,18,13,5
Ózyy,draenor,1247,shaman,elemental,36,22,14
Weåfy,outland,1247,shaman,elemental,24,13,11
Billburr,aegwynn,1247,shaman,elemental,27,14,13
Chispa,darkmoon-faire,1247,shaman,elemental,83,40,43
Kelvok,silvermoon,1246,shaman,elemental,24,13,11
Джохарион,deathguard,1244,shaman,elemental,74,32,42
Drýtón,blackrock,1243,shaman,elemental,30,13,17
Камам,gordunni,1243,shaman,elemental,66,28,38
Shangy,blackrock,1243,shaman,elemental,42,13,29
Levarázsol,outland,1242,shaman,elemental,30,13,17
Волгоградка,soulflayer,1242,shaman,elemental,30,13,17
Lexxthree,blackrock,1241,shaman,elemental,18,13,5
Maggoshishi,blackmoore,1241,shaman,elemental,176,90,86
Cendrør,hyjal,1240,shaman,elemental,24,13,11
Zerak,twisting-nether,1238,shaman,elemental,24,13,11
Pawsh,dun-modr,1238,shaman,elemental,51,24,27
Makgoa,ysondre,1237,shaman,elemental,18,13,5
Флоррэт,gordunni,1231,shaman,elemental,273,125,148
Ägornot,kazzak,1230,shaman,elemental,33,14,19
Khayac,ravencrest,1229,shaman,elemental,30,13,17
Slushï,argent-dawn,1226,shaman,elemental,53,17,36
Asiorr,silvermoon,1225,shaman,elemental,47,16,31
Maino,archimonde,1223,shaman,elemental,117,61,56
Bigheal,quelthalas,1222,shaman,elemental,30,13,17
Формацепт,ashenvale,1220,shaman,elemental,115,54,61
Waterboi,blackmoore,1219,shaman,elemental,24,13,11
Nagyrakéta,ragnaros,1218,shaman,elemental,88,37,51
Foxxyluv,stormscale,1215,shaman,elemental,20,14,6
Quizx,blackrock,1215,shaman,elemental,66,27,39
Тагтар,howling-fjord,1213,shaman,elemental,75,26,49
Dando,silvermoon,1212,shaman,elemental,36,16,20
Хипхопробот,gordunni,1211,shaman,elemental,28,14,14
Lukyjos,drakthul,1210,shaman,elemental,30,16,14
Hatyatya,ragnaros,1210,shaman,elemental,76,38,38
Akimboo,kilrogg,1208,shaman,elemental,54,26,28
Skeiilz,hyjal,1208,shaman,elemental,36,13,23
Teslasenpai,outland,1207,shaman,elemental,94,33,61
Rulasha,silvermoon,1205,shaman,elemental,36,14,22
Practicetwo,argent-dawn,1204,shaman,elemental,36,14,22
Babydòll,neptulon,1197,shaman,elemental,24,13,11
Elementhero,frostmane,1196,shaman,elemental,48,21,27
Xtatenea,uldum,1193,shaman,elemental,172,87,85
Pararrayøs,sanguino,1192,shaman,elemental,61,28,33
Shellex,kazzak,1190,shaman,elemental,213,110,103
Zjindi,shattered-hand,1190,shaman,elemental,30,15,15
Valdera,dun-morogh,1189,shaman,elemental,24,14,10
Derblitz,baelgun,1189,shaman,elemental,42,21,21
Sniffa,ysondre,1187,shaman,elemental,42,20,22
Strife,argent-dawn,1185,shaman,elemental,54,23,31
Syris,sinstralis,1185,shaman,elemental,42,17,25
Coton,grim-batol,1184,shaman,elemental,36,21,15
Zapper,blackrock,1184,shaman,elemental,69,28,41
Вайтиту,howling-fjord,1183,shaman,elemental,69,28,41
Räoûn,archimonde,1179,shaman,elemental,80,34,46
Lavalampa,magtheridon,1177,shaman,elemental,72,42,30
Amarök,nerzhul,1177,shaman,elemental,65,30,35
Stoned,sporeggar,1177,shaman,elemental,59,25,34
Меменосный,gordunni,1175,shaman,elemental,89,42,47
Амброски,gordunni,1174,shaman,elemental,84,49,35
Szvapotluk,ravencrest,1173,shaman,elemental,30,14,16
Nabo,archimonde,1173,shaman,elemental,32,13,19
Thokul,defias-brotherhood,1169,shaman,elemental,24,14,10
Bramùs,blackmoore,1168,shaman,elemental,60,24,36
Элемшамм,soulflayer,1167,shaman,elemental,83,47,36
Zhinjo,kazzak,1166,shaman,elemental,36,19,17
Blackmuamba,tarren-mill,1164,shaman,elemental,213,107,106
Kungfuali,antonidas,1163,shaman,elemental,232,110,122
Thrallotido,sanguino,1163,shaman,elemental,66,23,43
Фистинктотем,soulflayer,1162,shaman,elemental,35,16,19
Bigboisham,outland,1158,shaman,elemental,82,35,47
Ххенеси,soulflayer,1158,shaman,elemental,48,20,28
Azmerloth,outland,1152,shaman,elemental,18,12,6
Elemane,kazzak,1152,shaman,elemental,18,12,6
Дудивтф,soulflayer,1151,shaman,elemental,24,12,12
Neverplayele,kazzak,1151,shaman,elemental,24,12,12
Pedrototem,silvermoon,1149,shaman,elemental,48,31,17
Fimir,archimonde,1149,shaman,elemental,24,15,9
Эфирад,blackscar,1148,shaman,elemental,204,99,105
Justweirdaf,blackmoore,1148,shaman,elemental,45,20,25
Eustodia,minahonda,1146,shaman,elemental,18,14,4
Дзод,deathweaver,1146,shaman,elemental,24,12,12
Nebean,ragnaros,1146,shaman,elemental,24,12,12
Skullføck,argent-dawn,1145,shaman,elemental,24,12,12
Screwz,archimonde,1145,shaman,elemental,125,54,71
Socesalade,ysondre,1144,shaman,elemental,24,12,12
Thunderstryk,sylvanas,1143,shaman,elemental,72,37,35
Hekzen,tarren-mill,1143,shaman,elemental,27,13,14
Shamwowpow,stormscale,1142,shaman,elemental,30,12,18
Khanokekw,twisting-nether,1141,shaman,elemental,30,12,18
Ironmack,outland,1140,shaman,elemental,24,12,12
Zandali,tarren-mill,1139,shaman,elemental,43,24,19
Zuman,the-maelstrom,1138,shaman,elemental,36,19,17
Mohàwk,eredar,1135,shaman,elemental,96,48,48
Freizeitler,antonidas,1135,shaman,elemental,30,12,18
Zhid,zuljin,1135,shaman,elemental,36,12,24
Bahuq,antonidas,1134,shaman,elemental,18,12,6
Натуралист,galakrond,1130,shaman,elemental,30,12,18
Thunderrbob,darkspear,1129,shaman,elemental,43,25,18
Teslacoil,stormreaver,1129,shaman,elemental,84,45,39
Yaar,alleria,1126,shaman,elemental,36,22,14
Scurvy,malganis,1126,shaman,elemental,228,113,115
Saarroo,ravencrest,1126,shaman,elemental,60,25,35
Текка,fordragon,1126,shaman,elemental,30,12,18
Narkizza,silvermoon,1124,shaman,elemental,128,55,73
Schockolade,blackmoore,1122,shaman,elemental,30,12,18
Avarela,argent-dawn,1121,shaman,elemental,101,44,57
Bowtenstorm,ravencrest,1120,shaman,elemental,25,16,9
Goromar,kirin-tor,1116,shaman,elemental,145,67,78
Moilensis,archimonde,1116,shaman,elemental,36,13,23
Smohallah,naxxramas,1108,shaman,elemental,72,30,42
Gnark,dun-modr,1106,shaman,elemental,65,35,30
Fûchsí,blackhand,1104,shaman,elemental,107,55,52
Aslakki,turalyon,1099,shaman,elemental,128,56,72
Yasaburo,silvermoon,1097,shaman,elemental,29,15,14
Renegad,archimonde,1096,shaman,elemental,36,12,24
Thordahr,hyjal,1091,shaman,elemental,24,12,12
Kneggebrot,blackmoore,1090,shaman,elemental,27,13,14
Earthvixenz,ravencrest,1089,shaman,elemental,29,18,11
Grommalgue,hyjal,1089,shaman,elemental,40,19,21
Yalac,archimonde,1088,shaman,elemental,26,13,13
Hardsmoker,antonidas,1086,shaman,elemental,102,38,64
Drocthar,defias-brotherhood,1080,shaman,elemental,98,49,49
Hugzy,argent-dawn,1075,shaman,elemental,72,42,30
Озверею,goldrinn,1075,shaman,elemental,84,43,41
Deviantsham,tarren-mill,1072,shaman,elemental,84,42,42
Allfathêr,ragnaros,1072,shaman,elemental,36,14,22
Glenfinnan,pozzo-delleternità,1070,shaman,elemental,27,13,14
Slk,blackrock,1069,shaman,elemental,33,18,15
Poppelo,silvermoon,1068,shaman,elemental,26,12,14
Фоксняша,soulflayer,1067,shaman,elemental,43,21,22
Zerodown,outland,1064,shaman,elemental,189,92,97
Fàkecast,outland,1064,shaman,elemental,34,12,22
Бвансамдив,gordunni,1063,shaman,elemental,74,33,41
Procdaddy,eredar,1063,shaman,elemental,56,15,41
Drekthor,ulduar,1062,shaman,elemental,55,29,26
Vatrios,draenor,1062,shaman,elemental,48,20,28
Есю,howling-fjord,1056,shaman,elemental,18,11,7
Chirmani,blackrock,1055,shaman,elemental,12,11,1
Lekthar,draenor,1055,shaman,elemental,24,11,13
Kirïss,hyjal,1055,shaman,elemental,24,11,13
Furthehorde,frostmane,1054,shaman,elemental,18,11,7
Guccifootjob,defias-brotherhood,1054,shaman,elemental,22,12,10
Yraxara,draenor,1053,shaman,elemental,18,11,7
Èrò,blackhand,1053,shaman,elemental,24,11,13
Kiirø,ysondre,1052,shaman,elemental,94,48,46
Trastamar,dun-modr,1051,shaman,elemental,18,11,7
Штрайхен,blackscar,1051,shaman,elemental,24,11,13
Фанковарнесы,gordunni,1049,shaman,elemental,18,11,7
Raoult,ravencrest,1049,shaman,elemental,25,12,13
Louler,ragnaros,1049,shaman,elemental,24,11,13
Catatumbø,cthun,1049,shaman,elemental,24,11,13
Shamix,magtheridon,1049,shaman,elemental,32,11,21
Kylas,die-ewige-wacht,1047,shaman,elemental,18,11,7
Flork,burning-legion,1047,shaman,elemental,87,39,48
Frostshøck,tarren-mill,1046,shaman,elemental,18,11,7
Бородарастт,gordunni,1046,shaman,elemental,101,45,56
Schockbunny,blackrock,1046,shaman,elemental,30,11,19
Эртирон,howling-fjord,1044,shaman,elemental,24,11,13
Ofqds,archimonde,1044,shaman,elemental,24,11,13
Tpainx,kazzak,1043,shaman,elemental,24,11,13
Смогр,gordunni,1042,shaman,elemental,36,11,25
Trosy,burning-blade,1041,shaman,elemental,36,18,18
Mòra,silvermoon,1038,shaman,elemental,95,40,55
Дрекрош,howling-fjord,1037,shaman,elemental,210,96,114
Laquium,blackmoore,1032,shaman,elemental,37,15,22
Ormanthep,hyjal,1029,shaman,elemental,18,11,7
Flochy,argent-dawn,1027,shaman,elemental,53,31,22
Naedom,aggramar,1024,shaman,elemental,30,11,19
Especialista,uldum,1021,shaman,elemental,40,25,15
Ximid,doomhammer,1018,shaman,elemental,224,112,112
Terras,terokkar,1017,shaman,elemental,59,17,42
Sevk,ravencrest,1012,shaman,elemental,30,15,15
Loserlol,das-syndikat,1009,shaman,elemental,83,40,43
Beefnale,bladefist,1009,shaman,elemental,78,26,52
Naix,silvermoon,1009,shaman,elemental,36,11,25
Турелька,blackscar,1008,shaman,elemental,37,14,23
Nehehehehehe,drakthul,1007,shaman,elemental,21,11,10
Azovprime,terokkar,1007,shaman,elemental,24,11,13
Гленкуллен,blackscar,1006,shaman,elemental,72,32,40
Itsnasty,blackmoore,1004,shaman,elemental,42,20,22
Demelena,silvermoon,1003,shaman,elemental,18,11,7
Sijpetetmort,ysondre,1000,shaman,elemental,47,16,31
Hästdvärg,the-maelstrom,994,shaman,elemental,33,12,21
Mecct,ravencrest,984,shaman,elemental,28,11,17
Мурмус,eversong,984,shaman,elemental,60,13,47
Bluéshirtguy,blackhand,979,shaman,elemental,135,65,70
Kushme,silvermoon,979,shaman,elemental,84,40,44
Thatamazing,korgall,979,shaman,elemental,32,15,17
Велгур,soulflayer,979,shaman,elemental,54,23,31
Kcarlina,uldum,973,shaman,elemental,40,20,20
Raikton,pozzo-delleternità,971,shaman,elemental,106,44,62
Oddsocks,stormscale,969,shaman,elemental,111,44,67
Mimbar,thunderhorn,968,shaman,elemental,36,18,18
Gotrex,pozzo-delleternità,966,shaman,elemental,60,12,48
Lavadrak,eredar,960,shaman,elemental,12,10,2
ßlinky,outland,960,shaman,elemental,18,10,8
Strór,twisting-nether,960,shaman,elemental,18,10,8
Elemayó,tarren-mill,960,shaman,elemental,18,10,8
Näis,hyjal,960,shaman,elemental,18,10,8
Seyumi,draenor,960,shaman,elemental,24,10,14
Dshaman,aegwynn,960,shaman,elemental,24,10,14
Lovelyshaman,silvermoon,959,shaman,elemental,13,10,3
Hunteronpc,twisting-nether,959,shaman,elemental,18,10,8
Лучшийшаман,soulflayer,959,shaman,elemental,18,10,8
Bhargonen,silvermoon,959,shaman,elemental,18,10,8
Айбьорн,gordunni,959,shaman,elemental,24,10,14
Thundergødx,nemesis,959,shaman,elemental,24,10,14
Blover,drakthul,958,shaman,elemental,12,10,2
Rockstéady,outland,958,shaman,elemental,18,10,8
Rokils,silvermoon,958,shaman,elemental,18,10,8
Имсомниум,howling-fjord,958,shaman,elemental,30,10,20
Vestsha,frostmane,957,shaman,elemental,18,10,8
Raïgo,hyjal,957,shaman,elemental,18,10,8
Дректарыч,howling-fjord,957,shaman,elemental,18,10,8
Jazzrod,stormscale,957,shaman,elemental,24,10,14
Atuaßëlha,grim-batol,957,shaman,elemental,24,10,14
Гидрокорыто,gordunni,956,shaman,elemental,18,10,8
Rizorx,stormscale,956,shaman,elemental,21,11,10
Kunan,ysera,956,shaman,elemental,36,10,26
Drahka,kazzak,955,shaman,elemental,24,10,14
Klunkespiser,stormscale,955,shaman,elemental,30,10,20
Магмарончик,gordunni,953,shaman,elemental,78,27,51
Beastee,blackmoore,952,shaman,elemental,18,10,8
Aljorf,dun-modr,952,shaman,elemental,30,16,14
Jólla,twisting-nether,952,shaman,elemental,24,10,14
Varthon,tarren-mill,952,shaman,elemental,34,11,23
Hevercraft,archimonde,951,shaman,elemental,18,10,8
Sixinchwilly,outland,951,shaman,elemental,24,10,14
Chilliajin,tarren-mill,950,shaman,elemental,24,10,14
Kobeye,thrall,949,shaman,elemental,70,36,34
Babathar,ysondre,949,shaman,elemental,24,10,14
Блэкмаршал,howling-fjord,948,shaman,elemental,30,10,20
Rôhâr,stormscale,947,shaman,elemental,18,10,8
Nïà,kaelthas,946,shaman,elemental,56,20,36
Шейпан,gordunni,944,shaman,elemental,74,36,38
Óõ,dun-modr,938,shaman,elemental,18,10,8
Disharmony,outland,938,shaman,elemental,23,12,11
Rãgnãr,frostwolf,935,shaman,elemental,37,16,21
Watson,conseil-des-ombres,934,shaman,elemental,36,15,21
Louisvgaal,kazzak,934,shaman,elemental,24,10,14
Smorcxx,kazzak,934,shaman,elemental,30,10,20
Orishimaru,blackrock,932,shaman,elemental,23,10,13
Dëlkö,ravencrest,928,shaman,elemental,121,54,67
Jiaan,burning-legion,925,shaman,elemental,40,16,24
Соленый,booty-bay,924,shaman,elemental,162,75,87
Yukîmøn,hyjal,923,shaman,elemental,20,11,9
Бернтутрэп,soulflayer,919,shaman,elemental,29,10,19
Capslk,blackmoore,893,shaman,elemental,26,10,16
Garbushka,draenor,883,shaman,elemental,54,17,37
Cimbel,stormscale,880,shaman,elemental,13,10,3
Cloudborne,draenor,876,shaman,elemental,19,10,9
Kortgat,kilrogg,875,shaman,elemental,66,31,35
Captaînhuge,dunemaul,864,shaman,elemental,12,9,3
Jeelypink,dalaran,864,shaman,elemental,12,9,3
ßaraky,kazzak,864,shaman,elemental,12,9,3
Jaimê,ravencrest,864,shaman,elemental,18,9,9
Elvalya,archimonde,864,shaman,elemental,18,9,9
Lighttfeet,hyjal,864,shaman,elemental,18,9,9
Høtgødx,blackrock,864,shaman,elemental,19,9,10
Irønythar,drakthul,863,shaman,elemental,12,9,3
Фарраон,deathguard,863,shaman,elemental,18,9,9
Madeej,burning-legion,863,shaman,elemental,18,9,9
Luzzilol,garrosh,863,shaman,elemental,18,9,9
Satudarah,draenor,863,shaman,elemental,18,9,9
Рояльстарик,howling-fjord,863,shaman,elemental,18,9,9
Muertin,tarren-mill,863,shaman,elemental,18,9,9
Thunderstar,lightbringer,863,shaman,elemental,18,9,9
Terranator,sanguino,863,shaman,elemental,18,9,9
Bammë,archimonde,863,shaman,elemental,18,9,9
Dûmah,sanguino,863,shaman,elemental,25,10,15
Тайорн,howling-fjord,863,shaman,elemental,24,9,15
Kyraw,tarren-mill,863,shaman,elemental,24,9,15
Рэйвантотем,soulflayer,862,shaman,elemental,18,9,9
Ananasanax,twisting-nether,862,shaman,elemental,18,9,9
Strypsnare,auchindoun,862,shaman,elemental,18,9,9
Oroastbeef,archimonde,862,shaman,elemental,18,9,9
Shammehboi,auchindoun,862,shaman,elemental,21,10,11
Bunnz,kazzak,861,shaman,elemental,12,9,3
Fholst,draenor,861,shaman,elemental,18,9,9
Sopos,ragnaros,861,shaman,elemental,18,9,9
Blixtnedslag,shattered-hand,861,shaman,elemental,24,9,15
Ærö,outland,860,shaman,elemental,30,9,21
Hóonda,twisting-nether,858,shaman,elemental,18,9,9
Shamandeadly,aggra-português,858,shaman,elemental,18,9,9
Magraith,korgall,858,shaman,elemental,18,9,9
Undae,ravencrest,858,shaman,elemental,24,9,15
Lavahurt,kazzak,858,shaman,elemental,30,9,21
Hanumanas,kazzak,856,shaman,elemental,18,9,9
Taboune,illidan,854,shaman,elemental,18,9,9
Милыйдорогой,soulflayer,853,shaman,elemental,24,9,15
Proteasom,burning-legion,847,shaman,elemental,15,11,4
Бронзород,grom,840,shaman,elemental,12,9,3
Незнаком,booty-bay,834,shaman,elemental,42,19,23
Encourager,daggerspine,830,shaman,elemental,40,21,19
Fheng,defias-brotherhood,826,shaman,elemental,17,9,8
Grambozz,blackrock,825,shaman,elemental,16,9,7
Kíá,silvermoon,821,shaman,elemental,30,10,20
Elshamyonero,tarren-mill,815,shaman,elemental,18,10,8
Lowhpqt,blackrock,814,shaman,elemental,17,9,8
Lavaburstx,antonidas,810,shaman,elemental,28,10,18
Teleio,blackhand,807,shaman,elemental,29,11,18
Федосик,galakrond,806,shaman,elemental,133,65,68
Flowt,twisting-nether,799,shaman,elemental,23,9,14
Holdafstand,tarren-mill,798,shaman,elemental,14,9,5
Samlik,antonidas,796,shaman,elemental,39,10,29
Pappashaman,tarren-mill,768,shaman,elemental,10,9,1
Flam,outland,768,shaman,elemental,12,8,4
Palpazerr,archimonde,768,shaman,elemental,12,8,4
Bobobygunz,stormscale,768,shaman,elemental,12,8,4
Yerlas,burning-legion,768,shaman,elemental,12,8,4
Gødsplan,tarren-mill,768,shaman,elemental,12,8,4
Vygak,tarren-mill,768,shaman,elemental,12,8,4
Lakanukie,thrall,768,shaman,elemental,12,8,4
Indeed,frostmourne,768,shaman,elemental,12,8,4
Cöökiekeeper,twisting-nether,768,shaman,elemental,12,8,4
Imtwelvebtw,blackrock,768,shaman,elemental,12,8,4
Lilioz,ysondre,768,shaman,elemental,12,8,4
Idwala,outland,768,shaman,elemental,12,8,4
Twinshock,tarren-mill,768,shaman,elemental,18,8,10
Momine,stormscale,768,shaman,elemental,18,8,10
Totemly,alakir,768,shaman,elemental,18,8,10
Kónjo,kazzak,768,shaman,elemental,18,8,10
Gravépàct,blackrock,768,shaman,elemental,18,8,10
Shockleted,stormscale,768,shaman,elemental,18,8,10
Vix,argent-dawn,768,shaman,elemental,18,8,10
Lathisi,zenedar,768,shaman,elemental,19,8,11
Clickerboy,ravencrest,768,shaman,elemental,24,8,16
Thorunir,sylvanas,768,shaman,elemental,24,8,16
Minimalist,stormscale,767,shaman,elemental,12,8,4
Бладих,howling-fjord,767,shaman,elemental,12,8,4
Хексвглаз,howling-fjord,767,shaman,elemental,12,8,4
Bourdieu,thrall,767,shaman,elemental,12,8,4
Naargie,outland,767,shaman,elemental,12,8,4
Hobblefoot,stormscale,767,shaman,elemental,12,8,4
Kroit,stormreaver,767,shaman,elemental,12,8,4
Чаапалах,blackscar,767,shaman,elemental,12,8,4
Shámanos,sylvanas,767,shaman,elemental,12,8,4
Shamvareja,silvermoon,767,shaman,elemental,15,9,6
Darkterrors,dun-modr,767,shaman,elemental,16,9,7
Thunderdrak,sylvanas,767,shaman,elemental,17,8,9
Pìlle,eredar,767,shaman,elemental,18,8,10
Stonetone,silvermoon,767,shaman,elemental,18,8,10
Thomz,aggra-português,767,shaman,elemental,18,8,10
Вервольфоо,howling-fjord,767,shaman,elemental,24,8,16
Gaerth,aggramar,766,shaman,elemental,12,8,4
Mystico,sanguino,766,shaman,elemental,18,8,10
Forrak,argent-dawn,766,shaman,elemental,18,8,10
Talg,defias-brotherhood,766,shaman,elemental,21,8,13
Kossborax,blackhand,766,shaman,elemental,24,8,16
Parthon,ravencrest,765,shaman,elemental,12,8,4
Jollyhip,stormscale,765,shaman,elemental,12,8,4
Remkoo,blackrock,765,shaman,elemental,18,8,10
Khaleeya,blackmoore,765,shaman,elemental,24,8,16
Purgérkíng,silvermoon,764,shaman,elemental,18,8,10
Hexlettin,twisting-nether,763,shaman,elemental,18,8,10
Brryantblaks,colinas-pardas,763,shaman,elemental,23,10,13
Arabesk,arygos,763,shaman,elemental,24,9,15
Sugarsham,kazzak,763,shaman,elemental,24,8,16
Marhol,kirin-tor,761,shaman,elemental,18,8,10
Kennyo,uldum,739,shaman,elemental,30,10,20
Fourtwogodx,kazzak,735,shaman,elemental,20,9,11
Jessijames,outland,733,shaman,elemental,35,8,27
Vikingss,frostmane,722,shaman,elemental,17,8,9
Pakunamatata,shattrath,718,shaman,elemental,17,8,9
Gàtsby,archimonde,713,shaman,elemental,20,9,11
Feumble,archimonde,713,shaman,elemental,45,10,35
Reivhyl,magtheridon,704,shaman,elemental,10,8,2
Wacomtablet,kazzak,703,shaman,elemental,11,8,3
Baschúrr,blackrock,702,shaman,elemental,17,9,8
Кубадуба,blackscar,702,shaman,elemental,26,8,18
Fliszt,outland,672,shaman,elemental,13,8,5
Eneru,nemesis,672,shaman,elemental,12,7,5
Xayy,twisting-nether,672,shaman,elemental,12,7,5
Shamerific,magtheridon,672,shaman,elemental,12,7,5
Bharr,kazzak,672,shaman,elemental,12,7,5
Robcurly,blackmoore,672,shaman,elemental,12,7,5
Shamandoino,wildhammer,672,shaman,elemental,12,7,5
Kellesar,outland,672,shaman,elemental,12,7,5
Bonsaigodx,twisting-nether,672,shaman,elemental,12,7,5
Labûche,chogall,672,shaman,elemental,12,7,5
Dareos,anetheron,672,shaman,elemental,12,7,5
Windberg,ysondre,672,shaman,elemental,12,7,5
Бахмара,soulflayer,672,shaman,elemental,12,7,5
Bigblué,tarren-mill,672,shaman,elemental,12,7,5
Filiduttsham,ravencrest,672,shaman,elemental,12,7,5
Mogzu,blackmoore,672,shaman,elemental,12,7,5
Suldarissha,aegwynn,672,shaman,elemental,12,7,5
Экспатриот,greymane,672,shaman,elemental,12,7,5
Bosslikex,ravencrest,672,shaman,elemental,12,7,5
Kæde,dun-morogh,672,shaman,elemental,12,7,5
Thunderman,the-maelstrom,672,shaman,elemental,12,7,5
Wamah,sargeras,672,shaman,elemental,12,7,5
Brennokk,the-maelstrom,672,shaman,elemental,12,7,5
Гарбаджи,galakrond,672,shaman,elemental,12,7,5
Dynamodanny,blackmoore,672,shaman,elemental,12,7,5
Dócshock,blackmoore,672,shaman,elemental,12,7,5
Blakelivelyx,blackrock,672,shaman,elemental,18,7,11
Paidactor,kazzak,672,shaman,elemental,18,7,11
Yingou,azshara,672,shaman,elemental,18,7,11
Endry,elune,672,shaman,elemental,18,7,11
Reäz,archimonde,672,shaman,elemental,18,7,11
Шлолка,gordunni,672,shaman,elemental,18,7,11
Velkin,thrall,672,shaman,elemental,18,7,11
Caro,tarren-mill,672,shaman,elemental,18,7,11
Боузета,soulflayer,672,shaman,elemental,24,7,17
Феномх,deathguard,671,shaman,elemental,12,7,5
Rakamakafu,blackmoore,671,shaman,elemental,12,7,5
Санрэйн,soulflayer,671,shaman,elemental,12,7,5
Vukroth,argent-dawn,671,shaman,elemental,12,7,5
Lethal,darksorrow,671,shaman,elemental,18,7,11
Thunberg,ravencrest,671,shaman,elemental,18,7,11
Stephbäck,outland,671,shaman,elemental,18,7,11
Dogfrog,silvermoon,671,shaman,elemental,18,7,11
Moosavi,kazzak,671,shaman,elemental,18,7,11
Berzærker,ravencrest,671,shaman,elemental,24,7,17
Рокутаро,gordunni,670,shaman,elemental,12,7,5
Symy,draenor,670,shaman,elemental,12,7,5
Layonne,ysondre,670,shaman,elemental,18,7,11
Maelstorm,bronze-dragonflight,670,shaman,elemental,18,7,11
Jinbao,ravencrest,669,shaman,elemental,12,7,5
Carakh,archimonde,669,shaman,elemental,12,7,5
Интендо,soulflayer,668,shaman,elemental,12,7,5
Дбр,howling-fjord,667,shaman,elemental,18,7,11
Furian,die-nachtwache,666,shaman,elemental,12,7,5
Eratore,xavius,666,shaman,elemental,18,7,11
Zarakuda,magtheridon,663,shaman,elemental,34,9,25
Toxicnux,nemesis,655,shaman,elemental,17,7,10
Крузмвп,blackscar,655,shaman,elemental,23,7,16
Blyátmán,twisting-nether,638,shaman,elemental,14,8,6
Magmamartin,antonidas,638,shaman,elemental,23,7,16
Precíous,sporeggar,637,shaman,elemental,17,7,10
Kbds,outland,623,shaman,elemental,17,7,10
Вудвин,soulflayer,621,shaman,elemental,26,7,19
Wurstblinker,ravencrest,606,shaman,elemental,11,7,4
Elfenomeno,archimonde,576,shaman,elemental,6,6,0
Убицатысячи,soulflayer,576,shaman,elemental,6,6,0
Lavelover,tarren-mill,576,shaman,elemental,6,6,0
Ugáa,malganis,576,shaman,elemental,12,6,6
Tonifo,nemesis,576,shaman,elemental,12,6,6
Brandiløve,nemesis,576,shaman,elemental,12,6,6
Eddiemorphin,kazzak,576,shaman,elemental,12,6,6
Jíkkz,aegwynn,576,shaman,elemental,12,6,6
Yzeldan,hyjal,576,shaman,elemental,12,6,6
Linshock,tarren-mill,576,shaman,elemental,12,6,6
Magizey,defias-brotherhood,576,shaman,elemental,12,6,6
Shayal,defias-brotherhood,576,shaman,elemental,12,6,6
Localicious,ragnaros,576,shaman,elemental,12,6,6
Веег,deathweaver,576,shaman,elemental,12,6,6
Kilnih,archimonde,576,shaman,elemental,12,6,6
Shoewalker,ragnaros,576,shaman,elemental,12,6,6
Chocshock,tarren-mill,576,shaman,elemental,12,6,6
Pflöckli,blackmoore,576,shaman,elemental,12,6,6
Windfúhrèr,tarren-mill,576,shaman,elemental,12,6,6
Дагод,booty-bay,576,shaman,elemental,12,6,6
Elemefayoh,tarren-mill,576,shaman,elemental,12,6,6
Shamanirl,tarren-mill,576,shaman,elemental,12,6,6
Horokeu,blackrock,576,shaman,elemental,18,6,12
Chenoyaa,blackrock,576,shaman,elemental,18,6,12
Хыйь,howling-fjord,576,shaman,elemental,18,6,12
Mûhzala,blackmoore,576,shaman,elemental,18,6,12
Inyra,eredar,576,shaman,elemental,18,6,12
Elchivo,blackrock,576,shaman,elemental,18,6,12
Харно,gordunni,576,shaman,elemental,18,6,12
Krakatoa,dunemaul,576,shaman,elemental,24,6,18
Syndia,das-konsortium,575,shaman,elemental,12,6,6
Shlby,blackrock,575,shaman,elemental,12,6,6
Helloitsmee,thrall,575,shaman,elemental,12,6,6
Dobär,madmortem,575,shaman,elemental,12,6,6
Zulululul,burning-blade,575,shaman,elemental,12,6,6
Hardleft,stormscale,575,shaman,elemental,12,6,6
Tholdrin,outland,575,shaman,elemental,12,6,6
Скромнюля,eversong,575,shaman,elemental,12,6,6
Sparkybeard,ravencrest,575,shaman,elemental,12,6,6
Shockbestie,eredar,575,shaman,elemental,13,6,7
Wíndu,zuljin,575,shaman,elemental,21,7,14
Dreston,burning-blade,575,shaman,elemental,18,6,12
Téwa,hyjal,575,shaman,elemental,18,6,12
Grimrieper,stormscale,574,shaman,elemental,12,6,6
Nurychic,twisting-nether,574,shaman,elemental,12,6,6
Tiâna,archimonde,574,shaman,elemental,12,6,6
Yeah,emeriss,574,shaman,elemental,18,6,12
Shachira,silvermoon,571,shaman,elemental,12,6,6
Attm,twisting-nether,570,shaman,elemental,20,10,10
Isheartears,outland,543,shaman,elemental,11,6,5
Vyrá,onyxia,543,shaman,elemental,11,6,5
Darkara,forscherliga,527,shaman,elemental,11,6,5
Saintlyjin,kult-der-verdammten,527,shaman,elemental,11,6,5
Rezervoir,bladefist,522,shaman,elemental,15,9,6
Shaggé,tarren-mill,480,shaman,elemental,6,5,1
Boltar,die-aldor,480,shaman,elemental,6,5,1
Jarreau,turalyon,480,shaman,elemental,6,5,1
Langhantel,kazzak,480,shaman,elemental,6,5,1
Electricgødx,tarren-mill,480,shaman,elemental,6,5,1
Phobiatics,thrall,480,shaman,elemental,6,5,1
Mëditåtïøñ,blackrock,480,shaman,elemental,6,5,1
Efdemin,blackmoore,480,shaman,elemental,6,5,1
Zujaz,stormscale,480,shaman,elemental,6,5,1
Squixi,tarren-mill,480,shaman,elemental,6,5,1
Kikbokser,kazzak,480,shaman,elemental,6,5,1
Bumstead,ragnaros,480,shaman,elemental,6,5,1
Hexina,ragnaros,480,shaman,elemental,6,5,1
Izosha,hyjal,480,shaman,elemental,6,5,1
Plsdontpress,stormscale,480,shaman,elemental,6,5,1
Kenpaci,stormscale,480,shaman,elemental,6,5,1
Múixi,sanguino,480,shaman,elemental,10,6,4
Pianoforte,stormscale,480,shaman,elemental,10,6,4
Наладчик,gordunni,480,shaman,elemental,12,5,7
Cloovster,magtheridon,480,shaman,elemental,12,5,7
Ýípìÿøû,dun-modr,480,shaman,elemental,12,5,7
Вишняблэйз,soulflayer,480,shaman,elemental,12,5,7
Greur,twisting-nether,480,shaman,elemental,12,5,7
Tøõøõntêëêët,dun-modr,480,shaman,elemental,12,5,7
Tuncha,runetotem,480,shaman,elemental,12,5,7
Rykarn,eredar,480,shaman,elemental,12,5,7
Loshohealva,stormscale,480,shaman,elemental,12,5,7
Айспик,ashenvale,480,shaman,elemental,12,5,7
Smashsmash,the-maelstrom,480,shaman,elemental,12,5,7
Azariasz,twisting-nether,480,shaman,elemental,12,5,7
Maddskull,argent-dawn,480,shaman,elemental,12,5,7
Froostshoock,eredar,480,shaman,elemental,12,5,7
Bldyhatesyou,blackmoore,480,shaman,elemental,12,5,7
Zapojin,blackhand,480,shaman,elemental,12,5,7
Lindemánn,blackhand,480,shaman,elemental,12,5,7
Stòrm,ravencrest,480,shaman,elemental,12,5,7
Wâisted,ravencrest,480,shaman,elemental,12,5,7
Solobolo,ravencrest,480,shaman,elemental,12,5,7
Noru,ravencrest,480,shaman,elemental,12,5,7
Cptcutíe,antonidas,480,shaman,elemental,12,5,7
Danriesh,ravencrest,480,shaman,elemental,12,5,7
Суттех,soulflayer,480,shaman,elemental,12,5,7
Ketzersend,alleria,480,shaman,elemental,12,5,7
Susais,outland,480,shaman,elemental,12,5,7
Wûcs,silvermoon,480,shaman,elemental,12,5,7
Youngnastyx,blackrock,480,shaman,elemental,12,5,7
Amcin,stormreaver,480,shaman,elemental,12,5,7
Vìp,outland,480,shaman,elemental,12,5,7
Thàrin,archimonde,480,shaman,elemental,12,5,7
Neystee,archimonde,480,shaman,elemental,12,5,7
Flaskmus,haomarush,480,shaman,elemental,12,5,7
Greenswag,drakthul,480,shaman,elemental,12,5,7
Синнити,blackscar,480,shaman,elemental,12,5,7
Arigato,eonar,480,shaman,elemental,12,5,7
Swapxy,outland,480,shaman,elemental,12,5,7
Bahane,frostwolf,480,shaman,elemental,15,6,9
Kappatotem,silvermoon,480,shaman,elemental,18,5,13
Gethrok,rajaxx,480,shaman,elemental,18,5,13
Квелси,gordunni,480,shaman,elemental,18,5,13
Чикочирони,gordunni,480,shaman,elemental,18,5,13
Shamurky,kazzak,480,shaman,elemental,18,5,13
Havoc,boulderfist,480,shaman,elemental,18,5,13
Thunda,stormreaver,480,shaman,elemental,18,5,13
Nehrzul,malygos,480,shaman,elemental,18,5,13
Pinkylol,stormscale,480,shaman,elemental,24,5,19
Mïzû,conseil-des-ombres,479,shaman,elemental,12,5,7
Burnprof,nethersturm,479,shaman,elemental,12,5,7
Rinks,hyjal,479,shaman,elemental,12,5,7
Фурэн,soulflayer,479,shaman,elemental,12,5,7
Thundersioux,ravencrest,479,shaman,elemental,12,5,7
Albedøo,ragnaros,479,shaman,elemental,18,5,13
Tregator,burning-legion,479,shaman,elemental,18,5,13
Punchì,blackhand,479,shaman,elemental,24,5,19
Sinwithin,ravencrest,478,shaman,elemental,12,5,7
Chämalö,archimonde,476,shaman,elemental,12,5,7
Rayitoss,tyrande,456,shaman,elemental,18,7,11
Skengshammy,ragnaros,446,shaman,elemental,11,5,6
Urub,draenor,432,shaman,elemental,15,5,10
Mareaspibas,zuljin,431,shaman,elemental,11,5,6
Charth,ravencrest,428,shaman,elemental,9,5,4
Envergur,eitrigg,417,shaman,elemental,13,6,7
Blùé,tarren-mill,399,shaman,elemental,5,5,0
Teckan,tarren-mill,384,shaman,elemental,6,4,2
Márcon,das-konsortium,384,shaman,elemental,6,4,2
Aleshade,argent-dawn,384,shaman,elemental,6,4,2
Sugarfreé,ragnaros,384,shaman,elemental,6,4,2
Shafallen,tarren-mill,384,shaman,elemental,6,4,2
Euprathree,archimonde,384,shaman,elemental,6,4,2
Bkdgoodz,aegwynn,384,shaman,elemental,6,4,2
Rahuna,darksorrow,384,shaman,elemental,6,4,2
Criæ,blackrock,384,shaman,elemental,6,4,2
Jacc,sunstrider,384,shaman,elemental,6,4,2
Sebubu,twisting-nether,384,shaman,elemental,6,4,2
Finpower,kul-tiras,384,shaman,elemental,6,4,2
Ybbarcs,eredar,384,shaman,elemental,6,4,2
Pvpmax,blackhand,384,shaman,elemental,6,4,2
Trustlemac,onyxia,384,shaman,elemental,6,4,2
Stormlash,shattered-halls,384,shaman,elemental,6,4,2
Vøhm,archimonde,384,shaman,elemental,6,4,2
Shøckbot,blackhand,384,shaman,elemental,6,4,2
Tóuka,uldum,384,shaman,elemental,6,4,2
Zippidizap,ulduar,384,shaman,elemental,6,4,2
Kalji,archimonde,384,shaman,elemental,6,4,2
Flambusier,hyjal,384,shaman,elemental,6,4,2
Lyrashaman,draenor,384,shaman,elemental,6,4,2
Mící,argent-dawn,384,shaman,elemental,6,4,2
Hispanoxd,sanguino,384,shaman,elemental,6,4,2
Moôn,argent-dawn,384,shaman,elemental,6,4,2
Вашнюхтоптал,howling-fjord,384,shaman,elemental,6,4,2
Gandy,the-maelstrom,384,shaman,elemental,6,4,2
Føxï,pozzo-delleternità,384,shaman,elemental,6,4,2
Prokken,garrosh,384,shaman,elemental,6,4,2
Yacuzwerg,blackrock,384,shaman,elemental,6,4,2
Schamîx,blackrock,384,shaman,elemental,6,4,2
Kévinn,draenor,384,shaman,elemental,6,4,2
Selonthyx,ravencrest,384,shaman,elemental,6,4,2
Тотембот,soulflayer,384,shaman,elemental,10,5,5
Bigthór,kazzak,384,shaman,elemental,8,4,4
Khankayn,kilrogg,384,shaman,elemental,12,4,8
Saggrox,kazzak,384,shaman,elemental,12,4,8
Nùrsegemy,nemesis,384,shaman,elemental,12,4,8
Rompelukt,auchindoun,384,shaman,elemental,12,4,8
Goitbate,azuremyst,384,shaman,elemental,12,4,8
Xyckas,terrordar,384,shaman,elemental,12,4,8
Jäck,ravencrest,384,shaman,elemental,12,4,8
Cùn,blackmoore,384,shaman,elemental,12,4,8
Castør,silvermoon,384,shaman,elemental,12,4,8
Míza,ravencrest,384,shaman,elemental,12,4,8
Björnbritta,outland,384,shaman,elemental,12,4,8
Mawae,thrall,384,shaman,elemental,12,4,8
Shïnnkøk,stormscale,384,shaman,elemental,12,4,8
Вензеро,howling-fjord,384,shaman,elemental,12,4,8
Апинсмок,soulflayer,384,shaman,elemental,12,4,8
Tanillopzz,dun-modr,384,shaman,elemental,12,4,8
Slayerborn,eldrethalas,384,shaman,elemental,12,4,8
Jackburst,wrathbringer,384,shaman,elemental,12,4,8
Othemix,tarren-mill,384,shaman,elemental,12,4,8
Ogmehu,stormreaver,384,shaman,elemental,12,4,8
Zoolza,kirin-tor,384,shaman,elemental,12,4,8
Kookaboo,blackrock,384,shaman,elemental,12,4,8
Réläx,kazzak,384,shaman,elemental,12,4,8
Setac,stormscale,384,shaman,elemental,12,4,8
Karissah,silvermoon,384,shaman,elemental,12,4,8
Stlakañ,chants-éternels,384,shaman,elemental,12,4,8
Styxsm,blackhand,384,shaman,elemental,12,4,8
Zæüs,ragnaros,384,shaman,elemental,12,4,8
Nuekx,sanguino,384,shaman,elemental,12,4,8
Magicmekoz,draenor,384,shaman,elemental,12,4,8
Eskìmo,malganis,384,shaman,elemental,12,4,8
Rocktopus,outland,384,shaman,elemental,12,4,8
Snusy,stormscale,384,shaman,elemental,12,4,8
Димасечка,galakrond,384,shaman,elemental,12,4,8
Tism,stormscale,384,shaman,elemental,12,4,8
Znakharke,silvermoon,384,shaman,elemental,12,4,8
Hí,bronzebeard,384,shaman,elemental,12,4,8
Пса,fordragon,384,shaman,elemental,12,4,8
Swart,hyjal,384,shaman,elemental,12,4,8
Aleen,chogall,384,shaman,elemental,18,4,14
Zíp,archimonde,384,shaman,elemental,18,4,14
Zokah,emeriss,383,shaman,elemental,6,4,2
Rextion,ravencrest,383,shaman,elemental,6,4,2
Кеквэклоун,soulflayer,383,shaman,elemental,6,4,2
Разодран,gordunni,383,shaman,elemental,6,4,2
Purgedaddy,tarren-mill,383,shaman,elemental,6,4,2
Áza,archimonde,383,shaman,elemental,9,5,4
Dudoras,doomhammer,383,shaman,elemental,18,4,14
Santy,silvermoon,352,shaman,elemental,10,4,6
Roastý,blackrock,346,shaman,elemental,17,6,11
Khalamity,ravencrest,330,shaman,elemental,14,6,8
Raaborio,blackmoore,330,shaman,elemental,17,6,11
Cringergodx,blackhand,330,shaman,elemental,15,5,10
Gigawats,sylvanas,319,shaman,elemental,5,4,1
ßaßystärz,hyjal,319,shaman,elemental,5,4,1
Rinoh,stormreaver,319,shaman,elemental,8,4,4
Penesecco,nemesis,288,shaman,elemental,6,3,3
Filigran,ragnaros,288,shaman,elemental,6,3,3
Qicholardon,archimonde,288,shaman,elemental,6,3,3
Amu,ravencrest,288,shaman,elemental,6,3,3
Ghettero,ragnaros,288,shaman,elemental,6,3,3
Peaktrim,tarren-mill,288,shaman,elemental,6,3,3
Yashëa,ysondre,288,shaman,elemental,6,3,3
Nightingäle,silvermoon,288,shaman,elemental,6,3,3
Natty,ravencrest,288,shaman,elemental,6,3,3
Царьбер,soulflayer,288,shaman,elemental,6,3,3
Xye,bloodfeather,288,shaman,elemental,6,3,3
Begeshaman,sylvanas,288,shaman,elemental,6,3,3
Bladeyx,ragnaros,288,shaman,elemental,6,3,3
Tuftonshaman,ravencrest,288,shaman,elemental,6,3,3
Soozkovic,blackmoore,288,shaman,elemental,6,3,3
Херургх,soulflayer,288,shaman,elemental,6,3,3
Putrìfy,ravencrest,288,shaman,elemental,6,3,3
Sházam,destromath,288,shaman,elemental,6,3,3
Another,hakkar,288,shaman,elemental,6,3,3
Онеоне,deathweaver,288,shaman,elemental,6,3,3
Ramuthra,sanguino,288,shaman,elemental,6,3,3
Gelthan,zuljin,288,shaman,elemental,6,3,3
Fufupartyxx,blackrock,288,shaman,elemental,6,3,3
Sëídhr,arathi,288,shaman,elemental,6,3,3
Brobir,frostmane,288,shaman,elemental,6,3,3
Rubmetotems,burning-legion,288,shaman,elemental,6,3,3
Crysham,tarren-mill,288,shaman,elemental,6,3,3
Brandbombe,frostwolf,288,shaman,elemental,6,3,3
Shamanmans,grim-batol,288,shaman,elemental,6,3,3
Güinfury,zuljin,288,shaman,elemental,6,3,3
Joeyexe,outland,288,shaman,elemental,6,3,3
Volvíc,tichondrius,288,shaman,elemental,6,3,3
Mjukiz,tarren-mill,288,shaman,elemental,6,3,3
Whatsup,aggramar,288,shaman,elemental,6,3,3
Gorgath,dunemaul,288,shaman,elemental,6,3,3
Lefita,drakthul,288,shaman,elemental,6,3,3
Энхай,azuregos,288,shaman,elemental,6,3,3
Родохрозид,blackscar,288,shaman,elemental,6,3,3
Qenninka,drakthul,288,shaman,elemental,6,3,3
Тотемныйчад,gordunni,288,shaman,elemental,6,3,3
Ftier,ravencrest,288,shaman,elemental,6,3,3
Wincard,arathor,288,shaman,elemental,6,3,3
Faroh,ravencrest,288,shaman,elemental,6,3,3
Tjamei,outland,288,shaman,elemental,6,3,3
Eisenfêind,antonidas,288,shaman,elemental,6,3,3
Bharudor,antonidas,288,shaman,elemental,6,3,3
Neirdae,thunderhorn,288,shaman,elemental,6,3,3
Peneapunta,nemesis,288,shaman,elemental,6,3,3
Bas,nagrand,288,shaman,elemental,6,3,3
Saduria,antonidas,288,shaman,elemental,6,3,3
Tswiftx,tarren-mill,288,shaman,elemental,6,3,3
Nokosi,doomhammer,288,shaman,elemental,6,3,3
Shaulic,ravencrest,288,shaman,elemental,6,3,3
Shamazzle,kazzak,288,shaman,elemental,6,3,3
Nastysham,blackrock,288,shaman,elemental,6,3,3
Ezrasian,ragnaros,288,shaman,elemental,6,3,3
Blyxuhm,argent-dawn,288,shaman,elemental,6,3,3
Kapristylez,outland,288,shaman,elemental,6,3,3
Estexxsham,kazzak,288,shaman,elemental,6,3,3
Taggarengg,ragnaros,288,shaman,elemental,6,3,3
Gissary,drakthul,288,shaman,elemental,6,3,3
Hotstorm,bronzebeard,288,shaman,elemental,6,3,3
Dagra,twisting-nether,288,shaman,elemental,6,3,3
Ilovédogs,tarren-mill,288,shaman,elemental,6,3,3
Sponktrasado,eredar,288,shaman,elemental,6,3,3
Alphà,stormscale,288,shaman,elemental,6,3,3
Diffrinity,tarren-mill,288,shaman,elemental,6,3,3
Shamuzan,malfurion,288,shaman,elemental,6,3,3
Lunarsloth,hyjal,288,shaman,elemental,6,3,3
Dünnbier,blackhand,288,shaman,elemental,6,3,3
Shamanshow,eredar,288,shaman,elemental,6,3,3
Natureabuser,kazzak,288,shaman,elemental,6,3,3
Lifetimepro,twisting-nether,288,shaman,elemental,6,3,3
Hethne,kazzak,288,shaman,elemental,6,3,3
Zoraan,stormscale,288,shaman,elemental,6,3,3
Voodoodoouu,stormscale,288,shaman,elemental,6,3,3
Exolnard,twisting-nether,288,shaman,elemental,6,3,3
Nethershock,blackmoore,288,shaman,elemental,6,3,3
Whyisitspicy,kazzak,288,shaman,elemental,6,3,3
Kaptt,twisting-nether,288,shaman,elemental,6,3,3
Bigpinkpig,thunderhorn,288,shaman,elemental,7,3,4
Kletskebang,tarren-mill,288,shaman,elemental,10,4,6
Rargosh,malorne,288,shaman,elemental,12,3,9
Qwunjin,ragnaros,288,shaman,elemental,12,3,9
Gaera,veknilash,288,shaman,elemental,12,3,9
Benzi,ragnaros,288,shaman,elemental,12,3,9
Eliteblood,kazzak,288,shaman,elemental,12,3,9
Rätxs,blackhand,288,shaman,elemental,12,3,9
Throkal,blackhand,288,shaman,elemental,12,3,9
Iceshockz,sylvanas,288,shaman,elemental,12,3,9
Fatyoe,eredar,288,shaman,elemental,12,3,9
Grinan,hyjal,288,shaman,elemental,12,3,9
Tir,auchindoun,288,shaman,elemental,12,3,9
Korbas,burning-legion,288,shaman,elemental,12,3,9
Berith,spinebreaker,288,shaman,elemental,12,3,9
Yánux,aegwynn,288,shaman,elemental,12,3,9
Vodoochild,hyjal,288,shaman,elemental,12,3,9
Tonto,frostmane,288,shaman,elemental,12,3,9
Izir,archimonde,288,shaman,elemental,12,3,9
Frostpunk,tarren-mill,288,shaman,elemental,12,3,9
Чтозабред,gordunni,288,shaman,elemental,12,3,9
Fouchin,outland,288,shaman,elemental,12,3,9
Bónkas,kazzak,288,shaman,elemental,12,3,9
Joeculdacier,hyjal,288,shaman,elemental,12,3,9
Cazzari,thrall,288,shaman,elemental,12,3,9
Opaque,doomhammer,288,shaman,elemental,12,3,9
Azifox,hyjal,288,shaman,elemental,12,3,9
Corlysvelary,doomhammer,288,shaman,elemental,12,3,9
Aslansütü,eredar,288,shaman,elemental,12,3,9
Hecalix,ysondre,288,shaman,elemental,12,3,9
Elemania,mugthol,288,shaman,elemental,12,3,9
Jaeslin,tarren-mill,288,shaman,elemental,12,3,9
Woolysocks,draenor,288,shaman,elemental,12,3,9
Megaherz,sanguino,287,shaman,elemental,6,3,3
Bogatyrk,twisting-nether,287,shaman,elemental,6,3,3
Twotwozero,defias-brotherhood,286,shaman,elemental,6,3,3
Zalacrass,sanguino,286,shaman,elemental,6,3,3
Эскки,gordunni,286,shaman,elemental,6,3,3
Вещун,deathguard,284,shaman,elemental,12,3,9
Thytor,blackmoore,239,shaman,elemental,5,3,2
Deathshamãn,stormscale,239,shaman,elemental,11,3,8
Beautie,sylvanas,234,shaman,elemental,14,4,10
Kayden,uldum,234,shaman,elemental,15,4,11
Ahrim,argent-dawn,192,shaman,elemental,6,2,4
Conor,kult-der-verdammten,192,shaman,elemental,6,2,4
Garakh,argent-dawn,192,shaman,elemental,6,2,4
Waterpistol,twisting-nether,192,shaman,elemental,6,2,4
Nuvet,argent-dawn,192,shaman,elemental,6,2,4
Nabq,hyjal,192,shaman,elemental,6,2,4
Mynaye,hyjal,192,shaman,elemental,6,2,4
Patites,twisting-nether,192,shaman,elemental,6,2,4
Beletili,chogall,192,shaman,elemental,6,2,4
Baxz,twisting-nether,192,shaman,elemental,6,2,4
Purgegødxx,aegwynn,192,shaman,elemental,6,2,4
Zinlay,tarren-mill,192,shaman,elemental,6,2,4
Goreflame,argent-dawn,192,shaman,elemental,6,2,4
Ishkadar,twisting-nether,192,shaman,elemental,6,2,4
Chllup,drakthul,192,shaman,elemental,6,2,4
Bomboclat,azjolnerub,192,shaman,elemental,6,2,4
Cptsham,blackrock,192,shaman,elemental,6,2,4
Rakermän,dun-modr,192,shaman,elemental,6,2,4
Céndri,dun-modr,192,shaman,elemental,6,2,4
Ratatakéas,archimonde,192,shaman,elemental,6,2,4
Nnekalol,twisting-nether,192,shaman,elemental,6,2,4
Durinlaso,sanguino,192,shaman,elemental,6,2,4
Yöh,tarren-mill,192,shaman,elemental,6,2,4
Stivishamy,blackmoore,192,shaman,elemental,6,2,4
Zappyhog,turalyon,192,shaman,elemental,6,2,4
Lynox,ragnaros,192,shaman,elemental,6,2,4
Milara,anachronos,192,shaman,elemental,6,2,4
Telezex,twisting-nether,192,shaman,elemental,6,2,4
Растабоба,galakrond,192,shaman,elemental,6,2,4
Dormido,sanguino,192,shaman,elemental,6,2,4
Wawawoowee,archimonde,192,shaman,elemental,6,2,4
Shàmeonyou,dun-morogh,192,shaman,elemental,6,2,4
Roastbeef,blackrock,192,shaman,elemental,6,2,4
Шамяра,blackscar,192,shaman,elemental,6,2,4
Oldbuttgold,archimonde,192,shaman,elemental,6,2,4
Shamarre,executus,192,shaman,elemental,6,2,4
Tuksy,darkspear,192,shaman,elemental,6,2,4
Mehex,tarren-mill,192,shaman,elemental,6,2,4
Rok,darkspear,192,shaman,elemental,6,2,4
Cafardxx,archimonde,192,shaman,elemental,6,2,4
Mikah,frostwhisper,192,shaman,elemental,6,2,4
Macetoyaface,darksorrow,192,shaman,elemental,6,2,4
Frý,archimonde,192,shaman,elemental,6,2,4
Wârmachiine,burning-legion,192,shaman,elemental,6,2,4
Tigro,burning-legion,192,shaman,elemental,6,2,4
Laserra,sylvanas,192,shaman,elemental,6,2,4
Firsttime,alakir,192,shaman,elemental,6,2,4
Soeptent,tarren-mill,192,shaman,elemental,6,2,4
Anöuchkâ,ysondre,192,shaman,elemental,6,2,4
Exílium,tarren-mill,192,shaman,elemental,6,2,4
Albatroz,the-maelstrom,192,shaman,elemental,6,2,4
Reinssay,ysondre,192,shaman,elemental,6,2,4
Yobanivrot,the-maelstrom,192,shaman,elemental,6,2,4
Zackyboi,tarren-mill,192,shaman,elemental,6,2,4
Шаеман,soulflayer,192,shaman,elemental,6,2,4
Tates,jaedenar,192,shaman,elemental,6,2,4
Phènomènom,tarren-mill,192,shaman,elemental,6,2,4
Сновидений,soulflayer,192,shaman,elemental,6,2,4
Yiyi,boulderfist,192,shaman,elemental,6,2,4
Somnyum,alleria,192,shaman,elemental,6,2,4
Buffchampls,dalaran,192,shaman,elemental,6,2,4
Blubb,rajaxx,192,shaman,elemental,6,2,4
Bjerknes,draenor,192,shaman,elemental,6,2,4
Fuzzbolt,silvermoon,192,shaman,elemental,6,2,4
Dodododfewal,stormscale,192,shaman,elemental,6,2,4
Éàsy,blackmoore,192,shaman,elemental,6,2,4
Casterzajx,kazzak,192,shaman,elemental,6,2,4
Netaliya,kazzak,192,shaman,elemental,6,2,4
Melliska,silvermoon,192,shaman,elemental,6,2,4
Пимз,gordunni,192,shaman,elemental,6,2,4
Импфаразел,gordunni,192,shaman,elemental,6,2,4
Lemonez,ravencrest,192,shaman,elemental,6,2,4
Karpsham,stormscale,192,shaman,elemental,6,2,4
Equipshammy,silvermoon,192,shaman,elemental,6,2,4
Amonshokz,tarren-mill,192,shaman,elemental,6,2,4
Präsi,die-aldor,192,shaman,elemental,6,2,4
Zugx,silvermoon,192,shaman,elemental,6,2,4
Тандерхем,gordunni,192,shaman,elemental,6,2,4
Giïh,ravencrest,192,shaman,elemental,6,2,4
Djxyoloswag,silvermoon,192,shaman,elemental,6,2,4
Checkpoint,defias-brotherhood,192,shaman,elemental,6,2,4
Shreddedcntw,ravencrest,192,shaman,elemental,6,2,4
Littletrall,outland,192,shaman,elemental,6,2,4
Keisys,kazzak,192,shaman,elemental,6,2,4
Fläskbjarne,stormscale,192,shaman,elemental,6,2,4
Papskalla,ravencrest,192,shaman,elemental,6,2,4
Behemothsm,kazzak,192,shaman,elemental,6,2,4
Драгенхз,gordunni,192,shaman,elemental,6,2,4
Лаваяшка,gordunni,192,shaman,elemental,6,2,4
Semiro,draenor,192,shaman,elemental,6,2,4
Elshamino,ravencrest,192,shaman,elemental,6,2,4
Tolk,thrall,192,shaman,elemental,6,2,4
Kolchidyalah,la-croisade-écarlate,192,shaman,elemental,6,2,4
Rindenmulch,eredar,192,shaman,elemental,6,2,4
Shadowlolz,kazzak,192,shaman,elemental,6,2,4
Vaelox,kazzak,192,shaman,elemental,6,2,4
Squixi,ravencrest,192,shaman,elemental,6,2,4
Krovogor,silvermoon,192,shaman,elemental,6,2,4
Shambamm,stormscale,192,shaman,elemental,6,2,4
Beánz,blackmoore,192,shaman,elemental,6,2,4
Hairybolter,draenor,192,shaman,elemental,6,2,4
Wiev,blackmoore,192,shaman,elemental,6,2,4
Hogmodig,tarren-mill,192,shaman,elemental,7,2,5
Sweetcåndy,stormscale,192,shaman,elemental,12,2,10
Nakenfeigy,stormreaver,192,shaman,elemental,12,2,10
Cámmy,twisting-nether,192,shaman,elemental,12,2,10
Yarøu,antonidas,192,shaman,elemental,12,2,10
Максобман,howling-fjord,192,shaman,elemental,12,2,10
Thornyberrý,outland,192,shaman,elemental,12,2,10
Неерззул,soulflayer,192,shaman,elemental,12,2,10
Зуфар,howling-fjord,192,shaman,elemental,12,2,10
Lycburst,twisting-nether,192,shaman,elemental,12,2,10
Огневед,soulflayer,192,shaman,elemental,12,2,10
Ghostx,nemesis,192,shaman,elemental,18,2,16
Zeiger,minahonda,192,shaman,elemental,24,2,22
Khraajsy,sylvanas,191,shaman,elemental,6,2,4
Aspirio,ravencrest,175,shaman,elemental,11,2,9
Kivra,burning-legion,159,shaman,elemental,5,2,3
Thalgryn,twisting-nether,159,shaman,elemental,8,3,5
Tarzh,dalaran,159,shaman,elemental,8,3,5
Kortën,khaz-modan,159,shaman,elemental,10,2,8
Dragornor,grim-batol,144,shaman,elemental,3,3,0
Artigeartig,draenor,144,shaman,elemental,3,3,0
Jimkopf,eredar,138,shaman,elemental,10,4,6
Clappagobzz,kazzak,138,shaman,elemental,8,3,5
Disneyplus,tarren-mill,138,shaman,elemental,8,3,5
Amiashaman,stormscale,138,shaman,elemental,16,3,13
Корсика,gordunni,128,shaman,elemental,4,2,2
Shakgor,draenor,128,shaman,elemental,4,2,2
Zadrams,argent-dawn,96,shaman,elemental,3,2,1
Plarus,aegwynn,96,shaman,elemental,3,2,1
Grytkungen,daggerspine,96,shaman,elemental,3,2,1
Simpledream,tarren-mill,96,shaman,elemental,3,2,1
Bram,aggra-português,96,shaman,elemental,3,2,1
Thorcasso,azuremyst,96,shaman,elemental,3,2,1
Nopivøt,hyjal,96,shaman,elemental,7,2,5
Ferdizap,draenor,96,shaman,elemental,6,1,5
Elijaá,nordrassil,96,shaman,elemental,6,1,5
Grillfleîsch,azshara,96,shaman,elemental,6,1,5
Bärtigbaron,thrall,96,shaman,elemental,6,1,5
Shàwyn,sylvanas,96,shaman,elemental,6,1,5
Samisu,blackmoore,96,shaman,elemental,6,1,5
Ramaka,aegwynn,96,shaman,elemental,6,1,5
Bonestompamc,blackmoore,96,shaman,elemental,6,1,5
Nìtratx,archimonde,96,shaman,elemental,6,1,5
Hagelbrakan,stormscale,96,shaman,elemental,6,1,5
Ânne,blackrock,96,shaman,elemental,6,1,5
Killhorn,malganis,96,shaman,elemental,6,1,5
Glug,magtheridon,96,shaman,elemental,6,1,5
Nafay,lordaeron,96,shaman,elemental,6,1,5
Rakat,twisting-nether,96,shaman,elemental,6,1,5
Пэппивкашке,howling-fjord,96,shaman,elemental,6,1,5
Mittyzap,kazzak,96,shaman,elemental,6,1,5
Qï,tarren-mill,96,shaman,elemental,6,1,5
Lexyiasz,kazzak,96,shaman,elemental,6,1,5
Elementy,bronze-dragonflight,96,shaman,elemental,6,1,5
Bualocktv,sylvanas,96,shaman,elemental,6,1,5
Freexx,aegwynn,96,shaman,elemental,6,1,5
Hikigane,marécage-de-zangar,96,shaman,elemental,6,1,5
Saburo,thrall,96,shaman,elemental,6,1,5
Panzarkamp,stormscale,96,shaman,elemental,6,1,5
Fugasaku,sanguino,96,shaman,elemental,6,1,5
Xørd,ysondre,96,shaman,elemental,6,1,5
Newÿorc,dalaran,96,shaman,elemental,6,1,5
Felcrushed,stormscale,96,shaman,elemental,6,1,5
Venterlofeu,archimonde,96,shaman,elemental,6,1,5
Electroklart,defias-brotherhood,96,shaman,elemental,6,1,5
Bonjwa,eitrigg,96,shaman,elemental,6,1,5
Ämbientador,sanguino,96,shaman,elemental,6,1,5
Dizhkameduu,terokkar,96,shaman,elemental,6,1,5
Shamsteaks,ysera,96,shaman,elemental,6,1,5
Bispi,blackmoore,96,shaman,elemental,6,1,5
Zows,kazzak,96,shaman,elemental,6,1,5
Fatflop,sylvanas,96,shaman,elemental,6,1,5
Alekaris,burning-blade,96,shaman,elemental,6,1,5
Ellyy,silvermoon,96,shaman,elemental,6,1,5
Stiflersmôm,antonidas,96,shaman,elemental,6,1,5
Phanomz,ragnaros,96,shaman,elemental,6,1,5
Aguero,aegwynn,96,shaman,elemental,6,1,5
Skailzcham,hyjal,96,shaman,elemental,6,1,5
Jänis,ragnaros,96,shaman,elemental,6,1,5
Barockox,kazzak,96,shaman,elemental,6,1,5
Flurpz,outland,96,shaman,elemental,6,1,5
Menhir,ysondre,96,shaman,elemental,6,1,5
Subaki,die-aldor,96,shaman,elemental,6,1,5
Ghøhp,nerzhul,96,shaman,elemental,6,1,5
Zerim,taerar,96,shaman,elemental,6,1,5
Linknvm,thrall,96,shaman,elemental,6,1,5
Trendsetter,frostmane,96,shaman,elemental,6,1,5
Zaffyboi,draenor,96,shaman,elemental,6,1,5
Totam,grim-batol,96,shaman,elemental,6,1,5
Vorkanyx,ysondre,96,shaman,elemental,6,1,5
Choppintex,archimonde,96,shaman,elemental,6,1,5
Nuclearjohny,eredar,96,shaman,elemental,6,1,5
Châmanco,dun-modr,96,shaman,elemental,6,1,5
Монамур,deathguard,96,shaman,elemental,6,1,5
Depucova,silvermoon,96,shaman,elemental,6,1,5
Poglavica,dragonmaw,96,shaman,elemental,6,1,5
Biotopia,blackrock,96,shaman,elemental,6,1,5
Moglibard,grim-batol,96,shaman,elemental,6,1,5
Growlêy,draenor,96,shaman,elemental,6,1,5
Dérgérät,blackrock,96,shaman,elemental,6,1,5
Biztor,jaedenar,96,shaman,elemental,6,1,5
Pasjeop,ravencrest,96,shaman,elemental,6,1,5
Kilruk,ravencrest,96,shaman,elemental,6,1,5
Dergat,pozzo-delleternità,96,shaman,elemental,6,1,5
Papaver,zirkel-des-cenarius,96,shaman,elemental,6,1,5
Dwarfofwar,ravencrest,96,shaman,elemental,6,1,5
Jabena,draenor,96,shaman,elemental,6,1,5
Rykou,nagrand,96,shaman,elemental,6,1,5
Happyjuice,silvermoon,96,shaman,elemental,6,1,5
Driftal,laughing-skull,96,shaman,elemental,6,1,5
Heheheyup,ravencrest,96,shaman,elemental,6,1,5
Shaminista,ravencrest,96,shaman,elemental,6,1,5
Voodooshox,tarren-mill,96,shaman,elemental,6,1,5
Сентес,soulflayer,96,shaman,elemental,6,1,5
Çoco,blackrock,96,shaman,elemental,6,1,5
Lik,nethersturm,96,shaman,elemental,6,1,5
Shamira,nethersturm,96,shaman,elemental,6,1,5
Muisak,culte-de-la-rive-noire,96,shaman,elemental,6,1,5
Артокор,gordunni,96,shaman,elemental,6,1,5
Másàfî,tarren-mill,96,shaman,elemental,7,1,6
Ðdly,culte-de-la-rive-noire,96,shaman,elemental,8,1,7
Tapatak,antonidas,96,shaman,elemental,12,1,11
Zappypewpew,drakthul,96,shaman,elemental,12,1,11
Amaizin,stormscale,96,shaman,elemental,12,1,11
Kyst,elune,95,shaman,elemental,6,1,5
Torepåsporet,deathwing,79,shaman,elemental,5,1,4
Xiphoideus,draenor,79,shaman,elemental,5,1,4
Agnøt,khaz-modan,63,shaman,elemental,2,2,0
Yeháw,kazzak,48,shaman,elemental,3,1,2
Hyu,hyjal,42,shaman,elemental,10,2,8
Shammolino,nemesis,41,shaman,elemental,7,3,4
Gushgush,draenor,31,shaman,elemental,2,1,1
Shds,blackmoore,31,shaman,elemental,2,1,1
Michalb,tarren-mill,31,shaman,elemental,2,1,1
Chícago,ysondre,31,shaman,elemental,2,1,1
Thorên,blackmoore,16,shaman,elemental,1,1,0
Shamszy,grim-batol,16,shaman,elemental,1,1,0
Memourian,drakthul,16,shaman,elemental,7,1,6
Bredare,ravencrest,2406,shaman,enhancement,136,104,32
Blaukraut,stormscale,2375,shaman,enhancement,115,75,40
Mûnch,kazzak,2369,shaman,enhancement,110,73,37
Крааули,soulflayer,2283,shaman,enhancement,439,228,211
Dennismanone,tarren-mill,2264,shaman,enhancement,138,73,65
Китрасст,soulflayer,2263,shaman,enhancement,84,47,37
Китраст,soulflayer,2262,shaman,enhancement,105,56,49
Nevergroundx,perenolde,2257,shaman,enhancement,96,60,36
Axdn,ravencrest,2249,shaman,enhancement,92,51,41
Avines,twisting-nether,2249,shaman,enhancement,391,205,186
Дудивтф,soulflayer,2244,shaman,enhancement,194,105,89
Kwengi,stormreaver,2239,shaman,enhancement,268,145,123
Strippzz,stormscale,2238,shaman,enhancement,102,62,40
Fatpig,stormscale,2238,shaman,enhancement,83,47,36
Shadijr,stormscale,2233,shaman,enhancement,118,63,55
Hermerejildo,stormscale,2229,shaman,enhancement,196,101,95
Treyway,dun-modr,2218,shaman,enhancement,102,69,33
Swapxy,ravencrest,2215,shaman,enhancement,66,42,24
Joeyexe,outland,2215,shaman,enhancement,253,133,120
Kweng,stormreaver,2208,shaman,enhancement,193,109,84
Metastasis,dalaran,2202,shaman,enhancement,162,100,62
Shadiqt,stormscale,2194,shaman,enhancement,96,51,45
Onebutton,archimonde,2187,shaman,enhancement,78,51,27
Buffdraventy,archimonde,2176,shaman,enhancement,102,59,43
Æerømachine,outland,2170,shaman,enhancement,128,67,61
Acidtrips,thrall,2170,shaman,enhancement,153,77,76
Lizoo,ravencrest,2169,shaman,enhancement,102,66,36
Curioustowel,kazzak,2158,shaman,enhancement,71,40,31
Stribbzz,stormscale,2158,shaman,enhancement,376,207,169
Jaimæ,ravencrest,2156,shaman,enhancement,54,43,11
Fckumen,ravencrest,2155,shaman,enhancement,124,71,53
Baconbazooka,tarren-mill,2147,shaman,enhancement,101,60,41
Lovèless,stormscale,2147,shaman,enhancement,48,28,20
Áä,stormscale,2146,shaman,enhancement,48,42,6
Smorcshamyy,kazzak,2143,shaman,enhancement,230,122,108
Enhahaha,tarren-mill,2141,shaman,enhancement,84,45,39
Ujasdaddy,stormscale,2139,shaman,enhancement,72,54,18
Trulylove,tarren-mill,2138,shaman,enhancement,111,58,53
Gønêxt,ravencrest,2128,shaman,enhancement,81,53,28
Mustakrakish,terokkar,2127,shaman,enhancement,78,53,25
Sillaas,ysondre,2127,shaman,enhancement,210,104,106
Buzz,stormscale,2125,shaman,enhancement,102,56,46
Майндшторм,blackscar,2123,shaman,enhancement,156,96,60
Azifox,hyjal,2120,shaman,enhancement,180,90,90
Faroh,ravencrest,2119,shaman,enhancement,89,50,39
Тандервульф,howling-fjord,2119,shaman,enhancement,361,193,168
Shadi,stormscale,2119,shaman,enhancement,84,44,40
Critonian,twisting-nether,2117,shaman,enhancement,129,68,61
Shamanyxx,tarren-mill,2114,shaman,enhancement,269,141,128
Maelstrom,eredar,2113,shaman,enhancement,300,167,133
Бафамет,blackscar,2108,shaman,enhancement,66,39,27
Voodoodoouu,stormscale,2106,shaman,enhancement,173,93,80
Qnanen,ravencrest,2105,shaman,enhancement,212,121,91
Ostosmvp,ravencrest,2105,shaman,enhancement,126,64,62
Krónm,dun-modr,2104,shaman,enhancement,112,73,39
Sparkygødx,twisting-nether,2104,shaman,enhancement,54,33,21
Leavemeàlone,ysondre,2103,shaman,enhancement,48,37,11
Yombaï,archimonde,2102,shaman,enhancement,263,135,128
Myguns,silvermoon,2101,shaman,enhancement,182,97,85
Møldør,tarren-mill,2100,shaman,enhancement,132,84,48
Читорра,gordunni,2096,shaman,enhancement,114,62,52
Tebzs,ravencrest,2094,shaman,enhancement,78,51,27
Skullstorm,talnivarr,2091,shaman,enhancement,181,103,78
Kazing,outland,2086,shaman,enhancement,88,46,42
Noboorst,stormscale,2082,shaman,enhancement,100,52,48
Hermerejildo,tarren-mill,2079,shaman,enhancement,78,41,37
Syllaas,ysondre,2079,shaman,enhancement,300,151,149
Sswf,kazzak,2070,shaman,enhancement,60,35,25
Yashëa,ysondre,2069,shaman,enhancement,73,59,14
Ruffepuffe,twisting-nether,2069,shaman,enhancement,431,224,207
Babalahziz,ysondre,2065,shaman,enhancement,142,94,48
Chancè,tarren-mill,2065,shaman,enhancement,96,54,42
Feetaddict,kazzak,2062,shaman,enhancement,199,109,90
Taktouka,archimonde,2060,shaman,enhancement,125,65,60
Shambolicc,ravencrest,2059,shaman,enhancement,136,69,67
Mëditåtïøñ,blackrock,2059,shaman,enhancement,66,32,34
Schockerdidf,blackmoore,2058,shaman,enhancement,48,37,11
Xa,blackrock,2056,shaman,enhancement,219,121,98
Bigthór,kazzak,2055,shaman,enhancement,193,107,86
Falseshepard,kazzak,2055,shaman,enhancement,84,45,39
Shuffledog,stormscale,2054,shaman,enhancement,53,30,23
Shïnnøk,stormscale,2053,shaman,enhancement,568,289,279
Trulylove,outland,2049,shaman,enhancement,275,134,141
Zouk,ysondre,2045,shaman,enhancement,126,73,53
Milheroj,tarren-mill,2045,shaman,enhancement,165,89,76
Etox,darksorrow,2042,shaman,enhancement,144,73,71
Gúîtårgøð,sanguino,2042,shaman,enhancement,89,44,45
Вацунвец,goldrinn,2040,shaman,enhancement,227,124,103
Gõyokunomajo,kazzak,2035,shaman,enhancement,78,52,26
Ниокумибейт,soulflayer,2035,shaman,enhancement,100,64,36
Епуклопов,soulflayer,2035,shaman,enhancement,114,69,45
Oldveteran,eredar,2035,shaman,enhancement,127,76,51
Hexmex,stormreaver,2035,shaman,enhancement,164,89,75
Zró,blackrock,2035,shaman,enhancement,192,100,92
Djonebutton,kazzak,2034,shaman,enhancement,89,51,38
Plsdontpress,stormscale,2029,shaman,enhancement,121,70,51
Chakafuyo,dun-modr,2028,shaman,enhancement,74,45,29
Nopre,blackrock,2027,shaman,enhancement,547,284,263
Kishock,tarren-mill,2023,shaman,enhancement,60,38,22
Zulmalis,twisting-nether,2022,shaman,enhancement,183,104,79
Sparkyxd,twisting-nether,2014,shaman,enhancement,149,67,82
Rækwon,tarren-mill,2012,shaman,enhancement,182,100,82
Arslos,twisting-nether,2010,shaman,enhancement,50,39,11
Биттерлинкс,blackscar,2010,shaman,enhancement,80,39,41
Løne,sylvanas,2008,shaman,enhancement,227,131,96
Djsnéak,blackrock,2006,shaman,enhancement,119,62,57
Corvux,tarren-mill,2003,shaman,enhancement,102,55,47
Kikbokser,kazzak,2002,shaman,enhancement,106,64,42
Автозакзак,soulflayer,2002,shaman,enhancement,113,53,60
Karpsham,stormscale,1993,shaman,enhancement,300,146,154
Phobiatics,thrall,1991,shaman,enhancement,65,41,24
Morguk,zuljin,1991,shaman,enhancement,133,76,57
Twísting,tarren-mill,1989,shaman,enhancement,59,37,22
Wóllff,archimonde,1985,shaman,enhancement,153,80,73
Shukhevych,kazzak,1984,shaman,enhancement,281,147,134
Инсэйнгод,soulflayer,1983,shaman,enhancement,63,32,31
Milheroj,terenas,1981,shaman,enhancement,144,70,74
Архивоитель,soulflayer,1980,shaman,enhancement,136,80,56
Rëalg,zuljin,1975,shaman,enhancement,220,127,93
Wishsteen,stormscale,1973,shaman,enhancement,95,52,43
Woopiedoopie,silvermoon,1973,shaman,enhancement,266,143,123
Yüri,stormscale,1968,shaman,enhancement,313,155,158
Nòrgan,die-aldor,1966,shaman,enhancement,55,35,20
Hardeeshot,stormscale,1965,shaman,enhancement,97,58,39
Teknorave,dun-modr,1963,shaman,enhancement,84,43,41
Turbostuck,ravencrest,1960,shaman,enhancement,171,88,83
Нарленд,gordunni,1960,shaman,enhancement,240,122,118
Pusspatrol,kazzak,1959,shaman,enhancement,120,58,62
Энха,howling-fjord,1957,shaman,enhancement,81,41,40
Akatuseiwah,blackrock,1956,shaman,enhancement,65,33,32
Flappey,stormscale,1955,shaman,enhancement,86,55,31
Вацустайл,goldrinn,1955,shaman,enhancement,114,68,46
Windsòng,stormscale,1954,shaman,enhancement,66,45,21
Херургх,soulflayer,1954,shaman,enhancement,188,109,79
Horelio,sanguino,1954,shaman,enhancement,243,135,108
Disciplé,blackmoore,1953,shaman,enhancement,95,51,44
Shïnnkøk,stormscale,1953,shaman,enhancement,138,70,68
Doubleshock,draenor,1952,shaman,enhancement,46,32,14
Ниу,thermaplugg,1949,shaman,enhancement,54,32,22
Ennuii,blackrock,1949,shaman,enhancement,84,48,36
Экспл,ashenvale,1948,shaman,enhancement,202,105,97
Shockxy,norgannon,1947,shaman,enhancement,65,35,30
Вудумастер,gordunni,1946,shaman,enhancement,149,86,63
Ódicen,dun-modr,1946,shaman,enhancement,86,48,38
Sangoma,frostmane,1945,shaman,enhancement,398,201,197
Recaim,outland,1943,shaman,enhancement,77,41,36
Bredex,doomhammer,1942,shaman,enhancement,132,77,55
Zarkab,ysondre,1940,shaman,enhancement,106,71,35
Hezdnalien,aegwynn,1940,shaman,enhancement,191,108,83
Kulefesk,grim-batol,1936,shaman,enhancement,156,80,76
Talrall,twisting-nether,1934,shaman,enhancement,144,78,66
Schnellweg,arthas,1930,shaman,enhancement,78,48,30
Obryss,tarren-mill,1927,shaman,enhancement,53,34,19
Brokenguyman,defias-brotherhood,1924,shaman,enhancement,58,34,24
Viablous,ravencrest,1920,shaman,enhancement,214,127,87
Tâktoukâ,archimonde,1920,shaman,enhancement,244,130,114
Nuarishaman,kazzak,1917,shaman,enhancement,132,69,63
Echoingshock,argent-dawn,1916,shaman,enhancement,66,47,19
Друггрумилей,soulflayer,1913,shaman,enhancement,60,30,30
Matrixxer,aegwynn,1910,shaman,enhancement,63,44,19
Chehkhan,archimonde,1909,shaman,enhancement,94,47,47
Tordenlars,ragnaros,1908,shaman,enhancement,53,31,22
Altotem,blackmoore,1907,shaman,enhancement,53,37,16
Fözk,outland,1907,shaman,enhancement,66,36,30
Spaltbart,blackmoore,1906,shaman,enhancement,156,89,67
Тиидишам,blackscar,1905,shaman,enhancement,143,72,71
Слакербэдбой,gordunni,1904,shaman,enhancement,126,62,64
Arhitopg,silvermoon,1903,shaman,enhancement,120,64,56
Tosemist,stormscale,1900,shaman,enhancement,94,52,42
Matchstíck,draenor,1899,shaman,enhancement,132,64,68
Lavadelrey,drakthul,1895,shaman,enhancement,65,33,32
Kilnih,archimonde,1894,shaman,enhancement,60,35,25
Axsos,chamber-of-aspects,1892,shaman,enhancement,78,51,27
Poppakonstit,twisting-nether,1892,shaman,enhancement,142,86,56
Trixey,mazrigos,1892,shaman,enhancement,52,30,22
Frankone,outland,1892,shaman,enhancement,239,131,108
Канамаш,borean-tundra,1890,shaman,enhancement,107,69,38
Nachosauce,tarren-mill,1890,shaman,enhancement,53,28,25
Gottiy,blackhand,1890,shaman,enhancement,162,80,82
Blastoiselol,ragnaros,1889,shaman,enhancement,82,52,30
Metamorflord,ravencrest,1889,shaman,enhancement,126,71,55
Alainralso,archimonde,1888,shaman,enhancement,60,39,21
Powercolor,aegwynn,1888,shaman,enhancement,67,33,34
Djimin,sanguino,1887,shaman,enhancement,321,173,148
Grende,sylvanas,1885,shaman,enhancement,181,98,83
Blyxuhm,argent-dawn,1882,shaman,enhancement,48,26,22
Schoølbøyq,blackrock,1881,shaman,enhancement,42,26,16
Ohhmm,ravencrest,1881,shaman,enhancement,42,20,22
Lassolasse,sylvanas,1880,shaman,enhancement,60,37,23
Mírídíuss,silvermoon,1879,shaman,enhancement,65,37,28
Blitzmann,outland,1879,shaman,enhancement,54,30,24
Пеклоь,soulflayer,1879,shaman,enhancement,316,157,159
Veloudinos,twisting-nether,1877,shaman,enhancement,143,92,51
Sozetwo,tarren-mill,1877,shaman,enhancement,52,33,19
Shamarach,sylvanas,1877,shaman,enhancement,66,39,27
Deaslow,hyjal,1876,shaman,enhancement,246,130,116
Пэппивкашке,howling-fjord,1875,shaman,enhancement,92,50,42
Orakl,tarren-mill,1873,shaman,enhancement,221,127,94
Zetorgg,burning-legion,1873,shaman,enhancement,136,70,66
Kardyo,archimonde,1873,shaman,enhancement,117,60,57
Qwertyxd,ravencrest,1872,shaman,enhancement,90,54,36
Jaykelul,frostmane,1871,shaman,enhancement,24,20,4
Shds,blackmoore,1871,shaman,enhancement,118,68,50
Bullx,magtheridon,1870,shaman,enhancement,138,75,63
Raìjïn,draenor,1869,shaman,enhancement,54,31,23
Ятебясмету,gordunni,1867,shaman,enhancement,48,32,16
Jäy,twisting-nether,1867,shaman,enhancement,58,31,27
Pumpcok,durotan,1866,shaman,enhancement,82,48,34
Chatbanned,blackmoore,1866,shaman,enhancement,48,26,22
Барракудах,razuvious,1866,shaman,enhancement,242,124,118
Маелштромс,soulflayer,1865,shaman,enhancement,102,54,48
Бренненд,howling-fjord,1863,shaman,enhancement,212,113,99
Medistød,draenor,1862,shaman,enhancement,194,115,79
Turbotorgny,draenor,1862,shaman,enhancement,84,49,35
Turbostruck,ravencrest,1861,shaman,enhancement,144,63,81
Mittyzap,kazzak,1860,shaman,enhancement,126,71,55
Alterem,kazzak,1859,shaman,enhancement,233,120,113
Dimno,burning-blade,1857,shaman,enhancement,36,24,12
Naochí,silvermoon,1857,shaman,enhancement,35,23,12
Shrektar,outland,1857,shaman,enhancement,72,40,32
Hanrej,draenor,1856,shaman,enhancement,60,37,23
Shamhaár,blackmoore,1856,shaman,enhancement,100,61,39
Radåhn,outland,1854,shaman,enhancement,72,44,28
Nerfrets,malganis,1854,shaman,enhancement,209,121,88
Ваншотстайлз,soulflayer,1854,shaman,enhancement,148,76,72
Musham,blackrock,1852,shaman,enhancement,66,41,25
Klintxbob,hyjal,1852,shaman,enhancement,42,23,19
Daybidaybi,stormscale,1852,shaman,enhancement,233,116,117
Høwlstørmx,ravencrest,1850,shaman,enhancement,55,36,19
Буряя,blackscar,1848,shaman,enhancement,66,27,39
Getahex,ravencrest,1847,shaman,enhancement,35,26,9
Blubbers,magtheridon,1847,shaman,enhancement,60,36,24
Dwarfovic,ravencrest,1847,shaman,enhancement,42,24,18
Tailin,nozdormu,1846,shaman,enhancement,66,40,26
Cløke,stormscale,1846,shaman,enhancement,114,64,50
Shámi,gilneas,1846,shaman,enhancement,60,29,31
Monamour,twisting-nether,1845,shaman,enhancement,102,63,39
Чифсоса,soulflayer,1844,shaman,enhancement,116,64,52
Wúh,twisting-nether,1844,shaman,enhancement,271,147,124
Pvpone,ravencrest,1844,shaman,enhancement,42,21,21
Zutemaster,stormscale,1843,shaman,enhancement,164,90,74
Totemofgreed,rexxar,1843,shaman,enhancement,84,40,44
Ferconex,kazzak,1842,shaman,enhancement,250,135,115
Мсет,soulflayer,1841,shaman,enhancement,35,23,12
Siphem,stormscale,1841,shaman,enhancement,49,31,18
Fattywopwop,alakir,1841,shaman,enhancement,36,22,14
Salvadr,zuljin,1841,shaman,enhancement,91,50,41
Marohk,uldum,1840,shaman,enhancement,90,47,43
Boombastíc,ravencrest,1840,shaman,enhancement,178,89,89
Dendyre,outland,1840,shaman,enhancement,59,29,30
Вандерласт,howling-fjord,1839,shaman,enhancement,143,81,62
Nyrat,tarren-mill,1837,shaman,enhancement,71,41,30
Asaakira,blackmoore,1837,shaman,enhancement,331,166,165
Uhøfligeulf,draenor,1837,shaman,enhancement,148,70,78
Seçretweapøn,kazzak,1836,shaman,enhancement,84,47,37
Bikdig,dun-modr,1836,shaman,enhancement,126,67,59
Lavalaesh,ravencrest,1835,shaman,enhancement,107,61,46
Jtouni,outland,1834,shaman,enhancement,144,72,72
Lekthar,draenor,1833,shaman,enhancement,143,83,60
Дёмарок,galakrond,1832,shaman,enhancement,118,65,53
Exysen,kazzak,1831,shaman,enhancement,54,26,28
Wacomtablet,kazzak,1830,shaman,enhancement,42,24,18
Masêrati,ravencrest,1829,shaman,enhancement,42,25,17
Hermonidas,dun-modr,1829,shaman,enhancement,70,32,38
Ganachimby,zuljin,1828,shaman,enhancement,53,36,17
Сидог,soulflayer,1827,shaman,enhancement,48,32,16
Javaburst,ragnaros,1827,shaman,enhancement,203,110,93
Arkîmonde,silvermoon,1827,shaman,enhancement,339,177,162
Miikkas,blackhand,1826,shaman,enhancement,54,38,16
Stormkiler,defias-brotherhood,1826,shaman,enhancement,321,155,166
Eselwindzorn,blackrock,1825,shaman,enhancement,53,32,21
Commadore,korgall,1825,shaman,enhancement,71,33,38
Ananasanax,twisting-nether,1823,shaman,enhancement,114,63,51
Sonnestorm,tarren-mill,1822,shaman,enhancement,99,52,47
Noxz,blackrock,1822,shaman,enhancement,59,29,30
Pumpzuat,khadgar,1821,shaman,enhancement,58,37,21
Dakotasham,ravencrest,1821,shaman,enhancement,77,43,34
Lava,haomarush,1819,shaman,enhancement,141,80,61
Xôàrqt,eredar,1819,shaman,enhancement,308,163,145
Badmojø,silvermoon,1819,shaman,enhancement,256,121,135
Senroxx,blackrock,1818,shaman,enhancement,48,32,16
Aeisey,archimonde,1817,shaman,enhancement,83,52,31
Argotan,drakthul,1817,shaman,enhancement,71,43,28
Stormlash,shattered-halls,1817,shaman,enhancement,132,77,55
Thunberg,ravencrest,1817,shaman,enhancement,107,61,46
Hapkin,defias-brotherhood,1816,shaman,enhancement,54,38,16
Mckoy,kazzak,1816,shaman,enhancement,40,27,13
Maksimon,blackrock,1816,shaman,enhancement,84,49,35
Faydé,stormscale,1816,shaman,enhancement,36,19,17
Carousel,blackrock,1816,shaman,enhancement,52,27,25
Meatballspam,stormscale,1816,shaman,enhancement,89,44,45
Joanno,aegwynn,1815,shaman,enhancement,54,34,20
Androck,tarren-mill,1815,shaman,enhancement,109,57,52
Шаманутый,soulflayer,1815,shaman,enhancement,346,174,172
Khorgam,twisting-nether,1814,shaman,enhancement,30,19,11
Bobonbu,forscherliga,1813,shaman,enhancement,47,27,20
Tzaish,blackmoore,1813,shaman,enhancement,99,54,45
Voodooms,laughing-skull,1812,shaman,enhancement,151,91,60
Dhedge,draenor,1812,shaman,enhancement,108,61,47
Gelthan,zuljin,1812,shaman,enhancement,224,122,102
Zulren,draenor,1811,shaman,enhancement,42,23,19
Johncoltrane,archimonde,1810,shaman,enhancement,78,55,23
Dshaman,aegwynn,1810,shaman,enhancement,36,23,13
Speak,ragnaros,1810,shaman,enhancement,66,39,27
Gorogoró,kazzak,1809,shaman,enhancement,30,19,11
Wishstêên,stormscale,1809,shaman,enhancement,64,29,35
Tao,stormscale,1808,shaman,enhancement,24,19,5
Roxâm,hyjal,1808,shaman,enhancement,34,20,14
Ðrshock,blackmoore,1808,shaman,enhancement,54,31,23
Царьколтрэйн,blackscar,1808,shaman,enhancement,179,99,80
Testosterone,dun-modr,1808,shaman,enhancement,154,80,74
Grytkungen,daggerspine,1807,shaman,enhancement,74,48,26
Ewion,dalvengyr,1807,shaman,enhancement,129,82,47
Furystrikez,frostwolf,1807,shaman,enhancement,120,72,48
Madbud,stormscale,1807,shaman,enhancement,101,60,41
Ozilie,khaz-modan,1807,shaman,enhancement,135,78,57
Archiviert,blackmoore,1807,shaman,enhancement,168,93,75
Freyrr,tarren-mill,1807,shaman,enhancement,386,205,181
Zerocarè,tarren-mill,1806,shaman,enhancement,30,22,8
Vartarius,arthas,1806,shaman,enhancement,147,79,68
Tzivati,draenor,1806,shaman,enhancement,95,51,44
Shamtard,frostwhisper,1805,shaman,enhancement,186,94,92
Nøxz,blackmoore,1804,shaman,enhancement,60,31,29
Реактиватор,soulflayer,1803,shaman,enhancement,47,27,20
Actionhank,area-52,1803,shaman,enhancement,99,50,49
Walterwhite,blackrock,1800,shaman,enhancement,42,26,16
Sybred,twisting-nether,1800,shaman,enhancement,126,76,50
Axemodels,archimonde,1800,shaman,enhancement,60,32,28
Pocahøntas,archimonde,1799,shaman,enhancement,98,49,49
Calvey,magtheridon,1799,shaman,enhancement,82,37,45
Stormdrak,eredar,1798,shaman,enhancement,54,34,20
Athe,conseil-des-ombres,1797,shaman,enhancement,164,90,74
Raidwhipper,twisting-nether,1796,shaman,enhancement,168,99,69
Azrs,ravencrest,1796,shaman,enhancement,114,63,51
Shammyenh,burning-legion,1795,shaman,enhancement,84,49,35
Proccq,twisting-nether,1795,shaman,enhancement,48,24,24
Nátty,ravencrest,1794,shaman,enhancement,55,32,23
Shambolicc,kazzak,1794,shaman,enhancement,197,92,105
Zaeh,antonidas,1793,shaman,enhancement,79,54,25
Sødeskat,twisting-nether,1792,shaman,enhancement,66,38,28
Thunderr,dun-modr,1791,shaman,enhancement,130,73,57
Toteemikylpy,argent-dawn,1789,shaman,enhancement,90,54,36
Иллюминэйшн,soulflayer,1788,shaman,enhancement,65,36,29
Purgerooni,haomarush,1786,shaman,enhancement,82,50,32
Robzn,blackrock,1783,shaman,enhancement,50,32,18
Pumanii,silvermoon,1783,shaman,enhancement,114,63,51
Naturfury,ravencrest,1782,shaman,enhancement,82,59,23
Draeker,magtheridon,1782,shaman,enhancement,30,20,10
Estasham,stormscale,1781,shaman,enhancement,288,158,130
Spicemélange,archimonde,1781,shaman,enhancement,126,68,58
Basz,aegwynn,1780,shaman,enhancement,76,42,34
Stormfíst,tarren-mill,1777,shaman,enhancement,180,96,84
Satanloveme,stormscale,1777,shaman,enhancement,54,28,26
Altarian,nemesis,1776,shaman,enhancement,105,54,51
Stormasaurus,anachronos,1775,shaman,enhancement,88,51,37
Florgegoyd,eredar,1774,shaman,enhancement,162,104,58
Snëakyboom,stormscale,1774,shaman,enhancement,102,51,51
Narevoqi,madmortem,1773,shaman,enhancement,46,31,15
Pýthøn,silvermoon,1772,shaman,enhancement,54,27,27
Isucklasso,aegwynn,1769,shaman,enhancement,120,68,52
Chaeemerok,dun-modr,1769,shaman,enhancement,220,112,108
Рэйпушка,gordunni,1769,shaman,enhancement,53,25,28
Shuyö,kazzak,1768,shaman,enhancement,107,63,44
Faxsham,draenor,1766,shaman,enhancement,90,54,36
Mehex,tarren-mill,1766,shaman,enhancement,108,56,52
Caelx,ragnaros,1765,shaman,enhancement,41,27,14
Ludwigson,tarren-mill,1765,shaman,enhancement,143,83,60
Kohnân,hyjal,1765,shaman,enhancement,237,136,101
Чаапалах,blackscar,1765,shaman,enhancement,348,172,176
Nnele,sanguino,1762,shaman,enhancement,118,54,64
Riphonda,dragonmaw,1760,shaman,enhancement,90,52,38
Venomos,kazzak,1760,shaman,enhancement,117,61,56
Sígrun,aegwynn,1758,shaman,enhancement,42,28,14
Yacu,blackrock,1758,shaman,enhancement,83,45,38
Voodoodocter,kazzak,1758,shaman,enhancement,171,88,83
Vayshibro,turalyon,1757,shaman,enhancement,100,53,47
Видарх,soulflayer,1756,shaman,enhancement,42,20,22
Paschol,aegwynn,1755,shaman,enhancement,39,19,20
Mjjx,blackrock,1753,shaman,enhancement,90,61,29
Twkupe,tarren-mill,1753,shaman,enhancement,54,34,20
Neveil,tarren-mill,1752,shaman,enhancement,48,32,16
Eysns,blackrock,1751,shaman,enhancement,112,61,51
Lexyiasz,kazzak,1748,shaman,enhancement,100,68,32
Vargen,arygos,1748,shaman,enhancement,89,50,39
Grouzer,stormscale,1748,shaman,enhancement,108,51,57
Fyrkaz,aegwynn,1747,shaman,enhancement,42,24,18
Shamflurry,ravencrest,1747,shaman,enhancement,108,60,48
Leccyavenue,twisting-nether,1745,shaman,enhancement,36,20,16
Shaakez,kazzak,1745,shaman,enhancement,181,99,82
Sswfx,kazzak,1744,shaman,enhancement,36,22,14
Lurkmon,twisting-nether,1744,shaman,enhancement,140,76,64
Brøxygar,archimonde,1744,shaman,enhancement,227,120,107
Foulecamp,archimonde,1743,shaman,enhancement,188,103,85
Lokes,drakthul,1742,shaman,enhancement,381,191,190
Максобман,howling-fjord,1741,shaman,enhancement,54,30,24
Babae,draenor,1741,shaman,enhancement,96,37,59
Mohammed,kilrogg,1740,shaman,enhancement,53,34,19
Razzuan,kazzak,1740,shaman,enhancement,132,73,59
Setac,stormscale,1739,shaman,enhancement,36,22,14
Lavalordd,tarren-mill,1738,shaman,enhancement,86,46,40
Skyróxx,blackrock,1737,shaman,enhancement,57,34,23
Totemlié,ravencrest,1737,shaman,enhancement,57,32,25
Acivich,frostmane,1737,shaman,enhancement,102,57,45
Kachori,eredar,1737,shaman,enhancement,281,142,139
Кинговели,soulflayer,1736,shaman,enhancement,398,205,193
Mulf,darksorrow,1736,shaman,enhancement,160,82,78
Akhlýzz,ysondre,1734,shaman,enhancement,63,39,24
Enhshamanop,draenor,1733,shaman,enhancement,330,159,171
Fotmburstwin,blackmoore,1732,shaman,enhancement,54,34,20
Dalgia,tarren-mill,1732,shaman,enhancement,47,28,19
Totemilokum,stormscale,1732,shaman,enhancement,48,28,20
Сахарокь,soulflayer,1731,shaman,enhancement,71,38,33
Dzandell,silvermoon,1731,shaman,enhancement,281,136,145
Chikidi,silvermoon,1730,shaman,enhancement,107,66,41
Tobanga,malganis,1730,shaman,enhancement,48,29,19
Jabaraklol,stormscale,1728,shaman,enhancement,115,72,43
Reyax,aegwynn,1728,shaman,enhancement,73,38,35
Dóómd,kazzak,1728,shaman,enhancement,225,113,112
Халльбьерн,howling-fjord,1726,shaman,enhancement,60,36,24
Paintball,kazzak,1726,shaman,enhancement,303,160,143
Purada,blackrock,1724,shaman,enhancement,94,47,47
Халльбиорн,gordunni,1724,shaman,enhancement,73,36,37
Floorislava,culte-de-la-rive-noire,1724,shaman,enhancement,160,77,83
Brenhilda,blackmoore,1722,shaman,enhancement,102,66,36
Рэггдолл,soulflayer,1722,shaman,enhancement,120,52,68
Oldstorm,ravencrest,1720,shaman,enhancement,93,51,42
Azktor,kazzak,1720,shaman,enhancement,196,107,89
Sgf,stormscale,1720,shaman,enhancement,136,72,64
Dwarfstil,blackmoore,1719,shaman,enhancement,69,33,36
Khrin,blackmoore,1716,shaman,enhancement,60,36,24
Joanna,frostwolf,1716,shaman,enhancement,79,38,41
Тралси,howling-fjord,1715,shaman,enhancement,24,18,6
Drshockit,blackrock,1715,shaman,enhancement,153,83,70
Цукхер,soulflayer,1714,shaman,enhancement,41,27,14
Yogan,dun-modr,1714,shaman,enhancement,68,38,30
Cryrothx,outland,1714,shaman,enhancement,66,34,32
Lassø,blackmoore,1714,shaman,enhancement,75,37,38
Ubies,silvermoon,1713,shaman,enhancement,147,83,64
Traktorchox,draenor,1713,shaman,enhancement,105,57,48
Hassebolt,draenor,1713,shaman,enhancement,60,32,28
Рыганский,blackscar,1713,shaman,enhancement,97,42,55
Procctor,kazzak,1712,shaman,enhancement,30,24,6
Kickapoo,outland,1712,shaman,enhancement,54,32,22
Tauridus,blackrock,1711,shaman,enhancement,42,27,15
Brotein,blackmoore,1711,shaman,enhancement,36,21,15
Тандершторм,soulflayer,1710,shaman,enhancement,226,129,97
Panzarkamp,stormscale,1709,shaman,enhancement,137,72,65
Volvíc,tichondrius,1709,shaman,enhancement,60,29,31
Obrijames,tarren-mill,1708,shaman,enhancement,124,67,57
Enhx,ravencrest,1707,shaman,enhancement,36,23,13
Ryhèn,stormscale,1707,shaman,enhancement,292,156,136
Mecct,ravencrest,1706,shaman,enhancement,100,63,37
Шаманмиша,gordunni,1706,shaman,enhancement,458,233,225
Legitbro,ravencrest,1705,shaman,enhancement,60,31,29
Draabada,stormscale,1705,shaman,enhancement,142,71,71
Groyaboý,blackrock,1704,shaman,enhancement,24,18,6
Drade,aegwynn,1704,shaman,enhancement,47,29,18
Mèátßãllgøðx,kazzak,1704,shaman,enhancement,177,85,92
Baldmommy,tarren-mill,1703,shaman,enhancement,29,19,10
Andrëw,dalaran,1703,shaman,enhancement,70,42,28
Wafflë,ragnaros,1703,shaman,enhancement,132,70,62
Kuubskii,ravencrest,1702,shaman,enhancement,71,42,29
Bmtotem,twisting-nether,1702,shaman,enhancement,36,18,18
Hayvaan,blackrock,1701,shaman,enhancement,263,148,115
Мигнтз,soulflayer,1701,shaman,enhancement,49,24,25
Xxloon,blackrock,1700,shaman,enhancement,257,144,113
Toobiib,culte-de-la-rive-noire,1700,shaman,enhancement,84,39,45
Fiveyearsque,sylvanas,1699,shaman,enhancement,124,73,51
Djosershamy,draenor,1699,shaman,enhancement,132,67,65
Gromzog,twisting-nether,1699,shaman,enhancement,124,62,62
Махош,blackscar,1699,shaman,enhancement,42,21,21
Aspên,archimonde,1699,shaman,enhancement,78,35,43
Bluetide,ravencrest,1697,shaman,enhancement,57,38,19
Harpiks,tarren-mill,1697,shaman,enhancement,48,29,19
Detestable,eredar,1697,shaman,enhancement,74,37,37
Moini,eredar,1697,shaman,enhancement,102,47,55
Fotmglad,blackrock,1696,shaman,enhancement,90,50,40
Aswøg,kazzak,1695,shaman,enhancement,30,21,9
Rabalalaha,twisting-nether,1695,shaman,enhancement,193,98,95
Kyraw,tarren-mill,1694,shaman,enhancement,126,69,57
Argarok,argent-dawn,1694,shaman,enhancement,54,29,25
Kættmæck,tarren-mill,1694,shaman,enhancement,144,77,67
Enoughh,the-maelstrom,1694,shaman,enhancement,108,57,51
Kaimountain,defias-brotherhood,1693,shaman,enhancement,42,26,16
Zenka,burning-legion,1690,shaman,enhancement,72,49,23
Царьбер,soulflayer,1690,shaman,enhancement,80,45,35
Чесп,ashenvale,1690,shaman,enhancement,150,80,70
Lightning,aszune,1690,shaman,enhancement,83,41,42
Lavarage,kazzak,1689,shaman,enhancement,69,41,28
Enh,archimonde,1687,shaman,enhancement,42,20,22
Malyalewaria,silvermoon,1686,shaman,enhancement,83,57,26
Masztaar,ragnaros,1686,shaman,enhancement,227,116,111
Boltar,die-aldor,1684,shaman,enhancement,44,26,18
Kutipaperi,stormscale,1684,shaman,enhancement,113,65,48
Mamacitá,eredar,1683,shaman,enhancement,239,121,118
Ïï,archimonde,1682,shaman,enhancement,273,144,129
Ripstorm,sylvanas,1682,shaman,enhancement,60,30,30
Rokils,silvermoon,1680,shaman,enhancement,60,34,26
Griins,ravencrest,1680,shaman,enhancement,202,112,90
Взалходил,soulflayer,1680,shaman,enhancement,41,21,20
Духсалата,grom,1680,shaman,enhancement,54,27,27
Trent,tarren-mill,1679,shaman,enhancement,234,127,107
Procdaddy,stormscale,1679,shaman,enhancement,48,20,28
Spetsnazz,archimonde,1678,shaman,enhancement,230,114,116
Wheygodx,ravencrest,1677,shaman,enhancement,111,58,53
Tito,stormscale,1677,shaman,enhancement,85,36,49
Sciulz,nemesis,1676,shaman,enhancement,30,18,12
Стихиябороды,gordunni,1676,shaman,enhancement,126,72,54
Kosface,tarren-mill,1676,shaman,enhancement,218,117,101
Kedall,archimonde,1676,shaman,enhancement,66,32,34
Tdogfx,blackhand,1675,shaman,enhancement,78,45,33
Иннреи,howling-fjord,1675,shaman,enhancement,213,117,96
Doomëd,drakthul,1675,shaman,enhancement,48,24,24
Turbopuddi,kazzak,1674,shaman,enhancement,95,49,46
Palmalecki,ravencrest,1674,shaman,enhancement,75,37,38
Greythunda,archimonde,1672,shaman,enhancement,36,23,13
Shockkanta,antonidas,1672,shaman,enhancement,30,19,11
Bkid,archimonde,1672,shaman,enhancement,42,23,19
Björnbritta,outland,1672,shaman,enhancement,74,40,34
Ázøk,stormscale,1672,shaman,enhancement,293,144,149
Амфеминка,gordunni,1672,shaman,enhancement,180,88,92
Kenjaiir,twisting-nether,1671,shaman,enhancement,30,20,10
Jmpapa,tarren-mill,1671,shaman,enhancement,42,23,19
Людоед,thermaplugg,1671,shaman,enhancement,351,183,168
Pontifhkas,ragnaros,1670,shaman,enhancement,135,75,60
Raíndra,twisting-nether,1670,shaman,enhancement,107,59,48
Totemticks,aegwynn,1670,shaman,enhancement,78,42,36
Yobro,archimonde,1669,shaman,enhancement,96,55,41
Tinysalmon,hyjal,1669,shaman,enhancement,84,43,41
Rayoton,burning-legion,1669,shaman,enhancement,114,56,58
Shonbelly,argent-dawn,1668,shaman,enhancement,58,37,21
Mylilfurry,blackhand,1668,shaman,enhancement,100,62,38
Shamerific,magtheridon,1668,shaman,enhancement,108,63,45
Асцэндэд,lich-king,1668,shaman,enhancement,94,50,44
Neurax,sanguino,1668,shaman,enhancement,135,71,64
Pïdòrás,kazzak,1668,shaman,enhancement,59,30,29
Neystee,archimonde,1666,shaman,enhancement,36,21,15
Bærserker,blackmoore,1665,shaman,enhancement,52,29,23
Onepatchman,silvermoon,1665,shaman,enhancement,174,86,88
Depucova,silvermoon,1663,shaman,enhancement,88,56,32
Selticxz,blackrock,1663,shaman,enhancement,36,20,16
Botism,draenor,1663,shaman,enhancement,126,68,58
Funkins,hyjal,1663,shaman,enhancement,156,80,76
Sitkosham,burning-blade,1662,shaman,enhancement,170,94,76
Veteroth,argent-dawn,1662,shaman,enhancement,132,69,63
Skilltissue,executus,1662,shaman,enhancement,102,53,49
Ñøs,blackrock,1662,shaman,enhancement,126,64,62
Psychologism,sanguino,1660,shaman,enhancement,29,18,11
Lersham,the-maelstrom,1659,shaman,enhancement,89,48,41
Buffmepls,sanguino,1659,shaman,enhancement,56,28,28
Sêarix,aegwynn,1658,shaman,enhancement,120,69,51
Darkning,kazzak,1658,shaman,enhancement,90,50,40
Thoshir,silvermoon,1657,shaman,enhancement,23,19,4
Cripxo,sanguino,1657,shaman,enhancement,30,24,6
Smallwiik,hyjal,1657,shaman,enhancement,54,38,16
Bourdieu,thrall,1657,shaman,enhancement,132,76,56
Worstshamy,sanguino,1657,shaman,enhancement,42,23,19
Dectus,blackrock,1656,shaman,enhancement,48,26,22
Grrud,draenor,1655,shaman,enhancement,48,27,21
Agathoulis,burning-legion,1655,shaman,enhancement,84,42,42
Chêlëx,silvermoon,1654,shaman,enhancement,200,106,94
Kynaz,sanguino,1653,shaman,enhancement,183,86,97
Xanoo,stormscale,1652,shaman,enhancement,38,22,16
Níkíta,hyjal,1651,shaman,enhancement,71,46,25
Лолимин,borean-tundra,1651,shaman,enhancement,51,33,18
Плаглорд,howling-fjord,1651,shaman,enhancement,108,63,45
Toxicnux,nemesis,1651,shaman,enhancement,60,35,25
Tryor,darksorrow,1651,shaman,enhancement,48,26,22
Kilomanjaro,bloodfeather,1651,shaman,enhancement,66,35,31
Everblast,arathor,1651,shaman,enhancement,42,20,22
Yox,dun-modr,1650,shaman,enhancement,58,38,20
Purgelord,tarren-mill,1650,shaman,enhancement,86,52,34
Romacherry,aegwynn,1649,shaman,enhancement,179,102,77
Kaboomgødx,blackhand,1649,shaman,enhancement,47,26,21
Sector,silvermoon,1649,shaman,enhancement,78,38,40
Pvtpunch,stormscale,1648,shaman,enhancement,42,25,17
Yeruna,arthas,1648,shaman,enhancement,66,38,28
Fabz,twisting-nether,1647,shaman,enhancement,48,28,20
Locosonik,kazzak,1647,shaman,enhancement,58,28,30
Testogodx,defias-brotherhood,1646,shaman,enhancement,99,54,45
Teyshtwö,archimonde,1646,shaman,enhancement,107,52,55
Plockepinn,ravencrest,1646,shaman,enhancement,84,38,46
Жезуш,galakrond,1645,shaman,enhancement,81,52,29
Arkaos,exodar,1645,shaman,enhancement,73,46,27
Cch,kazzak,1645,shaman,enhancement,84,43,41
Tóyzz,ravencrest,1644,shaman,enhancement,110,66,44
Etrog,kazzak,1644,shaman,enhancement,66,38,28
Makaar,blackrock,1643,shaman,enhancement,54,28,26
Shaayys,archimonde,1643,shaman,enhancement,331,168,163
Лёхапулемёт,gordunni,1642,shaman,enhancement,36,25,11
Statikznba,outland,1642,shaman,enhancement,52,29,23
Wyrdanas,drakthul,1642,shaman,enhancement,91,48,43
Láynert,dun-modr,1642,shaman,enhancement,415,207,208
Fiskätarn,kazzak,1642,shaman,enhancement,68,28,40
Spacelazers,twisting-nether,1641,shaman,enhancement,29,19,10
Shawck,ravencrest,1641,shaman,enhancement,64,37,27
Ghostkod,burning-legion,1641,shaman,enhancement,265,146,119
Чухансмент,gordunni,1641,shaman,enhancement,78,42,36
Faustex,dun-morogh,1641,shaman,enhancement,37,19,18
Vøda,twisting-nether,1640,shaman,enhancement,36,22,14
Krassus,drakthul,1640,shaman,enhancement,65,39,26
Boradinn,hyjal,1640,shaman,enhancement,66,37,29
Îzanami,ravencrest,1640,shaman,enhancement,197,109,88
Xestil,blackmoore,1640,shaman,enhancement,76,39,37
Ooupsjr,tarren-mill,1640,shaman,enhancement,48,24,24
Тоннимонтана,howling-fjord,1639,shaman,enhancement,80,51,29
Lethal,darksorrow,1639,shaman,enhancement,87,50,37
Convîcted,grim-batol,1639,shaman,enhancement,125,70,55
Painshock,outland,1639,shaman,enhancement,159,82,77
Mmsalatik,nemesis,1639,shaman,enhancement,54,24,30
Rykarn,eredar,1638,shaman,enhancement,57,38,19
Jinckks,anachronos,1638,shaman,enhancement,36,21,15
Kijin,kirin-tor,1638,shaman,enhancement,142,76,66
Громовойбро,blackscar,1637,shaman,enhancement,42,24,18
Magmamonster,tarren-mill,1637,shaman,enhancement,48,25,23
Runeksham,tarren-mill,1636,shaman,enhancement,66,42,24
Btray,ravencrest,1636,shaman,enhancement,84,51,33
Torcok,sanguino,1635,shaman,enhancement,42,22,20
Khelyyn,tarren-mill,1635,shaman,enhancement,82,41,41
Carrywho,blackrock,1634,shaman,enhancement,30,19,11
Faltygo,drakthul,1634,shaman,enhancement,72,38,34
Ашхикиган,howling-fjord,1634,shaman,enhancement,150,69,81
Schôcker,blackmoore,1633,shaman,enhancement,60,40,20
Elemoont,tarren-mill,1633,shaman,enhancement,48,28,20
Sherlokholms,ravencrest,1632,shaman,enhancement,80,43,37
Gandy,the-maelstrom,1632,shaman,enhancement,180,92,88
Typhoön,sanguino,1632,shaman,enhancement,271,138,133
Belroc,ravencrest,1631,shaman,enhancement,42,21,21
Nibblez,aegwynn,1630,shaman,enhancement,84,52,32
Kezron,aegwynn,1629,shaman,enhancement,42,23,19
Defiaz,stormscale,1628,shaman,enhancement,74,48,26
Patsham,wildhammer,1628,shaman,enhancement,137,79,58
Natty,ravencrest,1628,shaman,enhancement,42,22,20
Lilmozart,twisting-nether,1628,shaman,enhancement,35,18,17
Шанья,gordunni,1628,shaman,enhancement,255,125,130
Barrathrum,stormscale,1626,shaman,enhancement,30,22,8
Snuskilaban,tarren-mill,1626,shaman,enhancement,90,56,34
Ùseless,archimonde,1626,shaman,enhancement,36,20,16
Pyrabolt,ravencrest,1626,shaman,enhancement,135,70,65
Vann,the-shatar,1626,shaman,enhancement,79,39,40
Громовойболт,howling-fjord,1625,shaman,enhancement,42,28,14
Madeej,burning-legion,1625,shaman,enhancement,42,27,15
Madzÿ,archimonde,1625,shaman,enhancement,48,28,20
Raijinn,blackrock,1625,shaman,enhancement,100,57,43
Thørÿm,archimonde,1624,shaman,enhancement,64,37,27
Бездпса,gordunni,1624,shaman,enhancement,60,33,27
Gnubbzer,antonidas,1624,shaman,enhancement,78,42,36
Chamkalix,sanguino,1624,shaman,enhancement,78,40,38
Proccazu,draenor,1623,shaman,enhancement,90,57,33
Broock,kazzak,1623,shaman,enhancement,42,25,17
Khanaky,hyjal,1623,shaman,enhancement,168,89,79
Totemtrine,ravencrest,1623,shaman,enhancement,221,116,105
Rahtafary,sanguino,1623,shaman,enhancement,43,21,22
Crowness,ragnaros,1622,shaman,enhancement,149,82,67
Shyne,vashj,1622,shaman,enhancement,102,55,47
Úpli,blackmoore,1621,shaman,enhancement,30,18,12
Twists,sylvanas,1621,shaman,enhancement,36,21,15
Veronikka,dalaran,1621,shaman,enhancement,56,26,30
Hailele,argent-dawn,1620,shaman,enhancement,38,25,13
Одтагад,gordunni,1620,shaman,enhancement,220,115,105
Shamira,nethersturm,1620,shaman,enhancement,66,31,35
Filiduttsham,ravencrest,1619,shaman,enhancement,30,22,8
Akimó,ravencrest,1619,shaman,enhancement,89,43,46
Gøretterøg,ysondre,1618,shaman,enhancement,39,24,15
Shamarach,ragnaros,1618,shaman,enhancement,41,25,16
Krishun,blackmoore,1618,shaman,enhancement,67,31,36
Зэбой,howling-fjord,1616,shaman,enhancement,50,33,17
Shocktopussi,stormscale,1616,shaman,enhancement,87,50,37
Kæzx,blackrock,1616,shaman,enhancement,66,34,32
Ðreamz,kaelthas,1616,shaman,enhancement,318,160,158
Kyshka,tarren-mill,1616,shaman,enhancement,36,17,19
Werdup,sunstrider,1616,shaman,enhancement,44,19,25
Donkingkong,ravencrest,1615,shaman,enhancement,90,51,39
Пойдипокури,howling-fjord,1615,shaman,enhancement,144,79,65
Ibicc,twisting-nether,1615,shaman,enhancement,49,26,23
Kagurja,blackmoore,1614,shaman,enhancement,30,21,9
Ревашторм,howling-fjord,1612,shaman,enhancement,96,53,43
Alethea,frostmane,1612,shaman,enhancement,102,55,47
Moaxtyr,blackmoore,1611,shaman,enhancement,78,48,30
Ореганно,howling-fjord,1611,shaman,enhancement,72,40,32
Windstørm,tarren-mill,1611,shaman,enhancement,45,24,21
Voodoohexman,kazzak,1611,shaman,enhancement,235,125,110
Jondil,das-syndikat,1611,shaman,enhancement,71,37,34
Pintulicious,antonidas,1611,shaman,enhancement,48,25,23
Zakgar,ysondre,1611,shaman,enhancement,170,88,82
Stalkun,tarren-mill,1611,shaman,enhancement,60,31,29
Мистерэнх,soulflayer,1611,shaman,enhancement,42,20,22
Trenhard,wildhammer,1610,shaman,enhancement,95,60,35
Tàvèrnellø,nemesis,1610,shaman,enhancement,34,21,13
Electricgødx,tarren-mill,1610,shaman,enhancement,36,21,15
Stromkek,eredar,1610,shaman,enhancement,116,66,50
Satisfya,ambossar,1610,shaman,enhancement,81,46,35
Dumbasha,ravencrest,1610,shaman,enhancement,30,17,13
Tarantan,eredar,1610,shaman,enhancement,78,44,34
Thunderdøme,stormscale,1610,shaman,enhancement,59,30,29
Hyi,silvermoon,1610,shaman,enhancement,72,35,37
Benderbub,blackhand,1609,shaman,enhancement,130,70,60
Reverbx,outland,1608,shaman,enhancement,66,35,31
Шокмужик,gordunni,1608,shaman,enhancement,60,28,32
Cealdlynn,blackmoore,1607,shaman,enhancement,41,24,17
Ecclîpce,archimonde,1607,shaman,enhancement,93,52,41
Mazokuu,ragnaros,1607,shaman,enhancement,230,128,102
Elémenta,turalyon,1607,shaman,enhancement,54,30,24
Alwaysangry,silvermoon,1607,shaman,enhancement,109,57,52
Wørldrúiner,kazzak,1606,shaman,enhancement,63,34,29
Ancestro,kazzak,1606,shaman,enhancement,60,32,28
Madmadbro,tarren-mill,1606,shaman,enhancement,228,120,108
Drímé,ravencrest,1605,shaman,enhancement,132,80,52
Naïda,conseil-des-ombres,1605,shaman,enhancement,275,135,140
Medoje,argent-dawn,1604,shaman,enhancement,42,31,11
Гоэл,ashenvale,1604,shaman,enhancement,153,79,74
Naahma,hyjal,1603,shaman,enhancement,118,52,66
Mástà,onyxia,1602,shaman,enhancement,42,28,14
Arashi,rashgarroth,1602,shaman,enhancement,167,91,76
Sélenágóméz,chamber-of-aspects,1602,shaman,enhancement,52,28,24
Bubashaman,kazzak,1602,shaman,enhancement,42,22,20
Vulkân,silvermoon,1601,shaman,enhancement,176,97,79
Crysis,sanguino,1601,shaman,enhancement,42,19,23
Tijae,ravencrest,1600,shaman,enhancement,24,19,5
Чёкнутое,soulflayer,1600,shaman,enhancement,178,106,72
Rutil,blackhand,1600,shaman,enhancement,80,47,33
Zayliha,ravencrest,1600,shaman,enhancement,66,37,29
Porphy,kazzak,1600,shaman,enhancement,69,38,31
Buuddha,drakthul,1600,shaman,enhancement,71,39,32
Sparkii,kazzak,1600,shaman,enhancement,48,23,25
Amelie,burning-steppes,1597,shaman,enhancement,48,27,21
Megazz,drakthul,1597,shaman,enhancement,105,56,49
Sndheal,kazzak,1596,shaman,enhancement,24,19,5
Kooda,hyjal,1596,shaman,enhancement,54,29,25
Ubramovitch,hyjal,1596,shaman,enhancement,60,32,28
Neovim,trollbane,1596,shaman,enhancement,77,40,37
Tianoele,drakthul,1595,shaman,enhancement,39,25,14
Juniyaa,blackrock,1595,shaman,enhancement,107,58,49
Ойрхин,greymane,1595,shaman,enhancement,120,59,61
Имсомниум,howling-fjord,1595,shaman,enhancement,53,24,29
Nînadobrevx,stormscale,1593,shaman,enhancement,177,96,81
Cåmilis,archimonde,1593,shaman,enhancement,127,64,63
Рокмару,soulflayer,1593,shaman,enhancement,63,30,33
Urub,draenor,1591,shaman,enhancement,669,341,328
Mikesinatra,tarren-mill,1589,shaman,enhancement,33,20,13
Åkra,kazzak,1589,shaman,enhancement,40,21,19
Kpåshaman,tarren-mill,1588,shaman,enhancement,76,46,30
Elhefe,ravencrest,1588,shaman,enhancement,42,22,20
Urshak,alleria,1587,shaman,enhancement,30,21,9
Пучмек,gordunni,1587,shaman,enhancement,54,37,17
Oneshotunía,burning-legion,1587,shaman,enhancement,30,18,12
Blazingfiré,tarren-mill,1587,shaman,enhancement,66,37,29
Миддей,blackscar,1587,shaman,enhancement,48,26,22
Vforvendeta,defias-brotherhood,1587,shaman,enhancement,167,87,80
Элементи,gordunni,1587,shaman,enhancement,453,234,219
Scherolol,aegwynn,1586,shaman,enhancement,30,20,10
Shooktide,blackrock,1585,shaman,enhancement,48,25,23
Slímshámmy,twisting-nether,1585,shaman,enhancement,44,21,23
Fuzzynuts,ravencrest,1584,shaman,enhancement,104,56,48
Shamspam,arathor,1583,shaman,enhancement,48,39,9
Kammek,tarren-mill,1583,shaman,enhancement,81,48,33
Bozzclqwnx,aegwynn,1583,shaman,enhancement,104,59,45
Rubmehtotem,silvermoon,1582,shaman,enhancement,30,19,11
Äijä,chromaggus,1582,shaman,enhancement,96,51,45
Babal,outland,1582,shaman,enhancement,42,18,24
Remkoo,blackrock,1581,shaman,enhancement,60,35,25
Nuclearjohny,eredar,1581,shaman,enhancement,78,40,38
Secramas,ragnaros,1579,shaman,enhancement,196,104,92
Smozze,grim-batol,1578,shaman,enhancement,279,141,138
Ромчи,gordunni,1578,shaman,enhancement,36,18,18
Shockndawe,kazzak,1577,shaman,enhancement,54,32,22
Shammyspam,outland,1576,shaman,enhancement,53,33,20
Evalennart,stormscale,1575,shaman,enhancement,84,47,37
Alexmahone,dun-morogh,1575,shaman,enhancement,84,40,44
Barneyflight,ravencrest,1573,shaman,enhancement,67,37,30
Kolbászlelkü,ragnaros,1573,shaman,enhancement,80,41,39
Kanaky,hyjal,1573,shaman,enhancement,108,54,54
Elèon,blackrock,1573,shaman,enhancement,209,100,109
Лилнасыкс,gordunni,1571,shaman,enhancement,92,48,44
Ql,twisting-nether,1571,shaman,enhancement,89,44,45
Wertih,burning-legion,1570,shaman,enhancement,56,35,21
Pinácoladáqt,stormscale,1570,shaman,enhancement,72,36,36
Tonitøtem,onyxia,1569,shaman,enhancement,78,43,35
Эбгерсон,soulflayer,1568,shaman,enhancement,234,123,111
Wârmachiine,burning-legion,1568,shaman,enhancement,178,91,87
Khamo,twisting-nether,1567,shaman,enhancement,119,56,63
Порнёреф,howling-fjord,1566,shaman,enhancement,171,98,73
Loshohealva,stormscale,1566,shaman,enhancement,72,37,35
Shambamm,stormscale,1566,shaman,enhancement,78,40,38
Azzizael,argent-dawn,1566,shaman,enhancement,108,55,53
Hexwife,archimonde,1566,shaman,enhancement,254,128,126
Жарюшашлыки,blackscar,1565,shaman,enhancement,31,20,11
Cãlipsio,kazzak,1565,shaman,enhancement,41,22,19
Reparagos,sanguino,1565,shaman,enhancement,143,73,70
Ric,nemesis,1565,shaman,enhancement,54,24,30
Thrâwl,kazzak,1563,shaman,enhancement,24,19,5
Sûmmêrz,ravencrest,1563,shaman,enhancement,42,25,17
Колаэнжоер,soulflayer,1563,shaman,enhancement,99,53,46
Ferome,kazzak,1563,shaman,enhancement,48,22,26
Litenrolixd,tarren-mill,1562,shaman,enhancement,40,21,19
Kagarsham,kazzak,1560,shaman,enhancement,93,55,38
Upisi,burning-legion,1560,shaman,enhancement,89,52,37
Groumgard,hyjal,1559,shaman,enhancement,62,33,29
Healníx,ravencrest,1559,shaman,enhancement,54,24,30
Ocnan,malganis,1558,shaman,enhancement,92,48,44
Earthhulk,thrall,1558,shaman,enhancement,55,28,27
Барракудах,gordunni,1558,shaman,enhancement,386,189,197
Ekinoz,outland,1558,shaman,enhancement,133,61,72
Thunderpath,ragnaros,1557,shaman,enhancement,54,29,25
Kilniz,archimonde,1557,shaman,enhancement,32,17,15
Galvarod,silvermoon,1557,shaman,enhancement,36,19,17
Yelawolf,shattered-hand,1556,shaman,enhancement,66,38,28
Madboys,kazzak,1556,shaman,enhancement,102,48,54
Galthazar,silvermoon,1554,shaman,enhancement,76,39,37
Casualhex,argent-dawn,1554,shaman,enhancement,564,284,280
Moosavi,kazzak,1553,shaman,enhancement,36,19,17
Wòóshy,ravencrest,1553,shaman,enhancement,42,22,20
Tism,stormscale,1552,shaman,enhancement,52,32,20
Mefhaman,tarren-mill,1552,shaman,enhancement,67,40,27
Tiuzzo,alakir,1552,shaman,enhancement,42,23,19
Thralgr,sylvanas,1552,shaman,enhancement,66,31,35
Dunî,tarren-mill,1551,shaman,enhancement,90,55,35
Dolkoditch,outland,1551,shaman,enhancement,36,20,16
Garulf,twisting-nether,1551,shaman,enhancement,141,69,72
Heeze,doomhammer,1550,shaman,enhancement,310,163,147
Ugory,die-aldor,1549,shaman,enhancement,24,18,6
Reisti,stormscale,1548,shaman,enhancement,42,27,15
Darhgan,argent-dawn,1548,shaman,enhancement,98,56,42
Mowjo,la-croisade-écarlate,1548,shaman,enhancement,36,18,18
Грушовыйторт,howling-fjord,1547,shaman,enhancement,53,27,26
Windypops,tarren-mill,1547,shaman,enhancement,48,23,25
Kuzsham,archimonde,1547,shaman,enhancement,45,20,25
Rehgan,ragnaros,1546,shaman,enhancement,96,58,38
Apexpredlol,blackmoore,1546,shaman,enhancement,96,45,51
Акаварри,gordunni,1545,shaman,enhancement,30,18,12
Triplezug,archimonde,1545,shaman,enhancement,54,30,24
Shroomzzx,blackmoore,1545,shaman,enhancement,104,53,51
Elemefayoh,tarren-mill,1545,shaman,enhancement,96,48,48
Sházam,destromath,1544,shaman,enhancement,78,42,36
Гусан,booty-bay,1544,shaman,enhancement,259,131,128
Hexrated,draenor,1543,shaman,enhancement,117,67,50
Drexx,thrall,1543,shaman,enhancement,40,22,18
Enkzäm,archimonde,1543,shaman,enhancement,255,138,117
Tartakos,ravencrest,1543,shaman,enhancement,85,44,41
Stormbreáker,twisting-nether,1542,shaman,enhancement,226,122,104
Zooloo,twilights-hammer,1541,shaman,enhancement,88,46,42
Filigran,ragnaros,1540,shaman,enhancement,138,76,62
Thalir,aegwynn,1540,shaman,enhancement,127,61,66
Maddogxz,frostwolf,1539,shaman,enhancement,24,17,7
Practical,argent-dawn,1539,shaman,enhancement,86,52,34
Oronakgladx,ravencrest,1539,shaman,enhancement,194,99,95
Jeki,ysondre,1539,shaman,enhancement,269,131,138
Tharma,blackmoore,1538,shaman,enhancement,42,25,17
Tejasviin,amanthul,1538,shaman,enhancement,78,28,50
Skut,zuljin,1537,shaman,enhancement,58,30,28
Yinyleón,ravencrest,1536,shaman,enhancement,30,20,10
Souljaman,silvermoon,1536,shaman,enhancement,70,40,30
Fulguris,ravencrest,1535,shaman,enhancement,41,20,21
Бицэпс,gordunni,1534,shaman,enhancement,48,26,22
Keisys,kazzak,1534,shaman,enhancement,53,27,26
Rehgar,frostwhisper,1534,shaman,enhancement,120,59,61
Pelorta,zuljin,1533,shaman,enhancement,35,23,12
Thorâ,frostmane,1533,shaman,enhancement,117,68,49
Obelicius,outland,1533,shaman,enhancement,92,53,39
Epicenter,bloodscalp,1533,shaman,enhancement,78,37,41
Politemanner,stormscale,1532,shaman,enhancement,30,16,14
Mesrines,archimonde,1532,shaman,enhancement,66,35,31
Billburr,aegwynn,1531,shaman,enhancement,24,16,8
Лапища,soulflayer,1531,shaman,enhancement,119,67,52
Kàffkalafká,blackrock,1531,shaman,enhancement,40,20,20
Онеоне,deathweaver,1530,shaman,enhancement,36,17,19
Дефибо,howling-fjord,1529,shaman,enhancement,204,105,99
Gerethor,burning-legion,1529,shaman,enhancement,111,54,57
Raindx,draenor,1527,shaman,enhancement,24,16,8
Løktarøgàr,archimonde,1527,shaman,enhancement,85,47,38
Nubokesel,ragnaros,1527,shaman,enhancement,190,101,89
Jawoburst,antonidas,1527,shaman,enhancement,77,40,37
Ugáa,malganis,1527,shaman,enhancement,36,18,18
Bumbummann,blackmoore,1527,shaman,enhancement,148,72,76
Скерлайн,blackscar,1527,shaman,enhancement,72,32,40
Kfcmanager,ravencrest,1526,shaman,enhancement,118,64,54
Axilary,tarren-mill,1525,shaman,enhancement,24,16,8
Lapürge,archimonde,1525,shaman,enhancement,51,30,21
Ruintotems,twisting-nether,1524,shaman,enhancement,35,24,11
Lickzmytotem,draenor,1523,shaman,enhancement,72,38,34
Chamirox,ysondre,1523,shaman,enhancement,174,88,86
Mõrax,ysondre,1523,shaman,enhancement,228,113,115
Xzan,tarren-mill,1523,shaman,enhancement,74,30,44
Kurdhran,blackmoore,1522,shaman,enhancement,132,71,61
Windshockah,tarren-mill,1522,shaman,enhancement,89,47,42
Mailea,silvermoon,1522,shaman,enhancement,72,38,34
Твалор,soulflayer,1521,shaman,enhancement,188,101,87
Swoltz,argent-dawn,1521,shaman,enhancement,108,49,59
Krovn,aszune,1521,shaman,enhancement,60,27,33
Флэшмэн,blackscar,1520,shaman,enhancement,24,19,5
Mudwalker,ravencrest,1520,shaman,enhancement,33,17,16
Exythed,silvermoon,1519,shaman,enhancement,24,16,8
Hïgør,hyjal,1519,shaman,enhancement,85,48,37
Ericlomax,frostwhisper,1519,shaman,enhancement,94,51,43
Erupted,draenor,1519,shaman,enhancement,103,51,52
Тандеркок,soulflayer,1519,shaman,enhancement,197,97,100
Ивми,gordunni,1519,shaman,enhancement,53,24,29
Zows,kazzak,1518,shaman,enhancement,48,28,20
Mîkè,draenor,1518,shaman,enhancement,36,19,17
Хаммерн,gordunni,1518,shaman,enhancement,149,73,76
Lupisregina,silvermoon,1517,shaman,enhancement,24,16,8
Tornis,terokkar,1517,shaman,enhancement,137,68,69
Puumbaa,defias-brotherhood,1516,shaman,enhancement,102,52,50
Boulestraan,silvermoon,1516,shaman,enhancement,61,26,35
Тессельхоф,howling-fjord,1515,shaman,enhancement,42,23,19
Wylly,aegwynn,1515,shaman,enhancement,30,16,14
Frrostshockk,outland,1514,shaman,enhancement,36,17,19
Cowfeelings,ravencrest,1513,shaman,enhancement,30,16,14
Lightningrod,ravencrest,1512,shaman,enhancement,81,48,33
Shalisazzar,dentarg,1512,shaman,enhancement,48,27,21
Shoqt,les-sentinelles,1512,shaman,enhancement,42,22,20
Gorrissen,sylvanas,1512,shaman,enhancement,60,31,29
Ghorlin,draenor,1512,shaman,enhancement,84,43,41
Фастэра,soulflayer,1512,shaman,enhancement,42,16,26
Silden,thrall,1511,shaman,enhancement,18,16,2
Whizjy,sanguino,1511,shaman,enhancement,75,40,35
Wolfshade,aggra-português,1509,shaman,enhancement,68,41,27
Cràfty,blackrock,1509,shaman,enhancement,95,49,46
Nwäar,archimonde,1509,shaman,enhancement,102,51,51
Жуксик,greymane,1509,shaman,enhancement,66,31,35
Apocadwarf,auchindoun,1508,shaman,enhancement,24,16,8
Soomx,hyjal,1508,shaman,enhancement,116,59,57
Касикандрэра,soulflayer,1508,shaman,enhancement,179,91,88
Miriam,stormreaver,1507,shaman,enhancement,54,31,23
Бурехлест,howling-fjord,1507,shaman,enhancement,90,49,41
Ghostwolfe,ravencrest,1507,shaman,enhancement,30,16,14
Blitzboss,eredar,1507,shaman,enhancement,54,28,26
Cheetooth,ragnaros,1507,shaman,enhancement,105,52,53
Дректаш,soulflayer,1506,shaman,enhancement,108,55,53
Ират,howling-fjord,1505,shaman,enhancement,66,46,20
Гексанол,soulflayer,1505,shaman,enhancement,99,53,46
Mistahbeard,stormscale,1505,shaman,enhancement,90,47,43
Antomadorf,ravencrest,1504,shaman,enhancement,66,38,28
Boulggour,chogall,1504,shaman,enhancement,121,64,57
Wolfwesti,outland,1503,shaman,enhancement,54,37,17
Totemino,silvermoon,1503,shaman,enhancement,78,38,40
Кесмар,soulflayer,1502,shaman,enhancement,78,45,33
Orshan,draenor,1502,shaman,enhancement,156,87,69
Юрахафанбой,blackscar,1502,shaman,enhancement,30,16,14
Thunderhøøf,blackhand,1502,shaman,enhancement,60,29,31
Lëvi,archimonde,1501,shaman,enhancement,57,33,24
Штурвальный,blackscar,1501,shaman,enhancement,66,36,30
Sleven,twisting-nether,1501,shaman,enhancement,30,16,14
Irønythar,drakthul,1501,shaman,enhancement,107,54,53
Pepernootje,sylvanas,1501,shaman,enhancement,106,51,55
Bolgrath,blackmoore,1500,shaman,enhancement,121,61,60
Zomac,tarren-mill,1499,shaman,enhancement,30,17,13
Freadorn,uldaman,1498,shaman,enhancement,42,23,19
Thorcc,kazzak,1498,shaman,enhancement,90,45,45
Korvok,draenor,1497,shaman,enhancement,36,16,20
Imbaone,karazhan,1496,shaman,enhancement,54,31,23
Tanjîrø,archimonde,1496,shaman,enhancement,42,24,18
Capsoul,ravencrest,1496,shaman,enhancement,82,45,37
Preams,blackrock,1496,shaman,enhancement,44,22,22
Ошиндра,gordunni,1496,shaman,enhancement,34,17,17
Earthshot,magtheridon,1495,shaman,enhancement,58,28,30
Haldrim,blackmoore,1494,shaman,enhancement,45,25,20
Pilcosham,frostwhisper,1494,shaman,enhancement,167,82,85
Nìno,azshara,1494,shaman,enhancement,35,16,19
Ñêmêsìs,gorgonnash,1493,shaman,enhancement,114,58,56
Tunae,azjolnerub,1492,shaman,enhancement,52,28,24
Zateen,alonsus,1492,shaman,enhancement,60,32,28
Рскувосемь,soulflayer,1492,shaman,enhancement,60,26,34
Otacboziji,sylvanas,1491,shaman,enhancement,112,54,58
Élisabethtwo,culte-de-la-rive-noire,1491,shaman,enhancement,42,18,24
Kenseienh,kazzak,1490,shaman,enhancement,317,163,154
Nexdown,archimonde,1490,shaman,enhancement,57,28,29
Atée,silvermoon,1490,shaman,enhancement,87,42,45
Амг,booty-bay,1489,shaman,enhancement,127,73,54
Volltinus,tarren-mill,1489,shaman,enhancement,83,35,48
Rîzza,blackmoore,1489,shaman,enhancement,42,17,25
Juliaroberts,ragnaros,1488,shaman,enhancement,129,72,57
Mhoriaak,stormscale,1488,shaman,enhancement,119,64,55
Kohzen,outland,1488,shaman,enhancement,93,46,47
Хастурыч,gordunni,1487,shaman,enhancement,159,83,76
Szublime,stormscale,1487,shaman,enhancement,130,65,65
Xwitchdoctor,draenor,1487,shaman,enhancement,127,63,64
Razush,draenor,1486,shaman,enhancement,30,17,13
Fatflop,sylvanas,1486,shaman,enhancement,96,51,45
Джаабб,booty-bay,1486,shaman,enhancement,159,77,82
Drockg,ravencrest,1485,shaman,enhancement,30,17,13
Элетеми,soulflayer,1485,shaman,enhancement,95,48,47
Tonifo,nemesis,1485,shaman,enhancement,107,54,53
Mcbloob,kazzak,1485,shaman,enhancement,153,76,77
Orsted,blackhand,1484,shaman,enhancement,35,16,19
Nargrul,tarren-mill,1483,shaman,enhancement,74,43,31
Dwarfofwar,ravencrest,1483,shaman,enhancement,46,26,20
Mehboul,hyjal,1482,shaman,enhancement,36,19,17
Wfgoesbrbr,blackrock,1482,shaman,enhancement,108,56,52
Juicewillis,defias-brotherhood,1481,shaman,enhancement,84,50,34
Numeschnäu,eredar,1479,shaman,enhancement,36,22,14
Моктрогтар,ashenvale,1478,shaman,enhancement,212,113,99
Rakermän,dun-modr,1478,shaman,enhancement,58,30,28
Zabojad,stormscale,1477,shaman,enhancement,42,23,19
Axahavregryn,kazzak,1477,shaman,enhancement,120,59,61
Wolfmane,twisting-nether,1477,shaman,enhancement,125,56,69
Таиров,soulflayer,1476,shaman,enhancement,39,28,11
Héio,dalaran,1476,shaman,enhancement,48,23,25
Chimp,lightnings-blade,1475,shaman,enhancement,36,21,15
Trendsetter,frostmane,1475,shaman,enhancement,50,29,21
Thorbjörne,ravencrest,1475,shaman,enhancement,48,24,24
Rocktopus,outland,1475,shaman,enhancement,57,27,30
Nêmônin,perenolde,1474,shaman,enhancement,30,18,12
Tornadozzer,burning-legion,1474,shaman,enhancement,128,74,54
Ramaka,aegwynn,1474,shaman,enhancement,57,25,32
Takazer,ysondre,1473,shaman,enhancement,36,26,10
Gorezz,stormscale,1472,shaman,enhancement,44,22,22
Шамунчез,gordunni,1472,shaman,enhancement,59,29,30
Kärmá,stormscale,1471,shaman,enhancement,28,16,12
Enigmar,stormscale,1471,shaman,enhancement,93,43,50
Makotonagano,ravencrest,1470,shaman,enhancement,107,60,47
Атл,deathguard,1469,shaman,enhancement,103,63,40
Elevotor,kult-der-verdammten,1468,shaman,enhancement,30,16,14
Ønlýsîn,eredar,1468,shaman,enhancement,47,25,22
Aurèl,culte-de-la-rive-noire,1468,shaman,enhancement,76,34,42
Roovenhance,aegwynn,1467,shaman,enhancement,40,27,13
Stratholmee,drakthul,1467,shaman,enhancement,86,47,39
Фарраон,deathguard,1467,shaman,enhancement,219,115,104
Totemlover,draenor,1465,shaman,enhancement,137,76,61
Пивототем,gordunni,1465,shaman,enhancement,50,27,23
Zmech,chamber-of-aspects,1465,shaman,enhancement,67,30,37
Язма,grom,1463,shaman,enhancement,160,87,73
Mockingghost,blackmoore,1463,shaman,enhancement,36,19,17
Дромгрон,howling-fjord,1463,shaman,enhancement,42,22,20
Movex,arathor,1463,shaman,enhancement,57,27,30
Likesx,ravencrest,1462,shaman,enhancement,53,30,23
Hairball,turalyon,1462,shaman,enhancement,48,27,21
Shamrún,sylvanas,1462,shaman,enhancement,108,55,53
Fromhaven,doomhammer,1462,shaman,enhancement,82,41,41
Zoombieboy,dun-modr,1461,shaman,enhancement,36,22,14
Rink,frostmane,1461,shaman,enhancement,66,39,27
Barthølømew,kazzak,1461,shaman,enhancement,60,32,28
Dökowski,nemesis,1461,shaman,enhancement,90,40,50
Apekeeper,silvermoon,1461,shaman,enhancement,66,29,37
Шамвкроксах,howling-fjord,1461,shaman,enhancement,60,26,34
Earthquaker,the-maelstrom,1459,shaman,enhancement,36,21,15
Itswoland,tarren-mill,1459,shaman,enhancement,40,21,19
Maskiimon,blackrock,1458,shaman,enhancement,32,17,15
Zyphel,draenor,1457,shaman,enhancement,42,24,18
Vascodagama,twisting-nether,1457,shaman,enhancement,54,30,24
Yabadabadoo,burning-legion,1457,shaman,enhancement,72,38,34
Ózyy,draenor,1456,shaman,enhancement,34,21,13
Лаваяшка,gordunni,1456,shaman,enhancement,126,59,67
Cillysha,ravencrest,1455,shaman,enhancement,46,27,19
Тенав,blackscar,1455,shaman,enhancement,116,66,50
Ghobi,blackrock,1454,shaman,enhancement,78,35,43
Gerwntas,argent-dawn,1453,shaman,enhancement,77,41,36
Дрегтан,howling-fjord,1453,shaman,enhancement,101,47,54
Nyxoqtx,draenor,1451,shaman,enhancement,36,27,9
Капарис,deathweaver,1451,shaman,enhancement,198,103,95
Kärmá,lightbringer,1451,shaman,enhancement,60,26,34
Vrontes,kazzak,1450,shaman,enhancement,89,49,40
Shunder,earthen-ring,1450,shaman,enhancement,86,44,42
Shyrion,onyxia,1448,shaman,enhancement,94,43,51
Hanumanas,kazzak,1447,shaman,enhancement,37,23,14
Soteuudistus,silvermoon,1447,shaman,enhancement,84,44,40
Puncochar,zuljin,1446,shaman,enhancement,52,29,23
Justblow,twisting-nether,1446,shaman,enhancement,109,59,50
Thunderforce,drakthul,1446,shaman,enhancement,90,48,42
Relentlessqt,aegwynn,1445,shaman,enhancement,23,16,7
Alphas,draenor,1445,shaman,enhancement,44,26,18
Gímlééy,argent-dawn,1445,shaman,enhancement,60,30,30
Berethar,burning-blade,1445,shaman,enhancement,55,26,29
Dirtymiké,tarren-mill,1444,shaman,enhancement,41,16,25
Barbebiendur,archimonde,1443,shaman,enhancement,48,20,28
Neptun,twisting-nether,1442,shaman,enhancement,136,69,67
Пакни,gordunni,1442,shaman,enhancement,60,28,32
Zzadoxor,doomhammer,1441,shaman,enhancement,54,30,24
Ratnandez,outland,1441,shaman,enhancement,60,28,32
Ðeron,dun-modr,1441,shaman,enhancement,36,16,20
Агмень,howling-fjord,1440,shaman,enhancement,277,136,141
Эйнхарий,howling-fjord,1440,shaman,enhancement,74,36,38
Furrymane,blackmoore,1439,shaman,enhancement,36,24,12
Тыпроиграл,gordunni,1439,shaman,enhancement,30,15,15
Шлолка,gordunni,1439,shaman,enhancement,42,16,26
Jinzsham,ragnaros,1438,shaman,enhancement,53,31,22
Perunya,tarren-mill,1438,shaman,enhancement,53,27,26
Rîquetanace,archimonde,1437,shaman,enhancement,18,15,3
Jasnäh,ysondre,1437,shaman,enhancement,72,33,39
Anstict,silvermoon,1436,shaman,enhancement,42,26,16
Айбывайбы,howling-fjord,1436,shaman,enhancement,69,33,36
Exolnard,twisting-nether,1435,shaman,enhancement,76,43,33
Насуплекс,howling-fjord,1435,shaman,enhancement,30,16,14
Камам,gordunni,1435,shaman,enhancement,155,81,74
Wallachia,ysondre,1434,shaman,enhancement,24,15,9
Elesilf,sanguino,1434,shaman,enhancement,102,53,49
Stormblitz,twisting-nether,1434,shaman,enhancement,104,51,53
Stlakañ,chants-éternels,1433,shaman,enhancement,36,25,11
Rodneymullen,tarren-mill,1433,shaman,enhancement,92,48,44
Ftp,archimonde,1432,shaman,enhancement,96,57,39
Valaya,archimonde,1432,shaman,enhancement,146,81,65
Kïngmuntje,sylvanas,1432,shaman,enhancement,96,52,44
Нэдсон,greymane,1432,shaman,enhancement,30,16,14
Sënz,archimonde,1432,shaman,enhancement,75,35,40
Arabesk,arygos,1431,shaman,enhancement,138,79,59
Wedís,outland,1431,shaman,enhancement,96,54,42
Argonautt,drakthul,1431,shaman,enhancement,185,87,98
Пиводафф,howling-fjord,1430,shaman,enhancement,30,16,14
Bysonx,kazzak,1430,shaman,enhancement,158,78,80
Gralek,silvermoon,1429,shaman,enhancement,24,15,9
Réxor,pozzo-delleternità,1429,shaman,enhancement,54,24,30
Blueberrÿ,grim-batol,1428,shaman,enhancement,78,43,35
Dcanne,outland,1428,shaman,enhancement,99,52,47
Yurkën,uldum,1428,shaman,enhancement,60,29,31
Bakakas,outland,1428,shaman,enhancement,102,41,61
Goatsandoats,doomhammer,1427,shaman,enhancement,44,29,15
Mcslammer,kazzak,1427,shaman,enhancement,114,54,60
Shâymin,blackhand,1426,shaman,enhancement,24,15,9
Sshaasam,tarren-mill,1426,shaman,enhancement,93,58,35
Lehit,outland,1424,shaman,enhancement,30,15,15
Greenswag,drakthul,1423,shaman,enhancement,36,17,19
Xélania,argent-dawn,1422,shaman,enhancement,54,25,29
Evííl,tarren-mill,1421,shaman,enhancement,18,15,3
Мустажи,gordunni,1421,shaman,enhancement,113,71,42
Тысячаимен,gordunni,1421,shaman,enhancement,69,31,38
Lesnitt,kazzak,1421,shaman,enhancement,63,27,36
Vorkanyx,ysondre,1420,shaman,enhancement,48,32,16
Zuvx,ravencrest,1420,shaman,enhancement,66,38,28
Rhakhatheckh,nemesis,1419,shaman,enhancement,75,40,35
Spiitlava,silvermoon,1419,shaman,enhancement,36,18,18
Mèshuggáh,ravencrest,1419,shaman,enhancement,36,17,19
Nicesky,antonidas,1418,shaman,enhancement,197,111,86
Видсон,soulflayer,1418,shaman,enhancement,57,31,26
Promethxis,silvermoon,1418,shaman,enhancement,105,50,55
Frostýx,draenor,1418,shaman,enhancement,45,20,25
Икзок,soulflayer,1417,shaman,enhancement,84,43,41
Chendra,scarshield-legion,1417,shaman,enhancement,179,83,96
Kanabi,darkspear,1417,shaman,enhancement,36,16,20
Shreks,frostmane,1413,shaman,enhancement,66,38,28
Verlas,kazzak,1413,shaman,enhancement,88,48,40
Сюсуй,blackscar,1413,shaman,enhancement,63,31,32
Vascós,frostwolf,1412,shaman,enhancement,54,36,18
Kabard,silvermoon,1412,shaman,enhancement,36,21,15
Malvik,tarren-mill,1411,shaman,enhancement,41,23,18
Voljen,festung-der-stürme,1411,shaman,enhancement,30,15,15
Легендашам,soulflayer,1411,shaman,enhancement,66,30,36
Цс,azuregos,1410,shaman,enhancement,239,120,119
Шампуньхан,blackscar,1410,shaman,enhancement,88,35,53
Gnark,dun-modr,1409,shaman,enhancement,73,46,27
Shamxd,kazzak,1409,shaman,enhancement,77,37,40
Ýøuschøkz,frostwolf,1409,shaman,enhancement,38,15,23
Pinkylol,stormscale,1408,shaman,enhancement,30,15,15
Apolomaeuz,frostwolf,1407,shaman,enhancement,108,60,48
Shockybalbóa,blackmoore,1407,shaman,enhancement,118,58,60
Explôsive,silvermoon,1407,shaman,enhancement,117,53,64
Bantzer,twisting-nether,1406,shaman,enhancement,43,25,18
Elektrikci,silvermoon,1406,shaman,enhancement,102,50,52
Кгб,greymane,1405,shaman,enhancement,299,150,149
Ogmehu,stormreaver,1404,shaman,enhancement,141,72,69
Shambambum,blackrock,1404,shaman,enhancement,170,81,89
Deathshamãn,stormscale,1404,shaman,enhancement,88,39,49
Yaar,alleria,1403,shaman,enhancement,106,58,48
Lavashnikov,burning-legion,1403,shaman,enhancement,297,155,142
Blackibird,garona,1403,shaman,enhancement,114,54,60
Gatraem,drakthul,1403,shaman,enhancement,68,32,36
Andrewbéelko,drakthul,1402,shaman,enhancement,30,17,13
Fakeyy,draenor,1402,shaman,enhancement,36,20,16
Kíngzo,archimonde,1402,shaman,enhancement,138,71,67
Ðezûga,antonidas,1402,shaman,enhancement,262,131,131
Tyrox,kirin-tor,1401,shaman,enhancement,105,54,51
Басари,gordunni,1401,shaman,enhancement,57,29,28
Allakbarz,stormscale,1401,shaman,enhancement,159,79,80
Курси,gordunni,1401,shaman,enhancement,234,113,121
Ðelenis,dun-modr,1401,shaman,enhancement,78,34,44
Enormo,eredar,1400,shaman,enhancement,72,37,35
Twam,outland,1399,shaman,enhancement,72,40,32
Lumii,azshara,1399,shaman,enhancement,48,21,27
Суттех,soulflayer,1399,shaman,enhancement,60,25,35
Шрамуля,soulflayer,1398,shaman,enhancement,83,48,35
Nøve,nemesis,1398,shaman,enhancement,54,31,23
Yasaburo,silvermoon,1397,shaman,enhancement,80,39,41
Procdaddy,eredar,1396,shaman,enhancement,54,25,29
Panicblast,stormscale,1396,shaman,enhancement,41,16,25
Адичал,soulflayer,1394,shaman,enhancement,78,46,32
Fullproc,archimonde,1394,shaman,enhancement,72,37,35
Doclava,twisting-nether,1393,shaman,enhancement,71,38,33
Rätxs,blackhand,1393,shaman,enhancement,130,66,64
Drogash,nemesis,1393,shaman,enhancement,66,33,33
Varagun,argent-dawn,1393,shaman,enhancement,74,32,42
Durek,sylvanas,1392,shaman,enhancement,77,44,33
Тленозавр,gordunni,1392,shaman,enhancement,198,100,98
Laix,khaz-modan,1392,shaman,enhancement,36,17,19
Tacøshock,ravencrest,1389,shaman,enhancement,20,16,4
Vasuman,khaz-modan,1389,shaman,enhancement,96,43,53
Shockbot,blackmoore,1388,shaman,enhancement,30,20,10
Psychobarbie,outland,1388,shaman,enhancement,59,31,28
You,stormscale,1388,shaman,enhancement,86,44,42
Skólt,blackrock,1387,shaman,enhancement,145,77,68
Atis,the-maelstrom,1386,shaman,enhancement,36,15,21
Xilz,twisting-nether,1384,shaman,enhancement,137,67,70
Tescriamelio,ysondre,1384,shaman,enhancement,111,53,58
Priora,argent-dawn,1383,shaman,enhancement,52,33,19
Thunderwitch,lordaeron,1383,shaman,enhancement,30,17,13
Shockthat,draenor,1383,shaman,enhancement,192,102,90
Nejbegrov,ravencrest,1383,shaman,enhancement,86,38,48
Skrewu,stormscale,1383,shaman,enhancement,36,15,21
Zubesha,blackhand,1381,shaman,enhancement,28,15,13
Treâzin,the-maelstrom,1381,shaman,enhancement,47,24,23
Aêriâl,shendralar,1380,shaman,enhancement,127,68,59
Shamaray,stormscale,1380,shaman,enhancement,216,115,101
Vollt,kazzak,1380,shaman,enhancement,37,18,19
Charuzo,stormscale,1379,shaman,enhancement,36,17,19
Хрофайс,soulflayer,1378,shaman,enhancement,60,35,25
Thundergun,defias-brotherhood,1377,shaman,enhancement,36,23,13
Electrify,aegwynn,1377,shaman,enhancement,46,26,20
Chämalö,archimonde,1376,shaman,enhancement,193,100,93
Hellskon,silvermoon,1374,shaman,enhancement,23,15,8
Плюжка,greymane,1374,shaman,enhancement,222,121,101
Rockjuices,twisting-nether,1374,shaman,enhancement,114,61,53
Arlatjur,tarren-mill,1373,shaman,enhancement,52,32,20
Furioous,ravencrest,1373,shaman,enhancement,200,104,96
Justweirdaf,blackmoore,1373,shaman,enhancement,111,55,56
Быковат,booty-bay,1371,shaman,enhancement,102,53,49
Tahsus,blackmoore,1371,shaman,enhancement,78,38,40
Florex,kazzak,1369,shaman,enhancement,75,34,41
Шторсонг,gordunni,1368,shaman,enhancement,86,51,35
Bôdaway,antonidas,1368,shaman,enhancement,27,16,11
Hatchum,les-sentinelles,1367,shaman,enhancement,78,34,44
Targoel,blackmoore,1366,shaman,enhancement,30,20,10
Gurtok,drakthul,1366,shaman,enhancement,60,35,25
Matusal,argent-dawn,1366,shaman,enhancement,109,55,54
Женяшилдх,howling-fjord,1366,shaman,enhancement,97,48,49
Рыргаск,howling-fjord,1365,shaman,enhancement,70,38,32
Splat,burning-blade,1365,shaman,enhancement,36,18,18
Экспатриот,greymane,1364,shaman,enhancement,78,39,39
Notoxus,antonidas,1364,shaman,enhancement,78,39,39
Hulcky,grim-batol,1364,shaman,enhancement,102,49,53
Moondei,archimonde,1363,shaman,enhancement,42,24,18
Rykon,teldrassil,1362,shaman,enhancement,48,26,22
Torukhaï,archimonde,1361,shaman,enhancement,96,51,45
Smoldermane,argent-dawn,1361,shaman,enhancement,41,16,25
Шаманнутая,gordunni,1360,shaman,enhancement,25,17,8
Бетадварф,borean-tundra,1358,shaman,enhancement,38,21,17
Vallchan,kazzak,1355,shaman,enhancement,66,35,31
Nazgréll,tarren-mill,1355,shaman,enhancement,102,45,57
Kharazhan,blackrock,1354,shaman,enhancement,30,19,11
Thoreign,burning-legion,1352,shaman,enhancement,34,16,18
Shockaibo,drakthul,1352,shaman,enhancement,63,29,34
Nâs,kazzak,1352,shaman,enhancement,36,16,20
Kuse,blackmoore,1352,shaman,enhancement,42,16,26
Kjellshocked,draenor,1351,shaman,enhancement,24,15,9
Элетар,gordunni,1351,shaman,enhancement,116,59,57
Лайтхальзен,howling-fjord,1350,shaman,enhancement,125,59,66
Madppl,outland,1350,shaman,enhancement,79,32,47
Lokresh,azjolnerub,1347,shaman,enhancement,97,48,49
Lorios,boulderfist,1347,shaman,enhancement,42,20,22
Rether,nemesis,1347,shaman,enhancement,149,69,80
Ягном,soulflayer,1347,shaman,enhancement,87,39,48
Срувтапкии,deathguard,1346,shaman,enhancement,108,58,50
Thogrin,bladefist,1346,shaman,enhancement,36,15,21
Balfalor,antonidas,1345,shaman,enhancement,30,15,15
Exgüsi,blackhand,1343,shaman,enhancement,48,30,18
Кууджа,howling-fjord,1343,shaman,enhancement,76,37,39
Даблпамп,howling-fjord,1343,shaman,enhancement,35,16,19
Cahuna,stormscale,1343,shaman,enhancement,75,29,46
Gatcharoller,ragnaros,1342,shaman,enhancement,35,15,20
Azagtoth,tarren-mill,1341,shaman,enhancement,24,14,10
Vukroth,argent-dawn,1341,shaman,enhancement,85,46,39
Psÿkz,kazzak,1340,shaman,enhancement,79,37,42
Gåiå,argent-dawn,1340,shaman,enhancement,49,20,29
Relampago,eredar,1339,shaman,enhancement,41,19,22
Chamel,draenor,1337,shaman,enhancement,30,14,16
Shoockwave,twisting-nether,1337,shaman,enhancement,72,32,40
Залатар,howling-fjord,1337,shaman,enhancement,63,26,37
Fingor,tarren-mill,1336,shaman,enhancement,24,17,7
Noxstorm,frostwolf,1336,shaman,enhancement,99,52,47
Nakenfeigy,stormreaver,1335,shaman,enhancement,72,40,32
Траллгодх,blackscar,1335,shaman,enhancement,41,18,23
Ojipko,hyjal,1335,shaman,enhancement,42,17,25
Dabbadabba,silvermoon,1335,shaman,enhancement,54,20,34
Sûckmytotem,ragnaros,1334,shaman,enhancement,24,14,10
Эрхус,soulflayer,1334,shaman,enhancement,36,18,18
Lilbantu,ravencrest,1333,shaman,enhancement,78,48,30
Lahur,blackmoore,1333,shaman,enhancement,48,29,19
Шоманос,gordunni,1333,shaman,enhancement,42,25,17
Éàsy,blackmoore,1333,shaman,enhancement,38,20,18
Kpvn,blackrock,1333,shaman,enhancement,52,26,26
Dropbax,khaz-modan,1333,shaman,enhancement,97,47,50
Саксаул,fordragon,1333,shaman,enhancement,31,15,16
Eleshamandps,kazzak,1333,shaman,enhancement,36,16,20
Ударбуридуде,howling-fjord,1333,shaman,enhancement,48,14,34
Zbrt,draenor,1332,shaman,enhancement,33,15,18
Ferdizap,draenor,1332,shaman,enhancement,49,21,28
Cbshaman,sylvanas,1332,shaman,enhancement,36,15,21
Ískuma,blackmoore,1331,shaman,enhancement,30,15,15
Занги,soulflayer,1331,shaman,enhancement,114,56,58
Boidarbre,sargeras,1331,shaman,enhancement,42,15,27
Реалайзер,blackscar,1330,shaman,enhancement,24,14,10
Suicidesheep,grim-batol,1330,shaman,enhancement,66,32,34
Jameo,drakthul,1330,shaman,enhancement,336,157,179
Rhastasho,archimonde,1329,shaman,enhancement,162,85,77
Carusø,thrall,1329,shaman,enhancement,88,46,42
Hitmeagain,blackhand,1329,shaman,enhancement,30,14,16
Dräpàrn,sylvanas,1329,shaman,enhancement,30,14,16
Trîkill,hyjal,1329,shaman,enhancement,66,30,36
Cloùt,the-maelstrom,1329,shaman,enhancement,33,15,18
Xhøxy,outland,1329,shaman,enhancement,83,37,46
Farewell,mannoroth,1328,shaman,enhancement,34,16,18
Notgood,blackhand,1328,shaman,enhancement,42,19,23
Jarrek,draenor,1328,shaman,enhancement,87,39,48
Ойбоойй,howling-fjord,1328,shaman,enhancement,43,19,24
Moodoo,antonidas,1328,shaman,enhancement,53,20,33
Bacheebg,darksorrow,1327,shaman,enhancement,173,90,83
Vnqsh,arathor,1326,shaman,enhancement,26,15,11
Cringergodx,blackhand,1326,shaman,enhancement,65,35,30
Tênzo,ysondre,1325,shaman,enhancement,63,30,33
Kylas,die-ewige-wacht,1325,shaman,enhancement,30,14,16
Exinos,sylvanas,1322,shaman,enhancement,83,43,40
Shamãn,draenor,1322,shaman,enhancement,90,38,52
Heálmaster,sanguino,1321,shaman,enhancement,73,42,31
Surpraisq,ravencrest,1321,shaman,enhancement,120,63,57
Янапятьминут,soulflayer,1321,shaman,enhancement,35,18,17
Caramelito,kirin-tor,1320,shaman,enhancement,30,18,12
Xaví,archimonde,1320,shaman,enhancement,81,35,46
Clembute,cthun,1319,shaman,enhancement,48,28,20
Shadrahla,stormscale,1319,shaman,enhancement,24,14,10
Ashmantle,twisting-nether,1319,shaman,enhancement,89,42,47
Dami,die-aldor,1319,shaman,enhancement,45,18,27
Drýtón,blackrock,1318,shaman,enhancement,18,14,4
Ragnarspung,kazzak,1318,shaman,enhancement,60,30,30
Hectoraïus,ysondre,1317,shaman,enhancement,62,34,28
Yatiri,vashj,1317,shaman,enhancement,30,14,16
Imotii,burning-legion,1317,shaman,enhancement,92,37,55
Нимххе,borean-tundra,1316,shaman,enhancement,24,15,9
Hopefully,eredar,1316,shaman,enhancement,24,14,10
Igniis,frostmane,1316,shaman,enhancement,146,81,65
Pøllemodex,frostwhisper,1316,shaman,enhancement,31,15,16
Awsomo,ravencrest,1316,shaman,enhancement,85,37,48
Masatø,hyjal,1316,shaman,enhancement,55,23,32
Stormrex,magtheridon,1315,shaman,enhancement,296,155,141
Ðragaø,kazzak,1315,shaman,enhancement,48,25,23
Renkass,outland,1315,shaman,enhancement,30,14,16
Biglynx,sanguino,1314,shaman,enhancement,158,93,65
Welgor,kult-der-verdammten,1314,shaman,enhancement,102,59,43
Blautorkel,amanthul,1314,shaman,enhancement,71,34,37
Purgérkíng,silvermoon,1314,shaman,enhancement,30,14,16
Айспик,ashenvale,1314,shaman,enhancement,101,37,64
Aherya,zuljin,1313,shaman,enhancement,49,27,22
Shamarre,executus,1313,shaman,enhancement,62,29,33
Тмх,ashenvale,1313,shaman,enhancement,33,15,18
Mícheller,ravencrest,1312,shaman,enhancement,24,14,10
Лэнгипас,gordunni,1312,shaman,enhancement,205,106,99
Шабыч,deathguard,1312,shaman,enhancement,60,25,35
Xakum,stormscale,1311,shaman,enhancement,122,72,50
Sinwithin,ravencrest,1311,shaman,enhancement,36,19,17
Outerspace,silvermoon,1311,shaman,enhancement,48,25,23
Blackmuamba,tarren-mill,1311,shaman,enhancement,42,18,24
Ragnadim,silvermoon,1310,shaman,enhancement,40,19,21
Botnet,outland,1309,shaman,enhancement,78,41,37
Çaycî,blackhand,1308,shaman,enhancement,27,19,8
Dergat,pozzo-delleternità,1308,shaman,enhancement,42,20,22
Daelements,shadowsong,1308,shaman,enhancement,57,26,31
Nalàar,hyjal,1305,shaman,enhancement,29,16,13
Opráwindfury,stormscale,1305,shaman,enhancement,68,33,35
Qauter,hellfire,1305,shaman,enhancement,30,14,16
Malicrnii,outland,1305,shaman,enhancement,39,17,22
Watzocham,archimonde,1305,shaman,enhancement,54,23,31
Интендо,soulflayer,1304,shaman,enhancement,57,30,27
Сирибериешка,soulflayer,1303,shaman,enhancement,24,15,9
Lyzouh,archimonde,1303,shaman,enhancement,36,14,22
Draugrinns,tarren-mill,1302,shaman,enhancement,42,21,21
Rìchì,blackrock,1302,shaman,enhancement,30,14,16
Darten,drakthul,1301,shaman,enhancement,24,18,6
Grimtøtem,defias-brotherhood,1301,shaman,enhancement,62,33,29
Idxbi,kazzak,1300,shaman,enhancement,192,104,88
Groundead,alakir,1300,shaman,enhancement,40,16,24
Elektekk,blackrock,1299,shaman,enhancement,34,17,17
Jeppoh,tarren-mill,1296,shaman,enhancement,37,22,15
Maurrigan,rashgarroth,1296,shaman,enhancement,24,14,10
Zandali,tarren-mill,1296,shaman,enhancement,90,50,40
Ragnos,sanguino,1296,shaman,enhancement,296,154,142
Halorah,argent-dawn,1296,shaman,enhancement,313,161,152
Macoox,drakthul,1296,shaman,enhancement,120,52,68
Baldshield,ragnaros,1295,shaman,enhancement,30,14,16
Shaddoo,stormscale,1294,shaman,enhancement,29,14,15
Sunetee,kazzak,1294,shaman,enhancement,54,23,31
Roastbeef,blackrock,1293,shaman,enhancement,58,33,25
Akimboo,kilrogg,1291,shaman,enhancement,108,50,58
Polarboy,blackmoore,1289,shaman,enhancement,27,16,11
Raveell,defias-brotherhood,1289,shaman,enhancement,165,76,89
Gigamuscle,ravencrest,1288,shaman,enhancement,30,15,15
Bighommie,draenor,1287,shaman,enhancement,44,28,16
Enzjé,blackrock,1287,shaman,enhancement,30,14,16
Reggard,drakthul,1286,shaman,enhancement,42,21,21
Ishokyou,thrall,1286,shaman,enhancement,88,42,46
Daguvner,stormscale,1282,shaman,enhancement,72,32,40
Апинсмок,soulflayer,1280,shaman,enhancement,116,56,60
Yeemayne,outland,1279,shaman,enhancement,24,16,8
Towi,krasus,1278,shaman,enhancement,44,23,21
Mou,the-maelstrom,1278,shaman,enhancement,42,16,26
Броаркар,razuvious,1277,shaman,enhancement,106,56,50
Kunancementa,ravencrest,1277,shaman,enhancement,134,62,72
Hammerkiller,kilrogg,1277,shaman,enhancement,55,23,32
Зуфар,howling-fjord,1276,shaman,enhancement,67,36,31
Бигмамуля,booty-bay,1276,shaman,enhancement,72,35,37
Korzo,amanthul,1275,shaman,enhancement,58,37,21
Другалёк,howling-fjord,1275,shaman,enhancement,127,66,61
Hexd,defias-brotherhood,1275,shaman,enhancement,84,36,48
Navy,frostwolf,1274,shaman,enhancement,24,14,10
Sg,la-croisade-écarlate,1274,shaman,enhancement,91,50,41
Poullpy,sargeras,1274,shaman,enhancement,44,19,25
Neroty,blackmoore,1274,shaman,enhancement,60,23,37
Yànkøràmbow,arakarahm,1273,shaman,enhancement,27,16,11
Orli,aszune,1273,shaman,enhancement,48,26,22
Guqin,ravencrest,1273,shaman,enhancement,106,53,53
Sinkero,hellscream,1273,shaman,enhancement,92,44,48
Burstorama,alleria,1272,shaman,enhancement,36,17,19
Cool,tarren-mill,1270,shaman,enhancement,45,18,27
Даркгрон,thermaplugg,1269,shaman,enhancement,84,44,40
Beletili,chogall,1269,shaman,enhancement,75,33,42
Katastrofuss,stormscale,1268,shaman,enhancement,88,47,41
Thundérshock,kazzak,1268,shaman,enhancement,60,23,37
Delgagalduos,kazzak,1267,shaman,enhancement,48,25,23
Dezîbel,nathrezim,1267,shaman,enhancement,42,17,25
Mokteb,archimonde,1266,shaman,enhancement,30,14,16
Monstermunch,ravencrest,1266,shaman,enhancement,33,14,19
Iicks,blackrock,1264,shaman,enhancement,60,25,35
Шамвкроксах,gordunni,1261,shaman,enhancement,30,14,16
Shamananas,antonidas,1261,shaman,enhancement,84,39,45
Йовва,soulflayer,1259,shaman,enhancement,30,23,7
Baineoof,tarren-mill,1259,shaman,enhancement,41,18,23
Odeserundiye,cthun,1254,shaman,enhancement,24,17,7
Sounoukfrit,dalaran,1254,shaman,enhancement,87,46,41
Gõðzilla,blackmoore,1253,shaman,enhancement,34,17,17
Cavir,burning-blade,1253,shaman,enhancement,48,21,27
En,blackhand,1253,shaman,enhancement,36,15,21
Simularcum,kazzak,1252,shaman,enhancement,42,21,21
Shafallen,tarren-mill,1251,shaman,enhancement,18,14,4
Manrod,tarren-mill,1251,shaman,enhancement,72,36,36
Keräx,cthun,1251,shaman,enhancement,48,17,31
Layonne,ysondre,1250,shaman,enhancement,62,34,28
Humming,sanguino,1250,shaman,enhancement,93,50,43
Vhert,twisting-nether,1248,shaman,enhancement,63,27,36
Yasan,kazzak,1247,shaman,enhancement,139,69,70
Eclaîr,thrall,1247,shaman,enhancement,30,13,17
Martini,tichondrius,1246,shaman,enhancement,21,14,7
Darkstrong,alakir,1245,shaman,enhancement,42,22,20
Holten,outland,1245,shaman,enhancement,78,37,41
Dropdattotem,stormscale,1245,shaman,enhancement,35,15,20
Domiro,ravencrest,1245,shaman,enhancement,41,13,28
Stub,nemesis,1244,shaman,enhancement,70,38,32
Napoulion,khaz-modan,1244,shaman,enhancement,24,13,11
Murdá,ravencrest,1244,shaman,enhancement,24,13,11
Shockinghell,sylvanas,1243,shaman,enhancement,24,13,11
Тандерхем,gordunni,1243,shaman,enhancement,60,31,29
Rauka,outland,1242,shaman,enhancement,24,15,9
Crazypop,outland,1242,shaman,enhancement,24,13,11
Tashunka,twisting-nether,1242,shaman,enhancement,190,91,99
Hichibane,archimonde,1242,shaman,enhancement,30,13,17
Morkyy,thrall,1241,shaman,enhancement,18,13,5
Greatthrall,kazzak,1241,shaman,enhancement,56,29,27
Shamanite,drakthul,1241,shaman,enhancement,89,42,47
Khorrax,malygos,1240,shaman,enhancement,78,40,38
Shamanlynx,ravencrest,1239,shaman,enhancement,36,23,13
Trollden,silvermoon,1239,shaman,enhancement,24,13,11
Zokah,emeriss,1239,shaman,enhancement,42,22,20
Izaarleus,argent-dawn,1239,shaman,enhancement,44,22,22
Thormarg,archimonde,1239,shaman,enhancement,66,30,36
Podoroschnik,blackmoore,1238,shaman,enhancement,30,13,17
Théar,ravencrest,1237,shaman,enhancement,48,25,23
Krux,burning-blade,1237,shaman,enhancement,163,84,79
Doblir,bloodscalp,1237,shaman,enhancement,47,22,25
Blutschrei,tarren-mill,1236,shaman,enhancement,292,142,150
Prømetheüs,sanguino,1235,shaman,enhancement,86,48,38
Baaruch,kazzak,1235,shaman,enhancement,157,77,80
Squirtstorm,ravencrest,1235,shaman,enhancement,71,26,45
Gonzprime,burning-legion,1234,shaman,enhancement,24,13,11
Crespouu,doomhammer,1234,shaman,enhancement,169,89,80
Shamomo,hyjal,1234,shaman,enhancement,173,80,93
Tholdrin,outland,1234,shaman,enhancement,30,13,17
Kargos,stormscale,1234,shaman,enhancement,30,13,17
Leetajz,dunemaul,1234,shaman,enhancement,36,13,23
Velkin,thrall,1233,shaman,enhancement,18,13,5
Burghezu,magtheridon,1232,shaman,enhancement,79,48,31
Vaesk,auchindoun,1232,shaman,enhancement,72,39,33
Hodir,bronzebeard,1232,shaman,enhancement,63,31,32
Shøckz,blackrock,1231,shaman,enhancement,24,13,11
Likklebit,twisting-nether,1231,shaman,enhancement,31,14,17
Xfiles,garona,1231,shaman,enhancement,30,13,17
Uhnnas,drakthul,1231,shaman,enhancement,36,14,22
Pushs,archimonde,1230,shaman,enhancement,24,13,11
Hedjin,argent-dawn,1230,shaman,enhancement,126,66,60
Чернышус,soulflayer,1230,shaman,enhancement,74,34,40
Литлсмурф,gordunni,1230,shaman,enhancement,75,34,41
Cowkiller,minahonda,1229,shaman,enhancement,42,23,19
ßaßystärz,hyjal,1229,shaman,enhancement,27,13,14
Виндфайр,blackscar,1228,shaman,enhancement,30,15,15
Shockblaster,draenor,1228,shaman,enhancement,34,14,20
Maulstrom,pozzo-delleternità,1227,shaman,enhancement,49,30,19
Apócalypsee,ravencrest,1227,shaman,enhancement,30,13,17
Blitzviech,aegwynn,1226,shaman,enhancement,29,14,15
Redderss,silvermoon,1226,shaman,enhancement,48,22,26
Silko,wrathbringer,1226,shaman,enhancement,55,24,31
Какпак,fordragon,1226,shaman,enhancement,79,34,45
Arcura,twisting-nether,1225,shaman,enhancement,120,62,58
Shanosy,ravencrest,1223,shaman,enhancement,30,13,17
Shamaneo,outland,1222,shaman,enhancement,51,31,20
Акер,deathguard,1221,shaman,enhancement,42,27,15
Cementatar,burning-blade,1221,shaman,enhancement,36,21,15
Slaphappy,hellscream,1221,shaman,enhancement,27,14,13
Шалман,thermaplugg,1220,shaman,enhancement,527,260,267
Strygwyrl,doomhammer,1220,shaman,enhancement,30,14,16
Crawsz,archimonde,1219,shaman,enhancement,67,31,36
Maajo,tarren-mill,1219,shaman,enhancement,125,54,71
Zerandolix,blackrock,1218,shaman,enhancement,44,22,22
Shamohd,ravencrest,1218,shaman,enhancement,71,29,42
Шамяра,blackscar,1217,shaman,enhancement,24,15,9
Ulvur,blackhand,1216,shaman,enhancement,30,13,17
Mahlga,argent-dawn,1214,shaman,enhancement,147,72,75
Палачок,eversong,1210,shaman,enhancement,207,100,107
Hororka,drakthul,1209,shaman,enhancement,72,34,38
Ørgus,aegwynn,1208,shaman,enhancement,371,193,178
Çesto,destromath,1205,shaman,enhancement,24,13,11
Trollomatic,das-syndikat,1205,shaman,enhancement,143,70,73
Fàkecast,outland,1204,shaman,enhancement,91,42,49
Jangal,die-nachtwache,1201,shaman,enhancement,39,23,16
Dathanar,silvermoon,1201,shaman,enhancement,30,15,15
Ipbar,blackrock,1200,shaman,enhancement,56,29,27
Magram,darksorrow,1200,shaman,enhancement,41,21,20
Loatrox,eredar,1200,shaman,enhancement,36,17,19
Vàlentina,blackmoore,1195,shaman,enhancement,278,144,134
Gárrok,nerathor,1193,shaman,enhancement,24,13,11
Vøhm,archimonde,1193,shaman,enhancement,36,13,23
Wioda,silvermoon,1191,shaman,enhancement,149,84,65
Fourbevent,archimonde,1186,shaman,enhancement,27,16,11
Talf,tarren-mill,1186,shaman,enhancement,23,13,10
Ponzu,silvermoon,1184,shaman,enhancement,24,14,10
Noiduttu,tarren-mill,1184,shaman,enhancement,112,59,53
Dronius,kragjin,1184,shaman,enhancement,36,15,21
Замвождя,blackscar,1183,shaman,enhancement,214,102,112
Faridstreng,blackmoore,1182,shaman,enhancement,17,13,4
Nudyjuice,tarren-mill,1181,shaman,enhancement,38,17,21
Patites,twisting-nether,1179,shaman,enhancement,90,44,46
Kertunsisko,emeriss,1179,shaman,enhancement,84,39,45
Treizelol,ysondre,1179,shaman,enhancement,83,38,45
Øzy,sanguino,1177,shaman,enhancement,58,38,20
Rúthless,blackrock,1176,shaman,enhancement,30,13,17
Màverìck,nemesis,1171,shaman,enhancement,24,16,8
Jorny,burning-legion,1171,shaman,enhancement,54,17,37
Fika,the-venture-co,1170,shaman,enhancement,90,49,41
Bepiz,sylvanas,1170,shaman,enhancement,36,13,23
Qzaah,garona,1169,shaman,enhancement,27,13,14
Hokaji,tarren-mill,1168,shaman,enhancement,36,13,23
Chàrlord,twisting-nether,1167,shaman,enhancement,31,13,18
Tremuchamy,tyrande,1166,shaman,enhancement,51,28,23
Saduria,antonidas,1166,shaman,enhancement,120,64,56
Shigasu,die-aldor,1166,shaman,enhancement,39,17,22
Notragon,chamber-of-aspects,1166,shaman,enhancement,74,27,47
Haono,khaz-modan,1165,shaman,enhancement,30,15,15
Quartodebue,nemesis,1162,shaman,enhancement,24,13,11
Магмарончик,gordunni,1158,shaman,enhancement,85,40,45
Glibnica,draenor,1158,shaman,enhancement,39,16,23
Salgueiro,grim-batol,1155,shaman,enhancement,42,20,22
Rûngard,aegwynn,1155,shaman,enhancement,38,15,23
Zerodown,outland,1154,shaman,enhancement,77,33,44
Ипа,thermaplugg,1153,shaman,enhancement,149,76,73
Uselesstwo,archimonde,1152,shaman,enhancement,24,12,12
Deadwölf,outland,1152,shaman,enhancement,30,12,18
Blîzo,tarren-mill,1151,shaman,enhancement,16,13,3
Shootinguard,kazzak,1151,shaman,enhancement,18,12,6
Xorez,blackmoore,1151,shaman,enhancement,18,12,6
Sangvinus,outland,1151,shaman,enhancement,56,22,34
Pestomvp,tarren-mill,1150,shaman,enhancement,18,12,6
Шаманычгодх,howling-fjord,1150,shaman,enhancement,32,13,19
Jaszczurka,stormrage,1149,shaman,enhancement,18,12,6
Dmgaddict,kazzak,1149,shaman,enhancement,24,12,12
Shamsterr,karazhan,1149,shaman,enhancement,48,23,25
Chikabomb,sylvanas,1148,shaman,enhancement,18,12,6
Namrdak,quelthalas,1148,shaman,enhancement,297,152,145
Leasysham,antonidas,1148,shaman,enhancement,24,12,12
Warjuice,stormscale,1148,shaman,enhancement,29,14,15
Useemerollin,twisting-nether,1148,shaman,enhancement,36,15,21
Furian,die-nachtwache,1148,shaman,enhancement,42,16,26
Krâthøos,archimonde,1147,shaman,enhancement,18,12,6
Famepolîce,blackrock,1147,shaman,enhancement,18,12,6
Kirtach,dun-modr,1146,shaman,enhancement,18,12,6
Highontotems,stormscale,1146,shaman,enhancement,22,13,9
Nairî,blackhand,1146,shaman,enhancement,24,12,12
Dianè,stormscale,1145,shaman,enhancement,19,13,6
Картохыч,howling-fjord,1145,shaman,enhancement,18,12,6
Киллдрак,howling-fjord,1144,shaman,enhancement,46,24,22
Zevissh,outland,1144,shaman,enhancement,24,12,12
Самоанец,howling-fjord,1144,shaman,enhancement,24,12,12
Bualocktv,sylvanas,1142,shaman,enhancement,24,12,12
Bachetobg,darksorrow,1142,shaman,enhancement,71,33,38
Naariell,argent-dawn,1142,shaman,enhancement,95,44,51
Mcbayn,tarren-mill,1142,shaman,enhancement,91,39,52
Vemvardetsom,stormreaver,1142,shaman,enhancement,30,12,18
Ðexx,stormscale,1141,shaman,enhancement,18,12,6
Electricmon,stormscale,1140,shaman,enhancement,72,42,30
Persaunne,archimonde,1140,shaman,enhancement,91,43,48
Brooce,sylvanas,1140,shaman,enhancement,30,12,18
Elijaá,nordrassil,1138,shaman,enhancement,24,12,12
Tookaageeroo,burning-legion,1136,shaman,enhancement,86,43,43
Gahmnir,silvermoon,1136,shaman,enhancement,24,12,12
Enjoykenker,ravencrest,1135,shaman,enhancement,30,12,18
Slapodden,outland,1134,shaman,enhancement,24,12,12
Lumpp,kazzak,1134,shaman,enhancement,48,14,34
Бирхэпнс,blackscar,1131,shaman,enhancement,104,48,56
Mustang,twilights-hammer,1129,shaman,enhancement,320,151,169
Philcallings,tarren-mill,1127,shaman,enhancement,27,13,14
Kassyoh,hyjal,1127,shaman,enhancement,30,14,16
Волкк,soulflayer,1126,shaman,enhancement,98,53,45
Reverse,xavius,1125,shaman,enhancement,24,12,12
Шамманидзе,gordunni,1125,shaman,enhancement,95,42,53
Gibspark,twisting-nether,1124,shaman,enhancement,30,17,13
Syphilya,dun-morogh,1124,shaman,enhancement,24,12,12
Хмелецкий,soulflayer,1123,shaman,enhancement,127,68,59
Бойкийкот,gordunni,1123,shaman,enhancement,84,41,43
Isladinks,draenor,1123,shaman,enhancement,158,74,84
Totkodem,twisting-nether,1121,shaman,enhancement,50,25,25
Keysersozey,zuluhed,1120,shaman,enhancement,24,12,12
Viandehachee,dalaran,1119,shaman,enhancement,35,18,17
Cracklord,outland,1119,shaman,enhancement,24,12,12
Sturmbréchér,area-52,1119,shaman,enhancement,30,12,18
Виндфуриа,gordunni,1118,shaman,enhancement,123,57,66
Sìrenia,tarren-mill,1117,shaman,enhancement,74,43,31
Janserey,burning-legion,1117,shaman,enhancement,35,13,22
Spideysámli,ragnaros,1116,shaman,enhancement,18,12,6
Precíous,sporeggar,1116,shaman,enhancement,40,22,18
Gameblast,thunderhorn,1116,shaman,enhancement,36,12,24
Ilnspirall,drakthul,1115,shaman,enhancement,36,15,21
Mynaye,hyjal,1115,shaman,enhancement,30,12,18
Grommalgue,hyjal,1113,shaman,enhancement,54,30,24
Manushamanu,stormscale,1113,shaman,enhancement,83,36,47
Levitate,pozzo-delleternità,1110,shaman,enhancement,48,31,17
Povecategla,grim-batol,1108,shaman,enhancement,51,24,27
Lvq,kazzak,1107,shaman,enhancement,24,12,12
Шпекс,eversong,1105,shaman,enhancement,55,24,31
Limech,dalaran,1105,shaman,enhancement,84,36,48
Тотемныйчад,gordunni,1104,shaman,enhancement,28,13,15
Tswiftx,tarren-mill,1103,shaman,enhancement,23,12,11
Cerita,bloodhoof,1103,shaman,enhancement,99,43,56
Esciamano,nemesis,1101,shaman,enhancement,47,31,16
Murog,dalaran,1100,shaman,enhancement,25,14,11
Biggie,pozzo-delleternità,1099,shaman,enhancement,27,12,15
Bumm,twisting-nether,1099,shaman,enhancement,42,17,25
Djzeus,twisting-nether,1098,shaman,enhancement,21,12,9
Eneruswag,draenor,1098,shaman,enhancement,29,14,15
Nuluadroguri,twisting-nether,1098,shaman,enhancement,34,13,21
Etxarne,twisting-nether,1098,shaman,enhancement,42,12,30
Kireekoura,tarren-mill,1097,shaman,enhancement,33,14,19
Nurychic,twisting-nether,1097,shaman,enhancement,115,47,68
Munnar,dalaran,1097,shaman,enhancement,42,17,25
Sifu,ragnaros,1096,shaman,enhancement,24,13,11
Aquæ,suramar,1096,shaman,enhancement,233,120,113
Ironsidé,ragnaros,1096,shaman,enhancement,48,18,30
Zugzie,draenor,1095,shaman,enhancement,60,28,32
Curcumin,ravencrest,1095,shaman,enhancement,48,19,29
Oddsocks,stormscale,1091,shaman,enhancement,206,99,107
Donaldopumpo,stormscale,1090,shaman,enhancement,29,15,14
Fjal,die-nachtwache,1090,shaman,enhancement,103,46,57
Грейсаша,howling-fjord,1088,shaman,enhancement,42,24,18
Mooshock,balnazzar,1084,shaman,enhancement,26,12,14
Kringspierce,twisting-nether,1083,shaman,enhancement,73,43,30
Scottish,auchindoun,1083,shaman,enhancement,47,24,23
Thossa,draenor,1083,shaman,enhancement,155,77,78
Quarris,silvermoon,1082,shaman,enhancement,17,12,5
Eliaap,antonidas,1082,shaman,enhancement,159,75,84
Эсфира,ashenvale,1081,shaman,enhancement,137,67,70
Харрум,soulflayer,1080,shaman,enhancement,110,57,53
Snoc,guldan,1077,shaman,enhancement,57,26,31
Bábbajaggí,blackrock,1077,shaman,enhancement,30,13,17
Сквиртушка,gordunni,1077,shaman,enhancement,56,22,34
Шманя,soulflayer,1076,shaman,enhancement,29,12,17
Gyuksz,arathor,1075,shaman,enhancement,29,12,17
Windfury,sylvanas,1071,shaman,enhancement,134,65,69
Абиджия,gordunni,1071,shaman,enhancement,28,12,16
Анашишка,borean-tundra,1069,shaman,enhancement,42,16,26
Atixz,blackmoore,1065,shaman,enhancement,34,12,22
Hyamala,chamber-of-aspects,1063,shaman,enhancement,37,20,17
Korbas,burning-legion,1062,shaman,enhancement,42,12,30
Rockymarciia,dalaran,1060,shaman,enhancement,30,21,9
Rorenth,blackhand,1060,shaman,enhancement,86,44,42
Боргрим,eversong,1059,shaman,enhancement,112,48,64
Lokasakke,tarren-mill,1056,shaman,enhancement,18,11,7
Axiiom,draenor,1056,shaman,enhancement,18,11,7
Crazo,tarren-mill,1056,shaman,enhancement,24,11,13
Биттерлинкс,soulflayer,1056,shaman,enhancement,24,11,13
Kelvok,silvermoon,1055,shaman,enhancement,18,11,7
Killykritz,draenor,1055,shaman,enhancement,18,11,7
Gixor,silvermoon,1055,shaman,enhancement,18,11,7
Abordoga,twisting-nether,1055,shaman,enhancement,18,11,7
Aünsa,archimonde,1055,shaman,enhancement,18,11,7
Pay,stormscale,1055,shaman,enhancement,18,11,7
Weaslêy,frostwolf,1055,shaman,enhancement,45,24,21
Deådwolf,stormscale,1055,shaman,enhancement,23,12,11
Grosgourdin,la-croisade-écarlate,1055,shaman,enhancement,24,11,13
Hungover,outland,1055,shaman,enhancement,30,11,19
Trobø,ravencrest,1055,shaman,enhancement,33,12,21
Shamroyce,blackhand,1054,shaman,enhancement,18,11,7
Borbor,argent-dawn,1054,shaman,enhancement,18,11,7
Flamii,burning-legion,1054,shaman,enhancement,18,11,7
Berserked,emeriss,1054,shaman,enhancement,18,11,7
Tryscham,blackmoore,1054,shaman,enhancement,24,11,13
Chuckystrike,arthas,1054,shaman,enhancement,24,11,13
Kral,defias-brotherhood,1053,shaman,enhancement,18,11,7
Lothepus,balnazzar,1053,shaman,enhancement,18,11,7
Shockrates,pozzo-delleternità,1053,shaman,enhancement,24,11,13
Othu,ragnaros,1053,shaman,enhancement,24,11,13
Bólterz,twisting-nether,1053,shaman,enhancement,40,16,24
Asschick,outland,1052,shaman,enhancement,18,11,7
Тотембот,soulflayer,1052,shaman,enhancement,24,11,13
Onefurall,ragnaros,1052,shaman,enhancement,24,11,13
Rèxxar,stormscale,1052,shaman,enhancement,24,11,13
Swooch,shattered-hand,1051,shaman,enhancement,12,11,1
Quexsha,kazzak,1051,shaman,enhancement,18,11,7
Mhyrtïlle,kirin-tor,1051,shaman,enhancement,18,11,7
Rùx,twisting-nether,1051,shaman,enhancement,24,11,13
Электро,thermaplugg,1051,shaman,enhancement,24,11,13
Thokul,defias-brotherhood,1050,shaman,enhancement,18,11,7
Xørd,ysondre,1050,shaman,enhancement,24,11,13
Âlphan,silvermoon,1050,shaman,enhancement,24,11,13
Bloodlusts,archimonde,1050,shaman,enhancement,25,11,14
Alëssïo,ysondre,1049,shaman,enhancement,24,15,9
Еонса,howling-fjord,1048,shaman,enhancement,24,11,13
Щцц,soulflayer,1047,shaman,enhancement,18,11,7
Checkpoint,defias-brotherhood,1047,shaman,enhancement,36,14,22
Azrodas,defias-brotherhood,1046,shaman,enhancement,24,11,13
Moonkiss,veknilash,1043,shaman,enhancement,101,53,48
Stormbuzz,burning-legion,1042,shaman,enhancement,18,11,7
Vainerish,malygos,1042,shaman,enhancement,36,19,17
Asmat,pozzo-delleternità,1042,shaman,enhancement,30,15,15
Anöuchkâ,ysondre,1041,shaman,enhancement,18,11,7
Kushme,silvermoon,1041,shaman,enhancement,144,67,77
Lottery,ragnaros,1041,shaman,enhancement,24,11,13
Bíìerlip,twisting-nether,1041,shaman,enhancement,36,11,25
Shamrøck,archimonde,1040,shaman,enhancement,66,32,34
Nabq,hyjal,1040,shaman,enhancement,24,11,13
Nezuka,turalyon,1040,shaman,enhancement,39,17,22
Elementastic,xavius,1038,shaman,enhancement,24,11,13
Mørwayn,ysondre,1035,shaman,enhancement,24,11,13
Ultaz,ravencrest,1034,shaman,enhancement,104,40,64
Zamals,khaz-modan,1032,shaman,enhancement,30,13,17
Свистт,fordragon,1032,shaman,enhancement,160,69,91
Nïà,kaelthas,1031,shaman,enhancement,127,55,72
Мэлтем,soulflayer,1031,shaman,enhancement,54,20,34
Thormyr,dalaran,1030,shaman,enhancement,24,11,13
Burstmakro,blackhand,1030,shaman,enhancement,24,11,13
Eleboss,frostwolf,1025,shaman,enhancement,54,28,26
Nethershock,blackmoore,1023,shaman,enhancement,139,74,65
ßrawl,hyjal,1021,shaman,enhancement,23,11,12
Thorhonzor,drakthul,1019,shaman,enhancement,47,20,27
Shaqd,thrall,1017,shaman,enhancement,23,11,12
Practicetwo,argent-dawn,1015,shaman,enhancement,29,11,18
Rázzìm,eredar,1014,shaman,enhancement,28,11,17
Дядяшаман,gordunni,1009,shaman,enhancement,36,13,23
Wargriman,kelthuzad,1008,shaman,enhancement,47,24,23
Shaminista,ravencrest,1001,shaman,enhancement,24,13,11
Chamtroulku,ysondre,1001,shaman,enhancement,23,11,12
Vegà,thrall,1000,shaman,enhancement,21,13,8
Bigmassage,blackmoore,996,shaman,enhancement,27,12,15
Casymi,ravencrest,995,shaman,enhancement,29,14,15
Grinar,stormreaver,992,shaman,enhancement,65,27,38
Асуралока,gordunni,990,shaman,enhancement,17,11,6
Watchmeplz,archimonde,990,shaman,enhancement,22,11,11
Freizeitler,antonidas,988,shaman,enhancement,17,11,6
Chronochrome,chamber-of-aspects,988,shaman,enhancement,164,84,80
Джусипуси,gordunni,987,shaman,enhancement,48,19,29
Biphrost,nemesis,986,shaman,enhancement,87,45,42
Джертик,howling-fjord,984,shaman,enhancement,25,16,9
Chamanauzore,hyjal,979,shaman,enhancement,77,31,46
Нуишам,soulflayer,978,shaman,enhancement,19,13,6
Xarozz,blackmoore,978,shaman,enhancement,127,60,67
Yunero,argent-dawn,975,shaman,enhancement,19,11,8
Jaykezap,kazzak,968,shaman,enhancement,27,13,14
Twotwozero,defias-brotherhood,968,shaman,enhancement,47,22,25
Zoghzog,elune,968,shaman,enhancement,89,38,51
Sacwel,silvermoon,967,shaman,enhancement,18,11,7
Krakennm,dalaran,962,shaman,enhancement,79,37,42
Amiashaman,stormscale,961,shaman,enhancement,59,30,29
Miøn,kazzak,960,shaman,enhancement,12,10,2
Tätschentim,blackrock,960,shaman,enhancement,12,10,2
Dumhuvud,stormscale,960,shaman,enhancement,12,10,2
Blackyx,dun-modr,960,shaman,enhancement,18,10,8
Burstboy,tarren-mill,960,shaman,enhancement,18,10,8
Likê,aegwynn,960,shaman,enhancement,18,10,8
Bullet,blackmoore,960,shaman,enhancement,18,10,8
Teckan,tarren-mill,960,shaman,enhancement,20,10,10
Flameshock,stormreaver,959,shaman,enhancement,12,10,2
Ræi,drakthul,959,shaman,enhancement,12,10,2
Asçele,kazzak,959,shaman,enhancement,18,10,8
Shuraex,blackmoore,959,shaman,enhancement,18,10,8
Sìberiano,pozzo-delleternità,959,shaman,enhancement,18,10,8
Hariboo,arthas,959,shaman,enhancement,18,10,8
Equipshammy,silvermoon,959,shaman,enhancement,18,10,8
Хеллбат,howling-fjord,959,shaman,enhancement,18,10,8
Raketsven,dentarg,959,shaman,enhancement,18,10,8
Batan,kazzak,959,shaman,enhancement,24,10,14
Gnomecake,vashj,959,shaman,enhancement,24,10,14
Athankatouch,draenor,958,shaman,enhancement,18,10,8
Berzer,ragnaros,958,shaman,enhancement,18,10,8
Hurb,malorne,958,shaman,enhancement,18,10,8
Myngo,thrall,958,shaman,enhancement,18,10,8
Fúre,ravencrest,958,shaman,enhancement,18,10,8
Ragthan,kazzak,958,shaman,enhancement,18,10,8
Jorginho,burning-blade,958,shaman,enhancement,18,10,8
Kreyly,der-mithrilorden,958,shaman,enhancement,18,10,8
Stormkëëpër,stormscale,958,shaman,enhancement,51,19,32
Ironlionzion,ragnaros,957,shaman,enhancement,21,11,10
Wutgarek,blackrock,956,shaman,enhancement,18,10,8
Nebean,ragnaros,955,shaman,enhancement,18,10,8
Ybbarcs,eredar,955,shaman,enhancement,18,10,8
Tufftnamn,frostmane,955,shaman,enhancement,24,10,14
Shåmazïng,ravencrest,955,shaman,enhancement,24,10,14
Pureflame,silvermoon,955,shaman,enhancement,24,10,14
Shynkqt,archimonde,955,shaman,enhancement,30,10,20
Ichboxdich,madmortem,954,shaman,enhancement,18,10,8
Mansquidgoat,darksorrow,954,shaman,enhancement,24,10,14
Charth,ravencrest,954,shaman,enhancement,49,18,31
Stormess,zuljin,953,shaman,enhancement,18,10,8
Ragnarökaren,stormscale,953,shaman,enhancement,24,10,14
Carcksn,nerathor,951,shaman,enhancement,18,10,8
Авалеси,gordunni,951,shaman,enhancement,30,10,20
Laquium,blackmoore,950,shaman,enhancement,24,10,14
Darkcleaver,drakthul,950,shaman,enhancement,24,10,14
Nazma,blackhand,949,shaman,enhancement,12,10,2
Rèol,blackmoore,949,shaman,enhancement,30,10,20
Rushfabi,aegwynn,948,shaman,enhancement,24,10,14
Amonshokz,tarren-mill,947,shaman,enhancement,24,10,14
Wuchtzwerg,terrordar,945,shaman,enhancement,12,10,2
Sardemar,defias-brotherhood,944,shaman,enhancement,30,17,13
Yarøu,antonidas,944,shaman,enhancement,32,11,21
Golfrick,hyjal,940,shaman,enhancement,33,11,22
Bigsmacks,runetotem,939,shaman,enhancement,23,10,13
Broxh,sanguino,935,shaman,enhancement,102,39,63
Fernik,sanguino,935,shaman,enhancement,36,13,23
Чухмандос,gordunni,932,shaman,enhancement,23,11,12
Peixy,dun-modr,931,shaman,enhancement,54,31,23
Bigpapi,azjolnerub,927,shaman,enhancement,17,10,7
Elrayitos,shendralar,927,shaman,enhancement,22,10,12
Maskulin,antonidas,925,shaman,enhancement,18,10,8
Zuvboy,the-maelstrom,924,shaman,enhancement,28,10,18
Drocthar,defias-brotherhood,923,shaman,enhancement,76,32,44
Gruldo,tarren-mill,915,shaman,enhancement,41,10,31
Eomsham,magtheridon,912,shaman,enhancement,21,10,11
Shamaniak,tarren-mill,912,shaman,enhancement,48,11,37
Tangragmg,runetotem,909,shaman,enhancement,78,32,46
Тыщатристах,howling-fjord,903,shaman,enhancement,18,11,7
Stubby,nagrand,903,shaman,enhancement,43,20,23
Ластыч,borean-tundra,900,shaman,enhancement,30,13,17
Mendoz,nazjatar,895,shaman,enhancement,146,74,72
Spamorions,rashgarroth,895,shaman,enhancement,20,10,10
Wawawoowee,archimonde,893,shaman,enhancement,16,10,6
Ryujìñjakka,culte-de-la-rive-noire,892,shaman,enhancement,36,16,20
Cimer,sargeras,891,shaman,enhancement,113,49,64
Schabapi,blackmoore,887,shaman,enhancement,20,10,10
Elcoustillou,throkferoth,886,shaman,enhancement,183,86,97
Залазани,soulflayer,884,shaman,enhancement,30,15,15
Bimms,eredar,879,shaman,enhancement,19,10,9
Fòóxi,ravencrest,877,shaman,enhancement,211,104,107
Mimsy,hyjal,876,shaman,enhancement,53,21,32
Ximid,doomhammer,875,shaman,enhancement,130,52,78
Tuzep,bloodscalp,871,shaman,enhancement,59,23,36
Nervuus,burning-legion,870,shaman,enhancement,51,16,35
Argueaner,eonar,867,shaman,enhancement,40,15,25
Агирук,goldrinn,866,shaman,enhancement,25,12,13
Rylidare,khaz-modan,865,shaman,enhancement,65,28,37
Shabuu,dun-modr,864,shaman,enhancement,12,9,3
Khylejenner,kazzak,864,shaman,enhancement,12,9,3
Йодаримару,howling-fjord,864,shaman,enhancement,12,9,3
Electro,dentarg,864,shaman,enhancement,12,9,3
Thunderman,the-maelstrom,864,shaman,enhancement,12,9,3
Hexftw,khaz-modan,864,shaman,enhancement,12,9,3
Turbothea,blackmoore,864,shaman,enhancement,12,9,3
ßluegelato,silvermoon,864,shaman,enhancement,12,9,3
Arshak,stormscale,864,shaman,enhancement,18,9,9
Eshami,tarren-mill,864,shaman,enhancement,18,9,9
Gopimusprime,twisting-nether,864,shaman,enhancement,18,9,9
Deadwôlf,stormscale,864,shaman,enhancement,18,9,9
Ghettocheff,blackmoore,864,shaman,enhancement,24,9,15
Stephelord,blackmoore,864,shaman,enhancement,30,9,21
Virrogs,argent-dawn,863,shaman,enhancement,18,9,9
Réläx,kazzak,863,shaman,enhancement,18,9,9
Fiden,drakthul,863,shaman,enhancement,18,9,9
Nëÿrën,drakthul,863,shaman,enhancement,18,9,9
Purgey,ravencrest,863,shaman,enhancement,18,9,9
Taraesh,blackhand,863,shaman,enhancement,18,9,9
Gwout,burning-legion,863,shaman,enhancement,18,9,9
Сенхан,goldrinn,863,shaman,enhancement,18,9,9
Zðhan,azshara,863,shaman,enhancement,18,9,9
Хукман,howling-fjord,863,shaman,enhancement,18,9,9
Ironkin,tarren-mill,863,shaman,enhancement,18,9,9
Jhagy,archimonde,863,shaman,enhancement,24,9,15
Рэкквием,howling-fjord,863,shaman,enhancement,24,9,15
Sgtspyke,ragnaros,863,shaman,enhancement,24,9,15
Ikiku,twisting-nether,863,shaman,enhancement,28,10,18
Shamehameha,thrall,862,shaman,enhancement,12,9,3
Szelenamoonx,outland,862,shaman,enhancement,18,9,9
Камшатт,howling-fjord,862,shaman,enhancement,18,9,9
Tuncha,runetotem,862,shaman,enhancement,18,9,9
Jabja,antonidas,862,shaman,enhancement,18,9,9
Brigantino,burning-legion,862,shaman,enhancement,18,9,9
Pissluffer,tarren-mill,862,shaman,enhancement,18,9,9
Gagné,hyjal,862,shaman,enhancement,18,9,9
Jaydc,silvermoon,862,shaman,enhancement,22,9,13
Mästerruv,the-maelstrom,862,shaman,enhancement,24,9,15
Ордосус,gordunni,862,shaman,enhancement,24,9,15
Abdegor,burning-legion,861,shaman,enhancement,18,9,9
Mákí,blackhand,861,shaman,enhancement,18,9,9
Vermilyon,sanguino,861,shaman,enhancement,18,9,9
Hatyatya,ragnaros,861,shaman,enhancement,22,10,12
Bananaspliit,stormscale,861,shaman,enhancement,24,9,15
Seriux,twisting-nether,860,shaman,enhancement,15,10,5
Erscreamiko,zuljin,860,shaman,enhancement,18,9,9
Rashtar,ravencrest,860,shaman,enhancement,18,9,9
Yobanivrot,the-maelstrom,860,shaman,enhancement,24,9,15
Discoshort,kazzak,860,shaman,enhancement,24,9,15
Elesmelly,draenor,860,shaman,enhancement,24,9,15
Tatyabis,drekthar,859,shaman,enhancement,18,9,9
Rãgnãr,frostwolf,859,shaman,enhancement,24,9,15
Schaufelkopf,blackrock,859,shaman,enhancement,30,9,21
Loko,terokkar,857,shaman,enhancement,18,9,9
Earthvixen,ravencrest,857,shaman,enhancement,47,23,24
Тельхар,soulflayer,857,shaman,enhancement,19,9,10
Óõ,dun-modr,857,shaman,enhancement,24,10,14
Yzeed,argent-dawn,856,shaman,enhancement,18,9,9
Kaareh,frostmourne,856,shaman,enhancement,18,9,9
Fashess,sunstrider,855,shaman,enhancement,24,9,15
Sharomen,draenor,853,shaman,enhancement,48,17,31
Megalupa,burning-legion,852,shaman,enhancement,12,9,3
Slavazsu,draenor,851,shaman,enhancement,18,9,9
Magdarr,ysondre,846,shaman,enhancement,30,9,21
Халлстэин,gordunni,846,shaman,enhancement,39,10,29
Tregator,burning-legion,843,shaman,enhancement,18,9,9
Gälädhan,ysondre,839,shaman,enhancement,30,14,16
Kuhjo,malganis,837,shaman,enhancement,18,9,9
ßlãstmåçhîñê,kazzak,831,shaman,enhancement,24,10,14
Buldozar,blackmoore,831,shaman,enhancement,28,9,19
Hazles,ragnaros,830,shaman,enhancement,28,9,19
Lamoulastorm,chogall,828,shaman,enhancement,17,9,8
Deeblu,nemesis,821,shaman,enhancement,24,9,15
Grinan,hyjal,817,shaman,enhancement,53,16,37
Rodfrugten,draenor,815,shaman,enhancement,17,9,8
Shelara,drakthul,810,shaman,enhancement,31,14,17
Exereon,ravencrest,808,shaman,enhancement,20,11,9
Мамонтшам,howling-fjord,808,shaman,enhancement,17,9,8
Ìkarus,eredar,804,shaman,enhancement,40,17,23
Vix,argent-dawn,799,shaman,enhancement,14,9,5
Ниокэнх,gordunni,797,shaman,enhancement,16,9,7
Danthesham,draenor,796,shaman,enhancement,22,9,13
Birnenpfeffi,malfurion,793,shaman,enhancement,24,9,15
Hamstéole,hyjal,784,shaman,enhancement,16,9,7
Razgriz,confrérie-du-thorium,784,shaman,enhancement,19,9,10
Laghärta,dun-modr,783,shaman,enhancement,62,32,30
Koiru,argent-dawn,782,shaman,enhancement,19,9,10
Dêblâzê,thrall,768,shaman,enhancement,12,8,4
Whatsatotem,hyjal,768,shaman,enhancement,12,8,4
Achtungblitz,blackrock,768,shaman,enhancement,12,8,4
Trulor,stormscale,768,shaman,enhancement,12,8,4
Krytonian,twisting-nether,768,shaman,enhancement,12,8,4
Azùk,kazzak,768,shaman,enhancement,12,8,4
Qätär,ravencrest,768,shaman,enhancement,12,8,4
Драгенхз,gordunni,768,shaman,enhancement,12,8,4
Trankilo,silvermoon,768,shaman,enhancement,12,8,4
Cocolopez,tichondrius,768,shaman,enhancement,12,8,4
Bufalan,uldum,768,shaman,enhancement,12,8,4
Бурапи,howling-fjord,768,shaman,enhancement,12,8,4
Olej,burning-legion,768,shaman,enhancement,12,8,4
Blimblau,stormrage,768,shaman,enhancement,12,8,4
Jillibaa,stormscale,768,shaman,enhancement,12,8,4
Otsle,kazzak,768,shaman,enhancement,12,8,4
Маккаккаккак,gordunni,768,shaman,enhancement,14,8,6
Alëxx,hyjal,768,shaman,enhancement,18,8,10
Kanÿtsu,archimonde,768,shaman,enhancement,18,8,10
Complete,hyjal,767,shaman,enhancement,12,8,4
Dafreq,blackhand,767,shaman,enhancement,12,8,4
Nazzag,twisting-nether,767,shaman,enhancement,12,8,4
Wonderman,jaedenar,767,shaman,enhancement,12,8,4
Carlos,magtheridon,767,shaman,enhancement,18,8,10
Eurøz,archimonde,767,shaman,enhancement,18,8,10
Nínive,zuljin,767,shaman,enhancement,18,8,10
Satzuki,stormscale,767,shaman,enhancement,18,8,10
Totemcillas,sanguino,767,shaman,enhancement,18,8,10
Zaappyboii,azjolnerub,767,shaman,enhancement,18,8,10
Nápälm,dun-modr,767,shaman,enhancement,18,8,10
Ownsafe,les-clairvoyants,767,shaman,enhancement,18,8,10
Sebikzap,ravencrest,767,shaman,enhancement,18,8,10
Tschacô,malganis,767,shaman,enhancement,18,8,10
Snoopfrog,dun-morogh,767,shaman,enhancement,18,8,10
Slegit,arthas,767,shaman,enhancement,18,8,10
Nahkasika,defias-brotherhood,767,shaman,enhancement,18,8,10
Davkas,chamber-of-aspects,767,shaman,enhancement,18,8,10
Szamanito,turalyon,767,shaman,enhancement,18,8,10
Эллектрошам,ashenvale,767,shaman,enhancement,24,8,16
Devastatiia,ragnaros,766,shaman,enhancement,12,8,4
Mathak,thrall,766,shaman,enhancement,18,8,10
Bangrim,ragnaros,766,shaman,enhancement,24,8,16
Târu,blackrock,766,shaman,enhancement,24,8,16
Niveamann,eredar,765,shaman,enhancement,12,8,4
Rosewall,twisting-nether,765,shaman,enhancement,12,8,4
Elayco,twisting-nether,765,shaman,enhancement,18,8,10
Dillerfranz,stormscale,765,shaman,enhancement,18,8,10
Lôù,archimonde,765,shaman,enhancement,18,8,10
Epti,argent-dawn,765,shaman,enhancement,24,8,16
Agrok,jaedenar,765,shaman,enhancement,30,8,22
Энхким,soulflayer,765,shaman,enhancement,32,8,24
Ronctaha,blackrock,764,shaman,enhancement,12,8,4
Nëllaqt,archimonde,764,shaman,enhancement,18,8,10
Блэкмаршал,howling-fjord,764,shaman,enhancement,18,8,10
Vilberoo,ravencrest,764,shaman,enhancement,24,8,16
Socesalade,ysondre,764,shaman,enhancement,24,8,16
Зулкунд,soulflayer,763,shaman,enhancement,18,8,10
Escreption,tarren-mill,763,shaman,enhancement,24,8,16
Thrallotido,sanguino,762,shaman,enhancement,12,8,4
Olayan,zenedar,762,shaman,enhancement,18,8,10
Тилливилли,howling-fjord,761,shaman,enhancement,12,8,4
Wewondik,drakthul,759,shaman,enhancement,35,9,26
Shamanares,arathor,757,shaman,enhancement,12,8,4
Slushï,argent-dawn,757,shaman,enhancement,30,8,22
Azabi,defias-brotherhood,756,shaman,enhancement,24,8,16
Шамблабла,soulflayer,756,shaman,enhancement,30,8,22
Pewz,twilights-hammer,753,shaman,enhancement,36,8,28
Fotmslave,laughing-skull,749,shaman,enhancement,15,10,5
Asogg,archimonde,743,shaman,enhancement,24,9,15
Boltmac,mugthol,736,shaman,enhancement,16,9,7
Azuto,outland,735,shaman,enhancement,23,8,15
Dénekha,zuljin,733,shaman,enhancement,14,9,5
Negårn,tarren-mill,719,shaman,enhancement,11,8,3
Wàve,stormscale,719,shaman,enhancement,17,8,9
Kkthxbb,aegwynn,718,shaman,enhancement,15,8,7
Xereús,kazzak,718,shaman,enhancement,23,8,15
Ihealbro,blackrock,714,shaman,enhancement,16,11,5
Shamansito,tyrande,713,shaman,enhancement,21,9,12
Messedmyself,outland,710,shaman,enhancement,21,9,12
Jockin,tarren-mill,710,shaman,enhancement,29,10,19
Pospodrol,ragnaros,704,shaman,enhancement,16,8,8
Spajry,drakthul,702,shaman,enhancement,14,8,6
Lavashock,tarren-mill,700,shaman,enhancement,28,8,20
Bizzlebeast,lightbringer,687,shaman,enhancement,19,8,11
Tiamât,culte-de-la-rive-noire,685,shaman,enhancement,19,8,11
Bärtigeberta,aegwynn,672,shaman,enhancement,10,8,2
Shockstuff,draenor,672,shaman,enhancement,12,7,5
Neterö,la-croisade-écarlate,672,shaman,enhancement,12,7,5
Wayoa,defias-brotherhood,672,shaman,enhancement,12,7,5
Bladeyx,ragnaros,672,shaman,enhancement,12,7,5
Primez,twilights-hammer,672,shaman,enhancement,12,7,5
Roineé,draenor,672,shaman,enhancement,12,7,5
Thundêrclâp,blackrock,672,shaman,enhancement,12,7,5
Борисэнимал,gordunni,672,shaman,enhancement,12,7,5
Vutututututu,ragnaros,672,shaman,enhancement,12,7,5
Turbosaab,draenor,672,shaman,enhancement,12,7,5
Fudgekek,ravencrest,672,shaman,enhancement,12,7,5
Faeroox,ravencrest,672,shaman,enhancement,12,7,5
Инсэйнгодх,soulflayer,672,shaman,enhancement,12,7,5
Lêmberger,eredar,672,shaman,enhancement,12,7,5
Pacó,zuluhed,672,shaman,enhancement,12,7,5
Zanjulu,ravenholdt,672,shaman,enhancement,12,7,5
Magharro,kazzak,672,shaman,enhancement,12,7,5
Runè,azjolnerub,672,shaman,enhancement,12,7,5
Эоя,howling-fjord,672,shaman,enhancement,12,7,5
Proper,tichondrius,672,shaman,enhancement,12,7,5
Warlari,silvermoon,672,shaman,enhancement,12,7,5
Сарокида,howling-fjord,672,shaman,enhancement,12,7,5
Metalbeef,xavius,672,shaman,enhancement,12,7,5
Øutfox,silvermoon,672,shaman,enhancement,12,7,5
Windfúhrèr,tarren-mill,672,shaman,enhancement,14,7,7
Horiq,kazzak,672,shaman,enhancement,18,7,11
Votie,tarren-mill,672,shaman,enhancement,18,7,11
Sorlk,kazzak,672,shaman,enhancement,18,7,11
Kärríegold,blackrock,672,shaman,enhancement,18,7,11
Bichîk,archimonde,672,shaman,enhancement,18,7,11
Нерезшок,soulflayer,672,shaman,enhancement,18,7,11
Shougaku,blackrock,672,shaman,enhancement,18,7,11
Irmax,stormscale,672,shaman,enhancement,18,7,11
Zerak,twisting-nether,672,shaman,enhancement,21,8,13
Lavalew,lightbringer,672,shaman,enhancement,24,7,17
Hurbi,twisting-nether,672,shaman,enhancement,24,7,17
Stormfury,balnazzar,671,shaman,enhancement,12,7,5
Джоннси,howling-fjord,671,shaman,enhancement,12,7,5
Wiev,blackmoore,671,shaman,enhancement,12,7,5
Êvø,draenor,671,shaman,enhancement,12,7,5
Outhell,sylvanas,671,shaman,enhancement,12,7,5
Okmogar,khaz-modan,671,shaman,enhancement,12,7,5
Shocknorris,auchindoun,671,shaman,enhancement,12,7,5
Корграш,howling-fjord,671,shaman,enhancement,12,7,5
Zenzua,twisting-nether,671,shaman,enhancement,12,7,5
Shrêd,silvermoon,671,shaman,enhancement,12,7,5
Thalmorius,argent-dawn,671,shaman,enhancement,12,7,5
Napwak,hyjal,671,shaman,enhancement,12,7,5
Groundedx,ravencrest,671,shaman,enhancement,12,7,5
Phookov,ravencrest,671,shaman,enhancement,12,7,5
Kejazal,blackrock,671,shaman,enhancement,12,7,5
Çøynx,aegwynn,671,shaman,enhancement,18,7,11
Coxshamanic,draenor,671,shaman,enhancement,18,7,11
Sajma,silvermoon,671,shaman,enhancement,18,7,11
Younglasso,blackrock,671,shaman,enhancement,18,7,11
Fanatroka,ravencrest,671,shaman,enhancement,18,7,11
Vaalè,aegwynn,671,shaman,enhancement,18,7,11
Teenx,auchindoun,671,shaman,enhancement,18,7,11
Ulfom,silvermoon,671,shaman,enhancement,18,7,11
Sztol,burning-legion,671,shaman,enhancement,18,7,11
Bram,aggra-português,671,shaman,enhancement,18,7,11
Götveren,eredar,671,shaman,enhancement,18,7,11
Ghøhp,nerzhul,671,shaman,enhancement,18,7,11
Lafia,blackrock,671,shaman,enhancement,18,7,11
Meangreen,stormscale,671,shaman,enhancement,18,7,11
Chiwas,outland,671,shaman,enhancement,18,7,11
Galandrohk,stormscale,671,shaman,enhancement,18,7,11
Beyondliving,silvermoon,671,shaman,enhancement,18,7,11
Gnilley,blackrock,671,shaman,enhancement,20,7,13
Dreamtotem,tarren-mill,671,shaman,enhancement,20,7,13
Phizzik,ravencrest,670,shaman,enhancement,18,7,11
Shockýbalboa,ragnaros,670,shaman,enhancement,18,7,11
Sacrx,dalaran,670,shaman,enhancement,24,7,17
Prettymoon,pozzo-delleternità,670,shaman,enhancement,24,7,17
Limutsis,twilights-hammer,670,shaman,enhancement,24,7,17
Rúberg,shadowsong,669,shaman,enhancement,18,7,11
Roberticos,sanguino,669,shaman,enhancement,18,7,11
Bnovisa,kazzak,668,shaman,enhancement,20,7,13
Spirites,drakthul,667,shaman,enhancement,12,7,5
Wartay,doomhammer,667,shaman,enhancement,12,7,5
Фролыч,deathguard,645,shaman,enhancement,23,9,14
Zeuuss,zuljin,643,shaman,enhancement,18,7,11
Hemradi,blackmoore,638,shaman,enhancement,11,7,4
Hollowtotem,darkmoon-faire,617,shaman,enhancement,20,8,12
Skillxdxdxd,outland,608,shaman,enhancement,16,7,9
Nintotemxo,stormscale,607,shaman,enhancement,14,7,7
Перегной,ashenvale,607,shaman,enhancement,22,7,15
Lemoncurry,tarren-mill,604,shaman,enhancement,20,7,13
Bux,khaz-modan,602,shaman,enhancement,16,7,9
Doomburger,darksorrow,592,shaman,enhancement,13,7,6
Ulumulu,frostwolf,576,shaman,enhancement,6,6,0
Loryaahx,hyjal,576,shaman,enhancement,6,6,0
Lifeflow,sylvanas,576,shaman,enhancement,6,6,0
Ðécålëgwâðà,hyjal,576,shaman,enhancement,6,6,0
Darkirondwar,silvermoon,576,shaman,enhancement,6,6,0
Silataf,hyjal,576,shaman,enhancement,10,6,4
Türzumachen,outland,576,shaman,enhancement,12,6,6
Shakyi,thrall,576,shaman,enhancement,12,6,6
Proccity,stormscale,576,shaman,enhancement,12,6,6
Shiggenbasta,kazzak,576,shaman,enhancement,12,6,6
Thundersioux,ravencrest,576,shaman,enhancement,12,6,6
Nightmurpf,defias-brotherhood,576,shaman,enhancement,12,6,6
Венли,ashenvale,576,shaman,enhancement,12,6,6
Gruggosh,argent-dawn,576,shaman,enhancement,12,6,6
Yompo,archimonde,576,shaman,enhancement,12,6,6
Yiiro,argent-dawn,576,shaman,enhancement,12,6,6
Tastyxo,blackmoore,576,shaman,enhancement,12,6,6
Noneedshaman,stormscale,576,shaman,enhancement,12,6,6
Sypxic,kazzak,576,shaman,enhancement,12,6,6
Drøgøs,dun-modr,576,shaman,enhancement,12,6,6
Degstaerian,ysera,576,shaman,enhancement,12,6,6
Isogrind,archimonde,576,shaman,enhancement,12,6,6
Guccifootjob,defias-brotherhood,576,shaman,enhancement,12,6,6
Charlienaay,draenor,576,shaman,enhancement,12,6,6
Thëhêxfäçtør,tarren-mill,576,shaman,enhancement,12,6,6
Mouraïne,eredar,576,shaman,enhancement,12,6,6
Kémar,frostwolf,576,shaman,enhancement,12,6,6
Obêlixx,blackmoore,576,shaman,enhancement,12,6,6
Burstystorm,stormscale,576,shaman,enhancement,12,6,6
Kaingar,ravencrest,576,shaman,enhancement,12,6,6
Вайгачи,soulflayer,576,shaman,enhancement,12,6,6
Povvder,ravencrest,576,shaman,enhancement,12,6,6
Thundhrim,silvermoon,576,shaman,enhancement,12,6,6
Buffresto,kazzak,576,shaman,enhancement,12,6,6
Élement,burning-legion,576,shaman,enhancement,12,6,6
Lokkrag,archimonde,576,shaman,enhancement,12,6,6
Сегурд,gordunni,576,shaman,enhancement,12,6,6
Searfang,korgall,576,shaman,enhancement,12,6,6
Thunderwill,sanguino,576,shaman,enhancement,12,6,6
Leïnnah,elune,576,shaman,enhancement,12,6,6
Lurtax,outland,576,shaman,enhancement,12,6,6
Kazhan,alexstrasza,576,shaman,enhancement,13,6,7
Dagoahgra,sanguino,576,shaman,enhancement,18,6,12
Trogodos,blackrock,576,shaman,enhancement,18,6,12
Rejrax,ravencrest,576,shaman,enhancement,18,6,12
Hieroinmunaa,sunstrider,576,shaman,enhancement,18,6,12
Haasshaman,ravencrest,576,shaman,enhancement,18,6,12
Fambition,ragnaros,575,shaman,enhancement,12,6,6
Сакмастер,howling-fjord,575,shaman,enhancement,12,6,6
Carakh,archimonde,575,shaman,enhancement,12,6,6
Shalý,antonidas,575,shaman,enhancement,12,6,6
Patuljak,outland,575,shaman,enhancement,12,6,6
Schamikolben,blackmoore,575,shaman,enhancement,12,6,6
Finni,hyjal,575,shaman,enhancement,12,6,6
Pocakberci,silvermoon,575,shaman,enhancement,12,6,6
Энхолет,soulflayer,575,shaman,enhancement,12,6,6
Ukkó,ravencrest,575,shaman,enhancement,12,6,6
Даркнесх,howling-fjord,575,shaman,enhancement,12,6,6
Shawnmendes,kazzak,575,shaman,enhancement,15,7,8
Izaro,blackmoore,575,shaman,enhancement,21,7,14
Emphirian,die-silberne-hand,575,shaman,enhancement,18,6,12
Altostratus,hellfire,575,shaman,enhancement,18,6,12
Saulty,archimonde,575,shaman,enhancement,18,6,12
Ashgar,drakthul,575,shaman,enhancement,18,6,12
Raytastic,aegwynn,575,shaman,enhancement,18,6,12
Tholatir,silvermoon,575,shaman,enhancement,24,6,18
Yousainlbolt,blackrock,575,shaman,enhancement,24,6,18
Chllup,drakthul,574,shaman,enhancement,12,6,6
Zackyboi,tarren-mill,574,shaman,enhancement,12,6,6
Chamaiko,kaelthas,574,shaman,enhancement,18,6,12
Shaxall,draenor,574,shaman,enhancement,18,6,12
Rebekca,twisting-nether,574,shaman,enhancement,18,6,12
Лорикок,grom,574,shaman,enhancement,28,7,21
Bubbschock,antonidas,573,shaman,enhancement,12,6,6
Zuziki,argent-dawn,573,shaman,enhancement,12,6,6
Casarú,arthas,570,shaman,enhancement,18,6,12
Xssanimo,draenor,559,shaman,enhancement,17,6,11
Hurtigtotem,ravencrest,558,shaman,enhancement,15,7,8
Bhroly,stormscale,522,shaman,enhancement,21,8,13
Xhahal,hyjal,521,shaman,enhancement,19,7,12
Johnyexe,drakthul,515,shaman,enhancement,14,7,7
Chapox,alleria,511,shaman,enhancement,11,6,5
Fapmasterz,eredar,511,shaman,enhancement,11,6,5
Guzguzguz,blackhand,511,shaman,enhancement,14,6,8
Дереза,greymane,510,shaman,enhancement,20,6,14
Whïtewïdøw,ysondre,480,shaman,enhancement,6,5,1
Dorxt,chogall,480,shaman,enhancement,6,5,1
Genrok,burning-blade,480,shaman,enhancement,6,5,1
Celv,ravencrest,480,shaman,enhancement,6,5,1
Synergizer,kazzak,480,shaman,enhancement,6,5,1
Ðevi,ravencrest,480,shaman,enhancement,6,5,1
Эйонн,gordunni,480,shaman,enhancement,6,5,1
Kutcher,aegwynn,480,shaman,enhancement,6,5,1
Belford,ysondre,480,shaman,enhancement,6,5,1
Jumborumbo,quelthalas,480,shaman,enhancement,6,5,1
Pánjo,blackrock,480,shaman,enhancement,6,5,1
Svetosham,wildhammer,480,shaman,enhancement,6,5,1
Grâfiks,twisting-nether,480,shaman,enhancement,6,5,1
Eku,illidan,480,shaman,enhancement,6,5,1
Obsessionx,stormscale,480,shaman,enhancement,6,5,1
Seaview,silvermoon,480,shaman,enhancement,6,5,1
Wooyoungsham,sylvanas,480,shaman,enhancement,6,5,1
Nargaz,burning-legion,480,shaman,enhancement,6,5,1
Bârtmân,blackmoore,480,shaman,enhancement,6,5,1
Matapijos,dun-modr,480,shaman,enhancement,9,6,3
Shamsteaks,thrall,480,shaman,enhancement,9,6,3
Dianshaman,ravencrest,480,shaman,enhancement,10,6,4
Bowtenstorm,ravencrest,480,shaman,enhancement,12,5,7
Xoul,aegwynn,480,shaman,enhancement,12,5,7
Laserra,sylvanas,480,shaman,enhancement,12,5,7
Seerko,terokkar,480,shaman,enhancement,12,5,7
Ctrlv,blackhand,480,shaman,enhancement,12,5,7
Getahex,draenor,480,shaman,enhancement,12,5,7
Xelphia,frostmane,480,shaman,enhancement,12,5,7
Hobblefoot,stormscale,480,shaman,enhancement,12,5,7
Tempóralex,blackhand,480,shaman,enhancement,12,5,7
Grolifer,archimonde,480,shaman,enhancement,12,5,7
Lilmarco,stormreaver,480,shaman,enhancement,12,5,7
Djkost,archimonde,480,shaman,enhancement,12,5,7
Ацитра,gordunni,480,shaman,enhancement,12,5,7
Khoyuav,blackrock,480,shaman,enhancement,12,5,7
Pank,kazzak,480,shaman,enhancement,12,5,7
Пыльныйхлеб,blackscar,480,shaman,enhancement,12,5,7
Duhdelido,ravencrest,480,shaman,enhancement,12,5,7
Åkee,kazzak,480,shaman,enhancement,12,5,7
Feetsniffax,outland,480,shaman,enhancement,12,5,7
Tîk,dalaran,480,shaman,enhancement,12,5,7
Teaboï,hyjal,480,shaman,enhancement,12,5,7
Hurik,sylvanas,480,shaman,enhancement,12,5,7
Ñax,silvermoon,480,shaman,enhancement,12,5,7
Kejllåke,stormscale,480,shaman,enhancement,12,5,7
Jonnykaye,outland,480,shaman,enhancement,12,5,7
Guzz,cthun,480,shaman,enhancement,12,5,7
Smorclelx,khadgar,480,shaman,enhancement,12,5,7
Дротчим,soulflayer,480,shaman,enhancement,12,5,7
Jólla,twisting-nether,480,shaman,enhancement,12,5,7
Volcanò,outland,480,shaman,enhancement,12,5,7
Zarosh,los-errantes,480,shaman,enhancement,12,5,7
Смокдог,razuvious,480,shaman,enhancement,12,5,7
Pakasschami,frostwolf,480,shaman,enhancement,12,5,7
Whyisitspicy,kazzak,480,shaman,enhancement,12,5,7
Keshinio,archimonde,480,shaman,enhancement,18,5,13
Crilath,ysondre,480,shaman,enhancement,18,5,13
Indan,kazzak,480,shaman,enhancement,18,5,13
Zaknakatel,drakthul,480,shaman,enhancement,18,5,13
Hiron,sylvanas,480,shaman,enhancement,18,5,13
Afterlife,alakir,480,shaman,enhancement,18,5,13
Tomberêve,chants-éternels,480,shaman,enhancement,18,5,13
Solverna,der-mithrilorden,480,shaman,enhancement,18,5,13
Scharmharne,dun-morogh,480,shaman,enhancement,18,5,13
Johnisplay,tarren-mill,480,shaman,enhancement,18,5,13
Halliane,ysondre,480,shaman,enhancement,24,5,19
Sïlvek,sanguino,480,shaman,enhancement,24,5,19
Thunderrbob,darkspear,479,shaman,enhancement,6,5,1
Brassefrasse,shattered-hand,479,shaman,enhancement,6,5,1
Zerwurster,thrall,479,shaman,enhancement,10,6,4
Aznan,burning-legion,479,shaman,enhancement,12,5,7
Hønneyjck,hyjal,479,shaman,enhancement,12,5,7
Cupet,dun-modr,479,shaman,enhancement,12,5,7
Bullshock,stormreaver,479,shaman,enhancement,12,5,7
Chamrøck,hyjal,479,shaman,enhancement,12,5,7
Bautenn,kazzak,479,shaman,enhancement,12,5,7
Durotansan,ragnaros,479,shaman,enhancement,12,5,7
Samolse,outland,479,shaman,enhancement,13,5,8
Elementarxss,blackmoore,479,shaman,enhancement,18,5,13
Плюювшкафы,ashenvale,479,shaman,enhancement,18,5,13
Lavahurt,kazzak,479,shaman,enhancement,18,5,13
Kaybiel,magtheridon,478,shaman,enhancement,12,5,7
Hilerr,draenor,478,shaman,enhancement,18,5,13
Cudderisback,blackmoore,478,shaman,enhancement,24,5,19
Asstroy,sanguino,477,shaman,enhancement,6,5,1
Diamantiá,die-aldor,477,shaman,enhancement,24,5,19
Shockdx,dun-modr,463,shaman,enhancement,11,5,6
Zaffyboi,draenor,448,shaman,enhancement,16,5,11
Vicinitysham,twisting-nether,447,shaman,enhancement,11,5,6
Kelbi,malganis,432,shaman,enhancement,9,5,4
Electrical,kazzak,426,shaman,enhancement,15,6,9
Sicknu,eredar,425,shaman,enhancement,23,6,17
Bodytypeonex,darksorrow,415,shaman,enhancement,17,5,12
Luqas,burning-legion,414,shaman,enhancement,8,5,3
Behemothsm,kazzak,400,shaman,enhancement,7,5,2
Totems,the-venture-co,384,shaman,enhancement,6,4,2
Элемуэль,soulflayer,384,shaman,enhancement,6,4,2
Нийрагонго,gordunni,384,shaman,enhancement,6,4,2
Onetwothreé,der-rat-von-dalaran,384,shaman,enhancement,6,4,2
Shamanski,der-mithrilorden,384,shaman,enhancement,6,4,2
Aloeverayo,defias-brotherhood,384,shaman,enhancement,6,4,2
Piripolkka,defias-brotherhood,384,shaman,enhancement,6,4,2
Timí,blackmoore,384,shaman,enhancement,6,4,2
Aitch,blackmoore,384,shaman,enhancement,6,4,2
Baldurr,sylvanas,384,shaman,enhancement,6,4,2
Blamy,auchindoun,384,shaman,enhancement,6,4,2
Ilkim,hyjal,384,shaman,enhancement,6,4,2
Россаврн,galakrond,384,shaman,enhancement,6,4,2
Vønhørk,dalaran,384,shaman,enhancement,6,4,2
Shocrates,stormreaver,384,shaman,enhancement,6,4,2
Thundertommy,ravencrest,384,shaman,enhancement,6,4,2
Thornaim,hyjal,384,shaman,enhancement,6,4,2
Richtigfies,kazzak,384,shaman,enhancement,6,4,2
Aylar,zenedar,384,shaman,enhancement,6,4,2
Tornado,ravencrest,384,shaman,enhancement,6,4,2
Shamanman,kazzak,384,shaman,enhancement,6,4,2
Lunarsloth,hyjal,384,shaman,enhancement,6,4,2
Icetotem,antonidas,384,shaman,enhancement,6,4,2
Srøgg,archimonde,384,shaman,enhancement,6,4,2
Lethz,hyjal,384,shaman,enhancement,6,4,2
Burstraze,tarren-mill,384,shaman,enhancement,6,4,2
Vullpix,zuljin,384,shaman,enhancement,6,4,2
Alàstor,kazzak,384,shaman,enhancement,6,4,2
Darkestred,tarren-mill,384,shaman,enhancement,6,4,2
Rage,quelthalas,384,shaman,enhancement,6,4,2
Shakhdan,archimonde,384,shaman,enhancement,6,4,2
Kaej,ravencrest,384,shaman,enhancement,6,4,2
Weåfy,outland,384,shaman,enhancement,6,4,2
Shialesham,twisting-nether,384,shaman,enhancement,6,4,2
Stonebeard,minahonda,384,shaman,enhancement,6,4,2
Taroc,nethersturm,384,shaman,enhancement,6,4,2
Hextazy,archimonde,384,shaman,enhancement,6,4,2
Gurupan,tarren-mill,384,shaman,enhancement,6,4,2
Umilbhess,pozzo-delleternità,384,shaman,enhancement,6,4,2
Burzum,twisting-nether,384,shaman,enhancement,6,4,2
Watchmechoke,twisting-nether,384,shaman,enhancement,6,4,2
Gozath,twisting-nether,384,shaman,enhancement,6,4,2
Eldmärta,stormscale,384,shaman,enhancement,6,4,2
Pierredollar,outland,384,shaman,enhancement,6,4,2
Mustabrutus,tarren-mill,384,shaman,enhancement,6,4,2
Trünk,arathi,384,shaman,enhancement,6,4,2
Олешао,howling-fjord,384,shaman,enhancement,6,4,2
Tmpsykø,dalaran,384,shaman,enhancement,6,4,2
Xalta,eldrethalas,384,shaman,enhancement,6,4,2
Avatargadash,stormscale,384,shaman,enhancement,6,4,2
Bewbtester,stormscale,384,shaman,enhancement,6,4,2
Procbly,tarren-mill,384,shaman,enhancement,6,4,2
Shambulänce,doomhammer,384,shaman,enhancement,9,5,4
Szzk,kazzak,384,shaman,enhancement,9,5,4
Courtney,sylvanas,384,shaman,enhancement,12,4,8
Shôcopan,los-errantes,384,shaman,enhancement,12,4,8
Nerfmytots,hyjal,384,shaman,enhancement,12,4,8
Sgbich,khaz-modan,384,shaman,enhancement,12,4,8
Kayalii,silvermoon,384,shaman,enhancement,12,4,8
Akenoo,die-aldor,384,shaman,enhancement,12,4,8
Waterboi,blackmoore,384,shaman,enhancement,12,4,8
Dáweïs,drakthul,384,shaman,enhancement,12,4,8
Sourens,twisting-nether,384,shaman,enhancement,12,4,8
Türak,tarren-mill,384,shaman,enhancement,12,4,8
Дюнволкер,razuvious,384,shaman,enhancement,12,4,8
Эпссон,soulflayer,384,shaman,enhancement,12,4,8
Крепуксх,soulflayer,384,shaman,enhancement,12,4,8
Claodze,stormscale,384,shaman,enhancement,12,4,8
Алимика,deathguard,384,shaman,enhancement,12,4,8
Wisetotem,kazzak,384,shaman,enhancement,12,4,8
Klamen,kazzak,384,shaman,enhancement,12,4,8
Kiwanuká,draenor,384,shaman,enhancement,12,4,8
Sheldoww,tarren-mill,384,shaman,enhancement,12,4,8
Tetóm,draenor,384,shaman,enhancement,12,4,8
Beefythunder,draenor,384,shaman,enhancement,12,4,8
Hexbeforesex,kazzak,384,shaman,enhancement,12,4,8
Blixtnedslag,shattered-hand,384,shaman,enhancement,12,4,8
Michi,dethecus,384,shaman,enhancement,12,4,8
Yeah,emeriss,384,shaman,enhancement,12,4,8
Nagyrakéta,ragnaros,384,shaman,enhancement,12,4,8
Хулн,gordunni,384,shaman,enhancement,12,4,8
Bumblebíí,ravencrest,384,shaman,enhancement,12,4,8
Invòkèr,kazzak,384,shaman,enhancement,12,4,8
Javalemcgee,ravencrest,384,shaman,enhancement,12,4,8
Szami,burning-legion,384,shaman,enhancement,12,4,8
Sfeerá,burning-legion,384,shaman,enhancement,12,4,8
Туркшаман,howling-fjord,384,shaman,enhancement,12,4,8
Warrmace,kazzak,384,shaman,enhancement,12,4,8
Шиока,borean-tundra,384,shaman,enhancement,12,4,8
Jaéto,ravencrest,384,shaman,enhancement,12,4,8
Cptcutíe,antonidas,384,shaman,enhancement,12,4,8
Yasunari,sanguino,384,shaman,enhancement,18,4,14
Derryo,silvermoon,384,shaman,enhancement,18,4,14
Wkretarka,burning-legion,384,shaman,enhancement,18,4,14
Powder,tichondrius,384,shaman,enhancement,18,4,14
Shipzen,kazzak,384,shaman,enhancement,18,4,14
Carnágé,blackrock,383,shaman,enhancement,6,4,2
Ðuster,jaedenar,383,shaman,enhancement,6,4,2
Goblaman,pozzo-delleternità,383,shaman,enhancement,6,4,2
Wolkano,zuljin,383,shaman,enhancement,10,5,5
Noobbuster,thrall,383,shaman,enhancement,12,4,8
Châmanco,dun-modr,383,shaman,enhancement,12,4,8
Аеесо,gordunni,383,shaman,enhancement,12,4,8
Hightotem,sanguino,383,shaman,enhancement,12,4,8
Ширудо,galakrond,383,shaman,enhancement,12,4,8
Rioshammy,kazzak,383,shaman,enhancement,14,4,10
Blutshock,zuluhed,382,shaman,enhancement,12,4,8
Envergur,eitrigg,379,shaman,enhancement,12,4,8
Shamantun,ragnaros,367,shaman,enhancement,11,4,7
Ciaolol,ragnaros,362,shaman,enhancement,13,6,7
Hassinto,dun-modr,348,shaman,enhancement,11,4,7
Piaoliang,ravencrest,336,shaman,enhancement,9,4,5
Arkänïc,hyjal,336,shaman,enhancement,15,4,11
Akash,culte-de-la-rive-noire,336,shaman,enhancement,15,4,11
Macchiavelli,blades-edge,319,shaman,enhancement,8,4,4
Komplat,eredar,319,shaman,enhancement,14,4,10
Moolurken,stormscale,304,shaman,enhancement,7,4,3
Mércander,kazzak,304,shaman,enhancement,7,4,3
Ayrá,ulduar,297,shaman,enhancement,12,6,6
Suedis,frostmane,288,shaman,enhancement,6,3,3
Qwevstorm,kazzak,288,shaman,enhancement,6,3,3
Phazuki,frostmane,288,shaman,enhancement,6,3,3
Hotsincezero,archimonde,288,shaman,enhancement,6,3,3
Cakedeux,grim-batol,288,shaman,enhancement,6,3,3
Knoffl,eredar,288,shaman,enhancement,6,3,3
Berzærker,ravencrest,288,shaman,enhancement,6,3,3
Vanquïsh,archimonde,288,shaman,enhancement,6,3,3
Nakutotem,ravencrest,288,shaman,enhancement,6,3,3
Rzia,kazzak,288,shaman,enhancement,6,3,3
Magosh,blackmoore,288,shaman,enhancement,6,3,3
Malcolmhex,ysondre,288,shaman,enhancement,6,3,3
Laeddish,silvermoon,288,shaman,enhancement,6,3,3
Unrealench,ravencrest,288,shaman,enhancement,6,3,3
Takanashisha,lordaeron,288,shaman,enhancement,6,3,3
Vainzxsham,ravencrest,288,shaman,enhancement,6,3,3
Làvagdx,archimonde,288,shaman,enhancement,6,3,3
Canoli,eredar,288,shaman,enhancement,6,3,3
Shreddedcntw,ravencrest,288,shaman,enhancement,6,3,3
Skanda,frostwolf,288,shaman,enhancement,6,3,3
Picabøø,kazzak,288,shaman,enhancement,6,3,3
Phýzed,archimonde,288,shaman,enhancement,6,3,3
Shametrainx,malganis,288,shaman,enhancement,6,3,3
Fairgewalt,blackhand,288,shaman,enhancement,6,3,3
Daishodrums,antonidas,288,shaman,enhancement,6,3,3
Størmgød,archimonde,288,shaman,enhancement,6,3,3
Daubidaubi,kazzak,288,shaman,enhancement,6,3,3
Penesecco,nemesis,288,shaman,enhancement,6,3,3
Demonshamy,silvermoon,288,shaman,enhancement,6,3,3
Athèna,blutkessel,288,shaman,enhancement,6,3,3
Namos,aegwynn,288,shaman,enhancement,6,3,3
Malfurîyon,blackhand,288,shaman,enhancement,6,3,3
Omegaproblem,blackmoore,288,shaman,enhancement,6,3,3
Hyperbeazt,stormscale,288,shaman,enhancement,6,3,3
Chispa,darkmoon-faire,288,shaman,enhancement,6,3,3
Saro,destromath,288,shaman,enhancement,6,3,3
Сажке,booty-bay,288,shaman,enhancement,6,3,3
Kemurus,kazzak,288,shaman,enhancement,6,3,3
Hansdieter,antonidas,288,shaman,enhancement,6,3,3
Ostbumsdirne,stormscale,288,shaman,enhancement,6,3,3
Неутолимыйх,blackscar,288,shaman,enhancement,6,3,3
Venterlofeu,archimonde,288,shaman,enhancement,6,3,3
Bløødypain,blackhand,288,shaman,enhancement,6,3,3
Varion,tichondrius,288,shaman,enhancement,6,3,3
Pissflinger,tarren-mill,288,shaman,enhancement,6,3,3
Аналкарниваа,gordunni,288,shaman,enhancement,6,3,3
Ашьф,gordunni,288,shaman,enhancement,6,3,3
Moebius,hellscream,288,shaman,enhancement,6,3,3
Foxfyre,tarren-mill,288,shaman,enhancement,6,3,3
Omnivamp,kazzak,288,shaman,enhancement,6,3,3
Akilzz,tarren-mill,288,shaman,enhancement,6,3,3
Nerdshammyx,tarren-mill,288,shaman,enhancement,6,3,3
Ветренаяледи,gordunni,288,shaman,enhancement,6,3,3
Sadoa,ravencrest,288,shaman,enhancement,6,3,3
Tidalflow,stormscale,288,shaman,enhancement,6,3,3
Нерфшок,gordunni,288,shaman,enhancement,6,3,3
Рокутаро,gordunni,288,shaman,enhancement,6,3,3
Ednard,silvermoon,288,shaman,enhancement,6,3,3
Glïmar,sanguino,288,shaman,enhancement,6,3,3
Kulho,stormscale,288,shaman,enhancement,6,3,3
Freekster,die-ewige-wacht,288,shaman,enhancement,6,3,3
Wûcs,silvermoon,288,shaman,enhancement,6,3,3
Samyishamy,tarren-mill,288,shaman,enhancement,6,3,3
Мэлик,howling-fjord,288,shaman,enhancement,6,3,3
Bizquit,blackhand,288,shaman,enhancement,6,3,3
Имфеллиар,howling-fjord,288,shaman,enhancement,6,3,3
Gamalimbo,tarren-mill,288,shaman,enhancement,6,3,3
Айбьорн,gordunni,288,shaman,enhancement,6,3,3
Odelagga,sylvanas,288,shaman,enhancement,6,3,3
Огнешторм,howling-fjord,288,shaman,enhancement,6,3,3
Kafese,uldaman,288,shaman,enhancement,6,3,3
Fourmana,sylvanas,288,shaman,enhancement,6,3,3
Renjín,tarren-mill,288,shaman,enhancement,6,3,3
Totoostoy,burning-legion,288,shaman,enhancement,6,3,3
Weltr,drakthul,288,shaman,enhancement,6,3,3
Кулутхе,soulflayer,288,shaman,enhancement,6,3,3
Chrisbrownx,outland,288,shaman,enhancement,6,3,3
Ñtk,dun-modr,288,shaman,enhancement,6,3,3
Parkroy,draenor,288,shaman,enhancement,6,3,3
Pelicius,sanguino,288,shaman,enhancement,6,3,3
Ccedtodeath,sylvanas,288,shaman,enhancement,6,3,3
Shoewalker,ragnaros,288,shaman,enhancement,6,3,3
Tharwin,hellfire,288,shaman,enhancement,6,3,3
Ghoon,arathor,288,shaman,enhancement,6,3,3
Sodor,laughing-skull,288,shaman,enhancement,6,3,3
Millesabords,dun-morogh,288,shaman,enhancement,6,3,3
Spørc,ragnaros,288,shaman,enhancement,6,3,3
Stormz,blackrock,288,shaman,enhancement,6,3,3
Vaexi,doomhammer,288,shaman,enhancement,6,3,3
Läzy,sanguino,288,shaman,enhancement,6,3,3
Bluemyst,outland,288,shaman,enhancement,6,3,3
Alkiog,cthun,288,shaman,enhancement,6,3,3
Skölls,kirin-tor,288,shaman,enhancement,6,3,3
Cocorocks,quelthalas,288,shaman,enhancement,6,3,3
Hexmynúts,draenor,288,shaman,enhancement,6,3,3
Bendimina,chogall,288,shaman,enhancement,6,3,3
Tarzh,dalaran,288,shaman,enhancement,6,3,3
Wakoteh,quelthalas,288,shaman,enhancement,6,3,3
Magraith,korgall,288,shaman,enhancement,6,3,3
Hyoshin,kirin-tor,288,shaman,enhancement,6,3,3
Lilkazamm,blackrock,288,shaman,enhancement,6,3,3
Hikigane,marécage-de-zangar,288,shaman,enhancement,6,3,3
Katsumî,dalaran,288,shaman,enhancement,6,3,3
Hystérik,chogall,288,shaman,enhancement,6,3,3
Виндфюрер,deathguard,288,shaman,enhancement,6,3,3
Foxtér,burning-blade,288,shaman,enhancement,6,3,3
Yerlas,burning-legion,288,shaman,enhancement,6,3,3
Yacuzwerg,blackrock,288,shaman,enhancement,6,3,3
Uomae,dun-modr,288,shaman,enhancement,6,3,3
Xesti,twisting-nether,288,shaman,enhancement,6,3,3
Cremed,kazzak,288,shaman,enhancement,6,3,3
Zahadumia,blackrock,288,shaman,enhancement,6,3,3
Vyzeries,silvermoon,288,shaman,enhancement,6,3,3
Rayez,draenor,288,shaman,enhancement,6,3,3
Karazrok,draenor,288,shaman,enhancement,6,3,3
Stormstout,zuljin,288,shaman,enhancement,6,3,3
Surge,darksorrow,288,shaman,enhancement,6,3,3
Bowellsham,magtheridon,288,shaman,enhancement,6,3,3
Nojiko,blackrock,288,shaman,enhancement,6,3,3
Håõkåh,hyjal,288,shaman,enhancement,6,3,3
Diviyo,magtheridon,288,shaman,enhancement,6,3,3
Happyfart,thrall,288,shaman,enhancement,9,3,6
Zwiisch,outland,288,shaman,enhancement,15,4,11
Kabà,aegwynn,288,shaman,enhancement,12,3,9
Thundereater,blackmoore,288,shaman,enhancement,12,3,9
Maino,archimonde,288,shaman,enhancement,12,3,9
Kónna,darksorrow,288,shaman,enhancement,12,3,9
Lorthargol,chamber-of-aspects,288,shaman,enhancement,12,3,9
Talgru,aegwynn,288,shaman,enhancement,12,3,9
Kappatotem,silvermoon,288,shaman,enhancement,12,3,9
Rharhahra,archimonde,288,shaman,enhancement,12,3,9
Garash,draenor,288,shaman,enhancement,12,3,9
Teldathree,archimonde,288,shaman,enhancement,12,3,9
Bonesee,turalyon,288,shaman,enhancement,12,3,9
Æskalatiøn,aegwynn,288,shaman,enhancement,12,3,9
Dastarus,archimonde,288,shaman,enhancement,12,3,9
Bonestompamc,blackmoore,288,shaman,enhancement,12,3,9
Brunütansol,sylvanas,288,shaman,enhancement,12,3,9
Arethousa,silvermoon,288,shaman,enhancement,12,3,9
Kobzol,draenor,288,shaman,enhancement,12,3,9
Shockmelone,blackrock,288,shaman,enhancement,12,3,9
Georgewhat,defias-brotherhood,288,shaman,enhancement,12,3,9
Ghortus,magtheridon,288,shaman,enhancement,12,3,9
Сторниер,howling-fjord,288,shaman,enhancement,12,3,9
Japom,ravencrest,288,shaman,enhancement,12,3,9
Egart,stormscale,288,shaman,enhancement,12,3,9
Suaaktt,tyrande,288,shaman,enhancement,12,3,9
Titiprosop,stormscale,288,shaman,enhancement,12,3,9
Orcazm,argent-dawn,288,shaman,enhancement,12,3,9
Inkman,azjolnerub,288,shaman,enhancement,12,3,9
Бьерн,deepholm,288,shaman,enhancement,12,3,9
Bordellgast,thrall,288,shaman,enhancement,12,3,9
Fünkchn,zuluhed,288,shaman,enhancement,12,3,9
Thundrthighs,aggramar,288,shaman,enhancement,12,3,9
Satishamz,ravencrest,288,shaman,enhancement,12,3,9
Avattar,twisting-nether,288,shaman,enhancement,12,3,9
Gramjäh,ysondre,288,shaman,enhancement,12,3,9
Akkix,antonidas,288,shaman,enhancement,12,3,9
Sturmfürsti,antonidas,288,shaman,enhancement,12,3,9
Areiyla,silvermoon,288,shaman,enhancement,12,3,9
Maybeyes,twisting-nether,288,shaman,enhancement,12,3,9
Shambamty,thrall,288,shaman,enhancement,12,3,9
Albedøo,ragnaros,288,shaman,enhancement,12,3,9
Morgenmuffel,die-aldor,287,shaman,enhancement,6,3,3
Nothìnto,pozzo-delleternità,287,shaman,enhancement,6,3,3
Trotzig,aegwynn,287,shaman,enhancement,6,3,3
Стакок,soulflayer,287,shaman,enhancement,6,3,3
Slappybag,ravencrest,287,shaman,enhancement,9,3,6
Zarun,stormrage,287,shaman,enhancement,12,3,9
Heshamman,kazzak,256,shaman,enhancement,22,3,19
Krudir,pozzo-delleternità,255,shaman,enhancement,8,4,4
Rký,outland,240,shaman,enhancement,9,3,6
Hamié,outland,239,shaman,enhancement,5,3,2
Kaátori,eredar,239,shaman,enhancement,5,3,2
Лирооии,howling-fjord,239,shaman,enhancement,5,3,2
Smashellos,pozzo-delleternità,239,shaman,enhancement,5,3,2
Jehae,archimonde,239,shaman,enhancement,5,3,2
Nefasti,stormscale,223,shaman,enhancement,8,3,5
Runfromme,kazzak,223,shaman,enhancement,8,3,5
Громулл,deathguard,223,shaman,enhancement,8,3,5
Qjx,blackrock,208,shaman,enhancement,7,3,4
Styxsm,blackhand,208,shaman,enhancement,7,3,4
Thunderstørm,chogall,192,shaman,enhancement,6,2,4
Mív,outland,192,shaman,enhancement,6,2,4
Wurrzág,outland,192,shaman,enhancement,6,2,4
Palarins,dalaran,192,shaman,enhancement,6,2,4
Magicmekoz,draenor,192,shaman,enhancement,6,2,4
Turbinká,burning-legion,192,shaman,enhancement,6,2,4
Diya,karazhan,192,shaman,enhancement,6,2,4
Schamitwo,twisting-nether,192,shaman,enhancement,6,2,4
Kwitnac,silvermoon,192,shaman,enhancement,6,2,4
Mmrpurge,twisting-nether,192,shaman,enhancement,6,2,4
Трупелмен,soulflayer,192,shaman,enhancement,6,2,4
Bloodfist,drakthul,192,shaman,enhancement,6,2,4
Giem,twisting-nether,192,shaman,enhancement,6,2,4
Aubesombre,dalaran,192,shaman,enhancement,6,2,4
Willfury,outland,192,shaman,enhancement,6,2,4
Суимембер,soulflayer,192,shaman,enhancement,6,2,4
Schamikraut,silvermoon,192,shaman,enhancement,6,2,4
Asijha,drakthul,192,shaman,enhancement,6,2,4
Miscode,twisting-nether,192,shaman,enhancement,6,2,4
Kaptt,twisting-nether,192,shaman,enhancement,6,2,4
Adrianjr,kazzak,192,shaman,enhancement,6,2,4
Pulvêrizêr,agamaggan,192,shaman,enhancement,6,2,4
Wertu,ragnaros,192,shaman,enhancement,6,2,4
Zenjo,the-maelstrom,192,shaman,enhancement,6,2,4
Fufupartyxx,blackrock,192,shaman,enhancement,6,2,4
Shoar,twisting-nether,192,shaman,enhancement,6,2,4
Shámyé,silvermoon,192,shaman,enhancement,6,2,4
Shamalamadi,ragnaros,192,shaman,enhancement,6,2,4
Volkar,auchindoun,192,shaman,enhancement,6,2,4
Shocknrun,sylvanas,192,shaman,enhancement,6,2,4
Flamboyantly,sylvanas,192,shaman,enhancement,6,2,4
Пофасту,gordunni,192,shaman,enhancement,6,2,4
Dalgorr,magtheridon,192,shaman,enhancement,6,2,4
Skillcapx,theradras,192,shaman,enhancement,6,2,4
Museum,khaz-modan,192,shaman,enhancement,6,2,4
Дортманшам,gordunni,192,shaman,enhancement,6,2,4
Leafytwo,drakthul,192,shaman,enhancement,6,2,4
Peeupeeu,silvermoon,192,shaman,enhancement,6,2,4
Savan,darkspear,192,shaman,enhancement,6,2,4
Airfs,twisting-nether,192,shaman,enhancement,6,2,4
Кюгельблиц,gordunni,192,shaman,enhancement,6,2,4
Holybrolyy,malfurion,192,shaman,enhancement,6,2,4
Ën,tarren-mill,192,shaman,enhancement,6,2,4
Yajevol,draenor,192,shaman,enhancement,6,2,4
Fírêblazè,uldum,192,shaman,enhancement,6,2,4
Spoko,hyjal,192,shaman,enhancement,6,2,4
Zulzur,zuljin,192,shaman,enhancement,6,2,4
Nicocage,draenor,192,shaman,enhancement,6,2,4
Ольтез,gordunni,192,shaman,enhancement,6,2,4
Зултира,gordunni,192,shaman,enhancement,6,2,4
Acces,stormscale,192,shaman,enhancement,6,2,4
Argomir,kazzak,192,shaman,enhancement,6,2,4
Эверви,gordunni,192,shaman,enhancement,6,2,4
Dykumlol,sanguino,192,shaman,enhancement,6,2,4
Clappagobzz,kazzak,192,shaman,enhancement,6,2,4
Donicork,aegwynn,192,shaman,enhancement,6,2,4
Мэгенфокс,howling-fjord,192,shaman,enhancement,6,2,4
Снюсн,blackscar,192,shaman,enhancement,6,2,4
Miscoj,zuljin,192,shaman,enhancement,6,2,4
Ðøminantx,stormscale,192,shaman,enhancement,6,2,4
Elé,ravenholdt,192,shaman,enhancement,6,2,4
Törque,sanguino,192,shaman,enhancement,6,2,4
Soeptent,tarren-mill,192,shaman,enhancement,6,2,4
Родохрозид,blackscar,192,shaman,enhancement,6,2,4
Shamtime,aegwynn,192,shaman,enhancement,6,2,4
Пончо,booty-bay,192,shaman,enhancement,6,2,4
Едрёна,blackscar,192,shaman,enhancement,6,2,4
Søló,stormscale,192,shaman,enhancement,6,2,4
Pandafightin,stormscale,192,shaman,enhancement,6,2,4
Xharnel,defias-brotherhood,192,shaman,enhancement,6,2,4
Муурид,thermaplugg,192,shaman,enhancement,6,2,4
Nerzúhl,ulduar,192,shaman,enhancement,6,2,4
Electroklart,defias-brotherhood,192,shaman,enhancement,6,2,4
Skullføck,argent-dawn,192,shaman,enhancement,6,2,4
Drekthor,ulduar,192,shaman,enhancement,6,2,4
Thoráck,stormscale,192,shaman,enhancement,6,2,4
Stormcaster,argent-dawn,192,shaman,enhancement,6,2,4
Bennycooch,silvermoon,192,shaman,enhancement,6,2,4
Denastyo,nemesis,192,shaman,enhancement,6,2,4
Tâw,blackhand,192,shaman,enhancement,6,2,4
Zartaan,nemesis,192,shaman,enhancement,6,2,4
Bonethugdex,bladefist,192,shaman,enhancement,6,2,4
Cleptocracy,draenor,192,shaman,enhancement,6,2,4
Peaksh,stormscale,192,shaman,enhancement,6,2,4
Mahoni,malganis,192,shaman,enhancement,6,2,4
Hugzy,argent-dawn,192,shaman,enhancement,6,2,4
Lovros,kazzak,192,shaman,enhancement,6,2,4
Какашисан,howling-fjord,192,shaman,enhancement,6,2,4
Råkk,argent-dawn,192,shaman,enhancement,6,2,4
Tsukuyømi,blackmoore,192,shaman,enhancement,6,2,4
Pierregasly,ravencrest,192,shaman,enhancement,6,2,4
Decoyy,tarren-mill,192,shaman,enhancement,6,2,4
Iloveléa,ravencrest,192,shaman,enhancement,6,2,4
Cuchullaín,blackmoore,192,shaman,enhancement,6,2,4
Ogshaman,archimonde,192,shaman,enhancement,6,2,4
Louvreparis,frostwolf,192,shaman,enhancement,6,2,4
Azzizael,chamber-of-aspects,192,shaman,enhancement,6,2,4
Tapatak,antonidas,192,shaman,enhancement,6,2,4
Elementhor,archimonde,192,shaman,enhancement,6,2,4
Gundsthunder,ravencrest,192,shaman,enhancement,6,2,4
Spiritualx,argent-dawn,192,shaman,enhancement,6,2,4
Santy,silvermoon,192,shaman,enhancement,6,2,4
Restmuell,blackmoore,192,shaman,enhancement,6,2,4
Magane,antonidas,192,shaman,enhancement,6,2,4
Yezu,medivh,192,shaman,enhancement,6,2,4
Dwarfpanda,ravencrest,192,shaman,enhancement,6,2,4
Kortoghissig,ravencrest,192,shaman,enhancement,6,2,4
Soozkovic,blackmoore,192,shaman,enhancement,6,2,4
Moropaskoil,ravencrest,192,shaman,enhancement,6,2,4
Zelenchovek,kazzak,192,shaman,enhancement,6,2,4
Titanseeks,blackmoore,192,shaman,enhancement,6,2,4
Zadarak,antonidas,192,shaman,enhancement,6,2,4
Cptnbbl,blackmoore,192,shaman,enhancement,6,2,4
Gaerth,aggramar,192,shaman,enhancement,6,2,4
Bizsham,ravencrest,192,shaman,enhancement,6,2,4
Nìtratx,archimonde,192,shaman,enhancement,6,2,4
Snapbábe,blackmoore,192,shaman,enhancement,6,2,4
Stiflersmôm,antonidas,192,shaman,enhancement,6,2,4
Rúnar,proudmoore,192,shaman,enhancement,6,2,4
Destroilleur,archimonde,192,shaman,enhancement,6,2,4
Poaeii,ysondre,192,shaman,enhancement,6,2,4
Thiogg,archimonde,192,shaman,enhancement,6,2,4
Starik,ravencrest,192,shaman,enhancement,6,2,4
Chodukken,grim-batol,192,shaman,enhancement,6,2,4
Mycameltotem,ravencrest,192,shaman,enhancement,6,2,4
Needsomelove,archimonde,192,shaman,enhancement,6,2,4
Oprawinfury,ravencrest,192,shaman,enhancement,6,2,4
Lazyspc,frostmane,192,shaman,enhancement,6,2,4
Fullmrawh,kazzak,192,shaman,enhancement,6,2,4
Tokuyama,archimonde,192,shaman,enhancement,6,2,4
Haugren,eredar,192,shaman,enhancement,6,2,4
Dogfrog,silvermoon,192,shaman,enhancement,6,2,4
Totemeistér,silvermoon,192,shaman,enhancement,6,2,4
Hamdoulaçava,archimonde,192,shaman,enhancement,7,2,5
Shamrøck,stormscale,192,shaman,enhancement,10,2,8
Zugzugdwarf,ravencrest,192,shaman,enhancement,11,2,9
Shinkd,draenor,192,shaman,enhancement,12,2,10
Dens,argent-dawn,192,shaman,enhancement,12,2,10
Borindor,silvermoon,192,shaman,enhancement,12,2,10
Elsassi,ravencrest,192,shaman,enhancement,12,2,10
Veeq,ravencrest,192,shaman,enhancement,12,2,10
Lolphobia,ravencrest,192,shaman,enhancement,12,2,10
Pachamane,archimonde,192,shaman,enhancement,12,2,10
Ххвхд,soulflayer,192,shaman,enhancement,12,2,10
Pwccey,drakthul,192,shaman,enhancement,12,2,10
Stormstriker,arathor,192,shaman,enhancement,12,2,10
Металорд,howling-fjord,192,shaman,enhancement,12,2,10
Xpv,silvermoon,192,shaman,enhancement,12,2,10
Khon,eredar,192,shaman,enhancement,12,2,10
Dérgérät,blackrock,192,shaman,enhancement,12,2,10
Shÿmä,dalaran,192,shaman,enhancement,12,2,10
Zarakuda,magtheridon,192,shaman,enhancement,12,2,10
Khakazis,ravencrest,192,shaman,enhancement,12,2,10
Arkkain,burning-legion,191,shaman,enhancement,6,2,4
Granett,argent-dawn,191,shaman,enhancement,19,2,17
Jacklupin,ravencrest,175,shaman,enhancement,11,2,9
Allfathêr,ragnaros,175,shaman,enhancement,11,2,9
Entrecoté,blackmoore,160,shaman,enhancement,10,2,8
Hóonda,twisting-nether,160,shaman,enhancement,10,2,8
Pômmes,aegwynn,159,shaman,enhancement,5,2,3
Brryantblaks,colinas-pardas,138,shaman,enhancement,10,4,6
Trenbruv,kazzak,138,shaman,enhancement,9,3,6
Shåmpoing,archimonde,138,shaman,enhancement,9,3,6
Heliosz,stormscale,137,shaman,enhancement,8,3,5
Anthrák,draenor,128,shaman,enhancement,4,2,2
Kraksham,ravencrest,128,shaman,enhancement,4,2,2
Nephylim,grim-batol,96,shaman,enhancement,3,2,1
Urubus,kazzak,96,shaman,enhancement,6,1,5
Sixinchwilly,outland,96,shaman,enhancement,6,1,5
Bigboisham,outland,96,shaman,enhancement,6,1,5
Überstorm,kazzak,96,shaman,enhancement,6,1,5
Olibuzzyezz,outland,96,shaman,enhancement,6,1,5
Trokag,hyjal,96,shaman,enhancement,6,1,5
Thoranis,kazzak,96,shaman,enhancement,6,1,5
Størmsky,outland,96,shaman,enhancement,6,1,5
Yrgus,hyjal,96,shaman,enhancement,6,1,5
Bambustic,kazzak,96,shaman,enhancement,6,1,5
Shåmssagat,kazzak,96,shaman,enhancement,6,1,5
Ragmir,kazzak,96,shaman,enhancement,6,1,5
Zoogang,ragnaros,96,shaman,enhancement,6,1,5
Spaceboy,archimonde,96,shaman,enhancement,6,1,5
Granz,archimonde,96,shaman,enhancement,6,1,5
Sekane,archimonde,96,shaman,enhancement,6,1,5
Élémentyum,archimonde,96,shaman,enhancement,6,1,5
Palpazerr,archimonde,96,shaman,enhancement,6,1,5
Malabestia,archimonde,96,shaman,enhancement,6,1,5
Eclïppce,archimonde,96,shaman,enhancement,6,1,5
Patateatotem,archimonde,96,shaman,enhancement,6,1,5
Nabo,archimonde,96,shaman,enhancement,6,1,5
Stòrm,ravencrest,96,shaman,enhancement,6,1,5
Sgroppino,stormscale,96,shaman,enhancement,6,1,5
Linknvm,thrall,96,shaman,enhancement,6,1,5
Shamanistick,grim-batol,96,shaman,enhancement,6,1,5
Madarak,pozzo-delleternità,96,shaman,enhancement,6,1,5
Celeby,nemesis,96,shaman,enhancement,6,1,5
Peneapunta,nemesis,96,shaman,enhancement,6,1,5
Maskinett,stormscale,96,shaman,enhancement,6,1,5
Импфаразел,gordunni,96,shaman,enhancement,6,1,5
Grimrieper,stormscale,96,shaman,enhancement,6,1,5
Blitzgodx,kargath,96,shaman,enhancement,6,1,5
Разодран,gordunni,96,shaman,enhancement,6,1,5
Straehne,malganis,96,shaman,enhancement,6,1,5
Харно,gordunni,96,shaman,enhancement,6,1,5
Hí,bronzebeard,96,shaman,enhancement,6,1,5
Цукерок,soulflayer,96,shaman,enhancement,6,1,5
Драмкул,soulflayer,96,shaman,enhancement,6,1,5
Nas,the-maelstrom,96,shaman,enhancement,6,1,5
Criæ,blackrock,96,shaman,enhancement,6,1,5
Buchas,burning-legion,96,shaman,enhancement,6,1,5
Jambie,bloodfeather,96,shaman,enhancement,6,1,5
Ramuthra,sanguino,96,shaman,enhancement,6,1,5
Gotreck,zuljin,96,shaman,enhancement,6,1,5
Shøckz,azjolnerub,96,shaman,enhancement,6,1,5
Lampard,magtheridon,96,shaman,enhancement,6,1,5
Gschmack,blackrock,96,shaman,enhancement,6,1,5
Mearu,bronze-dragonflight,96,shaman,enhancement,6,1,5
Shámóó,twisting-nether,96,shaman,enhancement,6,1,5
Testpapi,twisting-nether,96,shaman,enhancement,6,1,5
Eneel,blackmoore,96,shaman,enhancement,6,1,5
Preshear,twisting-nether,96,shaman,enhancement,6,1,5
Shaulic,ravencrest,96,shaman,enhancement,6,1,5
Woiz,ragnaros,96,shaman,enhancement,6,1,5
Cryptotem,ragnaros,96,shaman,enhancement,6,1,5
Xgoodlifelu,ragnaros,96,shaman,enhancement,6,1,5
Porthex,kazzak,96,shaman,enhancement,6,1,5
Хексвглаз,howling-fjord,96,shaman,enhancement,6,1,5
Чаиро,howling-fjord,96,shaman,enhancement,6,1,5
Eisenfêind,antonidas,96,shaman,enhancement,6,1,5
Takenq,stormscale,96,shaman,enhancement,6,1,5
Diablous,stormscale,96,shaman,enhancement,6,1,5
Shockqt,todeswache,96,shaman,enhancement,6,1,5
Lawdjeezes,draenor,96,shaman,enhancement,6,1,5
Laflur,draenor,96,shaman,enhancement,6,1,5
Amarök,nerzhul,96,shaman,enhancement,6,1,5
Ailsi,draenor,96,shaman,enhancement,6,1,5
Hàgs,stormscale,96,shaman,enhancement,6,1,5
Piptok,der-rat-von-dalaran,96,shaman,enhancement,6,1,5
Lamarrus,malganis,96,shaman,enhancement,6,1,5
Vexuz,silvermoon,96,shaman,enhancement,6,1,5
Dartagnón,blackhand,96,shaman,enhancement,6,1,5
Skylá,blackrock,96,shaman,enhancement,6,1,5
Goldhand,ravencrest,96,shaman,enhancement,6,1,5
Mùrkaz,ravencrest,96,shaman,enhancement,6,1,5
Vladraxes,draenor,96,shaman,enhancement,6,1,5
Schmick,alleria,96,shaman,enhancement,6,1,5
Ghaargrim,tarren-mill,96,shaman,enhancement,6,1,5
Xtremeshaman,blackmoore,96,shaman,enhancement,6,1,5
Stonetone,silvermoon,96,shaman,enhancement,6,1,5
Winiepuuh,antonidas,96,shaman,enhancement,6,1,5
Gewieft,azshara,96,shaman,enhancement,6,1,5
Tosaá,antonidas,96,shaman,enhancement,6,1,5
Glak,draenor,96,shaman,enhancement,6,1,5
Onii,alleria,96,shaman,enhancement,6,1,5
Zoélement,nerzhul,96,shaman,enhancement,6,1,5
Mikecrybaby,tarren-mill,96,shaman,enhancement,6,1,5
Grabmytotemz,tarren-mill,96,shaman,enhancement,6,1,5
Yolosweg,dentarg,96,shaman,enhancement,6,1,5
Thachen,tarren-mill,96,shaman,enhancement,6,1,5
Shaamz,tarren-mill,96,shaman,enhancement,6,1,5
Epicoverlord,tarren-mill,96,shaman,enhancement,6,1,5
Hollster,moonglade,96,shaman,enhancement,6,1,5
Carlpeant,drakthul,96,shaman,enhancement,6,1,5
Freexx,aegwynn,96,shaman,enhancement,8,1,7
Djznto,silvermoon,96,shaman,enhancement,8,1,7
Дваллинн,gordunni,96,shaman,enhancement,11,1,10
Хэллшам,howling-fjord,96,shaman,enhancement,12,1,11
Sigmaz,twisting-nether,96,shaman,enhancement,12,1,11
Sÿfrôw,hyjal,96,shaman,enhancement,12,1,11
Jytkysonni,stormreaver,96,shaman,enhancement,12,1,11
Эншам,blackscar,96,shaman,enhancement,12,1,11
Ymiras,argent-dawn,96,shaman,enhancement,12,1,11
Gamezclaw,aegwynn,96,shaman,enhancement,12,1,11
Eliteblood,kazzak,96,shaman,enhancement,12,1,11
Sycophant,stormscale,96,shaman,enhancement,12,1,11
Lavatherapy,grim-batol,96,shaman,enhancement,12,1,11
Volgue,kaelthas,96,shaman,enhancement,12,1,11
Swípzy,ravencrest,79,shaman,enhancement,5,1,4
Choltaj,burning-legion,79,shaman,enhancement,7,1,6
Malizious,ravencrest,63,shaman,enhancement,2,2,0
Daboo,the-venture-co,48,shaman,enhancement,3,1,2
Kuroisback,outland,48,shaman,enhancement,3,1,2
Tholin,rexxar,48,shaman,enhancement,3,1,2
Wenesday,ysondre,48,shaman,enhancement,3,1,2
Карбонатрикс,soulflayer,48,shaman,enhancement,12,3,9
Адскийсон,gordunni,42,shaman,enhancement,9,2,7
Klât,archimonde,42,shaman,enhancement,11,2,9
Aleshade,argent-dawn,31,shaman,enhancement,2,1,1
Shøkxz,kazzak,31,shaman,enhancement,2,1,1
Bìgby,draenor,31,shaman,enhancement,2,1,1
Ulaene,ravencrest,31,shaman,enhancement,2,1,1
Raigetsu,kazzak,16,shaman,enhancement,1,1,0
Aköyh,kazzak,2383,warlock,demonology,154,98,56
Dotjürgen,blackrock,2349,warlock,demonology,152,86,66
Skillførçé,kazzak,2343,warlock,demonology,72,49,23
Bualock,tarren-mill,2296,warlock,demonology,77,48,29
Voldby,kazzak,2292,warlock,demonology,87,49,38
Pogbõss,kazzak,2283,warlock,demonology,352,183,169
Амеаль,eversong,2249,warlock,demonology,481,251,230
Zezo,stormscale,2227,warlock,demonology,178,104,74
Byeedriver,kazzak,2218,warlock,demonology,123,80,43
Easycheasy,ravencrest,2217,warlock,demonology,77,49,28
Whøknøws,twisting-nether,2215,warlock,demonology,90,48,42
Lankycheese,kazzak,2211,warlock,demonology,119,67,52
Smaúg,archimonde,2210,warlock,demonology,288,149,139
Xerkh,thrall,2204,warlock,demonology,142,77,65
Kikeriki,blackhand,2200,warlock,demonology,110,58,52
Jimboneutron,stormscale,2198,warlock,demonology,65,36,29
Infý,ravencrest,2177,warlock,demonology,54,36,18
Cònq,tarren-mill,2175,warlock,demonology,90,50,40
Rumour,sunstrider,2175,warlock,demonology,96,50,46
Tuskawl,stormreaver,2173,warlock,demonology,97,55,42
Boltimoore,magtheridon,2169,warlock,demonology,89,48,41
Locktrainer,tarren-mill,2165,warlock,demonology,385,195,190
Rikkërt,draenor,2151,warlock,demonology,101,53,48
Anúki,kazzak,2150,warlock,demonology,49,38,11
Thardik,azuremyst,2149,warlock,demonology,150,79,71
Jackyfalls,blackmoore,2148,warlock,demonology,144,84,60
Tenshirou,blackrock,2141,warlock,demonology,83,49,34
Dispeluapls,blackmoore,2140,warlock,demonology,132,67,65
Droguri,darkspear,2139,warlock,demonology,185,111,74
Hannen,blackrock,2136,warlock,demonology,64,35,29
Indrâxx,hyjal,2135,warlock,demonology,60,47,13
Nayolana,argent-dawn,2135,warlock,demonology,130,73,57
Sad,lightnings-blade,2134,warlock,demonology,184,100,84
Bibiflexberg,eredar,2133,warlock,demonology,65,39,26
Onlylock,outland,2132,warlock,demonology,114,64,50
Млечный,blackscar,2131,warlock,demonology,452,232,220
Maintarget,blackrock,2130,warlock,demonology,171,91,80
Furrylóver,kazzak,2126,warlock,demonology,92,62,30
Favorizlmp,archimonde,2123,warlock,demonology,107,74,33
Malowix,outland,2123,warlock,demonology,94,50,44
Setyouinfear,ravencrest,2122,warlock,demonology,112,64,48
Сильвиос,howling-fjord,2122,warlock,demonology,135,72,63
Blackdog,argent-dawn,2122,warlock,demonology,147,78,69
Wspolnax,ravencrest,2119,warlock,demonology,78,44,34
Neverfearjk,aegwynn,2117,warlock,demonology,86,56,30
Infïnitýx,silvermoon,2116,warlock,demonology,121,75,46
Syntaxzwo,blackmoore,2116,warlock,demonology,78,44,34
Dotyboi,tarren-mill,2115,warlock,demonology,72,44,28
Purplemonkey,burning-blade,2114,warlock,demonology,92,51,41
Sêrø,aegwynn,2113,warlock,demonology,82,43,39
Supergeîl,blackrock,2112,warlock,demonology,71,38,33
ßualock,sylvanas,2111,warlock,demonology,72,42,30
Krøl,nemesis,2110,warlock,demonology,66,40,26
Smdtwo,drakthul,2109,warlock,demonology,142,75,67
Ägony,blackrock,2108,warlock,demonology,78,46,32
Dhärc,sanguino,2107,warlock,demonology,84,48,36
Ðåñtåy,ravencrest,2106,warlock,demonology,54,32,22
Фламмэнх,soulflayer,2106,warlock,demonology,84,46,38
Malddog,turalyon,2103,warlock,demonology,108,61,47
Syntax,blackmoore,2102,warlock,demonology,102,52,50
Shablagoo,twisting-nether,2099,warlock,demonology,138,77,61
Kimkold,twisting-nether,2096,warlock,demonology,222,120,102
Britneÿ,stormscale,2096,warlock,demonology,90,46,44
Alphazero,zuluhed,2095,warlock,demonology,90,45,45
Ogrez,nemesis,2095,warlock,demonology,131,65,66
Dæhli,argent-dawn,2092,warlock,demonology,150,77,73
Igõr,draenor,2084,warlock,demonology,48,29,19
Viscius,ysondre,2077,warlock,demonology,54,30,24
Firochektro,ravencrest,2075,warlock,demonology,129,68,61
Anthh,doomhammer,2074,warlock,demonology,84,44,40
Alotami,frostwolf,2073,warlock,demonology,63,39,24
Capsloq,la-croisade-écarlate,2070,warlock,demonology,144,77,67
Zehirisalari,twisting-nether,2055,warlock,demonology,114,63,51
Firochek,ravencrest,2054,warlock,demonology,90,47,43
Makkez,outland,2052,warlock,demonology,72,46,26
Deadpapi,outland,2052,warlock,demonology,144,83,61
Zoreck,uldum,2051,warlock,demonology,77,43,34
Djmäkish,outland,2050,warlock,demonology,66,35,31
Oldasianman,blackrock,2048,warlock,demonology,60,36,24
Mty,bronze-dragonflight,2039,warlock,demonology,171,91,80
Хаосболик,gordunni,2035,warlock,demonology,96,52,44
Конидэмико,blackscar,2031,warlock,demonology,107,51,56
Synthiax,silvermoon,2027,warlock,demonology,120,65,55
Nyotu,antonidas,2021,warlock,demonology,84,41,43
Сумракк,gordunni,2017,warlock,demonology,69,38,31
Ишла,gordunni,2017,warlock,demonology,137,73,64
Raspalakuja,kazzak,2016,warlock,demonology,71,35,36
Ðïÿëñbïëñfüû,suramar,2014,warlock,demonology,147,75,72
Шекигами,gordunni,2007,warlock,demonology,84,49,35
Stankaemayne,blackhand,2007,warlock,demonology,73,40,33
Wârlðck,twisting-nether,2004,warlock,demonology,78,49,29
Désolaté,kazzak,2004,warlock,demonology,59,36,23
Fløkee,blackmoore,2001,warlock,demonology,42,24,18
Арон,soulflayer,2000,warlock,demonology,71,38,33
Ffpiiras,dunemaul,1999,warlock,demonology,131,67,64
Glooness,burning-legion,1998,warlock,demonology,129,64,65
Bfaexpert,ravencrest,1996,warlock,demonology,42,30,12
Tyrantlol,sylvanas,1991,warlock,demonology,78,43,35
Vreeth,blackrock,1984,warlock,demonology,78,40,38
Khavar,antonidas,1983,warlock,demonology,118,66,52
Jawoxoxo,rexxar,1983,warlock,demonology,78,38,40
Dharc,dun-modr,1980,warlock,demonology,42,30,12
Онлидемо,gordunni,1979,warlock,demonology,72,45,27
Slockoló,ragnaros,1979,warlock,demonology,102,46,56
Kazzy,grim-batol,1978,warlock,demonology,60,39,21
Фирбог,soulflayer,1973,warlock,demonology,55,33,22
Badapow,stormscale,1972,warlock,demonology,66,35,31
Gattlingan,eredar,1970,warlock,demonology,72,47,25
Osbaa,bladefist,1969,warlock,demonology,89,43,46
Rïñ,ravencrest,1968,warlock,demonology,60,28,32
Аоепампгодх,howling-fjord,1967,warlock,demonology,36,24,12
Помечте,soulflayer,1967,warlock,demonology,142,74,68
Wotlkenjoyer,ravencrest,1964,warlock,demonology,45,36,9
Xtyran,blackmoore,1964,warlock,demonology,78,44,34
Louên,dun-modr,1963,warlock,demonology,78,37,41
Hannens,blackrock,1962,warlock,demonology,66,37,29
Cørpse,burning-legion,1958,warlock,demonology,142,75,67
Zila,sylvanas,1958,warlock,demonology,72,34,38
Rmpfarmer,kazzak,1957,warlock,demonology,30,24,6
Azerybedge,alexstrasza,1952,warlock,demonology,183,106,77
Jesez,aegwynn,1950,warlock,demonology,72,39,33
Kopfkissen,azshara,1949,warlock,demonology,105,54,51
Ezy,auchindoun,1947,warlock,demonology,124,66,58
Онлидемон,gordunni,1946,warlock,demonology,56,33,23
Hadrianor,sanguino,1944,warlock,demonology,33,21,12
Lagynka,wildhammer,1940,warlock,demonology,42,25,17
Crathar,kazzak,1939,warlock,demonology,132,70,62
Yamadea,stormscale,1939,warlock,demonology,84,43,41
Bonnieparkêr,onyxia,1938,warlock,demonology,54,28,26
Synlockiax,silvermoon,1933,warlock,demonology,110,73,37
Xenastro,silvermoon,1932,warlock,demonology,72,39,33
Apple,scarshield-legion,1930,warlock,demonology,133,69,64
Gv,ragnaros,1928,warlock,demonology,54,28,26
Cuteyess,shadowsong,1926,warlock,demonology,72,38,34
Nickrosh,terokkar,1924,warlock,demonology,51,31,20
Lokmonji,perenolde,1923,warlock,demonology,60,34,26
Skailzlock,hyjal,1920,warlock,demonology,130,82,48
Zerulian,ragnaros,1920,warlock,demonology,90,50,40
Vultzbolt,draenor,1920,warlock,demonology,66,36,30
Инфезиус,deathweaver,1917,warlock,demonology,106,58,48
Dabezdwl,outland,1915,warlock,demonology,138,73,65
Ðeface,nefarian,1914,warlock,demonology,60,40,20
Dontargetme,draenor,1913,warlock,demonology,74,43,31
Neinbosa,tarren-mill,1913,warlock,demonology,132,67,65
Delius,eitrigg,1912,warlock,demonology,113,72,41
Kamorilock,blackhand,1912,warlock,demonology,36,20,16
Адво,howling-fjord,1912,warlock,demonology,89,44,45
Мутгодх,soulflayer,1910,warlock,demonology,42,26,16
Demoner,tarren-mill,1910,warlock,demonology,108,52,56
Shadowvirus,auchindoun,1908,warlock,demonology,41,23,18
Lyndi,nerathor,1906,warlock,demonology,60,32,28
Kuloo,blackmoore,1904,warlock,demonology,60,36,24
Døwz,ysondre,1904,warlock,demonology,66,32,34
Sanguinis,theradras,1903,warlock,demonology,170,93,77
Stafar,kazzak,1903,warlock,demonology,132,65,67
Císuh,stormreaver,1902,warlock,demonology,98,51,47
Простохаос,howling-fjord,1899,warlock,demonology,62,37,25
Blacklock,argent-dawn,1899,warlock,demonology,102,56,46
Envizer,ravencrest,1898,warlock,demonology,36,25,11
Noobgg,kazzak,1896,warlock,demonology,172,89,83
Osbaa,ravencrest,1895,warlock,demonology,48,28,20
Myliege,kilrogg,1895,warlock,demonology,130,70,60
Ambitions,hyjal,1895,warlock,demonology,222,112,110
Nerfhunter,executus,1895,warlock,demonology,54,27,27
Delru,aegwynn,1892,warlock,demonology,48,26,22
Nunhesh,defias-brotherhood,1892,warlock,demonology,77,40,37
Shadowflamez,argent-dawn,1891,warlock,demonology,42,33,9
Kimjongnukes,archimonde,1889,warlock,demonology,47,31,16
Оброссыш,gordunni,1880,warlock,demonology,84,47,37
Vankraken,silvermoon,1880,warlock,demonology,36,20,16
Тьмазвёздная,gordunni,1878,warlock,demonology,134,70,64
Годнодх,gordunni,1878,warlock,demonology,89,45,44
Absurdity,twisting-nether,1875,warlock,demonology,64,35,29
Cigänä,archimonde,1875,warlock,demonology,48,22,26
Tyranttayyip,blackmoore,1874,warlock,demonology,48,28,20
Stafar,outland,1870,warlock,demonology,60,37,23
Keybump,outland,1870,warlock,demonology,114,68,46
Britneý,stormscale,1870,warlock,demonology,184,86,98
Тёмабиль,gordunni,1868,warlock,demonology,378,199,179
Weso,grim-batol,1868,warlock,demonology,72,36,36
Cappaoww,ravencrest,1865,warlock,demonology,42,27,15
Zouglougou,archimonde,1864,warlock,demonology,108,52,56
Bluh,twisting-nether,1860,warlock,demonology,36,22,14
Juicybolt,chogall,1858,warlock,demonology,95,50,45
Æßçåløønå,ravencrest,1857,warlock,demonology,48,25,23
Yôi,nemesis,1856,warlock,demonology,54,34,20
Lywov,stormscale,1856,warlock,demonology,47,24,23
Hupet,ragnaros,1855,warlock,demonology,30,21,9
Positivitywl,stormscale,1855,warlock,demonology,66,43,23
Blakstorm,archimonde,1855,warlock,demonology,48,31,17
Greeylock,blackhand,1855,warlock,demonology,66,40,26
Nêverse,archimonde,1855,warlock,demonology,40,24,16
Glavy,burning-legion,1853,warlock,demonology,191,104,87
Voídzero,hyjal,1853,warlock,demonology,61,33,28
Smíkz,blackhand,1852,warlock,demonology,48,29,19
Oniarc,ravencrest,1851,warlock,demonology,30,20,10
Discomugg,stormscale,1851,warlock,demonology,59,31,28
Stalowwy,silvermoon,1849,warlock,demonology,108,59,49
Jopasiski,draenor,1848,warlock,demonology,54,28,26
Shakuroz,frostwolf,1847,warlock,demonology,68,41,27
Динодотз,howling-fjord,1847,warlock,demonology,54,27,27
Gryme,dalaran,1846,warlock,demonology,81,51,30
Painowgee,kazzak,1846,warlock,demonology,42,22,20
Пухи,blackscar,1846,warlock,demonology,121,59,62
Bunne,twisting-nether,1843,warlock,demonology,96,50,46
Дьяволзаплач,howling-fjord,1841,warlock,demonology,102,51,51
Ravendoor,grim-batol,1841,warlock,demonology,124,61,63
Кварий,howling-fjord,1840,warlock,demonology,485,243,242
Makemeabrew,stormscale,1839,warlock,demonology,186,109,77
Zzooxx,silvermoon,1838,warlock,demonology,48,26,22
Attritiona,stormscale,1838,warlock,demonology,60,32,28
Commas,outland,1838,warlock,demonology,94,46,48
Dslap,grim-batol,1835,warlock,demonology,42,23,19
Fredé,kazzak,1835,warlock,demonology,48,24,24
Höfmänn,kazzak,1834,warlock,demonology,45,27,18
Purplereîgn,stormscale,1834,warlock,demonology,57,31,26
Dracsu,dun-modr,1832,warlock,demonology,134,78,56
Broxihwa,blackmoore,1832,warlock,demonology,229,127,102
Анрали,soulflayer,1832,warlock,demonology,59,31,28
Bibilockbert,aegwynn,1832,warlock,demonology,61,31,30
Veganlifter,ravencrest,1831,warlock,demonology,30,23,7
Froschhaxen,blackhand,1831,warlock,demonology,71,44,27
Kolskegg,doomhammer,1830,warlock,demonology,144,78,66
Jegfaller,wildhammer,1830,warlock,demonology,154,75,79
Avrilla,khaz-modan,1829,warlock,demonology,77,46,31
Icq,ravencrest,1829,warlock,demonology,77,46,31
Xalé,blackrock,1828,warlock,demonology,48,27,21
Svnlpowpow,kazzak,1828,warlock,demonology,71,37,34
Cujo,draenor,1828,warlock,demonology,68,31,37
Emitter,ravencrest,1827,warlock,demonology,36,27,9
Tamaduitoru,dragonblight,1827,warlock,demonology,78,51,27
Ravenglass,argent-dawn,1826,warlock,demonology,72,34,38
Benne,stormscale,1825,warlock,demonology,49,31,18
Lashyra,aszune,1825,warlock,demonology,66,40,26
Котрх,gordunni,1824,warlock,demonology,110,66,44
Kerthan,malorne,1823,warlock,demonology,127,78,49
Malificus,silvermoon,1823,warlock,demonology,114,67,47
Rikkért,draenor,1823,warlock,demonology,54,29,25
Règis,antonidas,1823,warlock,demonology,84,45,39
Tiendi,blackhand,1823,warlock,demonology,114,60,54
Hasselbalch,azshara,1823,warlock,demonology,58,30,28
Niyyu,blackmoore,1822,warlock,demonology,78,34,44
Chromex,dentarg,1821,warlock,demonology,24,19,5
Erøne,archimonde,1821,warlock,demonology,392,209,183
Épidémie,outland,1821,warlock,demonology,89,45,44
Этожедру,howling-fjord,1820,warlock,demonology,59,41,18
Kennyfõx,ysondre,1819,warlock,demonology,24,19,5
Ismenia,silvermoon,1819,warlock,demonology,60,39,21
Höfmänn,grim-batol,1819,warlock,demonology,54,33,21
Cellfear,kazzak,1818,warlock,demonology,42,24,18
Musallat,argent-dawn,1818,warlock,demonology,65,34,31
Dalamon,draenor,1818,warlock,demonology,60,31,29
Drogoon,blackmoore,1817,warlock,demonology,45,28,17
Fiveyearque,sylvanas,1817,warlock,demonology,54,33,21
Exorbïtant,blackrock,1817,warlock,demonology,235,122,113
Capsloq,sargeras,1817,warlock,demonology,57,28,29
Олимта,blackscar,1816,warlock,demonology,48,32,16
Warth,silvermoon,1816,warlock,demonology,42,28,14
Áutísm,silvermoon,1815,warlock,demonology,174,104,70
Devilfluffy,blackhand,1815,warlock,demonology,59,35,24
Афинц,deathguard,1814,warlock,demonology,30,19,11
Darkbasilet,hyjal,1814,warlock,demonology,53,31,22
Köftemec,blackrock,1813,warlock,demonology,48,29,19
Malzeva,ravencrest,1813,warlock,demonology,71,33,38
Spookytouch,draenor,1812,warlock,demonology,24,19,5
Тумнуктхай,gordunni,1812,warlock,demonology,42,24,18
Zàk,twisting-nether,1812,warlock,demonology,96,54,42
Ceu,tarren-mill,1812,warlock,demonology,70,39,31
Insídíous,tarren-mill,1812,warlock,demonology,78,41,37
Mustasheen,stormscale,1812,warlock,demonology,42,22,20
Gigoberto,kazzak,1811,warlock,demonology,57,31,26
Zatella,ravencrest,1811,warlock,demonology,188,100,88
Icò,ravencrest,1811,warlock,demonology,54,28,26
Zypzanti,antonidas,1810,warlock,demonology,155,97,58
Aladèèn,tarren-mill,1810,warlock,demonology,68,40,28
Kënnyfõx,ysondre,1809,warlock,demonology,24,19,5
Rektube,sanguino,1809,warlock,demonology,37,24,13
Tagzi,ravencrest,1809,warlock,demonology,47,29,18
Zzooxxie,silvermoon,1809,warlock,demonology,60,29,31
Gazdruul,culte-de-la-rive-noire,1808,warlock,demonology,78,48,30
Nürgle,stormscale,1808,warlock,demonology,90,53,37
Evalya,archimonde,1808,warlock,demonology,48,27,21
Darkenlock,burning-legion,1808,warlock,demonology,150,81,69
Skrana,kazzak,1808,warlock,demonology,83,43,40
Ðrrøßøticus,la-croisade-écarlate,1807,warlock,demonology,28,20,8
Smâûhg,blackrock,1807,warlock,demonology,42,28,14
Thugsupreme,ravencrest,1807,warlock,demonology,91,49,42
Superlocken,ragnaros,1807,warlock,demonology,42,22,20
Lúcìfér,stormscale,1806,warlock,demonology,66,34,32
Нэкрил,howling-fjord,1805,warlock,demonology,71,45,26
Фэлмор,howling-fjord,1805,warlock,demonology,54,33,21
Menescurse,blackhand,1805,warlock,demonology,46,27,19
Fearrari,ragnaros,1805,warlock,demonology,126,66,60
Nerigo,senjin,1805,warlock,demonology,48,24,24
Guetta,dalaran,1804,warlock,demonology,80,58,22
Филоняша,gordunni,1804,warlock,demonology,90,57,33
Nemwl,draenor,1804,warlock,demonology,66,36,30
Dontvori,outland,1803,warlock,demonology,42,28,14
Splicer,eredar,1803,warlock,demonology,49,29,20
Elnïa,conseil-des-ombres,1803,warlock,demonology,39,21,18
Дёмын,howling-fjord,1803,warlock,demonology,192,91,101
Addox,destromath,1802,warlock,demonology,47,30,17
Ryks,terrordar,1802,warlock,demonology,97,51,46
Нгага,howling-fjord,1802,warlock,demonology,465,241,224
Arkanyks,dalaran,1802,warlock,demonology,72,32,40
Nastychãtøn,ysondre,1801,warlock,demonology,45,26,19
Dabeastysx,sanguino,1800,warlock,demonology,42,28,14
Кайзершлафен,fordragon,1800,warlock,demonology,58,28,30
Xartul,tarren-mill,1799,warlock,demonology,24,20,4
Flocca,archimonde,1799,warlock,demonology,164,85,79
Htaedfo,tarren-mill,1798,warlock,demonology,110,50,60
Algolagniac,stormscale,1797,warlock,demonology,48,32,16
Fîgøk,conseil-des-ombres,1794,warlock,demonology,60,29,31
Officialysx,dun-modr,1792,warlock,demonology,30,19,11
Skyrender,argent-dawn,1792,warlock,demonology,54,25,29
Lïñglïñg,twisting-nether,1791,warlock,demonology,36,25,11
Варикай,gordunni,1791,warlock,demonology,98,57,41
Äåäåäåäåäåäå,ravencrest,1789,warlock,demonology,47,26,21
Wildimp,turalyon,1787,warlock,demonology,266,140,126
Mld,draenor,1786,warlock,demonology,55,39,16
Dâedra,argent-dawn,1786,warlock,demonology,107,57,50
Тевон,gordunni,1785,warlock,demonology,54,29,25
Izhi,ragnaros,1784,warlock,demonology,126,71,55
Hexdrix,thrall,1784,warlock,demonology,81,40,41
Quadraxer,antonidas,1783,warlock,demonology,60,29,31
Proßlock,kazzak,1780,warlock,demonology,123,73,50
Demonfaris,turalyon,1780,warlock,demonology,38,21,17
Selur,ragnaros,1778,warlock,demonology,93,54,39
Outofcurses,earthen-ring,1776,warlock,demonology,89,43,46
Gödisdëäd,sanguino,1770,warlock,demonology,41,20,21
Chargerinho,silvermoon,1768,warlock,demonology,53,31,22
Koisk,tarren-mill,1768,warlock,demonology,36,20,16
Axapnon,ragnaros,1767,warlock,demonology,48,23,25
Darksoll,hyjal,1763,warlock,demonology,42,23,19
Nâzgrel,tarren-mill,1763,warlock,demonology,138,70,68
Lockned,outland,1761,warlock,demonology,48,30,18
Kåtøñgøkákýû,aegwynn,1760,warlock,demonology,29,21,8
Grimmwald,stormreaver,1759,warlock,demonology,100,49,51
Киёкка,howling-fjord,1757,warlock,demonology,96,54,42
Артисона,gordunni,1757,warlock,demonology,56,30,26
Андреха,howling-fjord,1756,warlock,demonology,72,40,32
Omnípotens,silvermoon,1755,warlock,demonology,60,33,27
Санявахтовик,blackscar,1755,warlock,demonology,78,39,39
Fedpikkefar,kazzak,1755,warlock,demonology,67,27,40
Горгзок,howling-fjord,1754,warlock,demonology,42,27,15
Cresen,tarren-mill,1754,warlock,demonology,42,22,20
Koldarr,blackmoore,1754,warlock,demonology,204,101,103
Catchlock,tarren-mill,1752,warlock,demonology,36,20,16
Interceptêr,blackrock,1750,warlock,demonology,60,32,28
Alphalock,mannoroth,1747,warlock,demonology,118,57,61
Immaginare,sylvanas,1747,warlock,demonology,141,66,75
Nedivh,stormscale,1746,warlock,demonology,71,34,37
Scaevóla,ravencrest,1745,warlock,demonology,498,259,239
Dualla,aegwynn,1745,warlock,demonology,48,23,25
Rhaelgar,kazzak,1742,warlock,demonology,64,29,35
Zelieknight,ysondre,1741,warlock,demonology,66,32,34
Димаанстейбл,gordunni,1740,warlock,demonology,54,25,29
Decayez,thrall,1739,warlock,demonology,31,19,12
Lockimon,silvermoon,1737,warlock,demonology,33,22,11
Thorolock,blackhand,1736,warlock,demonology,42,26,16
Djfearbot,kazzak,1735,warlock,demonology,45,26,19
Kerídiin,twisting-nether,1734,warlock,demonology,52,30,22
Quarimathras,antonidas,1734,warlock,demonology,54,29,25
Kennÿfõx,ysondre,1732,warlock,demonology,24,19,5
Adafbhf,tichondrius,1731,warlock,demonology,71,36,35
Tjockoloco,tarren-mill,1730,warlock,demonology,209,113,96
Kemel,thrall,1725,warlock,demonology,36,26,10
Jinusek,burning-legion,1724,warlock,demonology,49,25,24
Nastýføxÿ,ysondre,1723,warlock,demonology,24,19,5
Snackstickz,twisting-nether,1723,warlock,demonology,102,59,43
Idezis,ragnaros,1722,warlock,demonology,36,24,12
Iskieel,ravencrest,1720,warlock,demonology,62,36,26
Dadcrush,antonidas,1720,warlock,demonology,84,42,42
Mayden,uldum,1719,warlock,demonology,34,21,13
Souleaterx,ravencrest,1719,warlock,demonology,54,26,28
Gyzmo,outland,1718,warlock,demonology,36,18,18
Kody,blackmoore,1714,warlock,demonology,48,28,20
Chromagnus,drakthul,1713,warlock,demonology,48,24,24
Impaler,tarren-mill,1711,warlock,demonology,305,151,154
Fsandtwo,ravencrest,1711,warlock,demonology,54,24,30
Soupamine,ysondre,1710,warlock,demonology,60,27,33
Omegazero,zuluhed,1709,warlock,demonology,30,18,12
Despépêche,garona,1709,warlock,demonology,42,24,18
Circe,draenor,1709,warlock,demonology,36,18,18
Хитбэйн,soulflayer,1709,warlock,demonology,93,41,52
Lockxdxd,burning-legion,1708,warlock,demonology,64,43,21
Deaddydoo,kazzak,1708,warlock,demonology,60,27,33
Зажиженный,soulflayer,1707,warlock,demonology,40,26,14
Totephia,kazzak,1707,warlock,demonology,132,63,69
Ahkan,argent-dawn,1705,warlock,demonology,74,33,41
Sokyra,tarren-mill,1700,warlock,demonology,165,84,81
Æternallock,nemesis,1699,warlock,demonology,146,88,58
Парачо,eversong,1699,warlock,demonology,42,21,21
Drerlord,tarren-mill,1699,warlock,demonology,48,21,27
Stormiq,kazzak,1698,warlock,demonology,155,76,79
Béastmodex,eredar,1697,warlock,demonology,67,41,26
Rune,aegwynn,1695,warlock,demonology,52,29,23
Hltbárgrïèfx,tarren-mill,1695,warlock,demonology,90,50,40
Gillgarres,twisting-nether,1693,warlock,demonology,107,60,47
Moffguldan,sanguino,1691,warlock,demonology,119,60,59
Requeims,outland,1691,warlock,demonology,54,25,29
Fixwarlock,blackmoore,1690,warlock,demonology,42,23,19
Shadowlîght,ravencrest,1689,warlock,demonology,30,21,9
Moslock,kazzak,1689,warlock,demonology,65,40,25
Бриант,gordunni,1689,warlock,demonology,47,19,28
Demonjoker,blackhand,1686,warlock,demonology,171,94,77
Nécron,ysondre,1686,warlock,demonology,147,71,76
Jkz,blackrock,1685,warlock,demonology,41,23,18
Ayóó,doomhammer,1685,warlock,demonology,741,382,359
Sedryn,turalyon,1685,warlock,demonology,1390,708,682
Eluinees,silvermoon,1684,warlock,demonology,36,25,11
Kûraiko,blackrock,1684,warlock,demonology,36,21,15
Shortyi,thrall,1684,warlock,demonology,47,23,24
Pipoûc,archimonde,1682,warlock,demonology,42,23,19
Æyna,thrall,1681,warlock,demonology,30,18,12
Hellbboy,azjolnerub,1681,warlock,demonology,103,60,43
Endherkonk,sanguino,1681,warlock,demonology,105,57,48
Dull,ravencrest,1680,warlock,demonology,54,30,24
Grêenbull,eredar,1680,warlock,demonology,49,27,22
Demospîrît,outland,1680,warlock,demonology,64,26,38
Murua,silvermoon,1678,warlock,demonology,86,42,44
Love,alexstrasza,1677,warlock,demonology,45,27,18
Følkman,twisting-nether,1677,warlock,demonology,48,24,24
Жериновсский,gordunni,1677,warlock,demonology,36,18,18
Brokenearman,defias-brotherhood,1676,warlock,demonology,36,22,14
Ahollic,frostwolf,1676,warlock,demonology,36,22,14
Kenthal,nemesis,1676,warlock,demonology,30,18,12
Шимара,eversong,1675,warlock,demonology,33,23,10
Thotseducer,kazzak,1675,warlock,demonology,54,34,20
Ромаколдун,howling-fjord,1674,warlock,demonology,64,35,29
Srhal,blackmoore,1672,warlock,demonology,168,96,72
Dimmybyrger,stormreaver,1672,warlock,demonology,36,19,17
Naze,aegwynn,1671,warlock,demonology,54,25,29
Bloodlock,onyxia,1670,warlock,demonology,42,22,20
Incesticide,ragnaros,1669,warlock,demonology,35,23,12
Dailylock,kazzak,1669,warlock,demonology,60,37,23
Nàughty,ragnaros,1665,warlock,demonology,120,60,60
Шэдоубёрн,soulflayer,1664,warlock,demonology,155,88,67
Ðêmøñîc,ravencrest,1664,warlock,demonology,48,26,22
Sourpatchkid,the-maelstrom,1664,warlock,demonology,47,22,25
Agathaharkne,minahonda,1660,warlock,demonology,60,34,26
Shadôrí,antonidas,1659,warlock,demonology,78,47,31
Lockmex,outland,1658,warlock,demonology,42,26,16
Felsturm,twisting-nether,1656,warlock,demonology,64,44,20
Nattû,outland,1656,warlock,demonology,36,20,16
Нистл,gordunni,1656,warlock,demonology,36,20,16
Darkdagor,blackrock,1656,warlock,demonology,55,30,25
Нафлэпил,gordunni,1655,warlock,demonology,54,31,23
Гурджес,soulflayer,1655,warlock,demonology,98,52,46
Кингпинг,soulflayer,1655,warlock,demonology,47,22,25
Shugglock,draenor,1654,warlock,demonology,48,26,22
Mjor,twisting-nether,1650,warlock,demonology,30,18,12
Itstrippy,tarren-mill,1650,warlock,demonology,78,43,35
Mendozaah,kazzak,1650,warlock,demonology,344,170,174
Ponçeur,ysondre,1648,warlock,demonology,43,25,18
Golborg,draenor,1648,warlock,demonology,129,61,68
Hellguards,silvermoon,1648,warlock,demonology,96,45,51
Mythoman,ravencrest,1647,warlock,demonology,66,36,30
Youseenbolt,ravencrest,1647,warlock,demonology,45,22,23
Utsus,tarren-mill,1645,warlock,demonology,36,23,13
Cthxil,frostwolf,1645,warlock,demonology,93,46,47
Smadrekas,ravencrest,1644,warlock,demonology,36,22,14
Джердхаус,fordragon,1644,warlock,demonology,54,27,27
Fandirxd,draenor,1643,warlock,demonology,126,59,67
Yoplen,drakthul,1642,warlock,demonology,54,30,24
Zéphon,blades-edge,1641,warlock,demonology,72,43,29
Zezca,draenor,1640,warlock,demonology,76,39,37
Tiffyilock,blackrock,1637,warlock,demonology,42,20,22
Scottware,draenor,1635,warlock,demonology,38,23,15
Darcîa,destromath,1635,warlock,demonology,247,129,118
Malumbra,argent-dawn,1635,warlock,demonology,57,27,30
Dotface,aegwynn,1633,warlock,demonology,42,21,21
Sörlewiis,the-maelstrom,1632,warlock,demonology,58,36,22
Nerzhull,stormscale,1632,warlock,demonology,123,66,57
Summonit,blackmoore,1632,warlock,demonology,114,60,54
Streganni,nemesis,1631,warlock,demonology,72,43,29
Dabulock,blackmoore,1631,warlock,demonology,111,61,50
Demicore,stormreaver,1631,warlock,demonology,72,31,41
Felgødx,nemesis,1630,warlock,demonology,24,17,7
Tekron,blackhand,1629,warlock,demonology,63,40,23
Letzterlude,thrall,1629,warlock,demonology,53,25,28
Лвнг,gordunni,1628,warlock,demonology,48,29,19
Kalinowa,burning-legion,1628,warlock,demonology,185,101,84
Naarnust,defias-brotherhood,1628,warlock,demonology,66,35,31
Кьютсанни,howling-fjord,1628,warlock,demonology,36,17,19
Анрали,deathguard,1627,warlock,demonology,30,17,13
Мешшугга,howling-fjord,1627,warlock,demonology,44,21,23
Xiraq,nathrezim,1627,warlock,demonology,36,17,19
Neuth,draenor,1627,warlock,demonology,56,24,32
Evalin,aggra-português,1626,warlock,demonology,113,69,44
Thorky,blackrock,1625,warlock,demonology,48,22,26
Erkai,kazzak,1624,warlock,demonology,45,24,21
Drainurlife,zenedar,1624,warlock,demonology,36,19,17
Agâshh,blackrock,1623,warlock,demonology,97,54,43
Dasda,defias-brotherhood,1623,warlock,demonology,89,49,40
Whj,ravencrest,1623,warlock,demonology,35,18,17
Docderlock,thrall,1623,warlock,demonology,45,23,22
Nachtreich,thrall,1622,warlock,demonology,30,17,13
Элси,howling-fjord,1622,warlock,demonology,30,17,13
Warlockyo,blackrock,1622,warlock,demonology,41,18,23
Храбзар,gordunni,1621,warlock,demonology,136,65,71
Xanatas,nemesis,1620,warlock,demonology,54,31,23
Ez,emeriss,1618,warlock,demonology,30,17,13
Yumiblood,tarren-mill,1618,warlock,demonology,77,41,36
Marador,drakthul,1617,warlock,demonology,30,17,13
Kawapow,azjolnerub,1615,warlock,demonology,88,56,32
Расмурът,soulflayer,1614,warlock,demonology,115,69,46
Xjms,darksorrow,1614,warlock,demonology,42,22,20
Fearmydear,alleria,1614,warlock,demonology,52,26,26
Sineko,twisting-nether,1612,warlock,demonology,363,187,176
Lichlolock,outland,1612,warlock,demonology,72,34,38
Eroszakolock,ragnaros,1611,warlock,demonology,24,17,7
Solidwarlock,archimonde,1611,warlock,demonology,60,37,23
Amited,drakthul,1611,warlock,demonology,48,27,21
Tamatóax,tarren-mill,1611,warlock,demonology,104,53,51
Dirtytyrant,sanguino,1610,warlock,demonology,30,17,13
Wåfa,kazzak,1610,warlock,demonology,395,214,181
Seldonn,pozzo-delleternità,1609,warlock,demonology,30,17,13
Môrgán,draenor,1609,warlock,demonology,234,117,117
Azraëlle,drekthar,1606,warlock,demonology,33,20,13
Lottopallo,arathor,1606,warlock,demonology,139,84,55
Shuggul,draenor,1606,warlock,demonology,37,22,15
Lockaria,zuljin,1606,warlock,demonology,93,53,40
Demosteaks,thrall,1606,warlock,demonology,42,22,20
Nainbusdemil,dalaran,1606,warlock,demonology,48,25,23
Kivuntuska,hyjal,1606,warlock,demonology,66,33,33
Nerdbane,blackrock,1605,warlock,demonology,36,20,16
Hubba,earthen-ring,1604,warlock,demonology,68,39,29
Емс,gordunni,1604,warlock,demonology,63,34,29
Dzodeep,kazzak,1603,warlock,demonology,42,25,17
Havexis,tichondrius,1602,warlock,demonology,42,32,10
Pentalock,blackmoore,1601,warlock,demonology,36,21,15
Prekt,ragnaros,1601,warlock,demonology,36,19,17
Sethtarr,draenor,1600,warlock,demonology,56,31,25
Kieman,tarren-mill,1600,warlock,demonology,60,30,30
Vêzor,twisting-nether,1600,warlock,demonology,76,36,40
Mindzsonghó,ragnaros,1599,warlock,demonology,36,21,15
Peremi,grim-batol,1599,warlock,demonology,54,30,24
Djshyasiañ,perenolde,1599,warlock,demonology,176,90,86
Alotadot,ravencrest,1598,warlock,demonology,75,42,33
Егосяхаос,soulflayer,1597,warlock,demonology,280,141,139
Гвоздяшка,blackscar,1597,warlock,demonology,47,22,25
Bigbagelbob,archimonde,1596,warlock,demonology,36,19,17
Дрын,gordunni,1594,warlock,demonology,36,21,15
Thralka,burning-legion,1593,warlock,demonology,138,73,65
Azthral,nemesis,1590,warlock,demonology,266,135,131
Deamonsmith,silvermoon,1589,warlock,demonology,70,40,30
Repah,doomhammer,1587,warlock,demonology,66,34,32
Paintrainz,darksorrow,1585,warlock,demonology,27,19,8
Eltharis,burning-legion,1584,warlock,demonology,41,21,20
Pørtalslave,ravencrest,1584,warlock,demonology,55,28,27
Potatowl,ravencrest,1582,warlock,demonology,36,18,18
Майдум,soulflayer,1582,warlock,demonology,47,23,24
Deathlock,outland,1581,warlock,demonology,60,37,23
Sïlïthuss,ravencrest,1581,warlock,demonology,129,70,59
Killua,kazzak,1581,warlock,demonology,47,24,23
Malkoran,sylvanas,1581,warlock,demonology,36,18,18
Stormytrumpy,twisting-nether,1580,warlock,demonology,39,21,18
Kosoki,burning-legion,1580,warlock,demonology,48,21,27
Мамхаус,howling-fjord,1579,warlock,demonology,36,22,14
Гнильсен,borean-tundra,1578,warlock,demonology,76,47,29
Beloezoloto,deathwing,1578,warlock,demonology,66,33,33
Gulzot,turalyon,1575,warlock,demonology,48,31,17
Bonemetz,blackmoore,1575,warlock,demonology,64,38,26
Сладкийпир,soulflayer,1574,warlock,demonology,144,79,65
Юккасарасти,gordunni,1572,warlock,demonology,30,18,12
Topmodelx,eredar,1572,warlock,demonology,30,17,13
Warlockoloco,blackmoore,1572,warlock,demonology,36,20,16
Skitless,blackmoore,1571,warlock,demonology,57,30,27
Dayan,stormreaver,1570,warlock,demonology,94,52,42
Youseenbølt,veklor,1570,warlock,demonology,48,19,29
Ароматныйх,howling-fjord,1569,warlock,demonology,42,20,22
Nekrosd,tarren-mill,1569,warlock,demonology,39,18,21
Endixujo,sanguino,1568,warlock,demonology,104,64,40
Демоник,deathguard,1567,warlock,demonology,36,18,18
Ijixed,ravencrest,1567,warlock,demonology,86,39,47
Itrix,aegwynn,1565,warlock,demonology,36,18,18
Larina,neptulon,1564,warlock,demonology,41,24,17
Silenozz,ragnaros,1564,warlock,demonology,91,49,42
Nagash,zuljin,1563,warlock,demonology,41,29,12
Søcraqt,blackrock,1562,warlock,demonology,55,29,26
Gemors,ravenholdt,1562,warlock,demonology,83,42,41
Cadavrus,arakarahm,1562,warlock,demonology,36,18,18
Eleriya,argent-dawn,1561,warlock,demonology,146,71,75
Dotsyoudown,kelthuzad,1560,warlock,demonology,36,18,18
Akumako,stormscale,1560,warlock,demonology,35,17,18
Khaleth,dun-modr,1559,warlock,demonology,29,17,12
Iovol,korgall,1559,warlock,demonology,150,81,69
Ruinovino,outland,1559,warlock,demonology,84,43,41
Itspoint,draenor,1558,warlock,demonology,65,33,32
Bionic,eredar,1557,warlock,demonology,31,18,13
Evanore,burning-legion,1555,warlock,demonology,115,59,56
Laveau,outland,1555,warlock,demonology,42,21,21
Фортэр,ashenvale,1555,warlock,demonology,120,56,64
Tonin,antonidas,1553,warlock,demonology,71,41,30
Trollgubbe,twilights-hammer,1551,warlock,demonology,42,24,18
Solitariøus,arathi,1550,warlock,demonology,97,48,49
Scattler,aegwynn,1548,warlock,demonology,36,24,12
Колдунишка,fordragon,1547,warlock,demonology,102,56,46
Luqhex,blackrock,1547,warlock,demonology,36,18,18
Velativ,silvermoon,1546,warlock,demonology,24,17,7
Костикк,howling-fjord,1546,warlock,demonology,37,21,16
Denzeal,argent-dawn,1546,warlock,demonology,108,53,55
Marketwizard,turalyon,1545,warlock,demonology,39,20,19
Hamnam,blackrock,1543,warlock,demonology,42,23,19
Benzakenta,sylvanas,1541,warlock,demonology,42,26,16
Haillun,twisting-nether,1541,warlock,demonology,35,17,18
Octoba,kirin-tor,1540,warlock,demonology,80,45,35
Sublînê,blackmoore,1540,warlock,demonology,100,49,51
Ilililii,ravencrest,1539,warlock,demonology,60,31,29
Terrorrize,draenor,1539,warlock,demonology,300,151,149
Morgan,jaedenar,1538,warlock,demonology,93,44,49
Shalazar,dun-modr,1537,warlock,demonology,138,80,58
Bultenx,tarren-mill,1537,warlock,demonology,54,28,26
Redshíne,hyjal,1537,warlock,demonology,54,24,30
Бельведерчи,blackscar,1536,warlock,demonology,267,140,127
Kikeri,blackhand,1535,warlock,demonology,27,16,11
Nuwdles,tarren-mill,1535,warlock,demonology,42,23,19
Güulran,les-clairvoyants,1535,warlock,demonology,161,88,73
Oggelock,tarren-mill,1534,warlock,demonology,24,16,8
Secretx,kazzak,1532,warlock,demonology,18,16,2
Sizezero,tarren-mill,1532,warlock,demonology,30,18,12
Kaamosliha,frostwhisper,1532,warlock,demonology,101,51,50
Altffeer,blackmoore,1531,warlock,demonology,47,27,20
Wëndigo,stormscale,1530,warlock,demonology,41,19,22
Cròwly,area-52,1529,warlock,demonology,46,29,17
Kasztyk,grim-batol,1529,warlock,demonology,30,16,14
Hörst,das-konsortium,1528,warlock,demonology,50,27,23
Honetia,ravencrest,1528,warlock,demonology,167,79,88
Cringetamer,silvermoon,1527,warlock,demonology,52,25,27
Tochka,archimonde,1526,warlock,demonology,90,44,46
Wiitchdoktor,twisting-nether,1526,warlock,demonology,42,18,24
Tsumde,dalaran,1525,warlock,demonology,239,123,116
Abdelkarime,khaz-modan,1523,warlock,demonology,78,35,43
Skarafftan,aegwynn,1522,warlock,demonology,24,16,8
Rinnieeqt,outland,1522,warlock,demonology,55,29,26
Hydroxyjk,ragnaros,1520,warlock,demonology,36,24,12
Carlss,sanguino,1519,warlock,demonology,48,24,24
Fedra,steamwheedle-cartel,1517,warlock,demonology,36,18,18
Rpez,archimonde,1514,warlock,demonology,490,254,236
Benvyx,twisting-nether,1514,warlock,demonology,35,16,19
Stormblast,azshara,1513,warlock,demonology,92,56,36
Ruhuen,stormscale,1513,warlock,demonology,46,23,23
Acererak,thunderhorn,1513,warlock,demonology,71,34,37
Кайрана,blackscar,1512,warlock,demonology,85,50,35
Харакула,fordragon,1512,warlock,demonology,78,42,36
Ájszmen,ravencrest,1512,warlock,demonology,179,89,90
Kritrouilles,sargeras,1510,warlock,demonology,36,19,17
Razzguul,blackmoore,1509,warlock,demonology,46,27,19
Theolock,ragnaros,1508,warlock,demonology,60,28,32
Ydidntuwait,ragnaros,1508,warlock,demonology,60,27,33
Styxwl,blackhand,1506,warlock,demonology,30,16,14
Mundunugu,sanguino,1505,warlock,demonology,31,20,11
Цетрелисс,gordunni,1505,warlock,demonology,78,40,38
Кейкегенкай,gordunni,1504,warlock,demonology,66,38,28
Silvercurse,azuremyst,1504,warlock,demonology,54,29,25
Roedin,tarren-mill,1504,warlock,demonology,153,65,88
Rafael,stormscale,1503,warlock,demonology,60,33,27
Гулдарий,howling-fjord,1502,warlock,demonology,351,185,166
Avanturnik,burning-legion,1500,warlock,demonology,36,20,16
Soyafärs,ravencrest,1500,warlock,demonology,60,29,31
Ðârk,silvermoon,1500,warlock,demonology,66,28,38
Hypotax,ragnaros,1499,warlock,demonology,114,58,56
Vidorious,kilrogg,1498,warlock,demonology,36,25,11
Líely,ravencrest,1498,warlock,demonology,42,24,18
Nomakqlock,dun-modr,1498,warlock,demonology,84,46,38
Zanzarismo,nemesis,1497,warlock,demonology,45,25,20
Zèlêph,archimonde,1496,warlock,demonology,24,17,7
Rotyou,blackmoore,1496,warlock,demonology,67,32,35
Иллугис,gordunni,1496,warlock,demonology,60,28,32
Longdickie,ravencrest,1495,warlock,demonology,60,29,31
Evillinna,frostmane,1495,warlock,demonology,37,16,21
Yvonita,chamber-of-aspects,1490,warlock,demonology,30,16,14
Jujuw,tarren-mill,1490,warlock,demonology,105,54,51
Panic,stormrage,1489,warlock,demonology,270,142,128
Fearhändig,aegwynn,1489,warlock,demonology,71,33,38
Марэд,howling-fjord,1485,warlock,demonology,58,29,29
Xalath,grim-batol,1483,warlock,demonology,42,24,18
Priszcilla,twisting-nether,1483,warlock,demonology,154,84,70
Эволюционист,gordunni,1483,warlock,demonology,42,22,20
Ппинг,soulflayer,1481,warlock,demonology,96,44,52
Мембер,thermaplugg,1480,warlock,demonology,42,17,25
Themus,twisting-nether,1479,warlock,demonology,30,20,10
Cahoa,archimonde,1479,warlock,demonology,60,35,25
Jondi,blackmoore,1479,warlock,demonology,49,27,22
Enviroq,burning-legion,1469,warlock,demonology,59,34,25
Sevastus,argent-dawn,1467,warlock,demonology,149,78,71
Demiurgus,auchindoun,1464,warlock,demonology,47,18,29
Mephysteroth,dalaran,1463,warlock,demonology,66,31,35
Мицуру,howling-fjord,1462,warlock,demonology,38,25,13
Khalkazar,darkspear,1462,warlock,demonology,66,32,34
Penske,sanguino,1462,warlock,demonology,81,39,42
Felburrn,twisting-nether,1459,warlock,demonology,143,70,73
Ghachi,draenor,1457,warlock,demonology,29,16,13
Зарлог,soulflayer,1455,warlock,demonology,72,33,39
Hâres,anetheron,1454,warlock,demonology,430,208,222
Seriasa,blackmoore,1454,warlock,demonology,72,28,44
Deprecated,burning-blade,1453,warlock,demonology,29,17,12
Камнилока,booty-bay,1453,warlock,demonology,127,70,57
Vatikanet,stormscale,1449,warlock,demonology,48,29,19
Indiasummerx,turalyon,1448,warlock,demonology,97,50,47
Грешъник,gordunni,1448,warlock,demonology,67,32,35
Lamboo,tarren-mill,1446,warlock,demonology,34,16,18
Morshax,ysondre,1443,warlock,demonology,52,31,21
Факлок,gordunni,1443,warlock,demonology,45,26,19
Absúrd,turalyon,1440,warlock,demonology,263,143,120
Spongebobx,kazzak,1439,warlock,demonology,24,15,9
Scallington,shattered-hand,1439,warlock,demonology,30,15,15
Someonepro,tarren-mill,1437,warlock,demonology,30,15,15
Biest,drakthul,1437,warlock,demonology,36,15,21
Jïñ,ravencrest,1436,warlock,demonology,24,15,9
Ethiq,blackrock,1436,warlock,demonology,30,15,15
Slurvefar,kazzak,1436,warlock,demonology,30,15,15
Чутьчутьзлая,gordunni,1436,warlock,demonology,54,25,29
Sadisticlól,burning-legion,1435,warlock,demonology,48,25,23
Bß,argent-dawn,1434,warlock,demonology,71,38,33
Agonyzed,argent-dawn,1434,warlock,demonology,52,27,25
Guldchan,drakthul,1433,warlock,demonology,24,15,9
Ädarä,cthun,1433,warlock,demonology,162,84,78
Ganjubass,tarren-mill,1432,warlock,demonology,24,15,9
Ablas,bladefist,1432,warlock,demonology,147,65,82
Kukcaryfuk,drakthul,1431,warlock,demonology,54,27,27
Saganelle,hyjal,1426,warlock,demonology,18,15,3
Shondonbeats,ravencrest,1426,warlock,demonology,27,17,10
Ghalorg,hyjal,1425,warlock,demonology,29,16,13
Visenyá,magtheridon,1424,warlock,demonology,30,16,14
Hyphonos,blackmoore,1422,warlock,demonology,30,15,15
Míkæ,ravencrest,1417,warlock,demonology,101,48,53
Nimh,azjolnerub,1416,warlock,demonology,112,61,51
Tschebo,eredar,1415,warlock,demonology,39,20,19
Стокыч,soulflayer,1415,warlock,demonology,42,15,27
Эмокитти,soulflayer,1414,warlock,demonology,72,41,31
Lunden,drakthul,1414,warlock,demonology,70,34,36
Malganas,sylvanas,1414,warlock,demonology,95,42,53
Chedipes,stormscale,1414,warlock,demonology,39,16,23
Szetbaszlock,ragnaros,1412,warlock,demonology,36,22,14
Njutbar,ragnaros,1412,warlock,demonology,33,20,13
Valadair,sanguino,1408,warlock,demonology,265,139,126
Героуд,howling-fjord,1407,warlock,demonology,30,15,15
Dementorian,blackrock,1405,warlock,demonology,24,15,9
Паникс,gordunni,1405,warlock,demonology,54,22,32
Trellaras,bloodfeather,1404,warlock,demonology,99,52,47
Lockmybllz,baelgun,1403,warlock,demonology,36,21,15
Qullnius,kazzak,1402,warlock,demonology,42,24,18
Tudii,frostwolf,1401,warlock,demonology,54,32,22
Morgána,outland,1401,warlock,demonology,30,15,15
Mefistosx,draenor,1397,warlock,demonology,54,24,30
Profylaxis,arathor,1396,warlock,demonology,46,23,23
Inien,sylvanas,1392,warlock,demonology,66,41,25
Чернаяскала,howling-fjord,1389,warlock,demonology,164,77,87
Happycadaver,blackrock,1388,warlock,demonology,45,21,24
Армдэд,galakrond,1388,warlock,demonology,84,39,45
Cozyboi,thrall,1386,warlock,demonology,112,67,45
Jag,neptulon,1384,warlock,demonology,92,55,37
Smallpee,kazzak,1380,warlock,demonology,54,25,29
Сквордин,gordunni,1378,warlock,demonology,30,17,13
Антетак,soulflayer,1378,warlock,demonology,42,22,20
Astéfion,dalaran,1378,warlock,demonology,30,15,15
Void,pozzo-delleternità,1377,warlock,demonology,119,62,57
Thorash,moonglade,1374,warlock,demonology,52,30,22
Aenygma,jaedenar,1374,warlock,demonology,54,29,25
Isuckwarlock,aegwynn,1371,warlock,demonology,34,15,19
Wítchær,blackhand,1370,warlock,demonology,48,28,20
Telyfol,ragnaros,1370,warlock,demonology,40,17,23
Deabrus,silvermoon,1369,warlock,demonology,65,31,34
Corbiejr,tarren-mill,1369,warlock,demonology,76,30,46
Bobkeso,sylvanas,1368,warlock,demonology,36,15,21
Tomlingen,terenas,1361,warlock,demonology,60,32,28
Brryant,colinas-pardas,1360,warlock,demonology,42,22,20
Lökjävel,twisting-nether,1359,warlock,demonology,30,17,13
Neffy,sinstralis,1359,warlock,demonology,75,38,37
Erèss,hyjal,1358,warlock,demonology,42,19,23
Чингинсхан,howling-fjord,1357,warlock,demonology,35,25,10
Letzman,ravencrest,1356,warlock,demonology,31,18,13
Candyman,bronze-dragonflight,1356,warlock,demonology,93,47,46
Nihale,arakarahm,1352,warlock,demonology,38,21,17
Mesîkatayut,outland,1351,warlock,demonology,81,46,35
Chimera,mugthol,1350,warlock,demonology,60,27,33
Olsel,draenor,1349,warlock,demonology,36,16,20
Простоседой,gordunni,1349,warlock,demonology,35,15,20
Kalhija,medivh,1347,warlock,demonology,60,32,28
Xanatar,blackhand,1347,warlock,demonology,72,29,43
Mércé,stormscale,1344,warlock,demonology,18,14,4
Ukjjkhj,frostmane,1344,warlock,demonology,37,15,22
Xarica,garona,1343,warlock,demonology,18,14,4
Mamasitica,ravencrest,1343,warlock,demonology,18,14,4
Beebs,aegwynn,1343,warlock,demonology,18,14,4
Kumamoto,tarren-mill,1342,warlock,demonology,30,14,16
Bewbys,draenor,1342,warlock,demonology,55,25,30
Famíliar,tarren-mill,1342,warlock,demonology,99,40,59
Lacape,dalaran,1340,warlock,demonology,28,15,13
Xfz,stormscale,1340,warlock,demonology,30,14,16
Баммес,galakrond,1338,warlock,demonology,178,83,95
Shârîngan,kazzak,1337,warlock,demonology,30,14,16
Evilonion,outland,1337,warlock,demonology,36,14,22
Esgül,draenor,1336,warlock,demonology,144,72,72
Mpslo,archimonde,1335,warlock,demonology,24,14,10
Døtzz,blackmoore,1335,warlock,demonology,30,14,16
Инсип,blackscar,1333,warlock,demonology,78,39,39
Vanskor,argent-dawn,1331,warlock,demonology,100,42,58
Elìphás,blackmoore,1330,warlock,demonology,36,14,22
Ккоксакер,gordunni,1329,warlock,demonology,24,14,10
Ilarizium,ysondre,1329,warlock,demonology,95,46,49
Dìablò,sylvanas,1328,warlock,demonology,60,36,24
Eatherial,twilights-hammer,1327,warlock,demonology,52,31,21
Kharless,kazzak,1327,warlock,demonology,38,19,19
Rîas,hyjal,1325,warlock,demonology,24,14,10
Raez,burning-blade,1325,warlock,demonology,48,18,30
Prestoc,wrathbringer,1324,warlock,demonology,30,14,16
Dedalus,zuluhed,1320,warlock,demonology,220,119,101
Hexendocc,blackmoore,1320,warlock,demonology,32,16,16
Kwanzaa,ravencrest,1319,warlock,demonology,24,14,10
Evilbuba,burning-legion,1319,warlock,demonology,70,36,34
Forthewin,stormreaver,1317,warlock,demonology,36,17,19
Gulldan,bloodfeather,1315,warlock,demonology,54,27,27
Allotropìa,ravencrest,1315,warlock,demonology,30,14,16
Dhraven,thrall,1314,warlock,demonology,78,36,42
Дуклок,howling-fjord,1313,warlock,demonology,70,37,33
Urfaust,blackmoore,1313,warlock,demonology,36,14,22
Papilena,turalyon,1312,warlock,demonology,67,31,36
Исверон,howling-fjord,1310,warlock,demonology,29,14,15
Rövsmärta,ragnaros,1306,warlock,demonology,39,20,19
Dominvs,silvermoon,1306,warlock,demonology,162,80,82
Arra,argent-dawn,1305,warlock,demonology,42,23,19
Øupas,ysondre,1304,warlock,demonology,42,14,28
Валентинчик,galakrond,1301,warlock,demonology,105,50,55
Déus,forscherliga,1300,warlock,demonology,263,126,137
Mmorgana,sanguino,1295,warlock,demonology,45,19,26
Maferous,argent-dawn,1293,warlock,demonology,41,19,22
Siaval,die-aldor,1292,warlock,demonology,51,25,26
Соргосор,gordunni,1290,warlock,demonology,23,16,7
Xoky,argent-dawn,1286,warlock,demonology,42,17,25
Degdeehei,draenor,1282,warlock,demonology,24,16,8
Cmzdalock,ravencrest,1279,warlock,demonology,36,23,13
Lifesteal,auchindoun,1279,warlock,demonology,67,34,33
Volomar,darkspear,1279,warlock,demonology,35,16,19
Cerberus,argent-dawn,1277,warlock,demonology,24,15,9
Мормир,deathguard,1274,warlock,demonology,88,37,51
Lugdan,blackmoore,1273,warlock,demonology,54,21,33
Trainindummy,ravencrest,1272,warlock,demonology,17,14,3
Tunrîda,illidan,1272,warlock,demonology,51,23,28
Auxi,the-maelstrom,1270,warlock,demonology,114,57,57
Acuacx,drakthul,1268,warlock,demonology,29,14,15
Shadowpriest,nemesis,1265,warlock,demonology,29,15,14
Mombo,the-maelstrom,1261,warlock,demonology,33,15,18
Andid,frostwolf,1253,warlock,demonology,61,30,31
Zoulgania,antonidas,1253,warlock,demonology,133,56,77
Narayan,ysondre,1252,warlock,demonology,71,40,31
Bachmut,ravencrest,1252,warlock,demonology,30,14,16
Lokisi,die-aldor,1249,warlock,demonology,60,34,26
Lhestér,outland,1248,warlock,demonology,24,13,11
Ахпорбес,gordunni,1247,warlock,demonology,40,22,18
Boomlok,tarren-mill,1247,warlock,demonology,24,13,11
Ôlo,rajaxx,1247,warlock,demonology,24,13,11
Idonthexafck,kazzak,1246,warlock,demonology,18,13,5
Okmybad,outland,1246,warlock,demonology,24,13,11
Fatzké,kargath,1246,warlock,demonology,28,13,15
Selene,der-rat-von-dalaran,1243,warlock,demonology,24,13,11
Бжк,gordunni,1243,warlock,demonology,30,13,17
Vregor,twisting-nether,1242,warlock,demonology,18,13,5
Drachus,outland,1242,warlock,demonology,18,13,5
Tarilinwelli,les-sentinelles,1242,warlock,demonology,24,13,11
Dmondmg,kazzak,1242,warlock,demonology,30,13,17
Blazik,kazzak,1237,warlock,demonology,36,20,16
Netcownt,silvermoon,1237,warlock,demonology,63,32,31
Diavoolitza,sylvanas,1237,warlock,demonology,120,57,63
Azaêl,azshara,1237,warlock,demonology,30,13,17
Lokko,nemesis,1237,warlock,demonology,65,26,39
Vìenna,outland,1235,warlock,demonology,24,13,11
Zetec,tarren-mill,1235,warlock,demonology,36,13,23
Gunca,sylvanas,1231,warlock,demonology,36,17,19
Sargaerot,draenor,1230,warlock,demonology,72,33,39
Dernaxz,argent-dawn,1225,warlock,demonology,26,15,11
Boldielocks,tarren-mill,1224,warlock,demonology,18,13,5
Screamo,sylvanas,1224,warlock,demonology,85,48,37
Bíü,tarren-mill,1219,warlock,demonology,30,13,17
Gnometefurax,hyjal,1218,warlock,demonology,55,24,31
Cevérus,chogall,1217,warlock,demonology,66,33,33
Rüwel,mannoroth,1214,warlock,demonology,65,29,36
Dedobozhe,ravencrest,1213,warlock,demonology,24,13,11
Yamajii,krasus,1205,warlock,demonology,77,42,35
Imadovich,silvermoon,1202,warlock,demonology,161,86,75
Lewd,dragonblight,1202,warlock,demonology,29,15,14
Filø,dalaran,1201,warlock,demonology,114,46,68
Marklock,drakthul,1199,warlock,demonology,18,13,5
Truckpunch,defias-brotherhood,1199,warlock,demonology,105,48,57
Vreyax,aegwynn,1195,warlock,demonology,29,13,16
Zdrac,stormscale,1185,warlock,demonology,91,38,53
Rngmåchinêx,ravencrest,1183,warlock,demonology,22,13,9
Мааверш,soulflayer,1181,warlock,demonology,42,25,17
Vorgoth,argent-dawn,1179,warlock,demonology,28,13,15
Waltrude,conseil-des-ombres,1171,warlock,demonology,77,27,50
Thyron,gorgonnash,1165,warlock,demonology,54,25,29
Krushell,sanguino,1158,warlock,demonology,36,21,15
Fujiitøra,ysondre,1158,warlock,demonology,165,85,80
Inani,ragnaros,1157,warlock,demonology,29,13,16
Jomitoisback,nemesis,1152,warlock,demonology,12,12,0
Простишутках,gordunni,1152,warlock,demonology,16,13,3
Bónz,outland,1152,warlock,demonology,18,12,6
Gorescrèám,stormscale,1152,warlock,demonology,18,12,6
Rbmk,sanguino,1152,warlock,demonology,18,12,6
Havefunxqt,archimonde,1152,warlock,demonology,26,13,13
Averiumx,ravencrest,1152,warlock,demonology,24,12,12
Isanê,blackrock,1152,warlock,demonology,24,12,12
Dotrulez,nemesis,1151,warlock,demonology,18,12,6
Инфес,deathweaver,1151,warlock,demonology,18,12,6
Shlipshlap,ravencrest,1151,warlock,demonology,24,12,12
Nargøf,outland,1151,warlock,demonology,24,12,12
Slâyâ,blackrock,1150,warlock,demonology,18,12,6
Melydor,ragnaros,1150,warlock,demonology,18,12,6
Morwëk,ysondre,1150,warlock,demonology,36,12,24
Slobb,blackrock,1149,warlock,demonology,18,12,6
Äri,blackmoore,1149,warlock,demonology,24,12,12
Antuan,sanguino,1149,warlock,demonology,30,12,18
Gülldän,chogall,1148,warlock,demonology,18,12,6
Desolador,tyrande,1148,warlock,demonology,30,12,18
Deadmanwlkin,aggra-português,1147,warlock,demonology,24,12,12
Édøras,archimonde,1146,warlock,demonology,30,12,18
Ashzu,quelthalas,1145,warlock,demonology,24,12,12
Jinxme,tarren-mill,1144,warlock,demonology,18,12,6
Ipetsincl,kazzak,1143,warlock,demonology,24,12,12
Sînâ,anubarak,1141,warlock,demonology,36,18,18
Lacus,voljin,1138,warlock,demonology,42,12,30
Aldhelm,draenor,1130,warlock,demonology,28,13,15
Немножковуду,soulflayer,1129,warlock,demonology,43,20,23
Nozalem,dalaran,1126,warlock,demonology,71,39,32
Cazul,archimonde,1118,warlock,demonology,20,13,7
Erwynna,conseil-des-ombres,1118,warlock,demonology,30,12,18
Ikorof,stormscale,1117,warlock,demonology,28,12,16
Силаскверна,deathguard,1116,warlock,demonology,96,43,53
Wanderingowl,argent-dawn,1103,warlock,demonology,18,12,6
Scarly,nordrassil,1103,warlock,demonology,41,21,20
Tripleshache,elune,1101,warlock,demonology,132,67,65
Cwyn,ravencrest,1088,warlock,demonology,30,13,17
Êdelmann,blackrock,1086,warlock,demonology,23,12,11
Ïvar,ysondre,1074,warlock,demonology,85,35,50
Remthorn,frostmane,1068,warlock,demonology,128,67,61
Wryy,nemesis,1067,warlock,demonology,25,12,13
Inferniøn,ravencrest,1056,warlock,demonology,12,11,1
Bicuriousdad,tarren-mill,1056,warlock,demonology,12,11,1
Dotosgyörgy,ragnaros,1056,warlock,demonology,18,11,7
Adellara,draenor,1056,warlock,demonology,18,11,7
Dotáhoe,twisting-nether,1056,warlock,demonology,22,12,10
Sabiocalvo,dun-modr,1056,warlock,demonology,153,75,78
Nazw,ravencrest,1056,warlock,demonology,24,11,13
Aljohno,twisting-nether,1056,warlock,demonology,24,11,13
Dwoorf,ravencrest,1056,warlock,demonology,24,11,13
Werzel,frostmane,1055,warlock,demonology,18,11,7
Syñdrome,ragnaros,1055,warlock,demonology,18,11,7
Gymenjoyer,ravencrest,1055,warlock,demonology,18,11,7
Lonelock,blackrock,1055,warlock,demonology,24,11,13
Dabzw,twisting-nether,1055,warlock,demonology,30,11,19
Tìdùs,nethersturm,1054,warlock,demonology,12,11,1
Drainsouls,stormscale,1054,warlock,demonology,18,11,7
Острогриф,gordunni,1054,warlock,demonology,18,11,7
Dàrksoul,thrall,1054,warlock,demonology,18,11,7
Eviloverlord,silvermoon,1054,warlock,demonology,24,11,13
Arizyoxot,twisting-nether,1054,warlock,demonology,24,11,13
Katâra,tarren-mill,1054,warlock,demonology,24,11,13
Shînîgamî,draenor,1053,warlock,demonology,18,11,7
Fenrixlol,zuljin,1052,warlock,demonology,18,11,7
Евнухоидизм,gordunni,1051,warlock,demonology,20,11,9
Törtidotcom,blackrock,1051,warlock,demonology,24,11,13
Nellyvato,eredar,1050,warlock,demonology,18,11,7
Kamehamehaa,stormscale,1050,warlock,demonology,18,11,7
Wolfdoom,cthun,1049,warlock,demonology,18,11,7
Ukicha,burning-blade,1049,warlock,demonology,18,11,7
Azpit,draenor,1049,warlock,demonology,18,11,7
Дулаан,blackscar,1042,warlock,demonology,18,11,7
Abnørmus,tarren-mill,1031,warlock,demonology,24,11,13
Thanàthos,pozzo-delleternità,1030,warlock,demonology,36,17,19
Mindtrick,drakthul,1028,warlock,demonology,24,11,13
Ambralia,blackmoore,1027,warlock,demonology,88,42,46
Mückea,eredar,1026,warlock,demonology,30,11,19
Yountyrantx,blackrock,1023,warlock,demonology,14,12,2
Shadowppl,outland,1021,warlock,demonology,26,12,14
Stregone,chogall,1018,warlock,demonology,24,13,11
Liittlefreak,silvermoon,1017,warlock,demonology,20,12,8
Hexus,teldrassil,1017,warlock,demonology,36,11,25
Maleesh,ravenholdt,1013,warlock,demonology,78,32,46
Gutras,ragnaros,1007,warlock,demonology,23,11,12
Dreamnyâsha,tarren-mill,1002,warlock,demonology,21,13,8
Sipsirica,ragnaros,1002,warlock,demonology,68,30,38
Flisiakm,exodar,1000,warlock,demonology,30,12,18
Fuark,teldrassil,987,warlock,demonology,17,11,6
Rîyuk,hyjal,986,warlock,demonology,22,11,11
Тэйлок,gordunni,977,warlock,demonology,23,11,12
Cedrea,ravencrest,975,warlock,demonology,47,11,36
Haitech,dalaran,974,warlock,demonology,16,11,5
Chãn,tarren-mill,960,warlock,demonology,12,10,2
Cadilloc,blackmoore,960,warlock,demonology,12,10,2
Miauwu,stormscale,960,warlock,demonology,12,10,2
Retnmsl,outland,960,warlock,demonology,18,10,8
Bankstair,stormscale,960,warlock,demonology,18,10,8
Moardôtz,tarren-mill,960,warlock,demonology,18,10,8
Plâytïmè,stormscale,960,warlock,demonology,18,10,8
Fearu,kazzak,960,warlock,demonology,24,10,14
Zartax,kazzak,960,warlock,demonology,24,10,14
Oozi,tarren-mill,959,warlock,demonology,12,10,2
Nerdlockx,tarren-mill,959,warlock,demonology,12,10,2
Нэваблэйз,howling-fjord,959,warlock,demonology,18,10,8
Plsbuffme,ravencrest,959,warlock,demonology,18,10,8
Boogersoup,outland,959,warlock,demonology,18,10,8
Pepsimaxlove,silvermoon,959,warlock,demonology,18,10,8
Dortes,blackrock,959,warlock,demonology,18,10,8
Alexutzu,sylvanas,959,warlock,demonology,18,10,8
Ívânguldán,twisting-nether,959,warlock,demonology,24,10,14
Lifetapped,tarren-mill,959,warlock,demonology,24,10,14
Amerihell,pozzo-delleternità,959,warlock,demonology,24,10,14
Davyjonessx,twisting-nether,958,warlock,demonology,18,10,8
Pissbolts,tarren-mill,958,warlock,demonology,18,10,8
Killning,medivh,958,warlock,demonology,18,10,8
Killidan,kelthuzad,958,warlock,demonology,18,10,8
Ooliver,kazzak,958,warlock,demonology,18,10,8
Teflondione,stormreaver,958,warlock,demonology,18,10,8
Petrapain,antonidas,958,warlock,demonology,22,11,11
Nox,ravenholdt,957,warlock,demonology,20,10,10
Boxxybabee,blackhand,956,warlock,demonology,12,10,2
Elkiä,ysondre,956,warlock,demonology,36,19,17
Жмотярище,gordunni,955,warlock,demonology,18,10,8
Hallowee,voljin,946,warlock,demonology,80,28,52
Ohnoitsnepss,chamber-of-aspects,939,warlock,demonology,42,12,30
Flamidien,archimonde,911,warlock,demonology,17,10,7
Dardec,hyjal,910,warlock,demonology,35,10,25
Zaross,khaz-modan,907,warlock,demonology,59,25,34
Myskul,burning-legion,906,warlock,demonology,22,12,10
Migyardondup,exodar,905,warlock,demonology,105,55,50
Themengh,stormscale,904,warlock,demonology,69,27,42
Djadizpunish,stormscale,894,warlock,demonology,15,11,4
Lifetap,tarren-mill,894,warlock,demonology,20,10,10
Snoggä,antonidas,885,warlock,demonology,36,17,19
Polanka,drakthul,878,warlock,demonology,18,10,8
Csüki,ragnaros,878,warlock,demonology,19,10,9
Wewondak,drakthul,876,warlock,demonology,11,10,1
Ixal,hyjal,870,warlock,demonology,60,28,32
Nastychatøn,ysondre,864,warlock,demonology,12,9,3
Ooroothothz,frostwolf,864,warlock,demonology,12,9,3
Yazurí,ravencrest,864,warlock,demonology,12,9,3
Fhla,kazzak,864,warlock,demonology,12,9,3
Nëismz,hyjal,864,warlock,demonology,12,9,3
Öbsury,hyjal,864,warlock,demonology,12,9,3
Sulnar,burning-legion,864,warlock,demonology,12,9,3
Bualock,sylvanas,864,warlock,demonology,12,9,3
Dogdrakex,tarren-mill,864,warlock,demonology,12,9,3
Deßra,stormscale,864,warlock,demonology,12,9,3
Magicisback,nemesis,864,warlock,demonology,12,9,3
Dadylock,silvermoon,864,warlock,demonology,12,9,3
Санядушнила,soulflayer,864,warlock,demonology,12,9,3
Журанайсбой,blackscar,864,warlock,demonology,18,9,9
Blekspel,outland,864,warlock,demonology,18,9,9
Nekrofille,outland,864,warlock,demonology,18,9,9
Rikmeyzter,burning-blade,864,warlock,demonology,18,9,9
Cassen,outland,864,warlock,demonology,24,9,15
Tops,thrall,863,warlock,demonology,12,9,3
Тапкидеда,gordunni,863,warlock,demonology,12,9,3
Myrkûl,kazzak,863,warlock,demonology,18,9,9
Malathrom,garona,863,warlock,demonology,18,9,9
Bananajouu,blackhand,863,warlock,demonology,18,9,9
Ewalock,chants-éternels,863,warlock,demonology,18,9,9
Pokidrain,twisting-nether,863,warlock,demonology,18,9,9
Destrolockz,tarren-mill,863,warlock,demonology,18,9,9
Cardinall,drakthul,863,warlock,demonology,18,9,9
Nosoulnoprob,sylvanas,863,warlock,demonology,24,9,15
Millhaus,gorgonnash,863,warlock,demonology,30,9,21
Nomercymcr,burning-legion,862,warlock,demonology,18,9,9
Drarken,sylvanas,862,warlock,demonology,18,9,9
Warlockout,ravencrest,862,warlock,demonology,18,9,9
Topmidbusta,draenor,862,warlock,demonology,18,9,9
Малгат,howling-fjord,862,warlock,demonology,24,9,15
Summøn,stormreaver,862,warlock,demonology,32,9,23
Nëeya,hyjal,861,warlock,demonology,18,9,9
Kazzulina,ravenholdt,861,warlock,demonology,24,9,15
Mietzekatz,stormscale,860,warlock,demonology,24,9,15
Oblutak,draenor,859,warlock,demonology,18,9,9
Corínnakopf,thrall,858,warlock,demonology,18,9,9
Zytomegalie,blackrock,856,warlock,demonology,18,9,9
Nikhusadark,draenor,856,warlock,demonology,19,9,10
Диффиндо,galakrond,854,warlock,demonology,12,9,3
Decimus,darkspear,847,warlock,demonology,23,9,14
Hhip,sanguino,842,warlock,demonology,27,10,17
Necrozar,blackrock,831,warlock,demonology,17,9,8
Hexovíc,blackmoore,829,warlock,demonology,23,9,14
Jendzababa,burning-legion,827,warlock,demonology,17,9,8
Farasuflet,burning-steppes,826,warlock,demonology,36,16,20
Déadwish,ravencrest,823,warlock,demonology,29,9,20
Dáinsleif,dun-modr,816,warlock,demonology,15,9,6
Vansouls,silvermoon,815,warlock,demonology,15,10,5
Дакиса,gordunni,815,warlock,demonology,17,9,8
Destrodanii,dun-morogh,814,warlock,demonology,17,9,8
Гупперлок,howling-fjord,810,warlock,demonology,27,12,15
Lókkíi,silvermoon,809,warlock,demonology,24,10,14
Комочеро,soulflayer,807,warlock,demonology,25,10,15
Бирел,soulflayer,799,warlock,demonology,16,9,7
Dsï,outland,799,warlock,demonology,17,9,8
Кусокплети,grom,797,warlock,demonology,19,10,9
Йотунхейм,ashenvale,792,warlock,demonology,20,9,11
Absoul,defias-brotherhood,768,warlock,demonology,12,8,4
Rozn,ravencrest,768,warlock,demonology,12,8,4
Staenkymayne,blackhand,768,warlock,demonology,12,8,4
Necksi,archimonde,768,warlock,demonology,12,8,4
Devildodo,elune,768,warlock,demonology,12,8,4
Шрэкс,blackscar,768,warlock,demonology,12,8,4
Homerbamboom,hyjal,768,warlock,demonology,12,8,4
Hyòkà,kazzak,768,warlock,demonology,12,8,4
Kronesx,tarren-mill,768,warlock,demonology,12,8,4
Gilfhaunter,malganis,768,warlock,demonology,12,8,4
Àmæla,thrall,768,warlock,demonology,12,8,4
Maevoni,blackmoore,768,warlock,demonology,12,8,4
Freyzul,twisting-nether,768,warlock,demonology,12,8,4
Cappaoow,ravencrest,768,warlock,demonology,12,8,4
Meshekinoqua,tarren-mill,768,warlock,demonology,12,8,4
Hyöká,kazzak,768,warlock,demonology,12,8,4
Milfhaunter,aegwynn,768,warlock,demonology,12,8,4
Аскамардва,gordunni,768,warlock,demonology,12,8,4
Mingingclass,stormscale,768,warlock,demonology,12,8,4
Dispelpls,dun-morogh,768,warlock,demonology,12,8,4
Manithedøg,stormscale,768,warlock,demonology,18,8,10
Viyn,blackrock,768,warlock,demonology,18,8,10
Уанбаттон,gordunni,768,warlock,demonology,18,8,10
Jarodshadow,stormscale,768,warlock,demonology,18,8,10
Zodzinisbad,ragnaros,768,warlock,demonology,18,8,10
Holypepe,tarren-mill,768,warlock,demonology,18,8,10
Spelldweller,silvermoon,768,warlock,demonology,18,8,10
Noytan,nemesis,768,warlock,demonology,18,8,10
Melfos,blackmoore,768,warlock,demonology,18,8,10
Dryaxc,frostwolf,768,warlock,demonology,18,8,10
Djezzick,stormscale,768,warlock,demonology,18,8,10
Idkdot,ravencrest,768,warlock,demonology,18,8,10
Myuoutwo,eldrethalas,768,warlock,demonology,18,8,10
Narsok,blackrock,768,warlock,demonology,18,8,10
Nastychâtøn,ysondre,768,warlock,demonology,18,8,10
Eizon,tarren-mill,767,warlock,demonology,12,8,4
Mandafni,blackmoore,767,warlock,demonology,12,8,4
Ðelðish,draenor,767,warlock,demonology,12,8,4
Tojezlo,drakthul,767,warlock,demonology,12,8,4
Likeqtz,thrall,767,warlock,demonology,12,8,4
Sovrìn,blackrock,767,warlock,demonology,12,8,4
Véstheim,saurfang,767,warlock,demonology,12,8,4
Wildo,grim-batol,767,warlock,demonology,12,8,4
Gullars,tarren-mill,767,warlock,demonology,12,8,4
Affrighten,karazhan,767,warlock,demonology,18,8,10
Khâmélÿa,culte-de-la-rive-noire,767,warlock,demonology,18,8,10
Neg,sylvanas,767,warlock,demonology,18,8,10
Heltjettad,ravencrest,767,warlock,demonology,18,8,10
Petcan,silvermoon,767,warlock,demonology,18,8,10
Violetmyst,outland,767,warlock,demonology,18,8,10
Klaab,hyjal,767,warlock,demonology,24,8,16
Otemlock,sanguino,766,warlock,demonology,12,8,4
Lethellin,antonidas,766,warlock,demonology,12,8,4
Guccie,ravencrest,766,warlock,demonology,17,10,7
Britneyféars,emeriss,766,warlock,demonology,18,8,10
Zeddy,draenor,766,warlock,demonology,18,8,10
Merzavka,kazzak,765,warlock,demonology,12,8,4
Xydama,blackrock,764,warlock,demonology,18,8,10
Gúldn,outland,763,warlock,demonology,30,8,22
Vazelin,stormscale,762,warlock,demonology,18,8,10
Ясяшотлав,soulflayer,761,warlock,demonology,22,11,11
Thudhor,burning-legion,745,warlock,demonology,16,8,8
Dotwhat,ravencrest,719,warlock,demonology,17,8,9
Аттропа,gordunni,709,warlock,demonology,149,63,86
Graveshaker,quelthalas,704,warlock,demonology,26,8,18
Myxâ,tarren-mill,699,warlock,demonology,11,8,3
Альтдаен,borean-tundra,687,warlock,demonology,19,8,11
Fearfearfear,archimonde,672,warlock,demonology,12,7,5
Shyleen,argent-dawn,672,warlock,demonology,12,7,5
Külebra,uldum,672,warlock,demonology,12,7,5
Fierce,dethecus,672,warlock,demonology,12,7,5
Yaboywoosh,ravencrest,672,warlock,demonology,12,7,5
Whocarezlock,stormscale,672,warlock,demonology,12,7,5
Jumskerbolts,outland,672,warlock,demonology,12,7,5
Horststenzl,blackrock,672,warlock,demonology,12,7,5
Líí,burning-blade,672,warlock,demonology,12,7,5
Тыплохтымох,soulflayer,672,warlock,demonology,12,7,5
Lickyicky,twisting-nether,672,warlock,demonology,12,7,5
Zzebz,archimonde,672,warlock,demonology,12,7,5
Laoganma,outland,672,warlock,demonology,12,7,5
Racursed,outland,672,warlock,demonology,12,7,5
Cptdotalot,tarren-mill,672,warlock,demonology,12,7,5
Fullxlock,hyjal,672,warlock,demonology,12,7,5
Жасминдос,blackscar,672,warlock,demonology,12,7,5
Mürsk,draenor,672,warlock,demonology,12,7,5
Tropìcal,grim-batol,672,warlock,demonology,12,7,5
Kalemma,kazzak,672,warlock,demonology,12,7,5
Ballerlock,ravencrest,672,warlock,demonology,12,7,5
Sapheâ,burning-legion,672,warlock,demonology,12,7,5
Zagreos,tarren-mill,672,warlock,demonology,12,7,5
Bono,frostwhisper,672,warlock,demonology,12,7,5
Kosfáce,tarren-mill,672,warlock,demonology,12,7,5
Thereya,dun-morogh,672,warlock,demonology,12,7,5
Dèsaad,stormscale,672,warlock,demonology,12,7,5
Sippe,laughing-skull,672,warlock,demonology,12,7,5
Clapx,magtheridon,672,warlock,demonology,12,7,5
Immolleria,frostmane,672,warlock,demonology,12,7,5
Lucifer,burning-legion,672,warlock,demonology,12,7,5
Likilaka,draenor,672,warlock,demonology,12,7,5
Кале,goldrinn,672,warlock,demonology,12,7,5
Plague,twisting-nether,672,warlock,demonology,12,7,5
Boomloc,tarren-mill,672,warlock,demonology,12,7,5
Framelock,draenor,672,warlock,demonology,12,7,5
Pufulet,sylvanas,672,warlock,demonology,12,7,5
Noîbe,chogall,672,warlock,demonology,12,7,5
Тагочи,gordunni,672,warlock,demonology,12,7,5
Miazmii,ragnaros,672,warlock,demonology,12,7,5
Дядяджонн,gordunni,672,warlock,demonology,12,7,5
Ahollic,antonidas,672,warlock,demonology,12,7,5
Ilovebronko,blackrock,672,warlock,demonology,18,7,11
Baldazar,dun-modr,672,warlock,demonology,18,7,11
Focalorx,tarren-mill,672,warlock,demonology,18,7,11
Hakai,los-errantes,672,warlock,demonology,18,7,11
Lichlolocked,outland,672,warlock,demonology,18,7,11
Theronas,tarren-mill,672,warlock,demonology,18,7,11
Artys,tarren-mill,672,warlock,demonology,18,7,11
Андурон,galakrond,672,warlock,demonology,24,7,17
Grimskog,silvermoon,671,warlock,demonology,12,7,5
Сч,ashenvale,671,warlock,demonology,12,7,5
Kvælstof,stormscale,671,warlock,demonology,12,7,5
Gaznul,blackmoore,671,warlock,demonology,12,7,5
Прозерппина,azuregos,671,warlock,demonology,12,7,5
Адилея,howling-fjord,671,warlock,demonology,12,7,5
Clungesuck,argent-dawn,671,warlock,demonology,12,7,5
Wirbelwind,forscherliga,671,warlock,demonology,18,7,11
Indifférence,archimonde,671,warlock,demonology,18,7,11
Локистраик,borean-tundra,671,warlock,demonology,18,7,11
Pestilus,thrall,671,warlock,demonology,18,7,11
Darcol,archimonde,671,warlock,demonology,18,7,11
Манапчик,soulflayer,671,warlock,demonology,24,7,17
Cannolix,blackhand,671,warlock,demonology,24,7,17
Muninnus,archimonde,670,warlock,demonology,21,8,13
Williamford,dun-modr,669,warlock,demonology,18,7,11
Etherbit,burning-legion,669,warlock,demonology,24,7,17
Darlanis,draenor,668,warlock,demonology,12,7,5
Wedgywarlock,stormscale,668,warlock,demonology,18,7,11
Ixtap,aegwynn,667,warlock,demonology,18,7,11
Унаросс,deathguard,655,warlock,demonology,23,7,16
Kavalierr,stormscale,624,warlock,demonology,21,8,13
Kïng,elune,622,warlock,demonology,15,8,7
Warlockxx,ravencrest,607,warlock,demonology,11,7,4
Kakuzil,draenor,576,warlock,demonology,6,6,0
Sanshukar,ravencrest,576,warlock,demonology,6,6,0
Fearbót,kazzak,576,warlock,demonology,6,6,0
Freshademic,tarren-mill,576,warlock,demonology,6,6,0
Evlwizardman,kazzak,576,warlock,demonology,6,6,0
Rîñøå,blackrock,576,warlock,demonology,6,6,0
Onewarlock,kazzak,576,warlock,demonology,6,6,0
Shadowburst,outland,576,warlock,demonology,6,6,0
Labreego,aggra-português,576,warlock,demonology,6,6,0
Missdreavius,argent-dawn,576,warlock,demonology,6,6,0
Marakh,stormscale,576,warlock,demonology,6,6,0
Cleyandra,arathor,576,warlock,demonology,12,6,6
Prestige,nemesis,576,warlock,demonology,12,6,6
Gammalgubbe,stormscale,576,warlock,demonology,12,6,6
Neijihbolt,blackrock,576,warlock,demonology,12,6,6
Kartanos,stormscale,576,warlock,demonology,12,6,6
Oloki,kazzak,576,warlock,demonology,12,6,6
Deathfløw,draenor,576,warlock,demonology,12,6,6
Vekkna,hyjal,576,warlock,demonology,12,6,6
Hyóká,kazzak,576,warlock,demonology,12,6,6
Kakren,ysondre,576,warlock,demonology,12,6,6
Devour,magtheridon,576,warlock,demonology,12,6,6
Zilgen,argent-dawn,576,warlock,demonology,12,6,6
Trickslock,kazzak,576,warlock,demonology,12,6,6
Zerx,malganis,576,warlock,demonology,12,6,6
Cropper,turalyon,576,warlock,demonology,12,6,6
Advoc,ravencrest,576,warlock,demonology,12,6,6
Lockróck,silvermoon,576,warlock,demonology,12,6,6
Quanà,eredar,576,warlock,demonology,12,6,6
Rivmuu,argent-dawn,576,warlock,demonology,12,6,6
Bowti,ravencrest,576,warlock,demonology,12,6,6
Lockydotty,silvermoon,576,warlock,demonology,12,6,6
Makghal,boulderfist,576,warlock,demonology,12,6,6
Nephystø,archimonde,576,warlock,demonology,12,6,6
Coochieii,kazzak,576,warlock,demonology,12,6,6
Gruldran,khaz-modan,576,warlock,demonology,12,6,6
Médeâ,ravencrest,576,warlock,demonology,12,6,6
Dïna,silvermoon,576,warlock,demonology,12,6,6
Lêxia,shattrath,576,warlock,demonology,12,6,6
Vîmø,antonidas,576,warlock,demonology,12,6,6
Hextreme,anetheron,576,warlock,demonology,12,6,6
Zpàrta,ragnaros,576,warlock,demonology,12,6,6
Deflagrate,kazzak,576,warlock,demonology,12,6,6
Käthy,arthas,576,warlock,demonology,12,6,6
Lifedriller,drakthul,576,warlock,demonology,12,6,6
Wacamolymojo,tarren-mill,576,warlock,demonology,12,6,6
Fezk,outland,576,warlock,demonology,12,6,6
Xzensor,ravencrest,576,warlock,demonology,12,6,6
Cetreros,minahonda,576,warlock,demonology,18,6,12
Эссминет,soulflayer,576,warlock,demonology,18,6,12
Kamí,sanguino,576,warlock,demonology,18,6,12
Øbéydêmøn,silvermoon,576,warlock,demonology,18,6,12
Фэлдред,soulflayer,576,warlock,demonology,18,6,12
Diablist,kazzak,576,warlock,demonology,18,6,12
Yeatso,blackmoore,576,warlock,demonology,18,6,12
Addox,blackhand,576,warlock,demonology,18,6,12
Ftpete,argent-dawn,576,warlock,demonology,18,6,12
Скиифул,howling-fjord,576,warlock,demonology,24,6,18
Fangdred,twisting-nether,575,warlock,demonology,6,6,0
Deadleth,blackrock,575,warlock,demonology,10,7,3
Askanios,twisting-nether,575,warlock,demonology,12,6,6
Тессарет,gordunni,575,warlock,demonology,12,6,6
Zerozwolf,tarren-mill,575,warlock,demonology,17,6,11
Kropi,blackhand,575,warlock,demonology,18,6,12
Xerxia,blackrock,575,warlock,demonology,18,6,12
Heximexi,malganis,575,warlock,demonology,18,6,12
Ragedrop,malygos,574,warlock,demonology,12,6,6
Methmuncher,twisting-nether,574,warlock,demonology,24,6,18
Petrosk,sanguino,569,warlock,demonology,12,6,6
Absurdd,turalyon,568,warlock,demonology,14,9,5
Medcit,ragnaros,558,warlock,demonology,29,6,23
Кхадгард,howling-fjord,544,warlock,demonology,16,6,10
Dmonlock,hyjal,543,warlock,demonology,17,6,11
Tvmpzwl,ravencrest,527,warlock,demonology,17,6,11
Shazem,tarren-mill,522,warlock,demonology,12,7,5
Sialri,burning-legion,522,warlock,demonology,14,7,7
Fantomass,twisting-nether,522,warlock,demonology,18,8,10
Elvània,eredar,512,warlock,demonology,10,6,4
Pinacholadá,norgannon,511,warlock,demonology,8,6,2
Никошо,gordunni,511,warlock,demonology,14,6,8
Festlock,burning-legion,511,warlock,demonology,14,6,8
Hiloqtlock,blackmoore,480,warlock,demonology,6,5,1
Gulgash,blackrock,480,warlock,demonology,6,5,1
Skali,stormrage,480,warlock,demonology,6,5,1
Buccellati,emerald-dream,480,warlock,demonology,6,5,1
Askmo,hyjal,480,warlock,demonology,6,5,1
Фирвебало,soulflayer,480,warlock,demonology,6,5,1
Chaosmuncher,draenor,480,warlock,demonology,6,5,1
Belial,minahonda,480,warlock,demonology,6,5,1
Dhârc,sanguino,480,warlock,demonology,6,5,1
Mudwalkin,ravencrest,480,warlock,demonology,6,5,1
Hellsplat,tarren-mill,480,warlock,demonology,6,5,1
Vitalyk,sanguino,480,warlock,demonology,6,5,1
Morvilleur,archimonde,480,warlock,demonology,6,5,1
Joinx,tarren-mill,480,warlock,demonology,6,5,1
Disrupted,blackmoore,480,warlock,demonology,6,5,1
Helldozer,nordrassil,480,warlock,demonology,6,5,1
Saadq,draenor,480,warlock,demonology,6,5,1
Swagzz,silvermoon,480,warlock,demonology,6,5,1
Лираума,howling-fjord,480,warlock,demonology,9,6,3
Cheesefeet,ravencrest,480,warlock,demonology,9,5,4
Trembly,alakir,480,warlock,demonology,12,5,7
Gulderrf,kirin-tor,480,warlock,demonology,12,5,7
Destroc,blackrock,480,warlock,demonology,12,5,7
Cadrega,nemesis,480,warlock,demonology,12,5,7
Nécromancér,doomhammer,480,warlock,demonology,12,5,7
Gulleigh,draenor,480,warlock,demonology,12,5,7
Irnx,tarren-mill,480,warlock,demonology,12,5,7
Malédictiøns,temple-noir,480,warlock,demonology,12,5,7
Agaton,twisting-nether,480,warlock,demonology,12,5,7
Zoodaddy,grim-batol,480,warlock,demonology,12,5,7
Anturia,garona,480,warlock,demonology,12,5,7
Furchtnervt,thrall,480,warlock,demonology,12,5,7
Msßeckinsale,tarren-mill,480,warlock,demonology,12,5,7
Nicetime,nefarian,480,warlock,demonology,12,5,7
Tôpsecret,aegwynn,480,warlock,demonology,12,5,7
Landii,ragnaros,480,warlock,demonology,12,5,7
Tepelkwastje,twisting-nether,480,warlock,demonology,12,5,7
Durátor,ravencrest,480,warlock,demonology,12,5,7
Vajalock,twisting-nether,480,warlock,demonology,12,5,7
Hogheru,kazzak,480,warlock,demonology,12,5,7
Векстах,gordunni,480,warlock,demonology,12,5,7
Bluenote,colinas-pardas,480,warlock,demonology,12,5,7
Súícìdèbøy,colinas-pardas,480,warlock,demonology,12,5,7
Mulax,aegwynn,480,warlock,demonology,12,5,7
Kigro,burning-legion,480,warlock,demonology,12,5,7
Sîlverdîze,thrall,480,warlock,demonology,12,5,7
Philat,antonidas,480,warlock,demonology,12,5,7
Bartoxus,antonidas,480,warlock,demonology,12,5,7
Purepkbob,quelthalas,480,warlock,demonology,12,5,7
Дотдозор,howling-fjord,480,warlock,demonology,12,5,7
Qzkimp,hyjal,480,warlock,demonology,12,5,7
Anquietas,uldaman,480,warlock,demonology,12,5,7
Rushkush,ravencrest,480,warlock,demonology,13,5,8
Chram,uldum,480,warlock,demonology,13,5,8
Heexmex,blackmoore,480,warlock,demonology,18,5,13
Kfo,ragnaros,480,warlock,demonology,18,5,13
Brodoh,dun-modr,480,warlock,demonology,18,5,13
Vanmorgoth,nazjatar,480,warlock,demonology,18,5,13
Ascètic,kazzak,480,warlock,demonology,18,5,13
Délidumrul,stormscale,480,warlock,demonology,18,5,13
Déemón,draenor,480,warlock,demonology,18,5,13
Limfus,terokkar,479,warlock,demonology,6,5,1
Loriene,trollbane,479,warlock,demonology,6,5,1
Ezekîél,blackhand,479,warlock,demonology,6,5,1
Kedrat,die-aldor,479,warlock,demonology,6,5,1
Aluy,blackmoore,479,warlock,demonology,12,5,7
Zungha,pozzo-delleternità,479,warlock,demonology,12,5,7
Zugg,lordaeron,447,warlock,demonology,11,5,6
Mirrorz,kazzak,447,warlock,demonology,14,6,8
Feyras,turalyon,425,warlock,demonology,12,6,6
Sanas,blackhand,415,warlock,demonology,8,5,3
Broxsz,blackrock,415,warlock,demonology,8,5,3
Acology,silvermoon,384,warlock,demonology,6,4,2
Demonkïng,archimonde,384,warlock,demonology,6,4,2
Pepitogodx,khaz-modan,384,warlock,demonology,6,4,2
Sêro,aegwynn,384,warlock,demonology,6,4,2
Bualock,stormscale,384,warlock,demonology,6,4,2
Cardyw,ravencrest,384,warlock,demonology,6,4,2
Simendimen,tarren-mill,384,warlock,demonology,6,4,2
Sãociprizin,archimonde,384,warlock,demonology,6,4,2
Komet,der-rat-von-dalaran,384,warlock,demonology,6,4,2
Fabz,aggra-português,384,warlock,demonology,6,4,2
Leadix,antonidas,384,warlock,demonology,6,4,2
Keibo,drakthul,384,warlock,demonology,6,4,2
Èy,stormscale,384,warlock,demonology,6,4,2
Колмидедди,gordunni,384,warlock,demonology,6,4,2
Zarkasar,stormscale,384,warlock,demonology,6,4,2
Незерлок,soulflayer,384,warlock,demonology,6,4,2
Oz,uldum,384,warlock,demonology,6,4,2
Náwwk,blackmoore,384,warlock,demonology,6,4,2
Adoxilock,twisting-nether,384,warlock,demonology,6,4,2
Глдан,deathguard,384,warlock,demonology,6,4,2
Ronazul,blackhand,384,warlock,demonology,6,4,2
Ingwert,frostwolf,384,warlock,demonology,6,4,2
Atruruz,antonidas,384,warlock,demonology,6,4,2
Farudai,die-aldor,384,warlock,demonology,6,4,2
Xuloth,ravencrest,384,warlock,demonology,6,4,2
Spiritthief,kazzak,384,warlock,demonology,6,4,2
Imissbolt,outland,384,warlock,demonology,6,4,2
Zakuri,blackmoore,384,warlock,demonology,6,4,2
Llilithh,draenor,384,warlock,demonology,6,4,2
Empra,stormscale,384,warlock,demonology,6,4,2
Анвена,soulflayer,384,warlock,demonology,6,4,2
Nekhar,twisting-nether,384,warlock,demonology,6,4,2
Âlîce,blackmoore,384,warlock,demonology,6,4,2
Morzár,outland,384,warlock,demonology,6,4,2
Slerpmami,ragnaros,384,warlock,demonology,6,4,2
Chaoxz,outland,384,warlock,demonology,6,4,2
Suyanne,los-errantes,384,warlock,demonology,6,4,2
Roglash,eredar,384,warlock,demonology,6,4,2
Bitshlog,draenor,384,warlock,demonology,6,4,2
Aniq,eredar,384,warlock,demonology,6,4,2
Zammah,thrall,384,warlock,demonology,6,4,2
Maleficious,silvermoon,384,warlock,demonology,6,4,2
Lémonz,stormscale,384,warlock,demonology,6,4,2
Eviil,tarren-mill,384,warlock,demonology,6,4,2
Phoenixwrath,malfurion,384,warlock,demonology,6,4,2
Sep,aegwynn,384,warlock,demonology,6,4,2
Lvko,burning-legion,384,warlock,demonology,6,4,2
Артекриолок,gordunni,384,warlock,demonology,6,4,2
Itryan,elune,384,warlock,demonology,6,4,2
Mbappéstylez,aegwynn,384,warlock,demonology,6,4,2
Meningitis,tyrande,384,warlock,demonology,6,4,2
Rredington,blackmoore,384,warlock,demonology,6,4,2
Cosec,silvermoon,384,warlock,demonology,6,4,2
Mayev,garrosh,384,warlock,demonology,6,4,2
Felhaen,silvermoon,384,warlock,demonology,6,4,2
Karygan,blackmoore,384,warlock,demonology,6,4,2
Yosiya,draenor,384,warlock,demonology,6,4,2
Fearco,ravencrest,384,warlock,demonology,6,4,2
Zereff,kragjin,384,warlock,demonology,6,4,2
Flxzshort,kazzak,384,warlock,demonology,6,4,2
Walloow,stormscale,384,warlock,demonology,6,4,2
Zàkx,silvermoon,384,warlock,demonology,6,4,2
Çüñ,shattered-hand,384,warlock,demonology,6,4,2
Хэрнор,gordunni,384,warlock,demonology,6,4,2
Worstlock,executus,384,warlock,demonology,6,4,2
Holyc,blackhand,384,warlock,demonology,6,4,2
Troch,nemesis,384,warlock,demonology,6,4,2
Куськысь,gordunni,384,warlock,demonology,9,5,4
Kemuruss,kazzak,384,warlock,demonology,10,5,5
Vextos,draenor,384,warlock,demonology,12,4,8
Birimbau,outland,384,warlock,demonology,12,4,8
Fallendex,eredar,384,warlock,demonology,12,4,8
Nulo,aggra-português,384,warlock,demonology,12,4,8
Legiozock,draenor,384,warlock,demonology,12,4,8
Vickelock,stormreaver,384,warlock,demonology,12,4,8
Lagyna,wildhammer,384,warlock,demonology,12,4,8
Krútéús,perenolde,384,warlock,demonology,12,4,8
Tolgaa,draenor,384,warlock,demonology,12,4,8
Gorgôk,culte-de-la-rive-noire,384,warlock,demonology,12,4,8
Hsp,dun-modr,384,warlock,demonology,12,4,8
Branduir,ragnaros,384,warlock,demonology,12,4,8
Xvron,tarren-mill,384,warlock,demonology,12,4,8
Babayagâ,sanguino,384,warlock,demonology,12,4,8
Мастеркрс,gordunni,384,warlock,demonology,12,4,8
Бесстолоч,ashenvale,384,warlock,demonology,12,4,8
Tuz,blackrock,384,warlock,demonology,12,4,8
Tharor,forscherliga,384,warlock,demonology,15,4,11
Alucena,silvermoon,384,warlock,demonology,18,4,14
Битриксс,soulflayer,383,warlock,demonology,6,4,2
Чёрныйкнижал,eversong,383,warlock,demonology,12,4,8
Sickdotter,outland,381,warlock,demonology,12,4,8
Monroé,hellfire,367,warlock,demonology,11,4,7
Nili,dethecus,351,warlock,demonology,11,4,7
Amrafel,draenor,335,warlock,demonology,15,5,10
Darkpush,outland,330,warlock,demonology,15,6,9
Cencible,twisting-nether,330,warlock,demonology,15,5,10
Divvaa,tarren-mill,330,warlock,demonology,21,5,16
Floriae,silvermoon,329,warlock,demonology,13,5,8
Atlaon,kazzak,319,warlock,demonology,5,4,1
Shadaw,kilrogg,319,warlock,demonology,5,4,1
Zeñøñsama,blackrock,288,warlock,demonology,6,3,3
Elmîr,blackmoore,288,warlock,demonology,6,3,3
Kitchiarû,uldaman,288,warlock,demonology,6,3,3
Bigsuckergg,norgannon,288,warlock,demonology,6,3,3
Oldasian,blackrock,288,warlock,demonology,6,3,3
Afflimoomoo,tarren-mill,288,warlock,demonology,6,3,3
Cainn,kilrogg,288,warlock,demonology,6,3,3
Sofias,tarren-mill,288,warlock,demonology,6,3,3
Syrax,darkmoon-faire,288,warlock,demonology,6,3,3
Shádóws,nagrand,288,warlock,demonology,6,3,3
Alcringe,kazzak,288,warlock,demonology,6,3,3
Silås,hyjal,288,warlock,demonology,6,3,3
Zeromaker,kazzak,288,warlock,demonology,6,3,3
Halfwai,ravencrest,288,warlock,demonology,6,3,3
Danishpistol,draenor,288,warlock,demonology,6,3,3
Talindra,stormscale,288,warlock,demonology,6,3,3
Zlomozg,laughing-skull,288,warlock,demonology,6,3,3
Plocke,aegwynn,288,warlock,demonology,6,3,3
Gyroib,stormscale,288,warlock,demonology,6,3,3
Tathyanna,archimonde,288,warlock,demonology,6,3,3
Waîdo,blackhand,288,warlock,demonology,6,3,3
Holeraa,stormscale,288,warlock,demonology,6,3,3
Sánas,blackhand,288,warlock,demonology,6,3,3
Gjallarbrù,archimonde,288,warlock,demonology,6,3,3
Eredun,stormscale,288,warlock,demonology,6,3,3
Bäle,stormreaver,288,warlock,demonology,6,3,3
Ðênnis,tarren-mill,288,warlock,demonology,6,3,3
Wendetta,stormreaver,288,warlock,demonology,6,3,3
Fandesoned,archimonde,288,warlock,demonology,6,3,3
Shjzzkl,blackmoore,288,warlock,demonology,6,3,3
Wombsa,blackmoore,288,warlock,demonology,6,3,3
Лысыйлокоть,soulflayer,288,warlock,demonology,6,3,3
Meleno,die-aldor,288,warlock,demonology,6,3,3
Xenq,ravencrest,288,warlock,demonology,6,3,3
Khoug,blackmoore,288,warlock,demonology,6,3,3
Cranekickzwl,blackmoore,288,warlock,demonology,6,3,3
Angryluna,kazzak,288,warlock,demonology,6,3,3
Минимила,soulflayer,288,warlock,demonology,6,3,3
Дотботх,howling-fjord,288,warlock,demonology,6,3,3
Ноанс,howling-fjord,288,warlock,demonology,6,3,3
Sleethy,destromath,288,warlock,demonology,6,3,3
Гвадривер,howling-fjord,288,warlock,demonology,6,3,3
Аркейнмизери,howling-fjord,288,warlock,demonology,6,3,3
Hifiz,grim-batol,288,warlock,demonology,6,3,3
Pidka,drakthul,288,warlock,demonology,6,3,3
Ммчоколадка,howling-fjord,288,warlock,demonology,6,3,3
Freshplanga,kazzak,288,warlock,demonology,6,3,3
Zloezlo,ravencrest,288,warlock,demonology,6,3,3
Moelock,frostmane,288,warlock,demonology,6,3,3
Энжелз,soulflayer,288,warlock,demonology,6,3,3
Hotdogvendor,kazzak,288,warlock,demonology,6,3,3
Magonyth,tarren-mill,288,warlock,demonology,6,3,3
Mekanix,kazzak,288,warlock,demonology,6,3,3
Teemzen,tarren-mill,288,warlock,demonology,6,3,3
Born,ravencrest,288,warlock,demonology,6,3,3
Soulharvestr,silvermoon,288,warlock,demonology,6,3,3
Nieché,tarren-mill,288,warlock,demonology,6,3,3
Mattihoh,rexxar,288,warlock,demonology,6,3,3
Грязнобулькс,soulflayer,288,warlock,demonology,6,3,3
Väladar,sanguino,288,warlock,demonology,6,3,3
Angrynoob,silvermoon,288,warlock,demonology,6,3,3
Wïnärchïk,tarren-mill,288,warlock,demonology,6,3,3
Hazzikosby,ravencrest,288,warlock,demonology,6,3,3
Áiram,the-maelstrom,288,warlock,demonology,6,3,3
Miselinek,drakthul,288,warlock,demonology,6,3,3
Vladov,ravencrest,288,warlock,demonology,6,3,3
Opiumers,kazzak,288,warlock,demonology,6,3,3
Vogz,burning-legion,288,warlock,demonology,6,3,3
Zìì,silvermoon,288,warlock,demonology,6,3,3
Matheus,zenedar,288,warlock,demonology,6,3,3
Sidragasoss,drakthul,288,warlock,demonology,6,3,3
Osyx,ravencrest,288,warlock,demonology,6,3,3
Ëlzäb,ragnaros,288,warlock,demonology,6,3,3
Karädoc,chogall,288,warlock,demonology,6,3,3
Lebaa,burning-steppes,288,warlock,demonology,6,3,3
Abinsur,drakthul,288,warlock,demonology,6,3,3
Клирри,gordunni,288,warlock,demonology,6,3,3
Nineinchlock,silvermoon,288,warlock,demonology,6,3,3
Greyz,bloodfeather,288,warlock,demonology,6,3,3
Rockymarcia,dalaran,288,warlock,demonology,6,3,3
Bëllatrïx,zuljin,288,warlock,demonology,6,3,3
Hytsulock,ysondre,288,warlock,demonology,6,3,3
Filianore,azjolnerub,288,warlock,demonology,6,3,3
Warlololock,magtheridon,288,warlock,demonology,6,3,3
Feardinkum,twisting-nether,288,warlock,demonology,6,3,3
Buserella,eredar,288,warlock,demonology,6,3,3
Sorxez,thrall,288,warlock,demonology,6,3,3
Сантизи,gordunni,288,warlock,demonology,6,3,3
Bryanz,sanguino,288,warlock,demonology,6,3,3
Prayz,twisting-nether,288,warlock,demonology,6,3,3
Slytofhandio,silvermoon,288,warlock,demonology,6,3,3
Wisdomness,aszune,288,warlock,demonology,6,3,3
Smileyfacè,silvermoon,288,warlock,demonology,6,3,3
Yerslock,twisting-nether,288,warlock,demonology,6,3,3
Curzed,emerald-dream,288,warlock,demonology,6,3,3
Ronniee,moonglade,288,warlock,demonology,6,3,3
Infernion,stormscale,288,warlock,demonology,6,3,3
Рашчер,gordunni,288,warlock,demonology,6,3,3
Keelina,eredar,288,warlock,demonology,6,3,3
Groli,argent-dawn,288,warlock,demonology,9,3,6
Nopower,dun-morogh,288,warlock,demonology,9,3,6
Stromzii,silvermoon,288,warlock,demonology,12,3,9
Articfox,outland,288,warlock,demonology,12,3,9
Assaabloy,stormscale,288,warlock,demonology,12,3,9
Ønyzukral,hyjal,288,warlock,demonology,12,3,9
Clef,blackmoore,288,warlock,demonology,12,3,9
Kyyuss,burning-legion,288,warlock,demonology,12,3,9
Doomgrunt,magtheridon,288,warlock,demonology,12,3,9
Exodemon,stormscale,288,warlock,demonology,12,3,9
Kàdszèle,ragnaros,288,warlock,demonology,12,3,9
Cypresshell,blackhand,288,warlock,demonology,12,3,9
Morrgo,die-arguswacht,288,warlock,demonology,12,3,9
Scheprick,twisting-nether,288,warlock,demonology,12,3,9
Slowfatlock,ravencrest,288,warlock,demonology,12,3,9
Lykketrolle,stormscale,288,warlock,demonology,12,3,9
Surgelock,draenor,288,warlock,demonology,12,3,9
Fyxs,talnivarr,288,warlock,demonology,12,3,9
Панкмэйстер,gordunni,288,warlock,demonology,18,3,15
Hartee,argent-dawn,288,warlock,demonology,18,3,15
Shblakk,outland,288,warlock,demonology,18,3,15
Lìlitu,malfurion,287,warlock,demonology,6,3,3
Backblech,wrathbringer,287,warlock,demonology,6,3,3
Wieczek,doomhammer,287,warlock,demonology,12,3,9
Dust,argent-dawn,287,warlock,demonology,12,3,9
Utuklululu,archimonde,286,warlock,demonology,12,3,9
Hasla,stormreaver,256,warlock,demonology,10,3,7
Felrazer,silvermoon,255,warlock,demonology,11,3,8
Calypso,korgall,239,warlock,demonology,5,3,2
Ánderx,dun-modr,239,warlock,demonology,5,3,2
Sallêy,blackhand,239,warlock,demonology,5,3,2
Skizofrenia,zuljin,234,warlock,demonology,10,5,5
Vornex,sporeggar,234,warlock,demonology,9,4,5
Hokoreuw,echsenkessel,234,warlock,demonology,9,4,5
Watii,stormscale,234,warlock,demonology,10,4,6
Elyraah,hyjal,234,warlock,demonology,17,5,12
Suucc,draenor,202,warlock,demonology,12,4,8
Eichenhand,azshara,192,warlock,demonology,4,3,1
Bësly,khaz-modan,192,warlock,demonology,9,3,6
Democraft,the-maelstrom,192,warlock,demonology,6,2,4
Nècrøphila,kazzak,192,warlock,demonology,6,2,4
Badriá,blackrock,192,warlock,demonology,6,2,4
Zxò,twisting-nether,192,warlock,demonology,6,2,4
Aratani,zuljin,192,warlock,demonology,6,2,4
Anicetuslol,lightnings-blade,192,warlock,demonology,6,2,4
Luckylocked,kazzak,192,warlock,demonology,6,2,4
Кощун,goldrinn,192,warlock,demonology,6,2,4
Baradür,sanguino,192,warlock,demonology,6,2,4
Nachoodude,blackrock,192,warlock,demonology,6,2,4
Händerå,ragnaros,192,warlock,demonology,6,2,4
Shirruun,the-maelstrom,192,warlock,demonology,6,2,4
Lokelicious,ragnaros,192,warlock,demonology,6,2,4
Pablø,silvermoon,192,warlock,demonology,6,2,4
Junakot,silvermoon,192,warlock,demonology,6,2,4
Jiy,senjin,192,warlock,demonology,6,2,4
Xaros,darksorrow,192,warlock,demonology,6,2,4
Flatwolenzy,blackrock,192,warlock,demonology,6,2,4
Limec,dun-morogh,192,warlock,demonology,6,2,4
Darkdax,dethecus,192,warlock,demonology,6,2,4
Charmerx,kazzak,192,warlock,demonology,6,2,4
Àbraxàs,nemesis,192,warlock,demonology,6,2,4
Алануэйк,deathguard,192,warlock,demonology,6,2,4
Bytethisx,aggra-português,192,warlock,demonology,6,2,4
Balgo,blackmoore,192,warlock,demonology,6,2,4
Ribbed,frostmane,192,warlock,demonology,6,2,4
Fearmighty,kazzak,192,warlock,demonology,6,2,4
Bu,zirkel-des-cenarius,192,warlock,demonology,6,2,4
Бешентумай,goldrinn,192,warlock,demonology,6,2,4
Chainlinc,turalyon,192,warlock,demonology,6,2,4
Hèrmit,kazzak,192,warlock,demonology,6,2,4
Ммотаро,soulflayer,192,warlock,demonology,6,2,4
Fortheend,twisting-nether,192,warlock,demonology,6,2,4
Dondada,aggra-português,192,warlock,demonology,6,2,4
Iblis,grim-batol,192,warlock,demonology,6,2,4
Pommeslock,blackmoore,192,warlock,demonology,6,2,4
Morgainé,arygos,192,warlock,demonology,6,2,4
Andrealphus,outland,192,warlock,demonology,6,2,4
Portlock,kazzak,192,warlock,demonology,6,2,4
Скверногрик,fordragon,192,warlock,demonology,6,2,4
Mïllâïneeqtx,archimonde,192,warlock,demonology,6,2,4
Nerfwarriors,stormscale,192,warlock,demonology,6,2,4
Tàkaz,drekthar,192,warlock,demonology,6,2,4
Trimar,archimonde,192,warlock,demonology,6,2,4
Clottbott,twisting-nether,192,warlock,demonology,6,2,4
Kudde,twisting-nether,192,warlock,demonology,6,2,4
Lylean,azjolnerub,192,warlock,demonology,6,2,4
Azgaroth,kazzak,192,warlock,demonology,6,2,4
Локбезног,soulflayer,192,warlock,demonology,6,2,4
Retrosatanas,archimonde,192,warlock,demonology,6,2,4
Drith,blades-edge,192,warlock,demonology,6,2,4
Kaobolt,archimonde,192,warlock,demonology,6,2,4
Gibbio,emerald-dream,192,warlock,demonology,6,2,4
Lurwina,aegwynn,192,warlock,demonology,6,2,4
Belzébut,confrérie-du-thorium,192,warlock,demonology,6,2,4
Bennybulle,stormscale,192,warlock,demonology,6,2,4
Gtxtreme,kazzak,192,warlock,demonology,6,2,4
Xedras,aegwynn,192,warlock,demonology,6,2,4
Cali,ahnqiraj,192,warlock,demonology,6,2,4
Belzedan,blackrock,192,warlock,demonology,6,2,4
Dzeju,burning-legion,192,warlock,demonology,6,2,4
Kelthagal,burning-legion,192,warlock,demonology,6,2,4
Oldasiangirl,blackrock,192,warlock,demonology,6,2,4
Panda,aegwynn,192,warlock,demonology,6,2,4
Withered,nagrand,192,warlock,demonology,6,2,4
Surfingbirdz,ragnaros,192,warlock,demonology,6,2,4
Paintherapy,blackrock,192,warlock,demonology,6,2,4
Salvatoríy,outland,192,warlock,demonology,6,2,4
Cräwley,ragnaros,192,warlock,demonology,6,2,4
Bountyqt,outland,192,warlock,demonology,6,2,4
Sneptics,draenor,192,warlock,demonology,6,2,4
Bryanzy,dun-modr,192,warlock,demonology,6,2,4
Bigtwat,stormscale,192,warlock,demonology,6,2,4
Epoku,stormscale,192,warlock,demonology,6,2,4
Лоредо,howling-fjord,192,warlock,demonology,6,2,4
Denominos,ravencrest,192,warlock,demonology,6,2,4
Liwerno,dunemaul,192,warlock,demonology,6,2,4
Hodille,argent-dawn,192,warlock,demonology,6,2,4
Pff,emeriss,192,warlock,demonology,6,2,4
Вижут,gordunni,192,warlock,demonology,6,2,4
Jisera,kiljaeden,192,warlock,demonology,6,2,4
Vitrolizz,twilights-hammer,192,warlock,demonology,6,2,4
Happysrme,thrall,192,warlock,demonology,6,2,4
Бонони,blackscar,192,warlock,demonology,6,2,4
Ebyssian,azshara,192,warlock,demonology,6,2,4
Zyréx,eredar,192,warlock,demonology,6,2,4
Omegachad,draenor,192,warlock,demonology,6,2,4
Хэлласс,blackscar,192,warlock,demonology,6,2,4
Шеизла,borean-tundra,192,warlock,demonology,6,2,4
Mirezl,taerar,192,warlock,demonology,6,2,4
Meisterhexe,taerar,192,warlock,demonology,6,2,4
Féarléss,tarren-mill,192,warlock,demonology,6,2,4
Adoy,tarren-mill,192,warlock,demonology,6,2,4
Sweëk,blackhand,192,warlock,demonology,6,2,4
Lynnqt,sylvanas,192,warlock,demonology,6,2,4
Ohanze,antonidas,192,warlock,demonology,6,2,4
Kyyte,draenor,192,warlock,demonology,6,2,4
Sâli,draenor,192,warlock,demonology,6,2,4
Lobbo,ravencrest,192,warlock,demonology,6,2,4
Azurma,tarren-mill,192,warlock,demonology,6,2,4
Kukkojapallo,ravencrest,192,warlock,demonology,6,2,4
Fearlessgødx,ravencrest,192,warlock,demonology,6,2,4
Dotcha,ravencrest,192,warlock,demonology,6,2,4
Вериберри,gordunni,192,warlock,demonology,6,2,4
Minidiction,ravencrest,192,warlock,demonology,6,2,4
Mohihi,ravencrest,192,warlock,demonology,6,2,4
Suppedo,antonidas,192,warlock,demonology,6,2,4
Lockpup,draenor,192,warlock,demonology,6,2,4
Ekispekis,tarren-mill,192,warlock,demonology,6,2,4
Nuckki,antonidas,192,warlock,demonology,6,2,4
Jàckie,rexxar,192,warlock,demonology,6,2,4
Fatkkroth,ravencrest,192,warlock,demonology,6,2,4
Critchlock,tarren-mill,192,warlock,demonology,6,2,4
Vàng,ysondre,192,warlock,demonology,6,2,4
Necronem,thrall,192,warlock,demonology,6,2,4
Малдрацит,gordunni,192,warlock,demonology,6,2,4
Portmachine,draenor,192,warlock,demonology,12,2,10
Бестий,fordragon,192,warlock,demonology,12,2,10
Arciam,kazzak,192,warlock,demonology,12,2,10
Wòóni,ravencrest,192,warlock,demonology,12,2,10
Henriett,ravencrest,192,warlock,demonology,12,2,10
Drthc,kazzak,192,warlock,demonology,12,2,10
Saruna,azshara,192,warlock,demonology,12,2,10
Mádará,tarren-mill,192,warlock,demonology,12,2,10
Rayanna,twisting-nether,192,warlock,demonology,18,2,16
Muleerox,kazzak,159,warlock,demonology,5,2,3
Пчелокнижник,howling-fjord,144,warlock,demonology,3,3,0
Omaleinfluch,antonidas,138,warlock,demonology,9,3,6
Chaosbolts,balnazzar,138,warlock,demonology,16,3,13
Myristica,die-todeskrallen,96,warlock,demonology,3,2,1
Лёхаиммолейт,deathguard,96,warlock,demonology,6,1,5
Rrore,ravencrest,96,warlock,demonology,6,1,5
Ruvy,twisting-nether,96,warlock,demonology,6,1,5
Ашимал,soulflayer,96,warlock,demonology,6,1,5
Nethros,ragnaros,96,warlock,demonology,6,1,5
Маверрикк,gordunni,96,warlock,demonology,6,1,5
Militianu,sylvanas,96,warlock,demonology,6,1,5
Sitosa,thrall,96,warlock,demonology,6,1,5
Ðæthpäct,dalaran,96,warlock,demonology,6,1,5
Pumpfake,ravencrest,96,warlock,demonology,6,1,5
Catherine,garrosh,96,warlock,demonology,6,1,5
Chuntlock,shadowsong,96,warlock,demonology,6,1,5
Rilette,dun-morogh,96,warlock,demonology,6,1,5
Mnscrs,blackhand,96,warlock,demonology,6,1,5
Dersdog,twisting-nether,96,warlock,demonology,6,1,5
Méetoo,thrall,96,warlock,demonology,6,1,5
Zebauron,twisting-nether,96,warlock,demonology,6,1,5
Bolt,stormscale,96,warlock,demonology,6,1,5
Gnimoz,silvermoon,96,warlock,demonology,6,1,5
Messire,ragnaros,96,warlock,demonology,6,1,5
Hathatchi,sylvanas,96,warlock,demonology,6,1,5
Borgenttw,stormscale,96,warlock,demonology,6,1,5
Lockitz,kazzak,96,warlock,demonology,6,1,5
Marann,dun-morogh,96,warlock,demonology,6,1,5
Yourdeaath,ravencrest,96,warlock,demonology,6,1,5
Árkan,thrall,96,warlock,demonology,6,1,5
Томмиджонсон,gordunni,96,warlock,demonology,6,1,5
Burzak,azshara,96,warlock,demonology,6,1,5
Nastypet,culte-de-la-rive-noire,96,warlock,demonology,6,1,5
Zangul,ysondre,96,warlock,demonology,6,1,5
Аффликатор,soulflayer,96,warlock,demonology,6,1,5
Zardonixz,stormscale,96,warlock,demonology,6,1,5
Wetube,stormscale,96,warlock,demonology,6,1,5
Necroless,shadowsong,96,warlock,demonology,6,1,5
Skufi,uldum,96,warlock,demonology,6,1,5
Tid,burning-legion,96,warlock,demonology,6,1,5
Darkbazul,burning-legion,96,warlock,demonology,6,1,5
Fazol,terokkar,96,warlock,demonology,6,1,5
Ðßøhßäøùí,blackmoore,96,warlock,demonology,6,1,5
Emethia,darksorrow,96,warlock,demonology,6,1,5
Diseased,darksorrow,96,warlock,demonology,6,1,5
Sshhaaddooww,outland,96,warlock,demonology,6,1,5
Shangalar,burning-legion,96,warlock,demonology,6,1,5
Lovromalt,kazzak,96,warlock,demonology,6,1,5
Jopil,stormreaver,96,warlock,demonology,6,1,5
Däw,archimonde,96,warlock,demonology,6,1,5
Zhadok,blackmoore,96,warlock,demonology,6,1,5
Remzin,silvermoon,96,warlock,demonology,6,1,5
Márinho,aggra-português,96,warlock,demonology,6,1,5
Helikipotter,kazzak,96,warlock,demonology,6,1,5
Kàiser,sanguino,96,warlock,demonology,12,1,11
Wolramir,thrall,96,warlock,demonology,12,1,11
Tchytcha,archimonde,79,warlock,demonology,5,1,4
Waryald,dun-modr,64,warlock,demonology,4,1,3
Boccu,magtheridon,64,warlock,demonology,4,1,3
Tuchmydot,ysondre,63,warlock,demonology,2,2,0
Tequendama,ysera,42,warlock,demonology,10,3,7
Ezpeazy,eredar,42,warlock,demonology,7,2,5
Xydar,stormscale,42,warlock,demonology,10,2,8
Lollock,teldrassil,31,warlock,demonology,2,1,1
Swagdots,frostwolf,31,warlock,demonology,2,1,1
Wartix,nathrezim,31,warlock,demonology,2,1,1
Агрессивная,soulflayer,31,warlock,demonology,2,1,1
Труупыч,gordunni,31,warlock,demonology,2,1,1
Berris,argent-dawn,31,warlock,demonology,2,1,1
Hellâna,kirin-tor,31,warlock,demonology,2,1,1
Ravenmore,kazzak,16,warlock,demonology,1,1,0
Loghit,ravencrest,16,warlock,demonology,1,1,0
Lzoo,ravencrest,2467,warlock,destruction,84,65,19
Creatúre,drakthul,2446,warlock,destruction,66,53,13
Inferniøn,ravencrest,2422,warlock,destruction,93,68,25
Faermorn,kazzak,2409,warlock,destruction,170,96,74
Infý,ravencrest,2400,warlock,destruction,238,151,87
Xwíng,stormscale,2400,warlock,destruction,161,100,61
Шедон,soulflayer,2352,warlock,destruction,95,60,35
Jâzggz,twisting-nether,2351,warlock,destruction,96,64,32
Bfaexpert,ravencrest,2348,warlock,destruction,78,50,28
Фаерморн,blackscar,2345,warlock,destruction,132,83,49
Sapheâ,burning-legion,2332,warlock,destruction,89,57,32
Спаводах,soulflayer,2332,warlock,destruction,115,70,45
Tópdogg,twisting-nether,2330,warlock,destruction,96,69,27
Wotlkenjoyer,ravencrest,2327,warlock,destruction,138,87,51
Steckenpferd,blackmoore,2325,warlock,destruction,66,45,21
Cryzzbad,stormscale,2319,warlock,destruction,96,62,34
Stopdaddyplz,ravencrest,2312,warlock,destruction,101,59,42
Brokenearman,defias-brotherhood,2308,warlock,destruction,53,44,9
Zâyo,ravencrest,2305,warlock,destruction,120,74,46
Erutaerc,drakthul,2303,warlock,destruction,144,86,58
Canabolic,stormscale,2288,warlock,destruction,102,63,39
Кириланскил,gordunni,2287,warlock,destruction,130,74,56
Geluwu,tarren-mill,2284,warlock,destruction,90,52,38
Senkai,kelthuzad,2266,warlock,destruction,72,50,22
Indraxx,hyjal,2266,warlock,destruction,110,60,50
Shârîngan,kazzak,2257,warlock,destruction,246,145,101
Bualock,stormscale,2257,warlock,destruction,95,54,41
Блакхен,blackscar,2257,warlock,destruction,84,47,37
Acentro,stormscale,2246,warlock,destruction,83,50,33
Zélroth,argent-dawn,2245,warlock,destruction,229,131,98
Боуман,howling-fjord,2243,warlock,destruction,96,56,40
Шархихохо,gordunni,2242,warlock,destruction,123,68,55
Боуманн,howling-fjord,2240,warlock,destruction,141,76,65
Tjl,kazzak,2239,warlock,destruction,239,135,104
Youngtyrant,blackrock,2238,warlock,destruction,96,53,43
Кериген,gordunni,2238,warlock,destruction,101,54,47
Xeremas,blackrock,2237,warlock,destruction,83,62,21
Lopari,aegwynn,2236,warlock,destruction,118,70,48
Panda,aegwynn,2225,warlock,destruction,89,50,39
Фримех,soulflayer,2221,warlock,destruction,95,68,27
Тагочи,gordunni,2221,warlock,destruction,279,147,132
Smoudini,blackrock,2216,warlock,destruction,102,56,46
Lyâ,ravencrest,2211,warlock,destruction,114,62,52
Rootzlx,ravencrest,2208,warlock,destruction,140,81,59
Anihli,kazzak,2205,warlock,destruction,383,203,180
Dæhli,argent-dawn,2204,warlock,destruction,102,56,46
Glooness,burning-legion,2203,warlock,destruction,84,47,37
Veganlifter,ravencrest,2201,warlock,destruction,60,44,16
Sharhý,kazzak,2200,warlock,destruction,94,54,40
Bóbtown,stormscale,2200,warlock,destruction,474,255,219
Laokoon,blackmoore,2199,warlock,destruction,126,83,43
Zila,sylvanas,2199,warlock,destruction,119,63,56
Deezbolts,kazzak,2191,warlock,destruction,101,54,47
Motcha,kazzak,2189,warlock,destruction,84,46,38
Amdead,sylvanas,2186,warlock,destruction,120,80,40
Ánderxyo,dun-modr,2185,warlock,destruction,54,40,14
Snapperz,stormscale,2184,warlock,destruction,162,87,75
Isodjdojk,ravencrest,2183,warlock,destruction,77,55,22
Ethiq,blackrock,2179,warlock,destruction,66,39,27
Legionlockxd,twisting-nether,2179,warlock,destruction,124,68,56
Absurdity,twisting-nether,2179,warlock,destruction,143,73,70
Azurma,tarren-mill,2178,warlock,destruction,107,60,47
Varaxxis,twisting-nether,2174,warlock,destruction,174,98,76
Боумонн,howling-fjord,2173,warlock,destruction,120,73,47
Ilovemimi,hyjal,2173,warlock,destruction,71,40,31
Sterlock,sylvanas,2171,warlock,destruction,139,73,66
Hladankurac,twisting-nether,2170,warlock,destruction,82,46,36
Kerídiin,twisting-nether,2170,warlock,destruction,161,90,71
Chaosbolt,kelthuzad,2169,warlock,destruction,78,47,31
Fsandtwo,ravencrest,2165,warlock,destruction,155,93,62
Twork,tarren-mill,2164,warlock,destruction,90,47,43
Aritrosyo,ravencrest,2163,warlock,destruction,48,35,13
Armellixd,dun-modr,2163,warlock,destruction,92,50,42
Xerxeus,drakthul,2162,warlock,destruction,72,50,22
Tierzxc,ravencrest,2162,warlock,destruction,99,58,41
Kaeb,archimonde,2160,warlock,destruction,78,45,33
Mekanix,kazzak,2160,warlock,destruction,107,61,46
Handicapped,burning-legion,2158,warlock,destruction,78,47,31
Portlock,kazzak,2158,warlock,destruction,226,122,104
Kuckacocucka,outland,2156,warlock,destruction,113,70,43
Gloon,burning-legion,2155,warlock,destruction,120,64,56
Jadesud,archimonde,2154,warlock,destruction,72,48,24
Zèlêph,archimonde,2154,warlock,destruction,192,120,72
Рашчер,gordunni,2153,warlock,destruction,119,68,51
Pepitogodx,khaz-modan,2151,warlock,destruction,132,85,47
Johanan,ravencrest,2148,warlock,destruction,53,35,18
Oarz,blackrock,2148,warlock,destruction,116,67,49
Yúnalesca,aegwynn,2147,warlock,destruction,149,90,59
Ìpen,bloodfeather,2146,warlock,destruction,95,54,41
Avenueat,kazzak,2145,warlock,destruction,81,43,38
Tekrowdy,blackmoore,2144,warlock,destruction,48,33,15
Soulboltx,ragnaros,2144,warlock,destruction,84,46,38
Koisk,tarren-mill,2142,warlock,destruction,82,47,35
Kresyda,dun-modr,2141,warlock,destruction,101,57,44
Lolbadx,ravencrest,2139,warlock,destruction,72,49,23
Cigarrette,draenor,2139,warlock,destruction,90,50,40
Umbraz,blackmoore,2139,warlock,destruction,203,107,96
Lhestér,outland,2138,warlock,destruction,130,73,57
Соргосор,gordunni,2137,warlock,destruction,146,81,65
Veganlifter,blackhand,2136,warlock,destruction,72,45,27
Рауваскх,howling-fjord,2136,warlock,destruction,65,35,30
Sehk,stormreaver,2134,warlock,destruction,72,47,25
Tàkaz,drekthar,2134,warlock,destruction,137,84,53
Dogdrakex,tarren-mill,2133,warlock,destruction,81,47,34
Lockisbadx,draenor,2132,warlock,destruction,72,43,29
Rexløck,nozdormu,2132,warlock,destruction,227,133,94
Fixwarlock,blackmoore,2132,warlock,destruction,77,44,33
Эвилакс,gordunni,2131,warlock,destruction,78,50,28
Flyingjakob,argent-dawn,2131,warlock,destruction,131,70,61
Keids,silvermoon,2129,warlock,destruction,36,32,4
Fyxs,talnivarr,2129,warlock,destruction,60,42,18
Valthorion,arthas,2129,warlock,destruction,90,50,40
Ty,earthen-ring,2128,warlock,destruction,152,97,55
Bambkin,twisting-nether,2128,warlock,destruction,179,105,74
Yùna,frostwolf,2128,warlock,destruction,206,112,94
Egiriefo,twisting-nether,2126,warlock,destruction,90,47,43
Xfz,stormscale,2126,warlock,destruction,120,62,58
Rohyna,archimonde,2125,warlock,destruction,66,48,18
Balding,blackhand,2124,warlock,destruction,60,37,23
Kalwyn,stormscale,2123,warlock,destruction,54,39,15
Milkywarlock,twisting-nether,2121,warlock,destruction,101,59,42
Ranath,ragnaros,2120,warlock,destruction,108,69,39
Nògg,frostwhisper,2120,warlock,destruction,66,42,24
Vîmø,antonidas,2120,warlock,destruction,203,123,80
Válýrá,blackhand,2119,warlock,destruction,83,53,30
Arfdispo,hyjal,2119,warlock,destruction,227,118,109
Ñila,ravencrest,2118,warlock,destruction,63,38,25
Boumbye,ysondre,2118,warlock,destruction,74,44,30
Артисона,gordunni,2118,warlock,destruction,89,47,42
Bónz,outland,2118,warlock,destruction,98,50,48
Dayken,silvermoon,2117,warlock,destruction,63,44,19
Reznör,archimonde,2117,warlock,destruction,54,34,20
Arbusxp,norgannon,2116,warlock,destruction,102,61,41
Ñøêssä,outland,2116,warlock,destruction,96,57,39
Nyiks,blackhand,2116,warlock,destruction,100,57,43
Madridistaß,outland,2116,warlock,destruction,299,155,144
Onekxz,blackrock,2115,warlock,destruction,56,45,11
Шархилол,gordunni,2115,warlock,destruction,59,37,22
Djmcwarlock,kazzak,2115,warlock,destruction,68,40,28
Brødo,dun-modr,2115,warlock,destruction,129,72,57
Guciflipflop,twisting-nether,2115,warlock,destruction,192,104,88
Lywov,stormscale,2115,warlock,destruction,132,66,66
Мспечень,howling-fjord,2112,warlock,destruction,72,46,26
Achluophobiå,ravencrest,2112,warlock,destruction,117,70,47
Abuu,ravencrest,2112,warlock,destruction,72,43,29
Xtasyslock,archimonde,2111,warlock,destruction,72,45,27
Bluefungirl,stormscale,2111,warlock,destruction,120,73,47
Гивмисоул,soulflayer,2111,warlock,destruction,88,52,36
Whakkx,blackrock,2111,warlock,destruction,114,66,48
Gruggenbach,twisting-nether,2110,warlock,destruction,72,41,31
Hasábqtja,ragnaros,2109,warlock,destruction,71,43,28
Ñia,ravencrest,2109,warlock,destruction,65,38,27
Михасяпевпев,gordunni,2109,warlock,destruction,96,54,42
Drdoit,blackrock,2109,warlock,destruction,84,46,38
Fiddyp,kazzak,2108,warlock,destruction,60,43,17
Силорий,howling-fjord,2108,warlock,destruction,85,54,31
Metaslave,sunstrider,2107,warlock,destruction,71,49,22
Vregor,twisting-nether,2106,warlock,destruction,54,38,16
Инферналках,gordunni,2106,warlock,destruction,71,48,23
Deadpapi,outland,2106,warlock,destruction,131,82,49
Bankstair,stormscale,2105,warlock,destruction,66,44,22
Drainsouls,stormscale,2105,warlock,destruction,189,105,84
Daubi,ravencrest,2104,warlock,destruction,78,44,34
Skillførçé,kazzak,2102,warlock,destruction,54,41,13
Bk,alexstrasza,2102,warlock,destruction,65,46,19
Tôpsecret,aegwynn,2102,warlock,destruction,65,44,21
Мишастрах,gordunni,2102,warlock,destruction,78,52,26
Héffer,outland,2102,warlock,destruction,145,94,51
Wldot,ravencrest,2102,warlock,destruction,84,53,31
Humpers,kazzak,2102,warlock,destruction,103,59,44
Wester,blackmoore,2102,warlock,destruction,108,61,47
Rumour,sunstrider,2102,warlock,destruction,84,45,39
Артик,gordunni,2101,warlock,destruction,48,37,11
Kamoriwl,blackhand,2101,warlock,destruction,78,45,33
Haedache,tarren-mill,2101,warlock,destruction,143,80,63
Nògg,kazzak,2101,warlock,destruction,113,57,56
Påsqúåls,ravencrest,2100,warlock,destruction,108,63,45
Nëismz,hyjal,2100,warlock,destruction,66,37,29
Deßra,stormscale,2100,warlock,destruction,90,50,40
Ez,emeriss,2097,warlock,destruction,67,50,17
Gorillabolts,tarren-mill,2096,warlock,destruction,150,74,76
Omegazero,zuluhed,2095,warlock,destruction,131,74,57
Телола,gordunni,2095,warlock,destruction,168,93,75
Boltilicious,kazzak,2094,warlock,destruction,180,96,84
Healylockx,stormscale,2085,warlock,destruction,66,40,26
Kasualdot,stormscale,2083,warlock,destruction,90,49,41
Inflicts,frostmane,2079,warlock,destruction,101,54,47
Felcamino,outland,2077,warlock,destruction,78,40,38
Dabzw,twisting-nether,2075,warlock,destruction,67,43,24
Noobgg,kazzak,2073,warlock,destruction,180,107,73
Nyotu,antonidas,2072,warlock,destruction,203,112,91
Блейдап,razuvious,2069,warlock,destruction,78,43,35
Anniefuchsia,ravencrest,2069,warlock,destruction,167,89,78
Alphazero,zuluhed,2069,warlock,destruction,255,133,122
Зеленаямразь,soulflayer,2069,warlock,destruction,184,91,93
Bualock,sylvanas,2068,warlock,destruction,66,33,33
Паилка,galakrond,2067,warlock,destruction,175,94,81
Whatamellown,aegwynn,2064,warlock,destruction,66,40,26
Fearbîtch,ravencrest,2064,warlock,destruction,102,61,41
Айхопъюдай,blackscar,2062,warlock,destruction,58,35,23
Epzi,outland,2062,warlock,destruction,65,38,27
Bewegen,frostwolf,2061,warlock,destruction,90,50,40
Gregwyn,hellscream,2060,warlock,destruction,89,53,36
Djwarlock,kazzak,2060,warlock,destruction,130,68,62
Rmpfarmer,kazzak,2057,warlock,destruction,42,27,15
Ashmodéus,defias-brotherhood,2057,warlock,destruction,82,45,37
Malddog,turalyon,2056,warlock,destruction,126,72,54
Bóbtownjr,ravencrest,2056,warlock,destruction,78,41,37
Shadowrey,blackrock,2056,warlock,destruction,80,42,38
Bryanzy,dun-modr,2055,warlock,destruction,65,41,24
Vileclass,ravencrest,2055,warlock,destruction,146,79,67
Tharaqt,kazzak,2054,warlock,destruction,76,45,31
Avogeiñ,tarren-mill,2053,warlock,destruction,93,47,46
Простишутках,gordunni,2051,warlock,destruction,48,30,18
Asáel,blackrock,2051,warlock,destruction,108,62,46
Жасминдос,blackscar,2050,warlock,destruction,69,45,24
Rhüd,twisting-nether,2050,warlock,destruction,95,54,41
Velv,nagrand,2050,warlock,destruction,166,81,85
Кобре,howling-fjord,2048,warlock,destruction,90,52,38
Halfwai,ravencrest,2047,warlock,destruction,78,52,26
Kimkold,twisting-nether,2047,warlock,destruction,137,65,72
Císuh,stormreaver,2046,warlock,destruction,145,79,66
Энжелз,soulflayer,2046,warlock,destruction,107,51,56
Salvabolter,outland,2045,warlock,destruction,160,91,69
Icéspícé,ravencrest,2045,warlock,destruction,66,33,33
Zilalol,sylvanas,2042,warlock,destruction,384,195,189
Karygan,blackmoore,2041,warlock,destruction,95,58,37
Xxjz,ravencrest,2041,warlock,destruction,168,92,76
Fearoclock,nemesis,2040,warlock,destruction,174,96,78
Dersdog,twisting-nether,2039,warlock,destruction,80,42,38
Malgarøth,tarren-mill,2039,warlock,destruction,95,46,49
Kwoleriker,norgannon,2038,warlock,destruction,76,43,33
Jazggzkekw,twisting-nether,2037,warlock,destruction,48,35,13
Kaldrik,burning-legion,2037,warlock,destruction,114,71,43
Necorinexx,silvermoon,2035,warlock,destruction,48,27,21
Bäle,stormreaver,2035,warlock,destruction,130,71,59
Kawanoski,kazzak,2034,warlock,destruction,77,49,28
Someonepro,tarren-mill,2034,warlock,destruction,191,97,94
Araqt,thrall,2033,warlock,destruction,83,51,32
Jazggzkxx,twisting-nether,2033,warlock,destruction,59,36,23
Alxor,archimonde,2033,warlock,destruction,156,91,65
Chaosbuster,magtheridon,2033,warlock,destruction,203,115,88
Nayolana,argent-dawn,2033,warlock,destruction,111,60,51
Voldby,kazzak,2032,warlock,destruction,328,164,164
Djdampening,bloodhoof,2031,warlock,destruction,190,111,79
Shadöwmäre,draenor,2030,warlock,destruction,90,50,40
Sjödin,tarren-mill,2029,warlock,destruction,42,30,12
Necromanya,ravencrest,2029,warlock,destruction,192,108,84
Ниезвестнно,soulflayer,2028,warlock,destruction,65,36,29
Онлидемон,gordunni,2028,warlock,destruction,159,84,75
Тьмазвёздная,gordunni,2027,warlock,destruction,108,71,37
Châmp,stormscale,2027,warlock,destruction,73,40,33
Freezme,tarren-mill,2026,warlock,destruction,90,55,35
Buâlock,stormscale,2025,warlock,destruction,54,35,19
Simony,ravencrest,2024,warlock,destruction,66,41,25
Brodoh,dun-modr,2024,warlock,destruction,58,31,27
Tuplajekku,sylvanas,2024,warlock,destruction,130,63,67
Onuurbro,kult-der-verdammten,2023,warlock,destruction,78,49,29
Pørtal,aggra-português,2022,warlock,destruction,155,82,73
Chromosomex,dentarg,2021,warlock,destruction,90,54,36
Vvj,ravencrest,2021,warlock,destruction,230,120,110
Kumamoto,tarren-mill,2020,warlock,destruction,72,44,28
Nospamcliqu,ysondre,2020,warlock,destruction,83,47,36
Кюратор,howling-fjord,2019,warlock,destruction,111,63,48
Bigbolt,arathor,2017,warlock,destruction,113,61,52
Brainac,blackrock,2016,warlock,destruction,60,37,23
Daeyon,ravencrest,2016,warlock,destruction,68,37,31
Jïñ,ravencrest,2015,warlock,destruction,63,47,16
Miauwu,stormscale,2015,warlock,destruction,53,38,15
Rockbèll,blackmoore,2014,warlock,destruction,66,44,22
Dótstuff,draenor,2014,warlock,destruction,54,36,18
Laedreth,argent-dawn,2013,warlock,destruction,304,160,144
Хастла,ashenvale,2012,warlock,destruction,114,64,50
Boltzer,archimonde,2008,warlock,destruction,155,88,67
Chromagnus,drakthul,2008,warlock,destruction,90,50,40
Простишуткаь,gordunni,2007,warlock,destruction,30,21,9
Gymenjoyer,ravencrest,2006,warlock,destruction,126,75,51
Stankaemayne,blackhand,2005,warlock,destruction,96,51,45
Bedep,sanguino,2004,warlock,destruction,54,29,25
Блудгэнг,blackscar,2000,warlock,destruction,108,68,40
Rêctûmsêêkêr,ravencrest,1999,warlock,destruction,114,60,54
Габана,gordunni,1998,warlock,destruction,60,38,22
Kitchiarû,uldaman,1998,warlock,destruction,60,35,25
Mxdojsrvqxzq,ravencrest,1998,warlock,destruction,385,199,186
Gøzù,antonidas,1998,warlock,destruction,72,37,35
Dsï,outland,1997,warlock,destruction,131,64,67
Veridy,kazzak,1996,warlock,destruction,154,87,67
Ðiavel,kazzak,1996,warlock,destruction,143,78,65
Ripnsew,ravencrest,1994,warlock,destruction,77,49,28
Øßey,magtheridon,1994,warlock,destruction,96,51,45
Фейкгодх,soulflayer,1994,warlock,destruction,102,53,49
Exephia,laughing-skull,1991,warlock,destruction,84,40,44
Klnr,ravencrest,1990,warlock,destruction,134,79,55
Upsahl,twisting-nether,1988,warlock,destruction,153,86,67
Anthraxus,argent-dawn,1988,warlock,destruction,84,43,41
Obrusik,burning-legion,1987,warlock,destruction,155,76,79
Gødprotøtýpe,ragnaros,1985,warlock,destruction,65,34,31
Kärme,archimonde,1984,warlock,destruction,78,49,29
Logicdotexé,tarren-mill,1983,warlock,destruction,67,42,25
Nyriat,tarren-mill,1982,warlock,destruction,90,60,30
Файрусх,soulflayer,1981,warlock,destruction,76,41,35
Luccifer,ravencrest,1979,warlock,destruction,54,34,20
Andrewdaniel,twisting-nether,1979,warlock,destruction,72,39,33
Sqx,veklor,1978,warlock,destruction,60,39,21
Blazed,dentarg,1978,warlock,destruction,60,36,24
Beebs,aegwynn,1977,warlock,destruction,58,40,18
Abdulrahim,archimonde,1976,warlock,destruction,36,23,13
Mýlìfêbélike,kazzak,1975,warlock,destruction,46,32,14
Fearo,kazzak,1975,warlock,destruction,172,94,78
Hotdoghomie,tarren-mill,1974,warlock,destruction,36,28,8
Gnargamehl,nemesis,1973,warlock,destruction,66,39,27
Laciewaifu,silvermoon,1973,warlock,destruction,73,41,32
Horststenzl,blackrock,1973,warlock,destruction,72,36,36
Nazw,ravencrest,1972,warlock,destruction,77,47,30
Ryûsuke,dun-modr,1972,warlock,destruction,119,65,54
Failtráin,blackhand,1972,warlock,destruction,65,35,30
Zarisya,blackmoore,1972,warlock,destruction,108,58,50
Kelthedral,tarren-mill,1972,warlock,destruction,232,119,113
Тевон,gordunni,1971,warlock,destruction,117,70,47
Fercon,kazzak,1971,warlock,destruction,104,59,45
Tarilinwelli,les-sentinelles,1970,warlock,destruction,46,42,4
Sëngir,drakthul,1970,warlock,destruction,414,208,206
Sgaitxd,ravencrest,1969,warlock,destruction,48,27,21
Feardotbye,stormscale,1969,warlock,destruction,72,40,32
Чудастрх,azuregos,1969,warlock,destruction,156,81,75
Lifetapped,tarren-mill,1968,warlock,destruction,89,48,41
Взорг,soulflayer,1968,warlock,destruction,189,100,89
Èmøgøðqt,ravencrest,1968,warlock,destruction,66,33,33
Pôhzz,archimonde,1967,warlock,destruction,48,34,14
Garlan,dun-modr,1967,warlock,destruction,352,186,166
Infernion,stormscale,1966,warlock,destruction,45,30,15
Exhäle,archimonde,1966,warlock,destruction,59,37,22
Acilock,outland,1966,warlock,destruction,68,42,26
Aniq,eredar,1965,warlock,destruction,72,37,35
Superlocken,ragnaros,1964,warlock,destruction,95,47,48
Èlton,tarren-mill,1963,warlock,destruction,273,150,123
Korbendallas,anubarak,1963,warlock,destruction,75,41,34
Drowlý,twisting-nether,1962,warlock,destruction,149,77,72
Theronas,tarren-mill,1961,warlock,destruction,66,39,27
Ragdoll,twisting-nether,1960,warlock,destruction,70,40,30
Andtheysay,outland,1960,warlock,destruction,284,156,128
Southyx,stormscale,1960,warlock,destruction,84,46,38
Biest,drakthul,1959,warlock,destruction,121,64,57
Gulwer,blackmoore,1959,warlock,destruction,90,46,44
Lémonz,stormscale,1958,warlock,destruction,64,33,31
Angst,tarren-mill,1957,warlock,destruction,66,43,23
Taon,ravencrest,1957,warlock,destruction,90,52,38
Adacheezzee,tyrande,1957,warlock,destruction,140,80,60
Osîrîs,aegwynn,1957,warlock,destruction,131,64,67
Gigoberto,kazzak,1956,warlock,destruction,38,24,14
Rune,aegwynn,1956,warlock,destruction,154,87,67
Габаныч,soulflayer,1955,warlock,destruction,69,45,24
Wällaar,ragnaros,1955,warlock,destruction,197,106,91
Бжк,gordunni,1955,warlock,destruction,359,192,167
Smaúg,archimonde,1955,warlock,destruction,325,165,160
Сумракк,gordunni,1954,warlock,destruction,66,35,31
Syviwl,outland,1954,warlock,destruction,77,37,40
Hømïcîðæl,ravencrest,1953,warlock,destruction,72,45,27
Isco,ysondre,1953,warlock,destruction,42,26,16
Ashlÿn,draenor,1952,warlock,destruction,47,31,16
Nekrofille,outland,1952,warlock,destruction,60,30,30
Howtofake,doomhammer,1951,warlock,destruction,99,51,48
Laolife,twisting-nether,1951,warlock,destruction,132,67,65
Hopéléss,aggra-português,1950,warlock,destruction,42,31,11
Ilbidello,nemesis,1950,warlock,destruction,60,40,20
Xesh,kiljaeden,1950,warlock,destruction,276,140,136
Bryanz,sanguino,1950,warlock,destruction,146,72,74
Laoganma,outland,1949,warlock,destruction,48,34,14
Tschapatalpi,blackhand,1947,warlock,destruction,70,35,35
Delru,aegwynn,1945,warlock,destruction,60,38,22
Plocke,aegwynn,1944,warlock,destruction,42,25,17
Jaimstar,ravencrest,1943,warlock,destruction,47,31,16
Vitus,malganis,1943,warlock,destruction,288,151,137
Nightìngale,silvermoon,1943,warlock,destruction,97,50,47
Сильвиос,howling-fjord,1943,warlock,destruction,100,49,51
Sarthrax,argent-dawn,1942,warlock,destruction,120,70,50
Corbbolt,drakthul,1942,warlock,destruction,114,60,54
Hebbxw,kazzak,1941,warlock,destruction,176,101,75
Gogmorok,dunemaul,1941,warlock,destruction,341,173,168
Cappaoww,ravencrest,1940,warlock,destruction,48,35,13
Freddaxd,outland,1940,warlock,destruction,93,56,37
Lsr,argent-dawn,1939,warlock,destruction,83,48,35
Bløødwins,burning-legion,1938,warlock,destruction,71,44,27
Badloljk,stormscale,1938,warlock,destruction,82,49,33
Giñtama,ravencrest,1936,warlock,destruction,30,24,6
Suprezz,sylvanas,1936,warlock,destruction,78,45,33
Кенгарь,howling-fjord,1936,warlock,destruction,153,80,73
Hlÿ,kazzak,1936,warlock,destruction,144,67,77
Mohihi,ravencrest,1934,warlock,destruction,84,42,42
Løckwood,blackrock,1933,warlock,destruction,52,32,20
Gilfhaunter,malganis,1932,warlock,destruction,30,23,7
Ruvy,twisting-nether,1932,warlock,destruction,63,37,26
Envizer,ravencrest,1931,warlock,destruction,48,30,18
Voidstim,stormscale,1931,warlock,destruction,147,77,70
Tikondrus,ravencrest,1930,warlock,destruction,96,53,43
Ayperos,tyrande,1930,warlock,destruction,108,59,49
Ðeface,nefarian,1929,warlock,destruction,144,79,65
Shadowbolt,outland,1929,warlock,destruction,45,21,24
Kayloo,archimonde,1928,warlock,destruction,78,48,30
Staenkymayne,blackhand,1927,warlock,destruction,28,21,7
Fornaio,nemesis,1927,warlock,destruction,36,24,12
Блэклаш,soulflayer,1927,warlock,destruction,54,30,24
Ulora,zirkel-des-cenarius,1927,warlock,destruction,113,62,51
Doturanal,blackmoore,1927,warlock,destruction,108,57,51
Wäisted,ravencrest,1926,warlock,destruction,72,39,33
Xiraq,nathrezim,1925,warlock,destruction,96,51,45
Macchíato,ragnaros,1925,warlock,destruction,84,44,40
Deathfløw,draenor,1923,warlock,destruction,156,94,62
Davyjonessx,twisting-nether,1923,warlock,destruction,158,75,83
Fredé,kazzak,1923,warlock,destruction,77,36,41
Sad,lightnings-blade,1920,warlock,destruction,132,76,56
Sakkrethxd,hyjal,1919,warlock,destruction,47,32,15
Acanthis,outland,1919,warlock,destruction,96,47,49
Imbalockzwei,aegwynn,1918,warlock,destruction,60,42,18
Pinacholadá,norgannon,1918,warlock,destruction,144,77,67
Brokengodx,dun-modr,1917,warlock,destruction,220,121,99
Jøkèr,stormscale,1916,warlock,destruction,36,23,13
Kalagorn,azshara,1916,warlock,destruction,60,35,25
Anyfears,outland,1916,warlock,destruction,65,36,29
Stefcheto,twilights-hammer,1916,warlock,destruction,221,114,107
Blakstorm,archimonde,1915,warlock,destruction,60,35,25
Decimus,darkspear,1914,warlock,destruction,156,87,69
Makîø,hyjal,1914,warlock,destruction,208,105,103
Shadewl,draenor,1913,warlock,destruction,94,59,35
Rénio,stormrage,1913,warlock,destruction,68,41,27
Malame,hyjal,1912,warlock,destruction,286,154,132
Aajora,malganis,1911,warlock,destruction,136,87,49
Wlistoohard,stormscale,1911,warlock,destruction,279,147,132
Drututt,the-maelstrom,1910,warlock,destruction,54,30,24
Kiros,ravencrest,1909,warlock,destruction,73,44,29
Senbolts,tarren-mill,1909,warlock,destruction,66,39,27
Drerlord,tarren-mill,1908,warlock,destruction,130,74,56
Raxan,stormscale,1907,warlock,destruction,107,58,49
Xunzu,drakthul,1907,warlock,destruction,126,61,65
Jopil,stormreaver,1907,warlock,destruction,93,44,49
Artys,tarren-mill,1906,warlock,destruction,54,36,18
Cørpse,burning-legion,1905,warlock,destruction,88,61,27
Carelock,chamber-of-aspects,1905,warlock,destruction,66,39,27
Raepist,terokkar,1905,warlock,destruction,78,46,32
Debbskidjur,tarren-mill,1905,warlock,destruction,97,57,40
Bladey,ragnaros,1905,warlock,destruction,297,157,140
Isuckwarlock,aegwynn,1904,warlock,destruction,90,42,48
Precogdiet,draenor,1903,warlock,destruction,36,28,8
Xarfoul,grim-batol,1903,warlock,destruction,54,36,18
Southylolz,stormscale,1902,warlock,destruction,54,32,22
Ignittes,ragnaros,1901,warlock,destruction,84,56,28
Nunomendes,archimonde,1901,warlock,destruction,60,37,23
Kaijim,aegwynn,1901,warlock,destruction,314,180,134
Nineinchlock,silvermoon,1900,warlock,destruction,72,33,39
Drtwoit,blackrock,1898,warlock,destruction,30,20,10
Osbaa,bladefist,1898,warlock,destruction,65,41,24
Якурюимнепох,gordunni,1898,warlock,destruction,261,140,121
Felerok,drakthul,1897,warlock,destruction,48,30,18
Файрик,blackscar,1897,warlock,destruction,42,26,16
Инсинирейтх,gordunni,1896,warlock,destruction,66,40,26
Benne,stormscale,1896,warlock,destruction,108,60,48
Kaktakto,ravencrest,1895,warlock,destruction,54,30,24
Easybolt,blackrock,1895,warlock,destruction,110,55,55
Fedpikkefar,kazzak,1895,warlock,destruction,84,41,43
Djfearfullx,archimonde,1893,warlock,destruction,123,71,52
Magonyth,ravencrest,1893,warlock,destruction,340,174,166
Tehkorrum,archimonde,1893,warlock,destruction,88,42,46
Extingul,tarren-mill,1892,warlock,destruction,77,48,29
Nádjá,ravencrest,1891,warlock,destruction,30,20,10
Thebigsuck,tarren-mill,1891,warlock,destruction,180,103,77
Meepx,nordrassil,1890,warlock,destruction,36,20,16
Dualla,aegwynn,1890,warlock,destruction,182,101,81
Ánderx,dun-modr,1890,warlock,destruction,60,32,28
Minicielle,ravencrest,1889,warlock,destruction,78,42,36
Ecoxx,aegwynn,1888,warlock,destruction,66,42,24
Mallevs,outland,1888,warlock,destruction,169,97,72
Juhpz,blackrock,1888,warlock,destruction,52,24,28
Djfearbot,kazzak,1887,warlock,destruction,84,53,31
Juppi,blackrock,1887,warlock,destruction,198,114,84
Klmlover,tarren-mill,1885,warlock,destruction,48,30,18
Dotg,blackrock,1885,warlock,destruction,54,30,24
Whøîäm,kazzak,1883,warlock,destruction,42,31,11
Hânex,ravencrest,1883,warlock,destruction,48,28,20
Doomdog,hyjal,1882,warlock,destruction,36,25,11
Wimbii,outland,1882,warlock,destruction,30,20,10
Zelieknight,ysondre,1881,warlock,destruction,598,310,288
Кишмякхб,gordunni,1880,warlock,destruction,112,54,58
Меззаморта,gordunni,1879,warlock,destruction,24,20,4
Redshíne,hyjal,1879,warlock,destruction,84,47,37
Visceris,ravencrest,1879,warlock,destruction,108,51,57
Whisperer,defias-brotherhood,1879,warlock,destruction,112,52,60
Baked,outland,1878,warlock,destruction,48,31,17
Öbsury,hyjal,1878,warlock,destruction,113,64,49
Rabasta,blackmoore,1878,warlock,destruction,71,36,35
Shangalar,burning-legion,1877,warlock,destruction,126,66,60
Шрэкс,blackscar,1876,warlock,destruction,56,30,26
Eboyclass,twisting-nether,1875,warlock,destruction,33,23,10
Killua,kazzak,1875,warlock,destruction,65,44,21
Fîgøk,conseil-des-ombres,1874,warlock,destruction,156,86,70
Halaïa,outland,1872,warlock,destruction,52,34,18
Magonyth,tarren-mill,1872,warlock,destruction,84,54,30
Ðènnis,tarren-mill,1870,warlock,destruction,42,28,14
Ditàà,archimonde,1870,warlock,destruction,77,49,28
Gis,laughing-skull,1870,warlock,destruction,107,56,51
Worse,kazzak,1869,warlock,destruction,54,32,22
Eltharis,burning-legion,1869,warlock,destruction,127,69,58
Dooms,antonidas,1868,warlock,destruction,42,31,11
Jamb,bloodfeather,1867,warlock,destruction,42,27,15
Traicklock,eredar,1867,warlock,destruction,58,32,26
Аоепампгодх,howling-fjord,1866,warlock,destruction,82,58,24
Tokodi,ragnaros,1866,warlock,destruction,84,46,38
Sinofbum,stormscale,1865,warlock,destruction,42,30,12
Petitcayou,archimonde,1865,warlock,destruction,52,28,24
Kikeri,blackhand,1865,warlock,destruction,90,48,42
Empra,stormscale,1864,warlock,destruction,60,31,29
Rokkarn,kazzak,1863,warlock,destruction,48,29,19
Ispankmysuc,korgall,1863,warlock,destruction,87,52,35
Колодун,gordunni,1863,warlock,destruction,60,35,25
Temnamagna,silvermoon,1863,warlock,destruction,207,111,96
Sizexl,silvermoon,1862,warlock,destruction,42,30,12
Pandacoffee,ravencrest,1861,warlock,destruction,131,76,55
Supergeîl,blackrock,1860,warlock,destruction,120,60,60
Trainindummy,ravencrest,1859,warlock,destruction,128,85,43
Phoyk,blackmoore,1859,warlock,destruction,48,29,19
Rustos,ravencrest,1859,warlock,destruction,123,72,51
Slipx,aegwynn,1859,warlock,destruction,94,53,41
Muleerox,kazzak,1859,warlock,destruction,78,41,37
Flatwolenzy,blackrock,1858,warlock,destruction,54,34,20
Havocgodxx,stormscale,1858,warlock,destruction,54,30,24
Demonälskare,kazzak,1857,warlock,destruction,48,31,17
Fullxlock,hyjal,1857,warlock,destruction,58,35,23
Âpocalypto,blackrock,1857,warlock,destruction,61,35,26
Kavalierr,stormscale,1857,warlock,destruction,169,89,80
Lecig,tarren-mill,1856,warlock,destruction,30,23,7
Sushilock,stormrage,1856,warlock,destruction,96,62,34
Mowxll,blackrock,1856,warlock,destruction,36,22,14
Holiax,archimonde,1856,warlock,destruction,48,29,19
Bréézéé,twisting-nether,1856,warlock,destruction,113,63,50
Cmdxo,malganis,1856,warlock,destruction,71,38,33
Salvatoríy,outland,1856,warlock,destruction,65,32,33
Shlipshlap,ravencrest,1855,warlock,destruction,71,43,28
Reeween,argent-dawn,1855,warlock,destruction,132,76,56
Igneutz,twisting-nether,1854,warlock,destruction,42,26,16
Bono,frostwhisper,1854,warlock,destruction,121,73,48
Habdruck,blackmoore,1854,warlock,destruction,427,232,195
Boltez,twisting-nether,1854,warlock,destruction,66,35,31
Darksoll,hyjal,1853,warlock,destruction,41,31,10
Plaguee,outland,1853,warlock,destruction,98,56,42
Gharloch,argent-dawn,1853,warlock,destruction,81,46,35
Uddze,pozzo-delleternità,1853,warlock,destruction,167,88,79
Nëismz,ravencrest,1852,warlock,destruction,43,27,16
Chaoscrit,eredar,1852,warlock,destruction,177,94,83
Блэкфлэймх,gordunni,1852,warlock,destruction,70,33,37
Märkähuikka,stormreaver,1851,warlock,destruction,60,38,22
Элси,howling-fjord,1851,warlock,destruction,48,28,20
Fakegodx,ravencrest,1851,warlock,destruction,65,35,30
Anabolicbaby,draenor,1850,warlock,destruction,36,26,10
Johnylock,draenor,1850,warlock,destruction,116,71,45
Tentigo,blackmoore,1850,warlock,destruction,90,45,45
Depressedkid,ravencrest,1850,warlock,destruction,60,30,30
Corano,ravencrest,1849,warlock,destruction,42,28,14
Bwc,aegwynn,1849,warlock,destruction,78,49,29
Alphå,blackmoore,1849,warlock,destruction,78,48,30
Satyrilian,tarren-mill,1849,warlock,destruction,71,42,29
Çamille,ulduar,1849,warlock,destruction,115,64,51
Artannas,elune,1848,warlock,destruction,55,35,20
Hellíc,kazzak,1848,warlock,destruction,54,30,24
Руктал,howling-fjord,1847,warlock,destruction,54,34,20
Marti,blackrock,1847,warlock,destruction,72,45,27
Watchmecutt,terenas,1847,warlock,destruction,54,31,23
Bailerlock,antonidas,1847,warlock,destruction,60,28,32
Fizzydark,malganis,1846,warlock,destruction,84,39,45
Cetreros,minahonda,1845,warlock,destruction,54,34,20
Бауглирх,howling-fjord,1845,warlock,destruction,167,88,79
Giantape,argent-dawn,1844,warlock,destruction,66,43,23
Finsterfluch,conseil-des-ombres,1844,warlock,destruction,86,53,33
Junakot,silvermoon,1844,warlock,destruction,114,60,54
Jupp,blackrock,1843,warlock,destruction,142,77,65
Hifiz,grim-batol,1842,warlock,destruction,36,25,11
Imforcedtowl,aegwynn,1842,warlock,destruction,48,32,16
Enragelock,tarren-mill,1842,warlock,destruction,119,76,43
Collectiòn,kazzak,1842,warlock,destruction,36,22,14
Хихихи,blackscar,1842,warlock,destruction,78,43,35
Looneytoonz,blackrock,1842,warlock,destruction,96,52,44
Pöhz,archimonde,1841,warlock,destruction,96,45,51
Mércé,stormscale,1840,warlock,destruction,36,26,10
Lasuch,burning-legion,1840,warlock,destruction,135,77,58
Badapow,stormscale,1840,warlock,destruction,50,26,24
Mafteryo,blackrock,1840,warlock,destruction,114,58,56
Attilergg,stormscale,1839,warlock,destruction,32,23,9
Richerdgir,ravencrest,1839,warlock,destruction,105,57,48
Immaginare,sylvanas,1839,warlock,destruction,294,155,139
Fluxlight,frostmourne,1838,warlock,destruction,42,22,20
Shadock,scarshield-legion,1836,warlock,destruction,102,59,43
Hachishaku,ravencrest,1836,warlock,destruction,165,93,72
Märtas,burning-blade,1836,warlock,destruction,143,79,64
Vøid,hellscream,1836,warlock,destruction,131,62,69
Bobop,sanguino,1834,warlock,destruction,106,60,46
Invoke,burning-blade,1834,warlock,destruction,54,30,24
Кром,howling-fjord,1834,warlock,destruction,48,26,22
Brainwashed,the-maelstrom,1834,warlock,destruction,205,110,95
Entropyboost,stormscale,1834,warlock,destruction,138,73,65
Secretx,kazzak,1833,warlock,destruction,42,24,18
Akumako,stormscale,1833,warlock,destruction,59,32,27
Spookytouch,draenor,1833,warlock,destruction,106,52,54
Asyncbuddy,azjolnerub,1832,warlock,destruction,48,32,16
Oldasianman,blackrock,1832,warlock,destruction,30,20,10
Chaosxd,outland,1832,warlock,destruction,58,37,21
Homerbamboom,hyjal,1832,warlock,destruction,77,49,28
Kiwibob,defias-brotherhood,1832,warlock,destruction,65,41,24
Skarløck,blackmoore,1832,warlock,destruction,42,26,16
Calli,blackrock,1832,warlock,destruction,52,32,20
Akechy,dun-modr,1832,warlock,destruction,124,76,48
Фирбог,soulflayer,1832,warlock,destruction,84,43,41
Fulcanelli,sargeras,1831,warlock,destruction,63,35,28
Ashh,ravencrest,1831,warlock,destruction,48,26,22
Aestheatic,draenor,1831,warlock,destruction,311,158,153
Wreky,thrall,1830,warlock,destruction,36,26,10
Dübêl,gorgonnash,1830,warlock,destruction,54,35,19
Worgonzolâ,madmortem,1830,warlock,destruction,221,134,87
Алистрен,fordragon,1830,warlock,destruction,179,99,80
Nekrosd,tarren-mill,1830,warlock,destruction,215,111,104
Teezeye,ragnaros,1830,warlock,destruction,118,59,59
Tõyz,twilights-hammer,1829,warlock,destruction,45,34,11
Veríty,kazzak,1829,warlock,destruction,30,20,10
Evlwizardman,kazzak,1829,warlock,destruction,50,32,18
Manhart,burning-legion,1829,warlock,destruction,70,40,30
Salouppio,archimonde,1829,warlock,destruction,88,48,40
Ganjubass,tarren-mill,1829,warlock,destruction,260,139,121
Helldoom,drakthul,1829,warlock,destruction,265,133,132
Ícekíss,hyjal,1828,warlock,destruction,48,33,15
Pprwl,tarren-mill,1828,warlock,destruction,126,77,49
Latia,argent-dawn,1828,warlock,destruction,46,28,18
Sheitana,ysondre,1828,warlock,destruction,78,47,31
Urururustyle,hyjal,1828,warlock,destruction,102,58,44
Zàkx,silvermoon,1828,warlock,destruction,361,190,171
Kmeta,twilights-hammer,1828,warlock,destruction,138,62,76
Хэлмок,howling-fjord,1827,warlock,destruction,42,31,11
Стоишьвфире,gordunni,1827,warlock,destruction,54,29,25
Idonthexafck,kazzak,1826,warlock,destruction,36,27,9
Spectarlock,tarren-mill,1826,warlock,destruction,78,43,35
Delen,ravencrest,1826,warlock,destruction,58,28,30
Oldefar,ravencrest,1825,warlock,destruction,48,30,18
Happsõr,eredar,1825,warlock,destruction,54,32,22
Oggelock,tarren-mill,1825,warlock,destruction,79,45,34
Wewondak,drakthul,1825,warlock,destruction,214,120,94
Büm,kazzak,1825,warlock,destruction,132,70,62
Juanwick,grim-batol,1824,warlock,destruction,43,33,10
Asilock,eredar,1824,warlock,destruction,48,32,16
Анрали,deathguard,1824,warlock,destruction,42,27,15
Ìambottger,silvermoon,1824,warlock,destruction,48,30,18
Zoodíac,blackrock,1824,warlock,destruction,69,42,27
Limity,nozdormu,1823,warlock,destruction,90,54,36
Coeurnichon,archimonde,1823,warlock,destruction,58,32,26
Spcnz,stormscale,1823,warlock,destruction,144,78,66
Sololock,ravencrest,1822,warlock,destruction,106,63,43
Jjejo,ragnaros,1822,warlock,destruction,100,59,41
Røiheenøk,archimonde,1822,warlock,destruction,156,80,76
Кварий,howling-fjord,1822,warlock,destruction,318,160,158
Кале,goldrinn,1821,warlock,destruction,136,87,49
Killáksi,ravencrest,1821,warlock,destruction,42,26,16
Atmosfèar,silvermoon,1821,warlock,destruction,66,37,29
Atraped,zuljin,1821,warlock,destruction,392,211,181
Likeqtz,thrall,1821,warlock,destruction,80,43,37
Hellfire,haomarush,1821,warlock,destruction,86,46,40
Stepwarlock,kazzak,1821,warlock,destruction,81,42,39
Adellaragg,draenor,1820,warlock,destruction,45,33,12
Korupcijax,kazzak,1820,warlock,destruction,36,21,15
Hauntit,chogall,1820,warlock,destruction,36,21,15
Merçedesa,tarren-mill,1820,warlock,destruction,35,20,15
Ghachi,draenor,1820,warlock,destruction,180,90,90
Trashløckx,blackrock,1819,warlock,destruction,42,30,12
Mocha,ravencrest,1819,warlock,destruction,48,31,17
Incesticide,ragnaros,1819,warlock,destruction,60,37,23
Lyaru,blackrock,1819,warlock,destruction,44,25,19
Ôlo,rajaxx,1819,warlock,destruction,54,30,24
Исверон,howling-fjord,1819,warlock,destruction,78,41,37
Fearing,malganis,1819,warlock,destruction,101,51,50
Rozibolt,draenor,1818,warlock,destruction,48,33,15
Lichlolock,outland,1818,warlock,destruction,96,60,36
Selassie,blackmoore,1818,warlock,destruction,78,48,30
Лешабетон,gordunni,1818,warlock,destruction,34,20,14
Shánx,hyjal,1818,warlock,destruction,66,38,28
Nqa,outland,1818,warlock,destruction,47,26,21
Ziigouigouii,archimonde,1817,warlock,destruction,42,28,14
Lylean,azjolnerub,1817,warlock,destruction,90,59,31
Лёхаиммолейт,deathguard,1817,warlock,destruction,54,30,24
Verson,silvermoon,1817,warlock,destruction,125,69,56
Srkzlol,durotan,1817,warlock,destruction,66,35,31
Fondudelock,hyjal,1817,warlock,destruction,48,25,23
Влицотьмой,gordunni,1817,warlock,destruction,84,42,42
Nëismz,azuremyst,1816,warlock,destruction,36,25,11
Unethicalx,ragnaros,1816,warlock,destruction,113,65,48
Alcringe,kazzak,1816,warlock,destruction,158,90,68
Porchpirate,draenor,1816,warlock,destruction,72,41,31
Аймох,gordunni,1816,warlock,destruction,54,30,24
Yukokotier,archimonde,1816,warlock,destruction,323,172,151
Matsuei,tarren-mill,1816,warlock,destruction,48,23,25
Aldiac,aegwynn,1815,warlock,destruction,36,25,11
Barneyboi,tarren-mill,1815,warlock,destruction,87,59,28
Louloudots,ragnaros,1815,warlock,destruction,36,22,14
Kartanos,stormscale,1815,warlock,destruction,63,34,29
Magicsin,aerie-peak,1814,warlock,destruction,36,31,5
Jappér,silvermoon,1814,warlock,destruction,36,30,6
Olsel,draenor,1814,warlock,destruction,47,30,17
Nemwl,draenor,1814,warlock,destruction,66,31,35
Framelock,draenor,1813,warlock,destruction,53,39,14
Coilxo,ravencrest,1813,warlock,destruction,58,37,21
Doodle,the-maelstrom,1813,warlock,destruction,66,38,28
Tbs,blackhand,1813,warlock,destruction,54,25,29
Slytherim,stormscale,1812,warlock,destruction,87,57,30
Sinthax,aegwynn,1812,warlock,destruction,126,74,52
Osbaa,ravencrest,1812,warlock,destruction,116,62,54
Majalea,antonidas,1811,warlock,destruction,30,23,7
Overwl,kazzak,1811,warlock,destruction,42,32,10
Fiearstyle,tarren-mill,1811,warlock,destruction,36,26,10
Linuviel,argent-dawn,1811,warlock,destruction,41,29,12
Kennÿfõx,ysondre,1811,warlock,destruction,29,20,9
Коломо,soulflayer,1811,warlock,destruction,51,35,16
Zàk,twisting-nether,1811,warlock,destruction,121,77,44
Krestox,blackmoore,1811,warlock,destruction,100,60,40
Паинбрингер,soulflayer,1811,warlock,destruction,96,54,42
Trooverx,ravencrest,1810,warlock,destruction,59,40,19
Mxxmmllm,kargath,1810,warlock,destruction,125,71,54
Todesgurke,alleria,1810,warlock,destruction,60,34,26
Melydor,ragnaros,1810,warlock,destruction,111,62,49
Fearbeachx,ravencrest,1810,warlock,destruction,54,30,24
Diablist,kazzak,1810,warlock,destruction,142,77,65
Хйу,galakrond,1810,warlock,destruction,60,26,34
Boterham,kilrogg,1809,warlock,destruction,54,38,16
Issyl,kazzak,1809,warlock,destruction,64,38,26
Cujo,draenor,1809,warlock,destruction,354,173,181
Pederpan,stormscale,1808,warlock,destruction,30,19,11
Skrana,kazzak,1808,warlock,destruction,83,48,35
Чупачупакаб,soulflayer,1808,warlock,destruction,59,34,25
Darkleci,archimonde,1808,warlock,destruction,60,34,26
Рипхард,soulflayer,1808,warlock,destruction,62,35,27
Haltros,stormscale,1808,warlock,destruction,48,26,22
Грэтиэн,howling-fjord,1808,warlock,destruction,369,197,172
Purexlock,dragonblight,1807,warlock,destruction,53,34,19
Catchlock,tarren-mill,1807,warlock,destruction,42,26,16
Hydrôlîc,blackrock,1807,warlock,destruction,60,34,26
Exorbïtant,blackrock,1807,warlock,destruction,312,167,145
Rhyakun,draenor,1806,warlock,destruction,51,33,18
Ahuicommem,hyjal,1806,warlock,destruction,55,33,22
Kakapo,archimonde,1806,warlock,destruction,65,38,27
Guldån,twisting-nether,1806,warlock,destruction,48,28,20
Abbzey,tarren-mill,1806,warlock,destruction,132,70,62
Rûttna,kazzak,1806,warlock,destruction,53,27,26
Ðemonsoul,stormscale,1806,warlock,destruction,566,284,282
Pumpelumpe,twisting-nether,1806,warlock,destruction,45,20,25
Yøshinø,wildhammer,1805,warlock,destruction,48,36,12
Rünek,tarren-mill,1805,warlock,destruction,42,29,13
Lockchonk,kazzak,1805,warlock,destruction,84,52,32
Rivmuu,argent-dawn,1805,warlock,destruction,130,78,52
Belial,minahonda,1805,warlock,destruction,75,41,34
Nellyvato,eredar,1805,warlock,destruction,184,89,95
Tanón,sanguino,1804,warlock,destruction,87,57,30
Sïeur,archimonde,1804,warlock,destruction,113,69,44
Shortíì,thrall,1804,warlock,destruction,48,26,22
Demojun,silvermoon,1804,warlock,destruction,282,150,132
Pinacoládaqt,stormscale,1804,warlock,destruction,59,31,28
Letmecast,sylvanas,1803,warlock,destruction,36,22,14
Plâytïmè,stormscale,1803,warlock,destruction,126,61,65
Måracujå,kazzak,1802,warlock,destruction,24,19,5
Nerdlockx,tarren-mill,1802,warlock,destruction,47,31,16
Loel,blackrock,1802,warlock,destruction,36,23,13
Pornhubx,stormscale,1802,warlock,destruction,48,30,18
Pilock,stormscale,1802,warlock,destruction,36,22,14
Zekarat,blackrock,1802,warlock,destruction,129,70,59
Britneÿ,stormscale,1802,warlock,destruction,60,29,31
Morcey,sylvanas,1801,warlock,destruction,79,49,30
Tuskawl,stormreaver,1800,warlock,destruction,36,22,14
Plsbuffme,ravencrest,1800,warlock,destruction,77,47,30
Моргоника,howling-fjord,1800,warlock,destruction,121,65,56
Tenkem,dun-modr,1800,warlock,destruction,129,69,60
Mirenli,kazzak,1800,warlock,destruction,36,19,17
Twisted,malganis,1800,warlock,destruction,132,69,63
Sluba,stormscale,1800,warlock,destruction,127,66,61
Lashyra,aszune,1800,warlock,destruction,48,24,24
Variu,blackhand,1799,warlock,destruction,206,118,88
Mosslock,silvermoon,1798,warlock,destruction,30,19,11
Gigachaos,outland,1798,warlock,destruction,197,115,82
Anomen,sanguino,1797,warlock,destruction,141,74,67
Fastkíll,silvermoon,1796,warlock,destruction,24,21,3
Qaripidia,ravencrest,1796,warlock,destruction,55,29,26
Mirah,ragnaros,1795,warlock,destruction,95,60,35
Djhanzó,outland,1795,warlock,destruction,57,30,27
Høliax,archimonde,1792,warlock,destruction,54,36,18
Thaidakar,thrall,1792,warlock,destruction,84,52,32
Bàbyløck,archimonde,1792,warlock,destruction,78,44,34
Wÿvërnn,archimonde,1792,warlock,destruction,181,98,83
Médeâ,ravencrest,1792,warlock,destruction,88,47,41
Robertóó,burning-legion,1792,warlock,destruction,64,34,30
Saffíe,ravencrest,1791,warlock,destruction,124,65,59
Bianchii,stormscale,1790,warlock,destruction,38,27,11
Autocannon,stormscale,1790,warlock,destruction,66,36,30
Gogonash,ravencrest,1790,warlock,destruction,76,36,40
Limoges,archimonde,1789,warlock,destruction,59,33,26
Ðæthpäct,dalaran,1789,warlock,destruction,100,49,51
Brodir,aszune,1788,warlock,destruction,102,56,46
Boccebelle,pozzo-delleternità,1787,warlock,destruction,36,21,15
Fiddlestickz,gilneas,1787,warlock,destruction,107,58,49
Britnèyfears,twisting-nether,1787,warlock,destruction,48,25,23
Демоник,deathguard,1787,warlock,destruction,97,50,47
Whøknøws,twisting-nether,1786,warlock,destruction,36,25,11
Flayør,ravencrest,1786,warlock,destruction,42,23,19
Kalaslars,draenor,1786,warlock,destruction,90,47,43
Precogbtw,ravencrest,1786,warlock,destruction,71,36,35
Aænn,blackrock,1785,warlock,destruction,66,41,25
Ërîkå,ravencrest,1785,warlock,destruction,99,59,40
Квейдсан,howling-fjord,1785,warlock,destruction,42,21,21
Hepheisto,blackmoore,1785,warlock,destruction,55,27,28
Destinyz,dun-modr,1784,warlock,destruction,60,40,20
Keybump,outland,1784,warlock,destruction,146,83,63
Dreggsow,blackmoore,1784,warlock,destruction,122,69,53
Veratus,dun-modr,1784,warlock,destruction,90,50,40
Slf,the-maelstrom,1784,warlock,destruction,66,32,34
Sznyes,ragnaros,1783,warlock,destruction,42,23,19
Gusvitori,sanguino,1783,warlock,destruction,54,29,25
Mangolicious,twisting-nether,1783,warlock,destruction,230,112,118
Harefrøken,ravencrest,1782,warlock,destruction,24,19,5
Féarléss,tarren-mill,1782,warlock,destruction,46,28,18
Ftpete,argent-dawn,1782,warlock,destruction,403,209,194
Knoxwhite,stormscale,1781,warlock,destruction,42,28,14
Mikthelock,nemesis,1780,warlock,destruction,77,44,33
Славеномен,howling-fjord,1779,warlock,destruction,333,178,155
Htaedfo,tarren-mill,1779,warlock,destruction,226,114,112
Deadlyrust,ragnaros,1778,warlock,destruction,177,84,93
Чернокок,blackscar,1777,warlock,destruction,90,41,49
Thorolock,blackhand,1776,warlock,destruction,78,42,36
Kerway,outland,1776,warlock,destruction,126,67,59
Kurono,silvermoon,1776,warlock,destruction,90,43,47
Cwz,ysondre,1775,warlock,destruction,26,20,6
Slerpmami,ragnaros,1775,warlock,destruction,32,21,11
Themut,draenor,1775,warlock,destruction,82,49,33
Justfamous,archimonde,1773,warlock,destruction,66,43,23
Vultzbolt,draenor,1773,warlock,destruction,165,93,72
Ràzek,kazzak,1773,warlock,destruction,239,121,118
Tajit,eredar,1773,warlock,destruction,66,32,34
Crse,antonidas,1772,warlock,destruction,79,52,27
Fiveyearque,sylvanas,1772,warlock,destruction,64,36,28
Gravemxney,tarren-mill,1772,warlock,destruction,42,22,20
Dimmybyrger,stormreaver,1772,warlock,destruction,39,20,19
Ffpiiras,dunemaul,1771,warlock,destruction,156,76,80
Простшутка,gordunni,1770,warlock,destruction,30,23,7
Reidonk,blackrock,1770,warlock,destruction,36,21,15
Demoner,tarren-mill,1769,warlock,destruction,156,90,66
Murdee,kazzak,1769,warlock,destruction,65,29,36
Ondarian,grim-batol,1768,warlock,destruction,56,37,19
Bloodworth,arathor,1768,warlock,destruction,227,119,108
Bigpoodleman,twisting-nether,1767,warlock,destruction,30,22,8
Supermaus,blackrock,1767,warlock,destruction,42,25,17
Vimb,archimonde,1767,warlock,destruction,87,47,40
Онлифан,soulflayer,1765,warlock,destruction,64,40,24
Freshademic,tarren-mill,1764,warlock,destruction,30,20,10
Micheller,ravencrest,1764,warlock,destruction,66,38,28
Histeria,tarren-mill,1764,warlock,destruction,69,38,31
Lonestar,sanguino,1764,warlock,destruction,60,24,36
Cobràk,stormscale,1763,warlock,destruction,30,23,7
Olympïe,archimonde,1763,warlock,destruction,70,44,26
Damnedhaze,stormscale,1763,warlock,destruction,169,83,86
Bufflockspls,outland,1762,warlock,destruction,114,65,49
Lockróck,silvermoon,1761,warlock,destruction,36,23,13
Pumpfake,ravencrest,1761,warlock,destruction,47,27,20
Mignetto,nemesis,1761,warlock,destruction,108,61,47
Cräwley,ragnaros,1761,warlock,destruction,84,41,43
Palihatschi,eredar,1761,warlock,destruction,95,41,54
Warlockoloco,blackmoore,1760,warlock,destruction,202,113,89
Telodotto,nemesis,1760,warlock,destruction,42,23,19
Kronesx,tarren-mill,1759,warlock,destruction,52,23,29
Nerfbolts,archimonde,1758,warlock,destruction,36,25,11
Zenii,nemesis,1758,warlock,destruction,30,20,10
Lokmonji,perenolde,1758,warlock,destruction,87,50,37
Curzed,emerald-dream,1757,warlock,destruction,80,47,33
Zeñøñsama,blackrock,1757,warlock,destruction,54,26,28
Dràghel,grim-batol,1756,warlock,destruction,36,21,15
Kivilock,dun-modr,1756,warlock,destruction,113,63,50
Trîppîn,blackrock,1756,warlock,destruction,60,32,28
Dotshok,aegwynn,1755,warlock,destruction,120,63,57
Nutyx,twisting-nether,1755,warlock,destruction,111,58,53
Оброссыш,gordunni,1755,warlock,destruction,54,28,26
Anthh,doomhammer,1754,warlock,destruction,30,20,10
Marador,drakthul,1754,warlock,destruction,107,54,53
Rackare,darksorrow,1753,warlock,destruction,118,72,46
Бонибеннет,gordunni,1753,warlock,destruction,92,51,41
Nijva,silvermoon,1753,warlock,destruction,178,91,87
Zuldanius,stormscale,1753,warlock,destruction,90,46,44
Dualipa,arathor,1751,warlock,destruction,36,25,11
Voukserys,tarren-mill,1751,warlock,destruction,48,32,16
Datty,grim-batol,1751,warlock,destruction,36,24,12
Orgebixx,blackmoore,1751,warlock,destruction,102,55,47
Shadowcaller,sylvanas,1751,warlock,destruction,63,30,33
Tseva,aggra-português,1751,warlock,destruction,90,42,48
Iolxdd,ravencrest,1750,warlock,destruction,181,97,84
Delumia,tarren-mill,1749,warlock,destruction,153,82,71
Sunjal,stormscale,1748,warlock,destruction,42,26,16
Жизньтлён,gordunni,1748,warlock,destruction,126,69,57
Gödisdëäd,sanguino,1748,warlock,destruction,36,19,17
Enyras,nemesis,1748,warlock,destruction,54,27,27
Sxtynine,outland,1747,warlock,destruction,84,51,33
Døtàndrun,archimonde,1747,warlock,destruction,66,39,27
Neirah,stormscale,1747,warlock,destruction,83,45,38
Шекигами,gordunni,1747,warlock,destruction,54,28,26
Rúbs,sylvanas,1747,warlock,destruction,168,83,85
Steelock,kazzak,1746,warlock,destruction,51,30,21
Trâsto,cthun,1746,warlock,destruction,52,28,24
Kìnvaras,tarren-mill,1745,warlock,destruction,55,33,22
Belastiz,blackmoore,1745,warlock,destruction,108,61,47
Hamskurken,silvermoon,1744,warlock,destruction,58,33,25
Silmerion,twilights-hammer,1744,warlock,destruction,138,75,63
Gorthunz,kazzak,1744,warlock,destruction,95,40,55
Fatburner,draenor,1743,warlock,destruction,48,28,20
Aljohno,twisting-nether,1743,warlock,destruction,111,58,53
Boltonez,outland,1743,warlock,destruction,189,96,93
Dslap,grim-batol,1742,warlock,destruction,42,25,17
Mephaisto,kelthuzad,1742,warlock,destruction,66,36,30
Noskillfox,outland,1741,warlock,destruction,31,23,8
Дасведули,deepholm,1741,warlock,destruction,136,80,56
Бриант,gordunni,1740,warlock,destruction,42,24,18
Sargus,drakthul,1740,warlock,destruction,227,111,116
Maderto,burning-legion,1739,warlock,destruction,203,107,96
Gacknur,zuljin,1739,warlock,destruction,54,26,28
Acrion,blackrock,1738,warlock,destruction,45,22,23
Neburlock,dun-modr,1738,warlock,destruction,72,35,37
Царьдарк,soulflayer,1737,warlock,destruction,48,26,22
Rotangel,ragnaros,1737,warlock,destruction,72,37,35
Raverboyy,blackrock,1737,warlock,destruction,162,80,82
Bubalock,kazzak,1737,warlock,destruction,78,36,42
Maikus,stormscale,1736,warlock,destruction,143,82,61
Desimp,drakthul,1736,warlock,destruction,84,47,37
Сумракз,soulflayer,1736,warlock,destruction,36,19,17
Локдлячепухи,soulflayer,1735,warlock,destruction,46,30,16
Domdon,stormscale,1735,warlock,destruction,119,64,55
Starlok,nemesis,1735,warlock,destruction,47,25,22
Watchdots,blackrock,1735,warlock,destruction,84,43,41
Dwoorf,ravencrest,1735,warlock,destruction,47,24,23
Voidzero,hyjal,1735,warlock,destruction,53,26,27
Nantu,stormscale,1735,warlock,destruction,78,38,40
Fêâr,dun-modr,1734,warlock,destruction,40,28,12
Chaosborn,ravencrest,1734,warlock,destruction,60,29,31
Oz,uldum,1733,warlock,destruction,116,74,42
Règis,antonidas,1733,warlock,destruction,39,23,16
Fearbót,kazzak,1733,warlock,destruction,90,49,41
Fløkee,blackmoore,1733,warlock,destruction,42,21,21
Десло,thermaplugg,1731,warlock,destruction,42,25,17
Razek,eredar,1731,warlock,destruction,71,33,38
Rensayy,ysondre,1730,warlock,destruction,36,25,11
Asbest,blackrock,1730,warlock,destruction,82,42,40
Greenpeas,blackrock,1729,warlock,destruction,48,22,26
Wintheirl,argent-dawn,1728,warlock,destruction,176,93,83
Fogboi,tarren-mill,1728,warlock,destruction,78,40,38
Jûgøbænned,aegwynn,1727,warlock,destruction,45,33,12
Jørdanna,blackrock,1727,warlock,destruction,72,40,32
Skrikipanik,kazzak,1727,warlock,destruction,54,30,24
Börsenborisq,aegwynn,1727,warlock,destruction,89,48,41
Sanshukar,ravencrest,1726,warlock,destruction,24,18,6
Miseryfull,archimonde,1725,warlock,destruction,141,84,57
Whiteðevil,draenor,1725,warlock,destruction,42,24,18
Ceu,tarren-mill,1724,warlock,destruction,135,72,63
Conditions,tarren-mill,1724,warlock,destruction,588,287,301
Kozaras,tarren-mill,1723,warlock,destruction,36,23,13
Äåäåäåäåäåäå,ravencrest,1723,warlock,destruction,30,18,12
Scherzinger,archimonde,1722,warlock,destruction,30,18,12
Fearu,kazzak,1722,warlock,destruction,54,32,22
Verixdots,antonidas,1722,warlock,destruction,104,61,43
Shufflous,ghostlands,1722,warlock,destruction,40,23,17
Denasty,nemesis,1721,warlock,destruction,68,40,28
Teiser,nemesis,1721,warlock,destruction,36,18,18
Jawoxoxo,rexxar,1721,warlock,destruction,60,21,39
Авенюат,gordunni,1720,warlock,destruction,24,18,6
Killerbolt,blackmoore,1720,warlock,destruction,42,28,14
Requeims,outland,1720,warlock,destruction,40,24,16
Адоха,howling-fjord,1720,warlock,destruction,163,91,72
Warlockery,argent-dawn,1720,warlock,destruction,90,50,40
Лордандрюха,soulflayer,1719,warlock,destruction,36,23,13
Ламэ,gordunni,1719,warlock,destruction,126,70,56
Tessalizz,aegwynn,1718,warlock,destruction,30,21,9
Fizybubbele,malganis,1718,warlock,destruction,30,18,12
Bellicus,tarren-mill,1718,warlock,destruction,77,45,32
Веномхх,lich-king,1717,warlock,destruction,36,24,12
Contemtus,frostwhisper,1717,warlock,destruction,80,46,34
Päwzy,kazzak,1716,warlock,destruction,94,54,40
Scallington,shattered-hand,1715,warlock,destruction,48,24,24
Fearfearfear,archimonde,1715,warlock,destruction,90,43,47
Læsy,archimonde,1714,warlock,destruction,27,19,8
Pantry,tarren-mill,1714,warlock,destruction,30,18,12
Despayr,tarren-mill,1714,warlock,destruction,126,65,61
Nybbx,frostmane,1714,warlock,destruction,201,100,101
Smegwlock,tarren-mill,1713,warlock,destruction,96,55,41
Gjallarbrù,archimonde,1713,warlock,destruction,69,37,32
ßenäfflock,ragnaros,1712,warlock,destruction,52,30,22
Адво,howling-fjord,1711,warlock,destruction,35,24,11
Soundmagic,silvermoon,1711,warlock,destruction,36,22,14
Louên,dun-modr,1710,warlock,destruction,30,18,12
Hupet,ragnaros,1710,warlock,destruction,72,39,33
Stromzii,silvermoon,1710,warlock,destruction,162,83,79
Zxò,twisting-nether,1710,warlock,destruction,147,75,72
Elyö,dalaran,1709,warlock,destruction,628,309,319
Böggilock,tarren-mill,1708,warlock,destruction,94,57,37
Mld,draenor,1708,warlock,destruction,42,23,19
Henmur,stormscale,1708,warlock,destruction,130,64,66
Vulluin,blackrock,1708,warlock,destruction,48,23,25
Uzzi,dun-modr,1707,warlock,destruction,141,77,64
Shérlock,ravencrest,1707,warlock,destruction,48,26,22
Infinitefire,ravencrest,1707,warlock,destruction,42,22,20
Fluugew,tarren-mill,1707,warlock,destruction,90,41,49
Deadmoneyz,twisting-nether,1705,warlock,destruction,42,25,17
Juïcylucy,kazzak,1705,warlock,destruction,170,94,76
Cloud,kazzak,1704,warlock,destruction,36,24,12
Purplemafia,burning-blade,1704,warlock,destruction,36,18,18
Salastro,ragnaros,1703,warlock,destruction,77,42,35
Shádóws,nagrand,1703,warlock,destruction,243,128,115
Lillemarkus,tarren-mill,1703,warlock,destruction,78,38,40
Neoe,stormscale,1703,warlock,destruction,148,72,76
Hardnes,kazzak,1702,warlock,destruction,36,18,18
Maevex,stormscale,1702,warlock,destruction,48,23,25
Flamespitter,stormscale,1701,warlock,destruction,123,67,56
Killning,medivh,1700,warlock,destruction,266,137,129
Titimon,tarren-mill,1700,warlock,destruction,134,68,66
Boltgodx,thrall,1699,warlock,destruction,30,18,12
Tîllz,kargath,1698,warlock,destruction,24,22,2
Dotbotx,grim-batol,1698,warlock,destruction,36,23,13
Benganqt,kazzak,1698,warlock,destruction,284,153,131
Æhtrex,blackrock,1697,warlock,destruction,69,44,25
Twiseqtt,stormscale,1697,warlock,destruction,30,18,12
Trickslock,kazzak,1697,warlock,destruction,66,39,27
Chibbe,twisting-nether,1697,warlock,destruction,88,46,42
Alexindorf,silvermoon,1696,warlock,destruction,30,18,12
Ludé,eredar,1696,warlock,destruction,178,92,86
Fearco,ravencrest,1695,warlock,destruction,45,27,18
Веномзхх,lich-king,1695,warlock,destruction,37,19,18
Шеизла,borean-tundra,1694,warlock,destruction,120,70,50
Pelea,silvermoon,1694,warlock,destruction,54,31,23
Sotapen,ragnaros,1693,warlock,destruction,152,89,63
Wìtçhßlåðes,ysondre,1693,warlock,destruction,36,21,15
Vankraken,silvermoon,1693,warlock,destruction,96,52,44
Lacape,dalaran,1692,warlock,destruction,48,30,18
Хирацука,howling-fjord,1692,warlock,destruction,57,35,22
Marieejoana,nozdormu,1692,warlock,destruction,114,63,51
Aloof,outland,1692,warlock,destruction,291,154,137
Reuhn,kazzak,1692,warlock,destruction,96,50,46
Севербрянск,soulflayer,1691,warlock,destruction,36,22,14
Lókkíi,silvermoon,1691,warlock,destruction,407,216,191
Ðôtgøðx,ravencrest,1691,warlock,destruction,60,28,32
Limecqt,dun-morogh,1691,warlock,destruction,65,30,35
Ekispekis,tarren-mill,1690,warlock,destruction,36,22,14
Voodooskull,kazzak,1690,warlock,destruction,36,18,18
Väladar,sanguino,1690,warlock,destruction,47,23,24
Bmblockerina,blackrock,1688,warlock,destruction,89,55,34
Boyyano,tarren-mill,1688,warlock,destruction,30,18,12
Aspass,kazzak,1688,warlock,destruction,157,83,74
Smøkerzz,silvermoon,1688,warlock,destruction,100,52,48
Nagassh,arathor,1687,warlock,destruction,41,26,15
Lockukaracha,malganis,1687,warlock,destruction,98,59,39
Noahh,kazzak,1687,warlock,destruction,173,100,73
Onono,eredar,1687,warlock,destruction,101,57,44
Wumz,sylvanas,1687,warlock,destruction,77,42,35
Penorr,silvermoon,1687,warlock,destruction,42,20,22
Инфезиус,deathweaver,1686,warlock,destruction,30,18,12
Dotsyoudown,kelthuzad,1686,warlock,destruction,145,81,64
Demotrix,defias-brotherhood,1686,warlock,destruction,48,21,27
Nekros,archimonde,1685,warlock,destruction,60,39,21
Shóx,blackmoore,1685,warlock,destruction,48,27,21
Amited,drakthul,1685,warlock,destruction,95,52,43
Kasualix,ravencrest,1685,warlock,destruction,106,58,48
Fandirxd,draenor,1685,warlock,destruction,172,93,79
Ilovebronko,blackrock,1685,warlock,destruction,101,53,48
Darlih,ravencrest,1685,warlock,destruction,326,162,164
Kêkèkékêk,kazzak,1683,warlock,destruction,37,28,9
Gangleader,ravencrest,1683,warlock,destruction,59,37,22
Póssiblyreef,silvermoon,1683,warlock,destruction,84,46,38
Ayrefik,kazzak,1683,warlock,destruction,211,108,103
Tudii,frostwolf,1682,warlock,destruction,72,43,29
Lolock,archimonde,1681,warlock,destruction,32,19,13
Ilikebolts,blackmoore,1681,warlock,destruction,41,23,18
Søulcä,uldum,1680,warlock,destruction,36,27,9
Mizxxta,zuljin,1679,warlock,destruction,35,23,12
Candleburner,khaz-modan,1679,warlock,destruction,50,32,18
Augge,tarren-mill,1679,warlock,destruction,64,38,26
Tops,thrall,1678,warlock,destruction,30,23,7
Kumas,hyjal,1678,warlock,destruction,74,46,28
Kìmar,amanthul,1678,warlock,destruction,132,71,61
Bonemetz,blackmoore,1678,warlock,destruction,270,143,127
Riddim,ravenholdt,1678,warlock,destruction,36,18,18
Loulou,nagrand,1678,warlock,destruction,42,20,22
Darkwíngduck,aegwynn,1677,warlock,destruction,29,18,11
Jamié,ragnaros,1677,warlock,destruction,75,40,35
Guldinfy,outland,1676,warlock,destruction,24,22,2
Morrowgleam,outland,1676,warlock,destruction,39,26,13
Chãn,tarren-mill,1676,warlock,destruction,36,22,14
Joulsy,ravencrest,1676,warlock,destruction,78,45,33
Kognah,defias-brotherhood,1676,warlock,destruction,54,31,23
Zvinto,the-maelstrom,1676,warlock,destruction,47,26,21
Acidmvp,ravencrest,1676,warlock,destruction,72,38,34
Danidelarge,aegwynn,1676,warlock,destruction,70,36,34
Doomwrath,tarren-mill,1676,warlock,destruction,66,28,38
Монтадон,howling-fjord,1675,warlock,destruction,66,36,30
Marenov,kazzak,1675,warlock,destruction,168,90,78
Cynícal,blackmoore,1675,warlock,destruction,48,20,28
Dabzlol,twisting-nether,1674,warlock,destruction,40,25,15
Rádiz,blackhand,1674,warlock,destruction,48,25,23
Dotrulez,nemesis,1674,warlock,destruction,45,21,24
Fatos,nemesis,1673,warlock,destruction,48,28,20
Chaozvx,kazzak,1673,warlock,destruction,117,65,52
Berkobaggins,ravencrest,1673,warlock,destruction,94,49,45
Ødräcïe,twisting-nether,1672,warlock,destruction,42,18,24
Boomsparkle,blackrock,1671,warlock,destruction,36,23,13
Sseb,wildhammer,1671,warlock,destruction,30,18,12
Chafir,kazzak,1671,warlock,destruction,42,25,17
Wicherson,burning-legion,1671,warlock,destruction,112,62,50
Shreklock,burning-blade,1670,warlock,destruction,50,37,13
Forcas,archimonde,1670,warlock,destruction,320,168,152
Schøkøbasher,blackrock,1669,warlock,destruction,42,24,18
Коилсестры,blackscar,1669,warlock,destruction,45,25,20
Mønarch,argent-dawn,1669,warlock,destruction,85,46,39
Kenachaos,twisting-nether,1669,warlock,destruction,268,139,129
Hairyporta,blackmoore,1669,warlock,destruction,287,146,141
Vmorghuliss,sanguino,1669,warlock,destruction,132,59,73
Véstheim,saurfang,1668,warlock,destruction,156,83,73
Badguldan,blackmoore,1668,warlock,destruction,199,102,97
Кейкегенкай,gordunni,1668,warlock,destruction,147,74,73
Иренхх,gordunni,1667,warlock,destruction,92,47,45
Ahsykal,aegwynn,1667,warlock,destruction,60,28,32
Vreyax,aegwynn,1666,warlock,destruction,81,44,37
Koldarr,blackmoore,1666,warlock,destruction,211,110,101
Lykketrolle,stormscale,1665,warlock,destruction,72,45,27
Critchlock,tarren-mill,1665,warlock,destruction,65,35,30
Lokic,draenor,1665,warlock,destruction,52,24,28
Рипхард,gordunni,1665,warlock,destruction,54,23,31
Peacedust,grim-batol,1664,warlock,destruction,40,31,9
Dotys,sanguino,1664,warlock,destruction,57,39,18
Мамкадгара,howling-fjord,1664,warlock,destruction,53,28,25
Bruzzlbube,blackhand,1664,warlock,destruction,78,41,37
Ванадий,soulflayer,1664,warlock,destruction,101,47,54
Danidelarge,kazzak,1662,warlock,destruction,38,23,15
Кишмякхб,howling-fjord,1662,warlock,destruction,250,117,133
Lyconidas,magtheridon,1661,warlock,destruction,34,22,12
Unstablemind,nemesis,1661,warlock,destruction,33,19,14
Pouletmicuie,archimonde,1661,warlock,destruction,86,47,39
Sadixxqt,ravencrest,1660,warlock,destruction,36,24,12
Беллулар,howling-fjord,1660,warlock,destruction,36,22,14
Helvetica,darksorrow,1659,warlock,destruction,88,47,41
Síggýy,eredar,1659,warlock,destruction,41,21,20
Eviil,tarren-mill,1658,warlock,destruction,36,22,14
Sfwicked,tarren-mill,1658,warlock,destruction,48,29,19
Pixelz,twisting-nether,1658,warlock,destruction,179,86,93
Датри,grom,1657,warlock,destruction,71,46,25
Pestílentía,silvermoon,1657,warlock,destruction,66,42,24
Striks,ragnaros,1657,warlock,destruction,112,61,51
Absúrd,turalyon,1657,warlock,destruction,59,32,27
Сорзи,thermaplugg,1657,warlock,destruction,101,54,47
Tóuché,aegwynn,1657,warlock,destruction,211,111,100
Wankdiesel,der-rat-von-dalaran,1657,warlock,destruction,313,151,162
Brútality,nethersturm,1657,warlock,destruction,130,60,70
Avogein,tarren-mill,1656,warlock,destruction,36,19,17
Ketzu,hyjal,1656,warlock,destruction,206,103,103
Kigro,burning-legion,1655,warlock,destruction,78,42,36
Fatzké,kargath,1655,warlock,destruction,180,89,91
Maxiabe,hyjal,1654,warlock,destruction,106,64,42
Falakros,ravencrest,1653,warlock,destruction,95,56,39
Ностра,gordunni,1653,warlock,destruction,97,55,42
Prayz,twisting-nether,1652,warlock,destruction,36,21,15
Deathcoîl,the-maelstrom,1652,warlock,destruction,42,22,20
Neg,sylvanas,1651,warlock,destruction,41,22,19
Topmidbusta,draenor,1651,warlock,destruction,60,32,28
Alucena,silvermoon,1651,warlock,destruction,103,53,50
Jisera,kiljaeden,1651,warlock,destruction,42,19,23
Koffey,kazzak,1650,warlock,destruction,36,25,11
Spelldweller,silvermoon,1650,warlock,destruction,30,20,10
Hellraiserir,twisting-nether,1650,warlock,destruction,52,34,18
Salemlel,sanguino,1650,warlock,destruction,105,60,45
Gentoo,xavius,1650,warlock,destruction,98,55,43
Zerulian,ragnaros,1650,warlock,destruction,41,21,20
Kaspersdame,ravencrest,1650,warlock,destruction,47,24,23
Óop,outland,1650,warlock,destruction,102,51,51
Profesorr,defias-brotherhood,1650,warlock,destruction,42,21,21
Stickdüse,eredar,1649,warlock,destruction,84,42,42
Psýcholoc,kazzak,1648,warlock,destruction,38,25,13
Jawdrop,blackrock,1648,warlock,destruction,51,31,20
Yoplen,drakthul,1648,warlock,destruction,122,70,52
Syntax,blackmoore,1647,warlock,destruction,30,21,9
Oldasiangirl,blackrock,1647,warlock,destruction,30,20,10
Ноубрейкс,blackscar,1647,warlock,destruction,102,65,37
Toryon,archimonde,1647,warlock,destruction,64,35,29
Boglock,argent-dawn,1647,warlock,destruction,48,26,22
Testoorc,frostwolf,1647,warlock,destruction,146,75,71
Alexutzu,sylvanas,1646,warlock,destruction,66,42,24
Spiciously,antonidas,1646,warlock,destruction,69,37,32
Таксидермия,gordunni,1646,warlock,destruction,255,130,125
Withered,nagrand,1645,warlock,destruction,42,23,19
Selok,outland,1645,warlock,destruction,42,21,21
Xenq,ravencrest,1644,warlock,destruction,60,35,25
Highimhi,kazzak,1644,warlock,destruction,48,28,20
Necksi,archimonde,1643,warlock,destruction,36,25,11
Brugo,zuljin,1643,warlock,destruction,72,39,33
Jetsetmehmet,aegwynn,1643,warlock,destruction,90,44,46
Edrahil,lordaeron,1642,warlock,destruction,84,46,38
Âkâl,ravencrest,1642,warlock,destruction,165,90,75
Skyamino,hyjal,1641,warlock,destruction,42,27,15
Wîse,archimonde,1641,warlock,destruction,66,39,27
Drainurlife,stormscale,1641,warlock,destruction,114,66,48
Kkomradee,kazzak,1641,warlock,destruction,73,39,34
Ïori,hyjal,1641,warlock,destruction,77,40,37
Fearlessgødx,ravencrest,1641,warlock,destruction,136,69,67
Dotalike,kazzak,1641,warlock,destruction,72,33,39
Smíkz,blackhand,1640,warlock,destruction,59,36,23
Эот,soulflayer,1640,warlock,destruction,51,31,20
Ltheory,aegwynn,1640,warlock,destruction,78,44,34
Бонони,blackscar,1640,warlock,destruction,61,34,27
Rohlikov,drakthul,1640,warlock,destruction,60,31,29
Гвоздяшка,blackscar,1640,warlock,destruction,85,41,44
Dotxalot,blackrock,1639,warlock,destruction,58,40,18
Дэнаа,fordragon,1639,warlock,destruction,423,215,208
Lockostock,kazzak,1639,warlock,destruction,202,96,106
Trivalis,frostwolf,1638,warlock,destruction,84,49,35
Hiyashi,twisting-nether,1638,warlock,destruction,33,19,14
Siyruz,eredar,1638,warlock,destruction,106,59,47
Doomkicksin,haomarush,1638,warlock,destruction,42,22,20
Evylock,draenor,1638,warlock,destruction,36,18,18
Miller,stormscale,1637,warlock,destruction,54,31,23
Nùdex,ravencrest,1637,warlock,destruction,66,34,32
Ðêmøñîc,ravencrest,1637,warlock,destruction,48,21,27
Draka,kazzak,1636,warlock,destruction,113,68,45
Idfearthat,ragnaros,1636,warlock,destruction,60,36,24
Shugglock,draenor,1636,warlock,destruction,42,23,19
Nerfmebro,tarren-mill,1635,warlock,destruction,24,19,5
Icritmore,stormscale,1635,warlock,destruction,78,42,36
Orcwarlock,khadgar,1635,warlock,destruction,84,43,41
Dotsfired,aegwynn,1635,warlock,destruction,96,45,51
Warlololock,malganis,1634,warlock,destruction,42,24,18
Noomaca,drakthul,1634,warlock,destruction,324,157,167
Nerfwarriors,stormscale,1633,warlock,destruction,70,41,29
Sepulturá,thrall,1633,warlock,destruction,60,34,26
Wàrrìòr,ravencrest,1633,warlock,destruction,56,31,25
Puujäbäxd,stormscale,1633,warlock,destruction,42,21,21
Höfmänn,kazzak,1632,warlock,destruction,80,52,28
Lonelock,blackrock,1632,warlock,destruction,50,32,18
Rakshazza,eredar,1632,warlock,destruction,114,61,53
Blackiouz,stormscale,1632,warlock,destruction,217,109,108
Zetsubo,drakthul,1631,warlock,destruction,67,41,26
Elvània,eredar,1631,warlock,destruction,72,40,32
Agaton,twisting-nether,1630,warlock,destruction,24,17,7
Funcky,terokkar,1630,warlock,destruction,48,19,29
Jogie,ravencrest,1629,warlock,destruction,24,17,7
Vaimex,stormscale,1629,warlock,destruction,30,20,10
Xoraith,runetotem,1629,warlock,destruction,42,23,19
Wisdomness,aszune,1629,warlock,destruction,121,63,58
Worro,eredar,1629,warlock,destruction,54,28,26
Azthral,nemesis,1629,warlock,destruction,470,237,233
Ashykal,aegwynn,1629,warlock,destruction,120,57,63
Порртвейн,howling-fjord,1628,warlock,destruction,29,18,11
Флойх,blackscar,1628,warlock,destruction,54,31,23
Ineri,hyjal,1628,warlock,destruction,42,24,18
Aspas,outland,1628,warlock,destruction,77,43,34
Fearlólz,stormscale,1628,warlock,destruction,54,29,25
Тумнуктхай,gordunni,1628,warlock,destruction,114,59,55
Nherthul,sanguino,1628,warlock,destruction,261,133,128
Ðênnis,tarren-mill,1627,warlock,destruction,30,17,13
Ráklock,ragnaros,1627,warlock,destruction,48,27,21
Kyliân,blackmoore,1627,warlock,destruction,36,18,18
Xarica,garona,1627,warlock,destruction,36,17,19
Disrupted,blackmoore,1627,warlock,destruction,48,21,27
Sgait,ravencrest,1626,warlock,destruction,24,20,4
Höglund,twisting-nether,1626,warlock,destruction,39,26,13
Какойтолок,blackscar,1626,warlock,destruction,108,65,43
Çãél,ravencrest,1626,warlock,destruction,99,55,44
Cencible,twisting-nether,1626,warlock,destruction,127,66,61
Fluch,area-52,1626,warlock,destruction,60,26,34
Vitrolizz,twilights-hammer,1626,warlock,destruction,68,26,42
Соикулейн,gordunni,1625,warlock,destruction,29,23,6
Mobikagodx,drakthul,1625,warlock,destruction,27,19,8
Luwuock,twisting-nether,1625,warlock,destruction,30,21,9
Wryy,nemesis,1624,warlock,destruction,44,29,15
Pämppää,stormscale,1624,warlock,destruction,36,17,19
Bionic,eredar,1624,warlock,destruction,36,17,19
Khoug,blackmoore,1624,warlock,destruction,60,27,33
Quickccast,draenor,1623,warlock,destruction,97,58,39
Zéphon,blades-edge,1623,warlock,destruction,131,65,66
Flaming,ravencrest,1623,warlock,destruction,48,22,26
Priceburn,ravencrest,1622,warlock,destruction,39,23,16
Isata,blackhand,1622,warlock,destruction,36,20,16
Danishpistol,draenor,1622,warlock,destruction,81,39,42
Shiammetrý,kazzak,1622,warlock,destruction,36,17,19
Sylvein,drakthul,1621,warlock,destruction,30,21,9
Kasztyk,grim-batol,1621,warlock,destruction,47,27,20
Xuthil,korgall,1621,warlock,destruction,297,151,146
Gravedîgger,aggra-português,1621,warlock,destruction,42,21,21
Altffeer,blackmoore,1620,warlock,destruction,60,34,26
Zebauron,twisting-nether,1620,warlock,destruction,36,20,16
Seldonn,pozzo-delleternità,1620,warlock,destruction,35,18,17
Beåtrìce,archimonde,1620,warlock,destruction,63,31,32
Cokelight,thrall,1620,warlock,destruction,54,25,29
Chaoxz,outland,1619,warlock,destruction,138,81,57
Надсх,soulflayer,1619,warlock,destruction,30,17,13
Zikozor,ravencrest,1618,warlock,destruction,28,18,10
Xtkeks,blackmoore,1618,warlock,destruction,47,30,17
Blåir,kazzak,1618,warlock,destruction,107,66,41
Stavrogina,ravencrest,1618,warlock,destruction,30,17,13
Dragkur,sanguino,1618,warlock,destruction,59,31,28
Quarimathras,antonidas,1618,warlock,destruction,84,42,42
Парачо,eversong,1618,warlock,destruction,80,35,45
Инкубычь,gordunni,1617,warlock,destruction,33,22,11
Krøl,nemesis,1616,warlock,destruction,30,20,10
Husaì,laughing-skull,1616,warlock,destruction,88,58,30
Манфредх,gordunni,1616,warlock,destruction,107,57,50
Nebulus,lightnings-blade,1616,warlock,destruction,198,105,93
Hongkonger,kazzak,1616,warlock,destruction,434,226,208
Bh,ragnaros,1616,warlock,destruction,147,75,72
Maevax,stormscale,1616,warlock,destruction,48,23,25
Irukandji,chants-éternels,1616,warlock,destruction,42,20,22
Celphboss,twisting-nether,1615,warlock,destruction,48,28,20
Tangolock,ravencrest,1615,warlock,destruction,82,42,40
Jamzywarlock,kazzak,1615,warlock,destruction,77,37,40
Joemontana,blackrock,1615,warlock,destruction,42,20,22
Babáyàgá,blackhand,1614,warlock,destruction,176,102,74
Azaïdun,khaz-modan,1614,warlock,destruction,112,63,49
Mcdonkus,chamber-of-aspects,1614,warlock,destruction,39,21,18
Overbuffed,wildhammer,1613,warlock,destruction,30,17,13
Uralya,kazzak,1613,warlock,destruction,42,23,19
Straydots,grim-batol,1613,warlock,destruction,42,21,21
Depressor,ragnaros,1613,warlock,destruction,162,76,86
Scheprick,twisting-nether,1613,warlock,destruction,47,22,25
Сатенекс,soulflayer,1612,warlock,destruction,111,69,42
Ммотаро,soulflayer,1612,warlock,destruction,39,22,17
Yasa,khaz-modan,1612,warlock,destruction,159,87,72
Kosfáce,tarren-mill,1612,warlock,destruction,153,82,71
Saloninus,argent-dawn,1612,warlock,destruction,72,38,34
Necrofearz,sylvanas,1612,warlock,destruction,42,21,21
Opiumers,kazzak,1612,warlock,destruction,137,68,69
Empod,ragnaros,1612,warlock,destruction,99,48,51
Chaøs,thrall,1611,warlock,destruction,36,27,9
Drarken,sylvanas,1611,warlock,destruction,36,25,11
Exiled,dragonblight,1611,warlock,destruction,40,22,18
Nicodemo,tarren-mill,1611,warlock,destruction,36,19,17
Uhlum,arthas,1611,warlock,destruction,171,90,81
Kenjix,blackrock,1611,warlock,destruction,66,30,36
Barbyqueue,kazzak,1610,warlock,destruction,34,24,10
Dödkärringx,auchindoun,1610,warlock,destruction,58,33,25
Dogoon,sylvanas,1610,warlock,destruction,283,149,134
Sartaz,blackmoore,1610,warlock,destruction,90,45,45
Naslock,twisting-nether,1610,warlock,destruction,48,24,24
Meatbot,tarren-mill,1609,warlock,destruction,46,31,15
Trinox,teldrassil,1609,warlock,destruction,54,31,23
Lockyswag,draenor,1609,warlock,destruction,66,37,29
Toobadforyou,archimonde,1609,warlock,destruction,61,33,28
Darkeds,dun-modr,1609,warlock,destruction,179,93,86
Lysanruth,la-croisade-écarlate,1609,warlock,destruction,162,82,80
Skrabblel,tarren-mill,1609,warlock,destruction,36,18,18
Shaterz,dun-modr,1608,warlock,destruction,27,21,6
Ryssäbotti,stormscale,1608,warlock,destruction,31,23,8
Kitarah,blackrock,1608,warlock,destruction,30,21,9
Wushi,aggra-português,1608,warlock,destruction,42,27,15
Spykoosi,stormscale,1608,warlock,destruction,40,24,16
Esmuel,argent-dawn,1608,warlock,destruction,77,46,31
Wilog,silvermoon,1608,warlock,destruction,85,45,40
Хауда,gordunni,1608,warlock,destruction,238,118,120
Unkid,tarren-mill,1607,warlock,destruction,42,28,14
Малгат,howling-fjord,1607,warlock,destruction,29,18,11
Селикта,gordunni,1607,warlock,destruction,30,17,13
Еротикгодх,gordunni,1607,warlock,destruction,36,20,16
Фаердирка,blackscar,1607,warlock,destruction,36,19,17
Maxlox,tarren-mill,1607,warlock,destruction,35,17,18
Mayev,garrosh,1607,warlock,destruction,94,45,49
Гурджес,soulflayer,1606,warlock,destruction,42,29,13
Дуэлистка,soulflayer,1606,warlock,destruction,77,45,32
Jeffmillss,defias-brotherhood,1606,warlock,destruction,60,35,25
Demonkïng,archimonde,1606,warlock,destruction,147,82,65
Gango,outland,1606,warlock,destruction,110,61,49
Vestaya,burning-legion,1606,warlock,destruction,72,31,41
Dejin,tarren-mill,1605,warlock,destruction,30,17,13
Dispelpls,dun-morogh,1605,warlock,destruction,42,23,19
Холичорт,howling-fjord,1605,warlock,destruction,69,37,32
Storloz,argent-dawn,1605,warlock,destruction,119,62,57
Ipme,sanguino,1604,warlock,destruction,95,55,40
Felttofel,stormscale,1604,warlock,destruction,49,28,21
Garbageclass,outland,1604,warlock,destruction,36,20,16
Moelock,frostmane,1604,warlock,destruction,135,74,61
Lichlolocked,outland,1604,warlock,destruction,84,42,42
Mooncrushed,stormscale,1603,warlock,destruction,42,29,13
Zeinth,sanguino,1603,warlock,destruction,36,23,13
Nedivh,stormscale,1603,warlock,destruction,77,42,35
Craynos,die-arguswacht,1603,warlock,destruction,117,63,54
Ezclapforme,aegwynn,1603,warlock,destruction,146,77,69
Felhaen,silvermoon,1603,warlock,destruction,42,22,20
Mogwaï,blackhand,1603,warlock,destruction,178,92,86
Dreamnyâsha,tarren-mill,1603,warlock,destruction,42,19,23
Gishor,burning-legion,1602,warlock,destruction,24,19,5
Ebolara,aegwynn,1602,warlock,destruction,30,19,11
Sickening,twilights-hammer,1601,warlock,destruction,55,38,17
Gravewatcher,twisting-nether,1601,warlock,destruction,30,17,13
Dastey,stormscale,1601,warlock,destruction,36,18,18
Lócki,gilneas,1600,warlock,destruction,98,63,35
Wildimp,turalyon,1600,warlock,destruction,30,17,13
Letswreck,outland,1600,warlock,destruction,90,46,44
Kimwexler,ravencrest,1599,warlock,destruction,53,29,24
Gulleigh,draenor,1599,warlock,destruction,124,65,59
Midgetlockx,ravencrest,1598,warlock,destruction,25,20,5
Southy,stormscale,1598,warlock,destruction,36,19,17
Sneptics,draenor,1597,warlock,destruction,169,95,74
Tíktik,blackhand,1597,warlock,destruction,47,20,27
Томмиджонсон,gordunni,1596,warlock,destruction,58,33,25
Golgir,draenor,1596,warlock,destruction,166,89,77
Stazox,drakthul,1596,warlock,destruction,36,19,17
Napoloen,kazzak,1596,warlock,destruction,36,19,17
Necrobtch,quelthalas,1595,warlock,destruction,36,21,15
Désolaté,kazzak,1595,warlock,destruction,42,23,19
Sibora,eredar,1595,warlock,destruction,48,26,22
Fataldead,stormscale,1594,warlock,destruction,24,18,6
Hexdrix,thrall,1594,warlock,destruction,49,23,26
Bountyqt,outland,1593,warlock,destruction,36,19,17
Felcollíns,ravencrest,1593,warlock,destruction,36,19,17
Ðîâblô,silvermoon,1593,warlock,destruction,80,41,39
Sleethy,destromath,1593,warlock,destruction,60,28,32
Ñæly,ravencrest,1592,warlock,destruction,35,19,16
Whitebøy,hyjal,1592,warlock,destruction,51,27,24
Lugnalennart,tarren-mill,1592,warlock,destruction,211,108,103
Johnybanana,eredar,1591,warlock,destruction,92,51,41
Nimbin,taerar,1591,warlock,destruction,213,115,98
Nobodyknows,outland,1591,warlock,destruction,36,19,17
Chaosbørn,twisting-nether,1590,warlock,destruction,40,26,14
Drazol,sylvanas,1590,warlock,destruction,32,18,14
Pliixme,ysondre,1590,warlock,destruction,59,30,29
Jinxme,tarren-mill,1589,warlock,destruction,160,86,74
Shaxlock,draenor,1588,warlock,destruction,135,74,61
Мураса,grom,1588,warlock,destruction,89,48,41
Morathy,drekthar,1588,warlock,destruction,46,23,23
Turbonion,archimonde,1587,warlock,destruction,78,42,36
Nøl,sargeras,1587,warlock,destruction,351,176,175
Réxz,ravencrest,1586,warlock,destruction,72,36,36
Hexdoctor,ravencrest,1586,warlock,destruction,48,18,30
Strikeførce,ravencrest,1585,warlock,destruction,117,60,57
Rúbedo,thrall,1585,warlock,destruction,41,21,20
Færqt,blackrock,1585,warlock,destruction,78,34,44
Proctolock,garona,1584,warlock,destruction,95,57,38
Wåfa,kazzak,1584,warlock,destruction,74,41,33
Веберх,howling-fjord,1584,warlock,destruction,36,19,17
Hellguards,silvermoon,1584,warlock,destruction,89,41,48
Nèrfxløl,ragnaros,1583,warlock,destruction,76,50,26
Pelkopeelo,tarren-mill,1583,warlock,destruction,83,45,38
Jumbodot,tarren-mill,1583,warlock,destruction,74,40,34
Adipure,blackrock,1583,warlock,destruction,42,19,23
Beepbepp,grim-batol,1582,warlock,destruction,82,53,29
Articfox,outland,1582,warlock,destruction,128,67,61
Octoba,kirin-tor,1581,warlock,destruction,36,23,13
Deruud,defias-brotherhood,1581,warlock,destruction,170,89,81
Nerzhull,stormscale,1581,warlock,destruction,392,199,193
Nitmoredots,dun-modr,1581,warlock,destruction,60,29,31
Asmodéan,silvermoon,1581,warlock,destruction,42,20,22
Era,stormscale,1580,warlock,destruction,29,19,10
Furchtnervt,thrall,1579,warlock,destruction,36,19,17
Mihø,hyjal,1579,warlock,destruction,86,44,42
Аркейнмизери,howling-fjord,1578,warlock,destruction,37,26,11
Мицуру,howling-fjord,1578,warlock,destruction,112,64,48
Afflimoomoo,tarren-mill,1578,warlock,destruction,126,62,64
Sædotern,stormscale,1578,warlock,destruction,42,20,22
Вайнпрессх,gordunni,1578,warlock,destruction,44,18,26
Balthezy,defias-brotherhood,1577,warlock,destruction,24,18,6
Jpjpjp,gorgonnash,1577,warlock,destruction,78,48,30
Kohta,ravencrest,1577,warlock,destruction,36,22,14
Docik,kazzak,1577,warlock,destruction,106,52,54
Jaines,forscherliga,1577,warlock,destruction,47,20,27
Slàsh,hyjal,1576,warlock,destruction,54,36,18
Sabnøck,nemesis,1576,warlock,destruction,41,24,17
Жузек,howling-fjord,1576,warlock,destruction,84,49,35
Uneedtherapy,silvermoon,1576,warlock,destruction,72,42,30
Ketamol,ravencrest,1576,warlock,destruction,69,37,32
Грань,ashenvale,1576,warlock,destruction,301,158,143
Mariahscary,auchindoun,1575,warlock,destruction,36,21,15
Ábýss,ravencrest,1575,warlock,destruction,55,30,25
Flawzo,blackmoore,1574,warlock,destruction,96,51,45
Itstrippy,tarren-mill,1572,warlock,destruction,90,52,38
Ánárchy,stormscale,1572,warlock,destruction,42,22,20
Rhadaghast,outland,1571,warlock,destruction,89,50,39
Hajslaktarn,twisting-nether,1571,warlock,destruction,82,42,40
Bigbadgoblin,kazzak,1570,warlock,destruction,42,27,15
Áutísm,silvermoon,1570,warlock,destruction,138,71,67
Dahisx,ravencrest,1569,warlock,destruction,30,18,12
Lovromalt,kazzak,1569,warlock,destruction,54,29,25
Eriken,tarren-mill,1569,warlock,destruction,144,76,68
Cazzo,burning-blade,1569,warlock,destruction,385,197,188
Zwockeý,ravencrest,1568,warlock,destruction,30,20,10
Visable,kazzak,1568,warlock,destruction,36,19,17
Qzkimp,hyjal,1568,warlock,destruction,42,22,20
Shayexen,tarren-mill,1568,warlock,destruction,42,21,21
Jaliyah,outland,1567,warlock,destruction,54,32,22
Bolt,stormscale,1567,warlock,destruction,112,64,48
Axapnon,ragnaros,1567,warlock,destruction,36,20,16
Willthehoe,alonsus,1567,warlock,destruction,47,23,24
Jegfaller,wildhammer,1567,warlock,destruction,319,155,164
Lúcìfér,stormscale,1567,warlock,destruction,48,19,29
Woòkz,argent-dawn,1566,warlock,destruction,154,85,69
Xcstacy,kazzak,1566,warlock,destruction,42,22,20
Nasiegboch,frostwolf,1566,warlock,destruction,179,92,87
Fatkkroth,ravencrest,1565,warlock,destruction,49,30,19
Kàjah,outland,1563,warlock,destruction,59,29,30
Акэти,borean-tundra,1563,warlock,destruction,54,26,28
Gigólo,kazzak,1562,warlock,destruction,48,27,21
Ìzanamí,archimonde,1562,warlock,destruction,274,144,130
Sneps,azshara,1561,warlock,destruction,48,27,21
Нгага,howling-fjord,1561,warlock,destruction,456,233,223
Væde,stormscale,1561,warlock,destruction,61,31,30
Vantimere,ragnaros,1560,warlock,destruction,72,39,33
Ezdotggwp,stormscale,1560,warlock,destruction,54,28,26
Zoradiale,twisting-nether,1559,warlock,destruction,54,30,24
Banishedone,stormreaver,1559,warlock,destruction,135,72,63
Ael,chogall,1558,warlock,destruction,82,51,31
Bobstrr,drakthul,1558,warlock,destruction,54,20,34
Spysnop,draenor,1557,warlock,destruction,64,40,24
Chillman,stormrage,1557,warlock,destruction,96,58,38
Parásitø,zuljin,1557,warlock,destruction,35,20,15
Tropìcal,grim-batol,1557,warlock,destruction,36,17,19
Boccu,magtheridon,1556,warlock,destruction,97,54,43
Kerthan,malorne,1556,warlock,destruction,167,92,75
Егосяхаос,soulflayer,1556,warlock,destruction,102,54,48
Britneyfears,burning-legion,1556,warlock,destruction,36,18,18
Lobotomic,argent-dawn,1555,warlock,destruction,75,45,30
Flumez,stormscale,1555,warlock,destruction,141,80,61
Фтор,soulflayer,1555,warlock,destruction,51,28,23
Sândex,blackmoore,1555,warlock,destruction,38,19,19
Gimlidota,tarren-mill,1554,warlock,destruction,180,96,84
Inoculum,xavius,1553,warlock,destruction,89,45,44
Мегаклещ,soulflayer,1553,warlock,destruction,54,25,29
Izurria,tarren-mill,1552,warlock,destruction,36,21,15
Zorlon,frostmane,1551,warlock,destruction,36,26,10
Kresnyk,kazzak,1551,warlock,destruction,109,58,51
Tdoggydog,ragnaros,1551,warlock,destruction,90,45,45
Flocca,archimonde,1551,warlock,destruction,95,47,48
Нейросетьтут,howling-fjord,1549,warlock,destruction,36,20,16
Nàchtt,archimonde,1549,warlock,destruction,114,58,56
Shblakk,outland,1548,warlock,destruction,53,28,25
Chaosboltlol,ravencrest,1547,warlock,destruction,36,22,14
Vudukesh,draenor,1547,warlock,destruction,41,24,17
Kgg,outland,1547,warlock,destruction,159,78,81
Bellua,twisting-nether,1546,warlock,destruction,77,42,35
Zloezlo,ravencrest,1545,warlock,destruction,194,98,96
Ivannadie,outland,1545,warlock,destruction,48,24,24
Lánfeár,draenor,1545,warlock,destruction,91,43,48
Chubson,tarren-mill,1545,warlock,destruction,56,26,30
Nazmordith,argent-dawn,1545,warlock,destruction,68,29,39
Soulgünter,blackmoore,1544,warlock,destruction,90,59,31
Salazaros,die-silberne-hand,1544,warlock,destruction,96,52,44
Robertóoo,burning-legion,1544,warlock,destruction,89,48,41
Oorlogslot,sylvanas,1544,warlock,destruction,210,110,100
Spõk,ysondre,1544,warlock,destruction,256,134,122
Annihilatîon,aegwynn,1543,warlock,destruction,49,26,23
Rawsauce,outland,1542,warlock,destruction,20,17,3
Veoxohr,argent-dawn,1542,warlock,destruction,132,80,52
Бомбшелл,soulflayer,1542,warlock,destruction,44,19,25
Plamena,neptulon,1541,warlock,destruction,136,75,61
Shanyor,kazzak,1541,warlock,destruction,52,28,24
Enzyw,drakthul,1540,warlock,destruction,72,43,29
Drakedoge,draenor,1540,warlock,destruction,136,71,65
Ez,frostmane,1539,warlock,destruction,42,27,15
Sûdh,sanguino,1538,warlock,destruction,120,66,54
Litox,twisting-nether,1538,warlock,destruction,129,63,66
Veanice,eredar,1538,warlock,destruction,46,20,26
Cyanur,silvermoon,1538,warlock,destruction,48,20,28
Frilante,terokkar,1537,warlock,destruction,86,55,31
Unrealia,hyjal,1537,warlock,destruction,174,93,81
Депрессыш,gordunni,1537,warlock,destruction,42,21,21
Ðream,kaelthas,1537,warlock,destruction,62,30,32
Babakrake,alleria,1536,warlock,destruction,42,24,18
Enei,drakthul,1536,warlock,destruction,48,26,22
Slëydark,sanguino,1536,warlock,destruction,35,18,17
Mortuáry,drakthul,1536,warlock,destruction,108,55,53
Destrovid,stormscale,1536,warlock,destruction,42,21,21
Ðemise,antonidas,1536,warlock,destruction,69,33,36
Nkwango,blackmoore,1535,warlock,destruction,24,16,8
Anihlix,kazzak,1535,warlock,destruction,24,16,8
Anderxyo,sanguino,1535,warlock,destruction,24,16,8
Crueliadevil,stormscale,1535,warlock,destruction,181,88,93
Potatowl,ravencrest,1534,warlock,destruction,18,16,2
Kaylabae,silvermoon,1534,warlock,destruction,18,16,2
Bustabrinka,aggra-português,1534,warlock,destruction,18,16,2
Samyoung,kazzak,1534,warlock,destruction,167,91,76
Rénna,twisting-nether,1534,warlock,destruction,30,16,14
Shortyi,thrall,1533,warlock,destruction,24,16,8
Snackstickz,twisting-nether,1533,warlock,destruction,54,31,23
ßäßÿløl,dalaran,1533,warlock,destruction,59,32,27
Calypso,korgall,1533,warlock,destruction,30,16,14
Blackwizard,theradras,1533,warlock,destruction,177,94,83
Dreameater,twilights-hammer,1533,warlock,destruction,60,30,30
Zamahell,marécage-de-zangar,1532,warlock,destruction,24,17,7
Nephystø,archimonde,1532,warlock,destruction,24,16,8
Debz,twisting-nether,1531,warlock,destruction,25,16,9
Jonsdotter,outland,1531,warlock,destruction,30,16,14
Saladoor,draenor,1530,warlock,destruction,30,16,14
Dobromír,kazzak,1530,warlock,destruction,30,16,14
Sirmic,hyjal,1530,warlock,destruction,131,64,67
Notben,outland,1529,warlock,destruction,18,16,2
Aoea,draenor,1529,warlock,destruction,24,16,8
Destrodanii,dun-morogh,1529,warlock,destruction,30,18,12
Flatulenzus,blackrock,1529,warlock,destruction,36,16,20
Cringelord,vashj,1528,warlock,destruction,18,16,2
Golansobolt,sanguino,1528,warlock,destruction,30,16,14
Kenthal,nemesis,1528,warlock,destruction,75,34,41
Falel,das-konsortium,1527,warlock,destruction,30,23,7
Mêgasn,blackhand,1527,warlock,destruction,24,16,8
Toliver,drakthul,1527,warlock,destruction,78,44,34
Fatbëlly,argent-dawn,1527,warlock,destruction,191,95,96
Thorvos,blackmoore,1527,warlock,destruction,45,21,24
Biotic,dun-modr,1526,warlock,destruction,48,20,28
Тиранчухан,howling-fjord,1526,warlock,destruction,51,20,31
Postymalony,kazzak,1523,warlock,destruction,30,19,11
Føtmgodx,silvermoon,1523,warlock,destruction,98,54,44
Нэдлок,greymane,1523,warlock,destruction,30,16,14
Koonlock,kazzak,1523,warlock,destruction,151,80,71
Nÿhf,kirin-tor,1523,warlock,destruction,47,21,26
Tôertchen,aegwynn,1522,warlock,destruction,29,20,9
Raywl,blackmoore,1522,warlock,destruction,36,19,17
Weso,grim-batol,1522,warlock,destruction,73,34,39
Zexan,drakthul,1521,warlock,destruction,66,42,24
Pogrom,burning-legion,1521,warlock,destruction,74,45,29
Darkironhuan,blackrock,1521,warlock,destruction,42,25,17
Jackyfalls,blackmoore,1521,warlock,destruction,30,16,14
Kicx,blackrock,1521,warlock,destruction,47,25,22
Malinki,silvermoon,1521,warlock,destruction,42,20,22
Hathatchi,sylvanas,1521,warlock,destruction,96,45,51
Proßlock,kazzak,1521,warlock,destruction,116,54,62
Дэйву,howling-fjord,1521,warlock,destruction,36,16,20
Chedipes,stormscale,1520,warlock,destruction,42,31,11
Goodclass,tarren-mill,1520,warlock,destruction,24,17,7
Déemón,draenor,1520,warlock,destruction,70,44,26
Beerdurschd,antonidas,1520,warlock,destruction,51,31,20
Экспло,ashenvale,1520,warlock,destruction,78,46,32
Яжбатько,howling-fjord,1520,warlock,destruction,78,40,38
Героуд,howling-fjord,1519,warlock,destruction,141,75,66
Bottmbolt,blackhand,1519,warlock,destruction,69,36,33
Dzey,drakthul,1519,warlock,destruction,152,79,73
Felgød,ravencrest,1518,warlock,destruction,82,43,39
Чернаяскала,howling-fjord,1518,warlock,destruction,183,90,93
Kamí,sanguino,1518,warlock,destruction,77,37,40
Wauwish,stormscale,1517,warlock,destruction,89,52,37
Noctiz,pozzo-delleternità,1517,warlock,destruction,113,62,51
Ascètic,kazzak,1517,warlock,destruction,42,23,19
Asreaël,uldum,1517,warlock,destruction,60,32,28
Vordor,ravencrest,1517,warlock,destruction,60,25,35
Yazurí,ravencrest,1516,warlock,destruction,24,16,8
Silås,hyjal,1516,warlock,destruction,52,31,21
Onetwobolt,archimonde,1516,warlock,destruction,202,104,98
Noxii,gorgonnash,1515,warlock,destruction,78,43,35
Chapo,alleria,1515,warlock,destruction,48,21,27
Dbwl,kazzak,1514,warlock,destruction,24,16,8
Scrim,laughing-skull,1514,warlock,destruction,88,56,32
Sherrÿ,ragnaros,1514,warlock,destruction,60,34,26
Gengada,blackhand,1514,warlock,destruction,90,50,40
Lottopallo,arathor,1514,warlock,destruction,30,16,14
Cronai,silvermoon,1514,warlock,destruction,134,69,65
Makaspam,stormscale,1514,warlock,destruction,130,65,65
Misscringe,silvermoon,1514,warlock,destruction,168,83,85
Falock,tarren-mill,1513,warlock,destruction,48,28,20
Wagwann,argent-dawn,1513,warlock,destruction,54,31,23
Бигбрейн,soulflayer,1513,warlock,destruction,72,39,33
Usianbølts,blackmoore,1513,warlock,destruction,30,16,14
Kaedinx,twisting-nether,1513,warlock,destruction,646,329,317
Sarajaylock,kazzak,1513,warlock,destruction,52,26,26
Zoh,archimonde,1513,warlock,destruction,185,92,93
Lêxia,shattrath,1513,warlock,destruction,42,16,26
Torcal,archimonde,1512,warlock,destruction,24,16,8
Tarumar,burning-legion,1512,warlock,destruction,36,16,20
Трудзастафф,gordunni,1512,warlock,destruction,108,47,61
Lilbolty,outland,1511,warlock,destruction,48,22,26
Ghostfiend,tarren-mill,1510,warlock,destruction,54,35,19
Mellisandre,hellfire,1510,warlock,destruction,42,25,17
Meeatcookie,burning-legion,1510,warlock,destruction,49,29,20
Pipêz,blackmoore,1510,warlock,destruction,101,59,42
Zarastro,sunstrider,1510,warlock,destruction,358,177,181
Helgorak,ragnaros,1510,warlock,destruction,72,34,38
Sertdene,ravencrest,1509,warlock,destruction,78,43,35
Isata,ravencrest,1509,warlock,destruction,115,63,52
Kotihoitaja,stormreaver,1509,warlock,destruction,59,29,30
Lorelèi,silvermoon,1508,warlock,destruction,52,29,23
Демирус,gordunni,1508,warlock,destruction,48,25,23
Lubomirek,turalyon,1508,warlock,destruction,54,28,26
Xerthula,blackmoore,1507,warlock,destruction,30,16,14
Nøxxlock,blackhand,1507,warlock,destruction,173,90,83
Мерседэсс,gordunni,1507,warlock,destruction,78,37,41
Kasuni,sanguino,1507,warlock,destruction,72,30,42
Altfdrölf,blackhand,1506,warlock,destruction,31,21,10
Sylvxgodx,kazzak,1506,warlock,destruction,60,37,23
Lazyblue,hyjal,1506,warlock,destruction,127,61,66
Gigabolt,turalyon,1505,warlock,destruction,59,35,24
Rcodellamado,kazzak,1505,warlock,destruction,42,18,24
Izhi,ragnaros,1504,warlock,destruction,77,44,33
Kwoh,saurfang,1504,warlock,destruction,33,17,16
Hipiwl,silvermoon,1504,warlock,destruction,72,37,35
Morgan,jaedenar,1503,warlock,destruction,96,52,44
Leídernein,blutkessel,1503,warlock,destruction,42,22,20
Xasil,twisting-nether,1502,warlock,destruction,54,23,31
Merdotz,outland,1500,warlock,destruction,49,29,20
Morphosis,agamaggan,1500,warlock,destruction,42,21,21
Rotinhell,kazzak,1500,warlock,destruction,165,80,85
Voidislife,alakir,1499,warlock,destruction,201,104,97
Hokmor,blutkessel,1499,warlock,destruction,145,74,71
Azastarax,archimonde,1499,warlock,destruction,54,27,27
Ajgreedyy,grim-batol,1499,warlock,destruction,66,31,35
Cronice,ravencrest,1499,warlock,destruction,134,62,72
Misleev,pozzo-delleternità,1499,warlock,destruction,152,66,86
Jaimê,thrall,1498,warlock,destruction,106,57,49
Evillinna,frostmane,1498,warlock,destruction,119,62,57
Palmangel,draenor,1498,warlock,destruction,89,43,46
Schrimz,blackrock,1498,warlock,destruction,59,26,33
Nerdbane,blackrock,1497,warlock,destruction,105,57,48
Necradin,defias-brotherhood,1497,warlock,destruction,93,48,45
Xanatas,nemesis,1496,warlock,destruction,66,38,28
Lînden,magtheridon,1496,warlock,destruction,30,16,14
Spoíl,tarren-mill,1496,warlock,destruction,72,36,36
Interceptêr,blackrock,1496,warlock,destruction,36,18,18
Naemys,archimonde,1495,warlock,destruction,57,36,21
Askmo,hyjal,1495,warlock,destruction,46,29,17
Marklock,drakthul,1495,warlock,destruction,79,47,32
Горгзок,howling-fjord,1495,warlock,destruction,48,24,24
Locque,kazzak,1494,warlock,destruction,24,16,8
Kïng,elune,1494,warlock,destruction,66,34,32
Zòóf,stormscale,1493,warlock,destruction,120,73,47
Фирджеден,fordragon,1493,warlock,destruction,146,83,63
Inagony,twisting-nether,1493,warlock,destruction,29,16,13
Warlocat,the-maelstrom,1493,warlock,destruction,72,34,38
Aznel,nemesis,1491,warlock,destruction,37,22,15
Araphel,twisting-nether,1491,warlock,destruction,42,19,23
Weexi,kazzak,1490,warlock,destruction,32,20,12
Khano,twisting-nether,1490,warlock,destruction,147,79,68
Колдунишка,fordragon,1490,warlock,destruction,117,62,55
Gyroib,stormscale,1489,warlock,destruction,65,37,28
Chaosprophet,argent-dawn,1489,warlock,destruction,50,28,22
Zerøskil,blackrock,1488,warlock,destruction,24,16,8
Bowti,ravencrest,1488,warlock,destruction,100,63,37
Chía,thunderhorn,1488,warlock,destruction,47,26,21
Tomiaa,burning-legion,1488,warlock,destruction,78,37,41
Juicyj,twisting-nether,1488,warlock,destruction,50,23,27
Acrowley,twisting-nether,1487,warlock,destruction,52,26,26
Fandusttwo,drakthul,1486,warlock,destruction,66,36,30
Stürmer,thrall,1486,warlock,destruction,126,67,59
Scaevóla,ravencrest,1486,warlock,destruction,252,129,123
Belnea,draenor,1485,warlock,destruction,33,18,15
Petrapain,antonidas,1485,warlock,destruction,42,22,20
Белвет,blackscar,1485,warlock,destruction,116,56,60
Azaêl,azshara,1485,warlock,destruction,159,75,84
Nieché,tarren-mill,1484,warlock,destruction,66,37,29
Zeelotko,drakthul,1484,warlock,destruction,159,88,71
Perius,zuluhed,1484,warlock,destruction,102,47,55
Murishani,durotan,1483,warlock,destruction,30,18,12
Demoslik,hyjal,1483,warlock,destruction,60,27,33
Xârtôr,blackrock,1482,warlock,destruction,182,99,83
Dusken,kazzak,1481,warlock,destruction,41,21,20
Cursedotexe,ragnaros,1481,warlock,destruction,150,76,74
Faro,trollbane,1481,warlock,destruction,120,56,64
Millhaus,gorgonnash,1480,warlock,destruction,95,55,40
Necromantis,drakthul,1480,warlock,destruction,30,16,14
Banelock,dentarg,1480,warlock,destruction,102,49,53
Swèét,draenor,1479,warlock,destruction,30,18,12
Nokickplz,nemesis,1479,warlock,destruction,57,30,27
Branduir,ragnaros,1479,warlock,destruction,42,22,20
Musallat,argent-dawn,1479,warlock,destruction,43,20,23
Fearfearfear,blackhand,1478,warlock,destruction,29,16,13
Чернокнжник,soulflayer,1478,warlock,destruction,48,24,24
Diabló,outland,1478,warlock,destruction,60,29,31
Xànin,thrall,1478,warlock,destruction,60,28,32
Mummraa,ravencrest,1477,warlock,destruction,59,35,24
Cavekid,tarren-mill,1477,warlock,destruction,36,21,15
Fearster,twisting-nether,1477,warlock,destruction,112,62,50
Tschebo,eredar,1477,warlock,destruction,60,31,29
Barro,das-syndikat,1477,warlock,destruction,62,32,30
Kiritsugi,aszune,1476,warlock,destruction,65,38,27
Apokalyps,eldrethalas,1476,warlock,destruction,168,81,87
Lockdest,outland,1476,warlock,destruction,146,70,76
Rasheeka,ravencrest,1476,warlock,destruction,35,16,19
Zeddy,draenor,1475,warlock,destruction,120,67,53
Valcan,ragnaros,1475,warlock,destruction,139,76,63
Èrmes,eldrethalas,1475,warlock,destruction,178,91,87
Shêrlöck,stormscale,1475,warlock,destruction,138,69,69
Parley,frostmane,1475,warlock,destruction,66,32,34
Amadéth,twisting-nether,1474,warlock,destruction,44,26,18
Mvpðøtx,ravencrest,1474,warlock,destruction,79,45,34
Adoy,tarren-mill,1474,warlock,destruction,141,79,62
Farlier,draenor,1474,warlock,destruction,95,47,48
Codeincody,blackhand,1473,warlock,destruction,53,23,30
Kirillkaá,blackhand,1472,warlock,destruction,54,32,22
Kurioula,twisting-nether,1472,warlock,destruction,28,16,12
Inflamis,stormscale,1472,warlock,destruction,78,43,35
Törtidotcom,blackrock,1472,warlock,destruction,42,20,22
Nopainnodot,aegwynn,1472,warlock,destruction,75,34,41
Quasimodó,aegwynn,1471,warlock,destruction,79,48,31
Mækken,draenor,1471,warlock,destruction,279,138,141
Найтварлок,soulflayer,1471,warlock,destruction,40,17,23
Кореопсис,azuregos,1470,warlock,destruction,23,18,5
Érunali,archimonde,1470,warlock,destruction,23,16,7
Сайзэр,howling-fjord,1470,warlock,destruction,171,85,86
Xtleonidas,uldum,1470,warlock,destruction,132,64,68
Féar,doomhammer,1469,warlock,destruction,51,29,22
Hârzfeâr,blackmoore,1469,warlock,destruction,64,32,32
Favris,antonidas,1468,warlock,destruction,59,36,23
Sénsemann,madmortem,1466,warlock,destruction,65,37,28
Bossmanluke,defias-brotherhood,1466,warlock,destruction,29,16,13
Dérbombér,guldan,1466,warlock,destruction,36,19,17
Jmë,outland,1465,warlock,destruction,44,25,19
Mazaear,stormscale,1465,warlock,destruction,69,36,33
Hemara,emeriss,1465,warlock,destruction,54,27,27
Warlockyo,blackrock,1465,warlock,destruction,60,29,31
Aightz,twisting-nether,1464,warlock,destruction,24,18,6
Holaw,tarren-mill,1464,warlock,destruction,84,41,43
Datendariza,kazzak,1463,warlock,destruction,122,63,59
Magicstick,eredar,1463,warlock,destruction,89,41,48
Balgo,blackmoore,1462,warlock,destruction,60,32,28
Sydneyshaw,draenor,1462,warlock,destruction,129,64,65
Maedx,outland,1462,warlock,destruction,75,35,40
Chaotìc,nemesis,1460,warlock,destruction,47,36,11
Rêcc,blackmoore,1460,warlock,destruction,90,45,45
Cørleen,eredar,1460,warlock,destruction,154,69,85
Vactor,stormscale,1460,warlock,destruction,46,20,26
Nhéon,archimonde,1459,warlock,destruction,36,21,15
Chyther,ragnaros,1459,warlock,destruction,48,26,22
Antoniolm,cthun,1459,warlock,destruction,72,37,35
Пъё,howling-fjord,1459,warlock,destruction,131,60,71
Puppylover,outland,1458,warlock,destruction,54,34,20
Spaså,kazzak,1458,warlock,destruction,42,23,19
Кулутха,soulflayer,1457,warlock,destruction,37,21,16
Crazybolt,archimonde,1456,warlock,destruction,60,35,25
Dôtski,kazzak,1456,warlock,destruction,137,79,58
Pufulet,sylvanas,1456,warlock,destruction,195,101,94
Nosoulnoprob,sylvanas,1456,warlock,destruction,108,54,54
Lockteb,tarren-mill,1455,warlock,destruction,47,25,22
Zengrow,ravencrest,1454,warlock,destruction,27,17,10
Bte,draenor,1454,warlock,destruction,64,34,30
Zöyarüm,outland,1454,warlock,destruction,42,22,20
Даремно,gordunni,1454,warlock,destruction,48,24,24
Aleê,twisting-nether,1454,warlock,destruction,47,23,24
Орксамец,howling-fjord,1453,warlock,destruction,26,16,10
Lockybàlboa,tarren-mill,1453,warlock,destruction,48,29,19
Геролин,goldrinn,1452,warlock,destruction,109,54,55
Lucifer,burning-legion,1451,warlock,destruction,48,26,22
Anicetuslol,lightnings-blade,1451,warlock,destruction,30,16,14
Ammathrel,moonglade,1451,warlock,destruction,129,64,65
Horsewarlock,stormscale,1451,warlock,destruction,158,77,81
Антетак,soulflayer,1451,warlock,destruction,70,32,38
Banshore,ysondre,1450,warlock,destruction,47,29,18
Геоматика,gordunni,1450,warlock,destruction,64,28,36
Yehelzz,amanthul,1450,warlock,destruction,48,20,28
Drestar,ragnaros,1450,warlock,destruction,42,17,25
Kamehamehaa,stormscale,1449,warlock,destruction,48,29,19
Voiyane,silvermoon,1449,warlock,destruction,42,23,19
Воттоваара,azuregos,1449,warlock,destruction,118,59,59
Bisacodyl,outland,1448,warlock,destruction,113,56,57
Tzeeñtch,tarren-mill,1448,warlock,destruction,122,58,64
Kvanmor,kaelthas,1448,warlock,destruction,134,63,71
Гуслин,soulflayer,1447,warlock,destruction,136,72,64
Cooldowns,ravencrest,1447,warlock,destruction,85,45,40
Malumbra,argent-dawn,1447,warlock,destruction,42,19,23
Хиёрис,eversong,1446,warlock,destruction,75,47,28
Baz,frostmane,1446,warlock,destruction,227,115,112
Wøhx,archimonde,1445,warlock,destruction,66,29,37
Hellsplat,tarren-mill,1444,warlock,destruction,48,26,22
Gledoc,outland,1443,warlock,destruction,36,22,14
Lokicica,karazhan,1443,warlock,destruction,71,39,32
Sopingsop,chants-éternels,1443,warlock,destruction,62,33,29
Sambosa,twisting-nether,1443,warlock,destruction,42,21,21
Helkásh,tarren-mill,1443,warlock,destruction,66,31,35
Liqûid,destromath,1442,warlock,destruction,181,95,86
Diablesse,dun-modr,1441,warlock,destruction,118,59,59
Unknownlock,tarren-mill,1441,warlock,destruction,48,22,26
Agonymaster,twisting-nether,1440,warlock,destruction,36,20,16
Krombo,kazzak,1440,warlock,destruction,59,29,30
Bazoo,nathrezim,1440,warlock,destruction,277,132,145
Frèija,ravencrest,1439,warlock,destruction,24,15,9
Hasibe,ravencrest,1439,warlock,destruction,51,28,23
Amyw,magtheridon,1439,warlock,destruction,56,29,27
Uelimueli,onyxia,1439,warlock,destruction,71,35,36
Rhaelgar,kazzak,1439,warlock,destruction,60,29,31
Stecksen,blackmoore,1438,warlock,destruction,18,15,3
Cursier,blackmoore,1438,warlock,destruction,48,27,21
Auxi,the-maelstrom,1438,warlock,destruction,115,62,53
Cardinall,drakthul,1438,warlock,destruction,124,66,58
Dzimmi,kazzak,1438,warlock,destruction,42,22,20
Morezan,hyjal,1438,warlock,destruction,30,15,15
Ignorantduck,sunstrider,1438,warlock,destruction,51,25,26
Навидд,howling-fjord,1437,warlock,destruction,24,15,9
Gwl,stormscale,1437,warlock,destruction,24,15,9
Wedlock,stormscale,1437,warlock,destruction,70,40,30
Ragequit,xavius,1437,warlock,destruction,29,16,13
Thugsupreme,ravencrest,1437,warlock,destruction,78,41,37
Vicktorious,stormscale,1437,warlock,destruction,419,215,204
Greeylock,blackhand,1436,warlock,destruction,27,18,9
Ketriicken,argent-dawn,1436,warlock,destruction,108,55,53
Mavelya,blackmoore,1436,warlock,destruction,124,62,62
Rhss,stormscale,1436,warlock,destruction,30,15,15
Elldialock,draenor,1436,warlock,destruction,30,15,15
Анвена,soulflayer,1435,warlock,destruction,24,15,9
Kàdszèle,ragnaros,1435,warlock,destruction,34,19,15
Anevrae,argent-dawn,1435,warlock,destruction,58,28,30
Bondejohn,ravencrest,1434,warlock,destruction,30,16,14
Impmuncher,twisting-nether,1434,warlock,destruction,30,15,15
Теснер,gordunni,1434,warlock,destruction,88,39,49
Fynxo,blackmoore,1433,warlock,destruction,24,16,8
Miltuast,blackrock,1433,warlock,destruction,30,19,11
Raknoxyeyeye,blackrock,1433,warlock,destruction,24,15,9
Калестонх,soulflayer,1433,warlock,destruction,72,42,30
Kashdrakor,twisting-nether,1433,warlock,destruction,40,17,23
Stuckhard,silvermoon,1433,warlock,destruction,60,25,35
Gillgarres,twisting-nether,1432,warlock,destruction,250,127,123
Flockyy,draenor,1431,warlock,destruction,28,16,12
Kärringjävel,chamber-of-aspects,1431,warlock,destruction,84,47,37
Mannemus,tarren-mill,1430,warlock,destruction,24,16,8
Slavecry,silvermoon,1430,warlock,destruction,24,15,9
Softcøre,blackmoore,1430,warlock,destruction,48,29,19
Cráxx,onyxia,1430,warlock,destruction,211,107,104
Skuvee,archimonde,1429,warlock,destruction,23,18,5
Surfot,kazzak,1428,warlock,destruction,84,42,42
Chroll,nerathor,1427,warlock,destruction,84,52,32
Sicki,blackrock,1426,warlock,destruction,24,15,9
Deafcult,eonar,1426,warlock,destruction,75,37,38
Honetia,ravencrest,1426,warlock,destruction,86,41,45
Shallý,antonidas,1425,warlock,destruction,30,18,12
Sublînê,blackmoore,1425,warlock,destruction,150,85,65
Муза,gordunni,1425,warlock,destruction,56,30,26
Aparadexth,silvermoon,1424,warlock,destruction,24,15,9
Longdickie,ravencrest,1424,warlock,destruction,42,24,18
Krukke,tarren-mill,1424,warlock,destruction,54,28,26
Galardodric,outland,1424,warlock,destruction,60,30,30
Onyw,onyxia,1424,warlock,destruction,30,15,15
Megalockz,draenor,1423,warlock,destruction,24,15,9
Azgaroth,kazzak,1423,warlock,destruction,268,147,121
Kospar,dun-morogh,1423,warlock,destruction,105,57,48
Rahtireino,darksorrow,1422,warlock,destruction,72,32,40
Suppedo,antonidas,1422,warlock,destruction,94,40,54
Chanibad,emerald-dream,1421,warlock,destruction,24,15,9
Feer,defias-brotherhood,1421,warlock,destruction,72,33,39
Redroach,doomhammer,1420,warlock,destruction,24,16,8
Shazem,tarren-mill,1420,warlock,destruction,24,15,9
Durátor,ravencrest,1419,warlock,destruction,24,15,9
Palatical,terokkar,1419,warlock,destruction,42,21,21
Emalinne,argent-dawn,1419,warlock,destruction,68,31,37
Rosebëaf,archimonde,1418,warlock,destruction,77,36,41
Ðreaðlock,stormscale,1418,warlock,destruction,94,41,53
Mty,bronze-dragonflight,1417,warlock,destruction,53,28,25
Asmonmald,stormscale,1417,warlock,destruction,468,238,230
Graveshaker,quelthalas,1417,warlock,destruction,77,37,40
Animositywl,draenor,1416,warlock,destruction,42,27,15
Elhäbedehä,blackrock,1416,warlock,destruction,30,19,11
Запрещаю,galakrond,1416,warlock,destruction,224,116,108
Rakoru,blackmoore,1416,warlock,destruction,30,15,15
Некусайсасай,galakrond,1415,warlock,destruction,47,30,17
Hydrochloric,emerald-dream,1415,warlock,destruction,36,22,14
Midnigthh,sanguino,1415,warlock,destruction,30,16,14
Waandi,ravencrest,1414,warlock,destruction,58,32,26
Gehirnwäsche,frostwolf,1412,warlock,destruction,34,22,12
Микурочка,gordunni,1412,warlock,destruction,130,65,65
Shadowscurse,sylvanas,1412,warlock,destruction,60,28,32
Mootay,drekthar,1411,warlock,destruction,36,16,20
Lockismymain,eredar,1410,warlock,destruction,30,15,15
Sippe,laughing-skull,1410,warlock,destruction,36,16,20
Бездушный,gordunni,1410,warlock,destruction,36,15,21
Бирел,soulflayer,1409,warlock,destruction,24,15,9
Buddyparty,blackrock,1409,warlock,destruction,52,32,20
Balatonsound,ragnaros,1409,warlock,destruction,36,15,21
Fivestars,tarren-mill,1408,warlock,destruction,101,53,48
Døtzz,blackmoore,1408,warlock,destruction,44,23,21
Azzoaa,defias-brotherhood,1408,warlock,destruction,60,29,31
Vlotsi,twisting-nether,1407,warlock,destruction,20,15,5
Trickyy,azjolnerub,1407,warlock,destruction,69,39,30
Czx,twisting-nether,1407,warlock,destruction,42,22,20
Natsume,ragnaros,1407,warlock,destruction,43,21,22
Bivör,blackmoore,1407,warlock,destruction,110,48,62
Zlohell,drakthul,1405,warlock,destruction,48,30,18
Melow,sanguino,1405,warlock,destruction,65,35,30
Margincalled,kazzak,1405,warlock,destruction,36,18,18
Evaksiá,draenor,1405,warlock,destruction,48,23,25
Wurdulock,silvermoon,1405,warlock,destruction,54,25,29
Левсекси,eversong,1404,warlock,destruction,87,44,43
Vincewl,ravencrest,1404,warlock,destruction,114,57,57
Smadrekas,ravencrest,1404,warlock,destruction,58,25,33
Enaio,mannoroth,1404,warlock,destruction,36,15,21
Enydible,frostmane,1403,warlock,destruction,24,15,9
Senidez,blackhand,1403,warlock,destruction,36,18,18
Valtieri,tarren-mill,1403,warlock,destruction,44,21,23
Faitless,stormscale,1402,warlock,destruction,60,35,25
Swagzz,silvermoon,1402,warlock,destruction,60,34,26
Маларгас,soulflayer,1402,warlock,destruction,230,118,112
Phøénixx,dalaran,1402,warlock,destruction,33,16,17
Lockydavé,outland,1402,warlock,destruction,49,21,28
Vech,blackmoore,1401,warlock,destruction,57,33,24
Lynchian,draenor,1401,warlock,destruction,61,33,28
Зюзерг,soulflayer,1401,warlock,destruction,101,51,50
Facépalm,draenor,1401,warlock,destruction,54,21,33
Darkgainz,draenor,1400,warlock,destruction,39,22,17
Arthesia,archimonde,1400,warlock,destruction,30,16,14
Janemba,ysondre,1400,warlock,destruction,42,21,21
Гупперлок,howling-fjord,1400,warlock,destruction,48,21,27
Setta,argent-dawn,1400,warlock,destruction,54,21,33
Nibblez,shadowsong,1399,warlock,destruction,197,104,93
Maveri,tarren-mill,1398,warlock,destruction,57,32,25
Naavii,bloodscalp,1398,warlock,destruction,60,30,30
Cerberus,argent-dawn,1398,warlock,destruction,63,31,32
Nomakqlock,dun-modr,1397,warlock,destruction,36,23,13
Биохозард,deathguard,1397,warlock,destruction,201,106,95
Naxdas,burning-legion,1397,warlock,destruction,139,68,71
Vahron,kirin-tor,1397,warlock,destruction,97,42,55
Juppîne,aegwynn,1396,warlock,destruction,24,16,8
Barashnukor,blackmoore,1396,warlock,destruction,30,16,14
Birimbau,outland,1396,warlock,destruction,85,40,45
Тэлдвин,gordunni,1395,warlock,destruction,112,60,52
Sinsemilla,turalyon,1395,warlock,destruction,129,69,60
Dobonard,sylvanas,1395,warlock,destruction,38,19,19
Emalk,tarren-mill,1395,warlock,destruction,84,38,46
Xârdâs,blackrock,1395,warlock,destruction,50,21,29
Wajiggity,ravencrest,1394,warlock,destruction,42,23,19
Soulshift,blackmoore,1394,warlock,destruction,78,38,40
Акучабела,gordunni,1393,warlock,destruction,36,17,19
Çhãøsførÿã,blackmoore,1392,warlock,destruction,90,43,47
Прадедка,howling-fjord,1392,warlock,destruction,84,39,45
Essealaes,stormscale,1392,warlock,destruction,56,23,33
Warlockholms,archimonde,1391,warlock,destruction,24,15,9
Airini,draenor,1391,warlock,destruction,26,16,10
Lockboom,kazzak,1391,warlock,destruction,36,20,16
Satanizm,silvermoon,1391,warlock,destruction,96,46,50
Гнильен,soulflayer,1390,warlock,destruction,27,18,9
Шелруа,howling-fjord,1390,warlock,destruction,52,31,21
Vegetita,stormscale,1390,warlock,destruction,221,120,101
Fearhändig,aegwynn,1390,warlock,destruction,63,32,31
Sateerik,draenor,1390,warlock,destruction,55,27,28
Zollon,norgannon,1389,warlock,destruction,23,17,6
Gash,malganis,1389,warlock,destruction,72,37,35
Pommeslock,blackmoore,1389,warlock,destruction,125,62,63
Smileyfacè,silvermoon,1389,warlock,destruction,98,40,58
Smallpee,kazzak,1389,warlock,destruction,53,18,35
Ltany,drakthul,1388,warlock,destruction,24,16,8
Mccøy,archimonde,1388,warlock,destruction,36,19,17
Vanmorgoth,nazjatar,1388,warlock,destruction,30,15,15
Арцах,soulflayer,1388,warlock,destruction,60,29,31
Dotloca,draenor,1388,warlock,destruction,36,17,19
Моориус,soulflayer,1388,warlock,destruction,96,45,51
Culetto,the-venture-co,1388,warlock,destruction,53,23,30
Xshay,dun-modr,1388,warlock,destruction,51,18,33
Larzarus,aegwynn,1386,warlock,destruction,78,36,42
Iriepathie,nozdormu,1385,warlock,destruction,66,30,36
Aelvur,tarren-mill,1385,warlock,destruction,54,21,33
Ренториан,gordunni,1384,warlock,destruction,41,22,19
Hyphonos,blackmoore,1384,warlock,destruction,38,18,20
Deathscréam,burning-legion,1384,warlock,destruction,139,65,74
Línkéd,blackmoore,1384,warlock,destruction,96,43,53
Boltgodx,blackrock,1383,warlock,destruction,66,42,24
Sleive,ravencrest,1383,warlock,destruction,28,15,13
Dracsu,dun-modr,1383,warlock,destruction,49,26,23
Мирмех,gordunni,1383,warlock,destruction,60,29,31
Phennrym,kazzak,1382,warlock,destruction,23,15,8
Zaill,argent-dawn,1382,warlock,destruction,38,21,17
Darthvder,sylvanas,1382,warlock,destruction,61,29,32
Tarhatar,tarren-mill,1382,warlock,destruction,35,16,19
Boomlock,dun-morogh,1382,warlock,destruction,42,17,25
Exitumos,eredar,1381,warlock,destruction,53,27,26
Dxfive,tarren-mill,1381,warlock,destruction,92,46,46
Алхун,razuvious,1381,warlock,destruction,126,61,65
Zombpunk,sanguino,1380,warlock,destruction,172,86,86
Nitecro,blackmoore,1380,warlock,destruction,156,75,81
Devoto,stormscale,1380,warlock,destruction,57,26,31
Diåbló,stormscale,1379,warlock,destruction,188,99,89
Blackmagic,stormscale,1379,warlock,destruction,254,124,130
Ablas,bladefist,1379,warlock,destruction,140,62,78
Trollgubbe,twilights-hammer,1378,warlock,destruction,28,18,10
Lewdrumpslap,kazzak,1377,warlock,destruction,74,43,31
Rafael,stormscale,1377,warlock,destruction,49,27,22
Vooses,draenor,1377,warlock,destruction,59,30,29
Zyasuk,runetotem,1376,warlock,destruction,55,26,29
Repah,doomhammer,1376,warlock,destruction,76,34,42
Хелентесс,goldrinn,1375,warlock,destruction,36,23,13
Eatmabolt,alleria,1375,warlock,destruction,69,36,33
Nexpoze,drakthul,1375,warlock,destruction,42,17,25
Gâlà,elune,1374,warlock,destruction,36,21,15
Ðrussi,hyjal,1374,warlock,destruction,162,82,80
Darklobos,aggra-português,1374,warlock,destruction,42,20,22
Sweetlõck,ravencrest,1373,warlock,destruction,59,25,34
Valkiriaa,saurfang,1372,warlock,destruction,30,18,12
Telaldrah,argent-dawn,1372,warlock,destruction,46,24,22
Loveløck,blackrock,1372,warlock,destruction,35,15,20
Zaklinator,twisting-nether,1371,warlock,destruction,54,30,24
Shindubelore,aggra-português,1371,warlock,destruction,39,18,21
Byeedriver,kazzak,1370,warlock,destruction,22,15,7
Darcîa,destromath,1370,warlock,destruction,39,23,16
Verderbnis,malganis,1370,warlock,destruction,89,50,39
Baskakov,zuljin,1370,warlock,destruction,51,26,25
Ноанс,howling-fjord,1370,warlock,destruction,46,21,25
Chev,nemesis,1369,warlock,destruction,34,24,10
Анархия,gordunni,1369,warlock,destruction,30,17,13
Pookabee,ravencrest,1369,warlock,destruction,36,19,17
Xjms,darksorrow,1369,warlock,destruction,42,16,26
Иванфаков,soulflayer,1368,warlock,destruction,47,21,26
Narzisså,dalaran,1368,warlock,destruction,42,18,24
Sîlverdîze,thrall,1367,warlock,destruction,98,54,44
Eotlid,shattered-hand,1367,warlock,destruction,63,32,31
Demonslayer,khaz-modan,1367,warlock,destruction,48,23,25
Капризх,blackscar,1367,warlock,destruction,42,18,24
Quanchí,kazzak,1366,warlock,destruction,47,27,20
Líok,eredar,1365,warlock,destruction,47,21,26
Hulyekotsog,ragnaros,1364,warlock,destruction,54,37,17
Apôpis,archimonde,1364,warlock,destruction,113,63,50
Карьерщица,booty-bay,1364,warlock,destruction,168,89,79
Elmîr,blackmoore,1364,warlock,destruction,54,26,28
Wichtl,die-ewige-wacht,1364,warlock,destruction,42,19,23
Quebone,tarren-mill,1363,warlock,destruction,75,38,37
Sargal,sylvanas,1363,warlock,destruction,84,42,42
Covariance,nemesis,1363,warlock,destruction,72,29,43
Soldmygranny,kazzak,1362,warlock,destruction,27,17,10
Vakgu,blackmoore,1362,warlock,destruction,47,28,19
Tharaya,ravencrest,1362,warlock,destruction,29,15,14
Backdrip,ragnaros,1362,warlock,destruction,67,34,33
Gomezz,dalaran,1362,warlock,destruction,46,22,24
Gølpilølz,ysondre,1361,warlock,destruction,30,15,15
Whodares,drakthul,1361,warlock,destruction,75,33,42
Gricorby,drakthul,1360,warlock,destruction,23,16,7
Baïlos,conseil-des-ombres,1360,warlock,destruction,55,24,31
Лоллиторпеда,gordunni,1360,warlock,destruction,44,15,29
Cárloz,aegwynn,1359,warlock,destruction,24,15,9
Légréy,blackmoore,1359,warlock,destruction,54,30,24
Lockedaway,ravencrest,1359,warlock,destruction,42,22,20
Hell,twisting-nether,1359,warlock,destruction,65,28,37
Shutdown,sylvanas,1358,warlock,destruction,83,50,33
Mÿxin,blackhand,1358,warlock,destruction,42,19,23
Julsey,kazzak,1357,warlock,destruction,41,22,19
Sesoumaru,azshara,1357,warlock,destruction,106,46,60
Bergerac,archimonde,1357,warlock,destruction,35,15,20
Demosteaks,thrall,1356,warlock,destruction,24,15,9
Chaøsbølt,archimonde,1356,warlock,destruction,25,15,10
Realshady,kazzak,1356,warlock,destruction,30,16,14
Bkp,dun-modr,1356,warlock,destruction,36,16,20
Lulokko,nemesis,1355,warlock,destruction,36,22,14
Cängrë,dun-modr,1355,warlock,destruction,42,25,17
Lxié,ravencrest,1355,warlock,destruction,36,20,16
Dotzéro,ravencrest,1355,warlock,destruction,69,34,35
ßeatrix,tyrande,1355,warlock,destruction,42,17,25
Moonpoxlock,nerathor,1354,warlock,destruction,73,39,34
Diablotiin,hyjal,1354,warlock,destruction,393,197,196
Dotacy,kazzak,1354,warlock,destruction,234,112,122
Horridum,draenor,1354,warlock,destruction,157,69,88
Niszoght,dun-modr,1353,warlock,destruction,158,93,65
Mohawkyz,chamber-of-aspects,1353,warlock,destruction,59,32,27
Voltadol,dun-modr,1353,warlock,destruction,126,65,61
Раздирающая,gordunni,1352,warlock,destruction,76,41,35
Turrôk,blackmoore,1351,warlock,destruction,36,21,15
Boltexpert,twisting-nether,1351,warlock,destruction,30,15,15
Toutseul,eitrigg,1351,warlock,destruction,36,15,21
Алюций,gordunni,1350,warlock,destruction,57,24,33
Crokorc,ysondre,1349,warlock,destruction,107,48,59
Patirass,sanguino,1348,warlock,destruction,73,41,32
Сеннир,ashenvale,1348,warlock,destruction,54,24,30
Harrydôtta,blackmoore,1347,warlock,destruction,56,28,28
Skruios,anetheron,1346,warlock,destruction,70,36,34
Dhraven,thrall,1345,warlock,destruction,126,66,60
Potatowl,ragnaros,1344,warlock,destruction,24,14,10
Holeraa,stormscale,1344,warlock,destruction,225,112,113
Меркус,howling-fjord,1344,warlock,destruction,102,50,52
Ahollic,frostwolf,1343,warlock,destruction,18,14,4
Ðõxßéñðtñqíx,kazzak,1343,warlock,destruction,21,15,6
Toutanpapier,ysondre,1343,warlock,destruction,24,14,10
Archimitros,blackmoore,1343,warlock,destruction,24,14,10
Wildo,grim-batol,1343,warlock,destruction,114,64,50
Demoz,sanguino,1343,warlock,destruction,118,65,53
Hörst,das-konsortium,1343,warlock,destruction,122,58,64
Mudwalkin,ravencrest,1343,warlock,destruction,36,17,19
Hædês,antonidas,1343,warlock,destruction,30,14,16
Setyouinfear,ravencrest,1343,warlock,destruction,30,14,16
Дядяджони,gordunni,1342,warlock,destruction,18,14,4
Ghastlyy,aggra-português,1342,warlock,destruction,18,14,4
Odenbest,silvermoon,1342,warlock,destruction,24,14,10
Cigänä,archimonde,1342,warlock,destruction,24,14,10
Nanotrik,draenor,1342,warlock,destruction,24,14,10
Dakotalock,ravencrest,1342,warlock,destruction,28,15,13
Cahetel,nemesis,1342,warlock,destruction,77,38,39
Лоредо,howling-fjord,1342,warlock,destruction,86,36,50
Flxzshort,kazzak,1341,warlock,destruction,18,14,4
Öxygen,outland,1341,warlock,destruction,24,14,10
Mompets,stormscale,1341,warlock,destruction,36,14,22
Fhla,kazzak,1340,warlock,destruction,18,14,4
Anicetus,ravencrest,1340,warlock,destruction,18,14,4
Hasselbalch,azshara,1340,warlock,destruction,24,14,10
Sidragasoss,drakthul,1340,warlock,destruction,36,17,19
Love,alexstrasza,1339,warlock,destruction,30,18,12
Demirchayan,twisting-nether,1339,warlock,destruction,138,78,60
Salvatoriy,outland,1339,warlock,destruction,32,15,17
Loptous,dunemaul,1339,warlock,destruction,45,20,25
Tmoney,stormscale,1338,warlock,destruction,24,14,10
Pujatia,tarren-mill,1338,warlock,destruction,24,14,10
Lünatix,archimonde,1338,warlock,destruction,42,24,18
Лочундра,gordunni,1338,warlock,destruction,65,33,32
Ryurans,cthun,1338,warlock,destruction,98,49,49
Amakusa,archimonde,1338,warlock,destruction,58,29,29
Kromosonen,ravencrest,1338,warlock,destruction,84,37,47
Bankley,khaz-modan,1337,warlock,destruction,72,36,36
Лобарык,soulflayer,1337,warlock,destruction,59,28,31
Àbraxàs,nemesis,1337,warlock,destruction,149,66,83
Melyagang,hyjal,1336,warlock,destruction,18,14,4
Maenas,ravencrest,1336,warlock,destruction,24,14,10
Teezeyetwo,ragnaros,1336,warlock,destruction,30,14,16
Sécret,blackmoore,1335,warlock,destruction,24,14,10
Inportal,kazzak,1335,warlock,destruction,89,49,40
Darkdax,dethecus,1335,warlock,destruction,30,15,15
Rhev,trollbane,1335,warlock,destruction,62,30,32
Abnørmus,tarren-mill,1334,warlock,destruction,82,47,35
Яичнаялапша,soulflayer,1334,warlock,destruction,30,15,15
Cürsëd,culte-de-la-rive-noire,1334,warlock,destruction,30,14,16
Quentex,antonidas,1334,warlock,destruction,71,33,38
Eleriya,argent-dawn,1334,warlock,destruction,34,15,19
Narstia,archimonde,1334,warlock,destruction,88,38,50
Scader,kazzak,1333,warlock,destruction,36,14,22
Глотающий,gordunni,1332,warlock,destruction,30,19,11
Niiaa,archimonde,1332,warlock,destruction,24,14,10
Ragnarók,area-52,1332,warlock,destruction,27,15,12
Warlockgødx,silvermoon,1332,warlock,destruction,114,60,54
Boohyakka,tarren-mill,1332,warlock,destruction,30,14,16
Sindown,the-maelstrom,1332,warlock,destruction,74,34,40
Sehere,ragnaros,1331,warlock,destruction,38,21,17
Xanth,eldrethalas,1331,warlock,destruction,48,26,22
Sathanas,antonidas,1331,warlock,destruction,30,15,15
Holodream,stormreaver,1331,warlock,destruction,121,57,64
Shadaw,kilrogg,1330,warlock,destruction,18,14,4
Alethéia,stormscale,1330,warlock,destruction,24,14,10
Silkgates,kazzak,1330,warlock,destruction,47,21,26
Talriun,kazzak,1330,warlock,destruction,38,16,22
Primitivaa,dun-modr,1329,warlock,destruction,48,30,18
Ínsidióus,tarren-mill,1329,warlock,destruction,24,14,10
Azrail,anubarak,1329,warlock,destruction,367,182,185
Eldasz,silvermoon,1329,warlock,destruction,50,20,30
Evilonion,outland,1328,warlock,destruction,18,14,4
Bruhoman,kazzak,1328,warlock,destruction,24,15,9
Carthagî,blackmoore,1328,warlock,destruction,66,39,27
Richwitch,ravencrest,1328,warlock,destruction,24,14,10
Dieger,thunderhorn,1328,warlock,destruction,24,14,10
Hyrai,sylvanas,1328,warlock,destruction,24,14,10
Äsmødée,dalaran,1328,warlock,destruction,66,37,29
Danzil,silvermoon,1328,warlock,destruction,36,15,21
Castingsmth,draenor,1327,warlock,destruction,21,17,4
Benzakenta,sylvanas,1327,warlock,destruction,24,14,10
Darkfaxi,outland,1327,warlock,destruction,24,14,10
Dìablò,sylvanas,1327,warlock,destruction,96,54,42
Unkash,zuljin,1327,warlock,destruction,114,61,53
Dÿf,kazzak,1327,warlock,destruction,64,33,31
Ghostflame,tarren-mill,1327,warlock,destruction,100,50,50
Dalamon,draenor,1326,warlock,destruction,24,14,10
Kâzs,dun-modr,1326,warlock,destruction,87,46,41
Merloc,magtheridon,1325,warlock,destruction,50,30,20
Zanhek,kazzak,1325,warlock,destruction,77,42,35
Paranoid,sylvanas,1325,warlock,destruction,48,26,22
Ангебор,howling-fjord,1324,warlock,destruction,149,78,71
Zerokxp,blackmoore,1323,warlock,destruction,22,15,7
Ahylleslook,antonidas,1323,warlock,destruction,30,20,10
Grinspoon,ysondre,1323,warlock,destruction,60,32,28
Matheus,zenedar,1323,warlock,destruction,90,44,46
Эннинотбэд,howling-fjord,1322,warlock,destruction,29,14,15
Thepl,dalaran,1321,warlock,destruction,113,59,54
Wuhdun,burning-legion,1321,warlock,destruction,35,16,19
Akhade,silvermoon,1321,warlock,destruction,90,41,49
Deathpoid,draenor,1321,warlock,destruction,110,46,64
Lowkeyfed,stormscale,1320,warlock,destruction,18,14,4
Scandalfogel,frostmane,1320,warlock,destruction,30,16,14
Ragïa,archimonde,1319,warlock,destruction,28,17,11
Локерио,gordunni,1318,warlock,destruction,24,14,10
Mempricious,ravencrest,1318,warlock,destruction,30,14,16
Ruszczka,burning-legion,1318,warlock,destruction,33,15,18
Corbiejr,tarren-mill,1317,warlock,destruction,162,93,69
Zaerea,ravenholdt,1316,warlock,destruction,60,32,28
Zerx,malganis,1316,warlock,destruction,30,14,16
Tuz,blackrock,1316,warlock,destruction,90,40,50
Luckynòób,ravencrest,1316,warlock,destruction,42,18,24
Kääk,sylvanas,1315,warlock,destruction,108,58,50
Talindra,stormscale,1315,warlock,destruction,56,30,26
Papilena,turalyon,1314,warlock,destruction,24,15,9
Олдхалапеньо,soulflayer,1314,warlock,destruction,54,24,30
Zzombie,sylvanas,1314,warlock,destruction,68,30,38
Askanios,twisting-nether,1313,warlock,destruction,79,45,34
Soultwist,twisting-nether,1313,warlock,destruction,60,29,31
Kokainas,dun-modr,1313,warlock,destruction,54,26,28
Pcbbwarlock,sylvanas,1313,warlock,destruction,36,15,21
Fredysimo,silvermoon,1312,warlock,destruction,42,26,16
Seeles,frostmane,1312,warlock,destruction,30,14,16
Dreadnogg,tarren-mill,1311,warlock,destruction,130,63,67
Wezen,stormscale,1311,warlock,destruction,30,14,16
Toké,blackmoore,1311,warlock,destruction,30,14,16
Donmajor,amanthul,1311,warlock,destruction,48,19,29
Willibolt,blackhand,1311,warlock,destruction,48,17,31
Keilahkang,aerie-peak,1310,warlock,destruction,108,47,61
Kaamosliha,frostwhisper,1309,warlock,destruction,75,43,32
Galath,wrathbringer,1309,warlock,destruction,120,61,59
Angua,azuremyst,1309,warlock,destruction,72,36,36
Nuckki,antonidas,1309,warlock,destruction,534,265,269
Seya,azuremyst,1309,warlock,destruction,30,14,16
Wormies,doomhammer,1309,warlock,destruction,54,25,29
Harrykan,blackrock,1308,warlock,destruction,24,16,8
Эктос,soulflayer,1308,warlock,destruction,36,23,13
Kalemma,kazzak,1308,warlock,destruction,56,30,26
Seagelock,silvermoon,1308,warlock,destruction,108,48,60
Cleoputra,sylvanas,1307,warlock,destruction,38,20,18
Ussetmethrie,kazzak,1307,warlock,destruction,40,19,21
Wazze,azuremyst,1306,warlock,destruction,77,40,37
Mefistto,drakthul,1305,warlock,destruction,30,16,14
Ariyala,alleria,1305,warlock,destruction,47,25,22
Míkæ,ravencrest,1305,warlock,destruction,432,218,214
Kïrah,ysondre,1305,warlock,destruction,68,27,41
Toffifae,argent-dawn,1304,warlock,destruction,24,16,8
Krokator,draenor,1304,warlock,destruction,63,35,28
Plööp,malganis,1304,warlock,destruction,163,82,81
Phéar,deathwing,1304,warlock,destruction,30,14,16
Islazoldyck,draenor,1304,warlock,destruction,122,54,68
Cháos,forscherliga,1304,warlock,destruction,91,40,51
Poulebar,ysondre,1303,warlock,destruction,24,14,10
Blyskawicar,silvermoon,1302,warlock,destruction,18,14,4
Shadeshanox,blackmoore,1302,warlock,destruction,36,23,13
Lokajci,outland,1302,warlock,destruction,37,22,15
Дольпико,howling-fjord,1301,warlock,destruction,60,33,27
Rizzbolt,ravencrest,1301,warlock,destruction,183,94,89
Peardrax,draenor,1301,warlock,destruction,75,38,37
Batráz,tarren-mill,1301,warlock,destruction,172,86,86
Melkorh,twisting-nether,1301,warlock,destruction,47,21,26
Argenus,khazgoroth,1301,warlock,destruction,36,14,22
Tolgaa,draenor,1301,warlock,destruction,44,15,29
Nerokin,blackrock,1300,warlock,destruction,144,82,62
Gåylørd,ravencrest,1300,warlock,destruction,42,16,26
Fêars,blackrock,1299,warlock,destruction,62,34,28
Problemchild,sunstrider,1298,warlock,destruction,120,64,56
Хубаскис,soulflayer,1298,warlock,destruction,61,26,35
Vâgg,blackmoore,1298,warlock,destruction,48,18,30
Dexterr,sylvanas,1297,warlock,destruction,122,61,61
Zillinzy,frostmane,1297,warlock,destruction,30,15,15
Ooliver,kazzak,1296,warlock,destruction,24,14,10
Ädarä,cthun,1296,warlock,destruction,66,33,33
Rumpelelse,blackrock,1294,warlock,destruction,28,16,12
Pensiblesie,runetotem,1294,warlock,destruction,622,308,314
Kar,haomarush,1293,warlock,destruction,139,61,78
Girldoom,silvermoon,1293,warlock,destruction,55,19,36
Narkstzhki,kazzak,1292,warlock,destruction,97,61,36
Chram,uldum,1292,warlock,destruction,89,51,38
Profylaxis,arathor,1292,warlock,destruction,69,38,31
Proflock,drakthul,1292,warlock,destruction,54,28,26
Jadek,ragnaros,1292,warlock,destruction,92,42,50
Raggnarlock,ravencrest,1292,warlock,destruction,54,24,30
Jxø,twisting-nether,1290,warlock,destruction,34,18,16
Regularbag,ravencrest,1290,warlock,destruction,60,30,30
Zerozwolf,tarren-mill,1289,warlock,destruction,54,20,34
Kolosh,twisting-nether,1288,warlock,destruction,56,28,28
Hôjâm,twisting-nether,1287,warlock,destruction,54,27,27
Yahddist,hyjal,1287,warlock,destruction,32,15,17
Useidûm,ravencrest,1287,warlock,destruction,30,14,16
Hurn,thunderhorn,1286,warlock,destruction,84,48,36
Untactful,tarren-mill,1286,warlock,destruction,117,60,57
Nàughty,ragnaros,1285,warlock,destruction,91,39,52
Nicolino,doomhammer,1283,warlock,destruction,72,42,30
Turbofamilly,hyjal,1282,warlock,destruction,23,14,9
Staynecro,malfurion,1282,warlock,destruction,55,27,28
Демонкор,blackscar,1281,warlock,destruction,47,32,15
Chaosftw,archimonde,1281,warlock,destruction,35,17,18
Гангстахохо,soulflayer,1280,warlock,destruction,45,18,27
Îzanamî,aegwynn,1279,warlock,destruction,36,14,22
Southylol,stormscale,1278,warlock,destruction,17,14,3
Deo,confrérie-du-thorium,1278,warlock,destruction,54,33,21
Xfear,blackrock,1277,warlock,destruction,24,16,8
Kycknosa,archimonde,1277,warlock,destruction,26,14,12
Àsh,dun-modr,1277,warlock,destruction,101,47,54
Oishi,kaelthas,1277,warlock,destruction,50,22,28
Modzal,kazzak,1276,warlock,destruction,48,28,20
Xoram,kult-der-verdammten,1276,warlock,destruction,60,29,31
Demohoror,stormscale,1276,warlock,destruction,42,20,22
Zivalelia,silvermoon,1276,warlock,destruction,143,66,77
Phántom,frostmane,1276,warlock,destruction,72,31,41
Longchamp,stormscale,1275,warlock,destruction,28,15,13
Ocaya,kazzak,1275,warlock,destruction,30,16,14
Baalthazar,jaedenar,1275,warlock,destruction,85,43,42
Подликерная,howling-fjord,1274,warlock,destruction,24,18,6
Charmine,tarren-mill,1274,warlock,destruction,42,22,20
Dreamage,exodar,1274,warlock,destruction,54,27,27
Kærastan,sylvanas,1274,warlock,destruction,100,46,54
Filianore,azjolnerub,1273,warlock,destruction,79,38,41
Dégenerat,burning-legion,1272,warlock,destruction,70,38,32
Neetlock,suramar,1272,warlock,destruction,36,19,17
Xhartus,argent-dawn,1271,warlock,destruction,42,18,24
Bahlrok,burning-legion,1270,warlock,destruction,36,19,17
Acohab,draenor,1270,warlock,destruction,36,18,18
Shinamna,tarren-mill,1270,warlock,destruction,30,15,15
Lodem,darksorrow,1270,warlock,destruction,72,31,41
Sulvar,draenor,1269,warlock,destruction,48,22,26
Блэкмайндер,howling-fjord,1268,warlock,destruction,80,44,36
Rezax,blackrock,1268,warlock,destruction,101,55,46
Kåros,argent-dawn,1268,warlock,destruction,37,18,19
Wiitchdoktor,twisting-nether,1268,warlock,destruction,30,14,16
Innok,pozzo-delleternità,1267,warlock,destruction,29,17,12
Lula,drakthul,1266,warlock,destruction,91,58,33
Бутабой,soulflayer,1266,warlock,destruction,87,47,40
Øpaco,khazgoroth,1266,warlock,destruction,65,27,38
Truckpunch,defias-brotherhood,1265,warlock,destruction,40,25,15
Hárdí,tarren-mill,1265,warlock,destruction,24,15,9
Чиназис,gordunni,1265,warlock,destruction,102,49,53
Sovrìn,blackrock,1264,warlock,destruction,20,14,6
Slattkica,draenor,1264,warlock,destruction,24,14,10
Tsumde,dalaran,1264,warlock,destruction,86,43,43
Divvaa,tarren-mill,1264,warlock,destruction,136,65,71
Tabarnak,archimonde,1264,warlock,destruction,30,14,16
Necrolock,tarren-mill,1263,warlock,destruction,47,23,24
Bloodyknight,draenor,1262,warlock,destruction,91,54,37
Klimsonxd,burning-legion,1262,warlock,destruction,28,15,13
Woudstok,ysondre,1260,warlock,destruction,29,15,14
Symbiosis,kazzak,1260,warlock,destruction,102,50,52
Terris,khaz-modan,1260,warlock,destruction,127,62,65
Карамбут,fordragon,1259,warlock,destruction,178,87,91
Üserper,chamber-of-aspects,1259,warlock,destruction,143,64,79
Sorxez,thrall,1258,warlock,destruction,86,40,46
Blackjackk,tarren-mill,1258,warlock,destruction,102,42,60
Pekkoperkele,ravenholdt,1257,warlock,destruction,116,56,60
Capichera,nemesis,1257,warlock,destruction,98,45,53
Kriplock,twisting-nether,1257,warlock,destruction,53,21,32
Krëkk,silvermoon,1256,warlock,destruction,30,14,16
Zuyox,silvermoon,1256,warlock,destruction,53,22,31
Sylrathas,burning-legion,1255,warlock,destruction,117,61,56
Jillyãen,hyjal,1255,warlock,destruction,31,15,16
Ladodida,darkspear,1253,warlock,destruction,50,20,30
Jobbymancer,twisting-nether,1252,warlock,destruction,42,25,17
Dededimons,stormscale,1252,warlock,destruction,104,52,52
Shadowppl,outland,1252,warlock,destruction,32,14,18
Dominvs,silvermoon,1251,warlock,destruction,260,128,132
Hunbeliever,ragnaros,1250,warlock,destruction,36,22,14
Аномаликах,gordunni,1250,warlock,destruction,30,16,14
Dubbzy,outland,1250,warlock,destruction,39,19,20
Вешка,azuregos,1249,warlock,destruction,33,18,15
Oloki,kazzak,1249,warlock,destruction,154,77,77
Oxsen,hyjal,1249,warlock,destruction,60,29,31
Kaakmasta,der-abyssische-rat,1248,warlock,destruction,18,13,5
Sêro,aegwynn,1248,warlock,destruction,18,13,5
Присесть,razuvious,1248,warlock,destruction,51,28,23
Deflagrate,kazzak,1248,warlock,destruction,24,13,11
Kyiüû,archimonde,1248,warlock,destruction,28,15,13
Антарриэль,howling-fjord,1248,warlock,destruction,42,22,20
Демолиша,gordunni,1248,warlock,destruction,34,14,20
Kevinbolter,kult-der-verdammten,1247,warlock,destruction,18,13,5
Mîjagî,blackhand,1247,warlock,destruction,89,47,42
Гулдарий,howling-fjord,1247,warlock,destruction,162,85,77
Felbunni,silvermoon,1247,warlock,destruction,87,39,48
Darkpiche,kazzak,1247,warlock,destruction,36,14,22
Shuggul,draenor,1246,warlock,destruction,18,13,5
Sqxfkndog,ravencrest,1246,warlock,destruction,18,13,5
Needlez,twisting-nether,1246,warlock,destruction,18,13,5
Stunspectoo,turalyon,1246,warlock,destruction,34,23,11
Osyx,ravencrest,1246,warlock,destruction,28,15,13
Mumbay,ragnaros,1246,warlock,destruction,215,107,108
Камнилока,booty-bay,1246,warlock,destruction,66,30,36
Skafferi,tarren-mill,1246,warlock,destruction,30,13,17
Insomniæc,ravencrest,1245,warlock,destruction,18,13,5
Pherlet,sylvanas,1245,warlock,destruction,24,13,11
Pushedover,outland,1245,warlock,destruction,27,14,13
Grumrah,argent-dawn,1245,warlock,destruction,179,83,96
Yhwäch,archimonde,1245,warlock,destruction,48,22,26
Silith,magtheridon,1245,warlock,destruction,74,32,42
Gdkw,tarren-mill,1245,warlock,destruction,84,36,48
Yasagoth,chamber-of-aspects,1245,warlock,destruction,42,16,26
Krachol,emeriss,1244,warlock,destruction,24,13,11
Fidlesticks,ragnaros,1244,warlock,destruction,33,15,18
Shena,chogall,1244,warlock,destruction,30,13,17
Skorpionus,wildhammer,1244,warlock,destruction,48,20,28
Raddikal,archimonde,1243,warlock,destruction,24,13,11
Hannahowo,garona,1243,warlock,destruction,24,13,11
Mystereo,bloodscalp,1243,warlock,destruction,41,21,20
Varyola,twisting-nether,1243,warlock,destruction,96,42,54
Dpsforehead,draenor,1242,warlock,destruction,19,13,6
Cajnik,sylvanas,1242,warlock,destruction,24,13,11
Skâald,senjin,1242,warlock,destruction,91,43,48
Cursecannon,outland,1241,warlock,destruction,18,13,5
Анкхзул,howling-fjord,1240,warlock,destruction,24,13,11
Goodbyex,aegwynn,1240,warlock,destruction,24,13,11
Yumala,frostmourne,1240,warlock,destruction,48,24,24
Jimbrown,eredar,1240,warlock,destruction,50,23,27
Thigh,burning-legion,1240,warlock,destruction,30,13,17
Mentalx,outland,1240,warlock,destruction,30,13,17
Mawdogger,ravencrest,1239,warlock,destruction,18,13,5
Phît,kilrogg,1239,warlock,destruction,24,13,11
Lézion,hyjal,1239,warlock,destruction,27,14,13
Raspalakuja,kazzak,1239,warlock,destruction,30,13,17
Shagrab,nemesis,1238,warlock,destruction,63,36,27
Painowgee,kazzak,1238,warlock,destruction,30,13,17
Somanydots,twisting-nether,1237,warlock,destruction,120,57,63
Xaok,dun-modr,1237,warlock,destruction,35,15,20
Møärdötd,aggra-português,1236,warlock,destruction,18,13,5
Pyroplasmic,tarren-mill,1236,warlock,destruction,77,46,31
Braveonê,twisting-nether,1236,warlock,destruction,126,63,63
Firinmalazor,blackrock,1236,warlock,destruction,72,35,37
Rawrix,blackrock,1236,warlock,destruction,30,13,17
Pentalock,blackmoore,1235,warlock,destruction,24,13,11
Vulgrim,kirin-tor,1235,warlock,destruction,75,37,38
Finjas,azjolnerub,1235,warlock,destruction,72,34,38
Radanras,blackmoore,1234,warlock,destruction,24,13,11
Rodhad,kazzak,1234,warlock,destruction,24,13,11
Dotcha,ravencrest,1233,warlock,destruction,66,41,25
Heximexi,malganis,1233,warlock,destruction,42,21,21
Zhoxx,outland,1233,warlock,destruction,30,13,17
Глянемче,deathguard,1233,warlock,destruction,40,17,23
Vae,doomhammer,1232,warlock,destruction,24,13,11
Scud,frostwolf,1232,warlock,destruction,24,13,11
Felrazer,silvermoon,1232,warlock,destruction,30,13,17
Crysy,confrérie-du-thorium,1232,warlock,destruction,30,13,17
Бесстолоч,ashenvale,1232,warlock,destruction,30,13,17
Veinh,archimonde,1231,warlock,destruction,24,17,7
Dér,sanguino,1231,warlock,destruction,24,13,11
Mantimond,uldum,1231,warlock,destruction,213,107,106
Aurelíá,ravencrest,1231,warlock,destruction,71,32,39
Инсип,blackscar,1230,warlock,destruction,24,14,10
Murphloc,silvermoon,1230,warlock,destruction,38,20,18
Arnoediad,twisting-nether,1230,warlock,destruction,45,18,27
Najash,silvermoon,1228,warlock,destruction,66,32,34
Rottend,aggra-português,1228,warlock,destruction,87,38,49
Keibo,drakthul,1228,warlock,destruction,30,13,17
Wolferand,argent-dawn,1228,warlock,destruction,42,17,25
Ромаколдун,howling-fjord,1227,warlock,destruction,30,13,17
Drfóx,draenor,1227,warlock,destruction,59,24,35
Келебрах,howling-fjord,1226,warlock,destruction,18,13,5
Cryd,thrall,1226,warlock,destruction,18,13,5
Blackojrien,outland,1226,warlock,destruction,24,13,11
Tepegöz,korgall,1226,warlock,destruction,28,14,14
Азерок,howling-fjord,1226,warlock,destruction,76,37,39
Kaobolt,archimonde,1226,warlock,destruction,42,18,24
Hêíîrähû,kazzak,1225,warlock,destruction,24,16,8
Байронет,gordunni,1225,warlock,destruction,30,13,17
Samigina,argent-dawn,1224,warlock,destruction,41,16,25
Lokibra,antonidas,1223,warlock,destruction,131,62,69
Hejhana,drakthul,1223,warlock,destruction,126,57,69
Cocottee,la-croisade-écarlate,1222,warlock,destruction,33,17,16
Puiia,draenor,1221,warlock,destruction,120,64,56
Кискатёмная,blackscar,1221,warlock,destruction,215,104,111
Adriankolock,sylvanas,1220,warlock,destruction,19,13,6
Chickoz,eredar,1220,warlock,destruction,109,57,52
Nopower,dun-morogh,1220,warlock,destruction,53,27,26
Góblér,blackrock,1219,warlock,destruction,51,26,25
Diseased,darksorrow,1218,warlock,destruction,132,75,57
Fiendy,tarren-mill,1218,warlock,destruction,30,14,16
Chochliko,silvermoon,1218,warlock,destruction,36,13,23
Whippet,nemesis,1217,warlock,destruction,18,13,5
Westfaliu,blackhand,1217,warlock,destruction,66,24,42
Bangbrös,stormscale,1216,warlock,destruction,24,13,11
Saereda,kazzak,1216,warlock,destruction,75,39,36
Borrìs,blackhand,1216,warlock,destruction,160,83,77
Oldemoilépti,hyjal,1216,warlock,destruction,30,14,16
Senaida,sylvanas,1215,warlock,destruction,88,49,39
Artyrus,burning-legion,1215,warlock,destruction,110,56,54
Гулдас,thermaplugg,1214,warlock,destruction,45,22,23
Kneereap,antonidas,1213,warlock,destruction,63,34,29
Bandìtten,alakir,1213,warlock,destruction,28,15,13
Asmodaî,anubarak,1213,warlock,destruction,127,63,64
Guntok,tarren-mill,1211,warlock,destruction,37,22,15
Ammitra,argent-dawn,1211,warlock,destruction,33,16,17
Ganesha,sanguino,1210,warlock,destruction,35,16,19
Lucifa,arthas,1210,warlock,destruction,78,31,47
Hyòx,aegwynn,1209,warlock,destruction,116,52,64
Wxl,kazzak,1208,warlock,destruction,60,39,21
Sicktir,aerie-peak,1208,warlock,destruction,100,49,51
Карлон,fordragon,1208,warlock,destruction,39,16,23
Крутизол,fordragon,1206,warlock,destruction,43,25,18
Lokko,nemesis,1205,warlock,destruction,42,23,19
Patricius,malfurion,1205,warlock,destruction,29,13,16
Seymor,amanthul,1203,warlock,destruction,48,22,26
Ayóó,doomhammer,1202,warlock,destruction,107,58,49
Drthc,kazzak,1202,warlock,destruction,36,17,19
Mirrorz,kazzak,1200,warlock,destruction,47,24,23
Babayagâ,sanguino,1199,warlock,destruction,63,30,33
Gosa,gorgonnash,1198,warlock,destruction,36,22,14
Нотимба,gordunni,1198,warlock,destruction,48,28,20
Sortiarius,silvermoon,1198,warlock,destruction,110,60,50
Macinek,burning-blade,1198,warlock,destruction,84,39,45
Zenondoros,arthas,1195,warlock,destruction,21,13,8
Имморталх,soulflayer,1195,warlock,destruction,38,17,21
Máleficent,azshara,1195,warlock,destruction,30,13,17
Гринлайм,howling-fjord,1193,warlock,destruction,98,48,50
Lîlu,hyjal,1193,warlock,destruction,42,16,26
Fearmex,turalyon,1191,warlock,destruction,42,21,21
Стафилокок,deepholm,1190,warlock,destruction,23,13,10
Jackdot,antonidas,1190,warlock,destruction,24,13,11
Emoriy,blackmoore,1190,warlock,destruction,64,34,30
Plague,twisting-nether,1188,warlock,destruction,27,14,13
Binkybabes,outland,1188,warlock,destruction,57,27,30
Neffy,sinstralis,1188,warlock,destruction,76,31,45
Johntrabolta,chogall,1187,warlock,destruction,88,46,42
Irókuzito,aggra-português,1185,warlock,destruction,24,13,11
Ðârk,silvermoon,1185,warlock,destruction,106,39,67
Nelektaus,stormscale,1182,warlock,destruction,30,14,16
Idleglance,outland,1181,warlock,destruction,17,13,4
Дифарес,gordunni,1180,warlock,destruction,51,29,22
Oxypvp,ravencrest,1179,warlock,destruction,69,27,42
Joopz,ravencrest,1177,warlock,destruction,63,33,30
Phàine,outland,1177,warlock,destruction,35,14,21
Kaeos,ravencrest,1176,warlock,destruction,24,15,9
Smuutil,drakthul,1176,warlock,destruction,36,20,16
Darkà,rexxar,1176,warlock,destruction,42,21,21
Bèkshà,blackrock,1176,warlock,destruction,26,13,13
Stonysalami,turalyon,1175,warlock,destruction,42,28,14
Локкрис,blackscar,1175,warlock,destruction,98,48,50
Áéé,kazzak,1175,warlock,destruction,46,21,25
Fathernurgle,hellfire,1173,warlock,destruction,99,53,46
Ðestrucko,burning-legion,1170,warlock,destruction,127,55,72
Lovrog,twisting-nether,1169,warlock,destruction,21,13,8
Öyo,outland,1169,warlock,destruction,254,127,127
Харрам,howling-fjord,1169,warlock,destruction,42,21,21
Thorenss,medivh,1168,warlock,destruction,128,61,67
Jossim,outland,1167,warlock,destruction,83,42,41
Армдэд,galakrond,1167,warlock,destruction,47,14,33
Cocadémo,archimonde,1166,warlock,destruction,31,13,18
Neprux,burning-blade,1165,warlock,destruction,135,59,76
Troo,daggerspine,1165,warlock,destruction,30,13,17
Xydar,stormscale,1163,warlock,destruction,54,25,29
Aldyst,ragnaros,1163,warlock,destruction,47,20,27
Íntikam,blackrock,1160,warlock,destruction,54,25,29
Arkatraz,blackhand,1159,warlock,destruction,60,28,32
Krastey,malfurion,1157,warlock,destruction,22,13,9
Cozyboi,thrall,1156,warlock,destruction,204,104,100
Drillingsdad,dun-morogh,1155,warlock,destruction,73,31,42
Traickolock,antonidas,1152,warlock,destruction,18,12,6
Мэрджис,soulflayer,1152,warlock,destruction,18,12,6
Phobilock,guldan,1152,warlock,destruction,18,12,6
Dotjürgen,blackrock,1152,warlock,destruction,18,12,6
Низвестнно,soulflayer,1152,warlock,destruction,18,12,6
Yzzie,drakthul,1152,warlock,destruction,18,12,6
Feemers,thrall,1152,warlock,destruction,18,12,6
Lìmè,silvermoon,1152,warlock,destruction,24,12,12
Ðotbot,grim-batol,1152,warlock,destruction,24,12,12
Ekàti,ravencrest,1152,warlock,destruction,24,12,12
Консидёро,gordunni,1152,warlock,destruction,30,12,18
Leman,sylvanas,1151,warlock,destruction,18,12,6
Destrodmitri,blackmoore,1151,warlock,destruction,18,12,6
Jkz,blackrock,1151,warlock,destruction,21,13,8
Wspolnax,ravencrest,1151,warlock,destruction,24,12,12
Negoda,defias-brotherhood,1151,warlock,destruction,100,48,52
Estefanía,tarren-mill,1150,warlock,destruction,18,12,6
Yamadea,stormscale,1150,warlock,destruction,18,12,6
Kikaikek,stormscale,1150,warlock,destruction,18,12,6
Tastemyzbay,hyjal,1150,warlock,destruction,24,12,12
Zyggdrasil,hyjal,1150,warlock,destruction,24,12,12
Warlockxx,ravencrest,1150,warlock,destruction,24,12,12
Zehirisalari,twisting-nether,1150,warlock,destruction,36,12,24
Scadar,kazzak,1149,warlock,destruction,18,12,6
Cárrymemommy,ravencrest,1149,warlock,destruction,18,12,6
Dallar,stormscale,1149,warlock,destruction,18,12,6
Irwene,argent-dawn,1149,warlock,destruction,24,12,12
Qwyncess,archimonde,1149,warlock,destruction,24,12,12
Sorrayá,eredar,1148,warlock,destruction,77,34,43
ßritneyfears,blackmoore,1148,warlock,destruction,30,12,18
Kieman,tarren-mill,1148,warlock,destruction,36,12,24
Getup,arthas,1147,warlock,destruction,24,12,12
Höfmänn,grim-batol,1147,warlock,destruction,24,12,12
Mewd,hyjal,1147,warlock,destruction,24,12,12
Hexam,blackmoore,1147,warlock,destruction,30,12,18
Forgepower,ghostlands,1146,warlock,destruction,24,12,12
Favorizlmp,archimonde,1146,warlock,destruction,24,12,12
Mjuklock,ravencrest,1146,warlock,destruction,24,12,12
Lomis,wrathbringer,1146,warlock,destruction,97,45,52
Критолог,borean-tundra,1146,warlock,destruction,30,12,18
Solomohn,steamwheedle-cartel,1145,warlock,destruction,18,13,5
Yzïah,blackrock,1145,warlock,destruction,18,12,6
Thicklock,twisting-nether,1144,warlock,destruction,42,20,22
Jinxzed,frostwhisper,1143,warlock,destruction,18,12,6
Fangdred,twisting-nether,1143,warlock,destruction,24,12,12
Moardotts,ravencrest,1143,warlock,destruction,25,12,13
Ionutmanea,ravencrest,1143,warlock,destruction,41,16,25
Зажиженный,soulflayer,1142,warlock,destruction,21,12,9
Dathos,ragnaros,1142,warlock,destruction,54,26,28
Psychofear,kazzak,1142,warlock,destruction,30,12,18
Kuntdotz,draenor,1141,warlock,destruction,24,12,12
Чпокерша,deepholm,1141,warlock,destruction,52,22,30
Numlockz,jaedenar,1141,warlock,destruction,30,12,18
Atruruz,antonidas,1140,warlock,destruction,101,52,49
Hymirr,arathor,1140,warlock,destruction,31,12,19
Вериберри,gordunni,1139,warlock,destruction,24,12,12
Yudy,burning-legion,1137,warlock,destruction,25,13,12
Whine,uldum,1137,warlock,destruction,149,75,74
Omnigul,grim-batol,1137,warlock,destruction,92,46,46
Halacska,arathor,1137,warlock,destruction,24,12,12
Ezekîél,blackhand,1137,warlock,destruction,156,68,88
Скул,soulflayer,1137,warlock,destruction,30,12,18
Rampelnicka,burning-blade,1135,warlock,destruction,24,12,12
Äiriss,hyjal,1135,warlock,destruction,30,12,18
Делегент,deathguard,1134,warlock,destruction,114,44,70
Wildlily,aggramar,1131,warlock,destruction,46,24,22
Nirây,thrall,1131,warlock,destruction,61,19,42
Shadowflare,blackmoore,1130,warlock,destruction,38,15,23
Valkiá,earthen-ring,1129,warlock,destruction,112,57,55
Panicbolt,ravencrest,1129,warlock,destruction,24,12,12
Bojjisama,silvermoon,1128,warlock,destruction,18,12,6
Drdotalot,twisting-nether,1126,warlock,destruction,24,12,12
Squát,kazzak,1125,warlock,destruction,24,12,12
Whiskeycola,blackmoore,1124,warlock,destruction,18,12,6
Rrore,ravencrest,1124,warlock,destruction,24,12,12
Тарналор,gordunni,1124,warlock,destruction,36,14,22
Стейн,soulflayer,1120,warlock,destruction,57,24,33
Xioom,thrall,1120,warlock,destruction,52,17,35
Laanik,twisting-nether,1119,warlock,destruction,20,13,7
Лузер,blackscar,1119,warlock,destruction,58,17,41
Fiddlock,draenor,1117,warlock,destruction,22,13,9
Shololock,kazzak,1116,warlock,destruction,20,13,7
Aftxrlife,arathor,1116,warlock,destruction,22,13,9
Noobtamer,kazzak,1116,warlock,destruction,23,12,11
Langeklunker,outland,1116,warlock,destruction,24,12,12
Биги,eversong,1115,warlock,destruction,47,16,31
Kharless,kazzak,1114,warlock,destruction,49,25,24
Микрочпоньк,galakrond,1113,warlock,destruction,24,14,10
Слававдвх,blackscar,1112,warlock,destruction,84,48,36
Tid,burning-legion,1112,warlock,destruction,23,12,11
Çüñ,shattered-hand,1111,warlock,destruction,23,12,11
Maxxilla,twisting-nether,1111,warlock,destruction,258,124,134
Шоуганай,soulflayer,1110,warlock,destruction,67,35,32
Synnox,blackrock,1108,warlock,destruction,36,20,16
Gastkäft,shadowsong,1105,warlock,destruction,73,34,39
Naniika,blackmoore,1104,warlock,destruction,84,50,34
Mîtskî,argent-dawn,1104,warlock,destruction,44,19,25
Bigdambolt,blackrock,1103,warlock,destruction,17,12,5
Lagoren,draenor,1102,warlock,destruction,24,12,12
Runthejewels,ragnaros,1101,warlock,destruction,30,12,18
Warvoid,silvermoon,1101,warlock,destruction,34,12,22
Whitebanshee,turalyon,1099,warlock,destruction,54,31,23
Fatality,drakthul,1099,warlock,destruction,26,13,13
Pidka,drakthul,1098,warlock,destruction,24,17,7
Demonmilf,ysondre,1098,warlock,destruction,23,12,11
Rikkai,anubarak,1096,warlock,destruction,24,12,12
Hivxherpes,ravencrest,1095,warlock,destruction,29,12,17
Kharzug,alakir,1093,warlock,destruction,56,24,32
Rasputia,thunderhorn,1091,warlock,destruction,127,65,62
Даркинсоул,soulflayer,1090,warlock,destruction,21,13,8
Loriene,trollbane,1088,warlock,destruction,46,21,25
Yokûjin,twisting-nether,1087,warlock,destruction,23,12,11
Уставок,soulflayer,1087,warlock,destruction,42,20,22
Drfresh,dun-modr,1087,warlock,destruction,78,30,48
Cuteyess,shadowsong,1086,warlock,destruction,23,12,11
Евнухоидизм,gordunni,1086,warlock,destruction,68,30,38
Elshinko,stormscale,1086,warlock,destruction,32,13,19
Buserella,eredar,1085,warlock,destruction,30,12,18
Vendømlørd,archimonde,1083,warlock,destruction,36,12,24
Allehar,burning-legion,1080,warlock,destruction,24,14,10
Qloss,burning-legion,1080,warlock,destruction,56,25,31
Bunnyflow,blackmoore,1080,warlock,destruction,34,13,21
Ruul,sanguino,1079,warlock,destruction,50,20,30
Lárgo,chamber-of-aspects,1078,warlock,destruction,53,24,29
Skybert,sunstrider,1077,warlock,destruction,30,15,15
Konstantína,eredar,1076,warlock,destruction,217,108,109
Zesekk,blackmoore,1073,warlock,destruction,198,88,110
Jinckslock,anachronos,1072,warlock,destruction,13,12,1
Vyku,burning-legion,1070,warlock,destruction,36,12,24
Ymersai,stormscale,1069,warlock,destruction,105,49,56
Адомать,lich-king,1068,warlock,destruction,30,13,17
Cainn,kilrogg,1067,warlock,destruction,48,23,25
Хефрак,deathguard,1067,warlock,destruction,139,65,74
Demonjailer,kazzak,1067,warlock,destruction,27,12,15
Marann,dun-morogh,1066,warlock,destruction,44,26,18
Nôgariûs,blackrock,1065,warlock,destruction,29,13,16
Kayoss,auchindoun,1063,warlock,destruction,36,16,20
Lefttorot,garrosh,1062,warlock,destruction,52,24,28
Korne,nemesis,1061,warlock,destruction,124,52,72
Amon,suramar,1058,warlock,destruction,55,28,27
Babidí,blackmoore,1057,warlock,destruction,48,27,21
Hexiønløck,archimonde,1056,warlock,destruction,12,11,1
Kënnyfõx,ysondre,1056,warlock,destruction,12,11,1
Fjutta,outland,1056,warlock,destruction,18,11,7
Незерлок,soulflayer,1056,warlock,destruction,18,11,7
Projectlock,draenor,1056,warlock,destruction,18,11,7
Kankbae,stormscale,1056,warlock,destruction,18,11,7
Ltoplaylock,turalyon,1056,warlock,destruction,18,11,7
Кремация,blackscar,1056,warlock,destruction,18,11,7
Teemzen,tarren-mill,1056,warlock,destruction,24,11,13
Ratziel,sylvanas,1056,warlock,destruction,42,15,27
Rüjï,sanguino,1056,warlock,destruction,54,19,35
Resterx,blackhand,1055,warlock,destruction,12,11,1
Goatsoklm,archimonde,1055,warlock,destruction,18,11,7
Øprøx,sanguino,1055,warlock,destruction,18,11,7
Neverfearjk,aegwynn,1055,warlock,destruction,18,11,7
Razzalock,eredar,1055,warlock,destruction,24,11,13
Dalyvan,blackrock,1055,warlock,destruction,24,11,13
Methmuncher,twisting-nether,1055,warlock,destruction,50,19,31
Asper,ragnaros,1055,warlock,destruction,30,11,19
Boltsnhoes,tarren-mill,1055,warlock,destruction,30,11,19
Ronniee,moonglade,1054,warlock,destruction,18,11,7
Buudds,frostmane,1054,warlock,destruction,18,11,7
Dontargetme,draenor,1054,warlock,destruction,18,11,7
Tørcal,hyjal,1054,warlock,destruction,18,11,7
Archí,twisting-nether,1054,warlock,destruction,18,11,7
Finlock,kult-der-verdammten,1054,warlock,destruction,21,12,9
Elmáestro,aegwynn,1054,warlock,destruction,21,12,9
Ullalol,magtheridon,1054,warlock,destruction,24,11,13
Zordochlock,kazzak,1054,warlock,destruction,24,11,13
Jelessa,lordaeron,1054,warlock,destruction,24,11,13
Lilkit,kazzak,1054,warlock,destruction,36,11,25
Ржоммба,soulflayer,1053,warlock,destruction,18,11,7
Хэлласс,blackscar,1053,warlock,destruction,24,11,13
Shadowthrone,ragnaros,1053,warlock,destruction,24,11,13
Sôlon,azshara,1053,warlock,destruction,24,11,13
Yenex,blackhand,1053,warlock,destruction,32,14,18
Phicon,silvermoon,1052,warlock,destruction,18,11,7
Костикк,howling-fjord,1052,warlock,destruction,18,11,7
Harrydóttár,draenor,1052,warlock,destruction,24,11,13
Jasdemonly,stormscale,1052,warlock,destruction,24,11,13
Numidia,tarren-mill,1051,warlock,destruction,24,11,13
Disgraced,stormscale,1051,warlock,destruction,24,11,13
Katâra,tarren-mill,1051,warlock,destruction,30,11,19
Peterpaîn,blackmoore,1050,warlock,destruction,22,14,8
Hargart,ysondre,1050,warlock,destruction,18,11,7
Kuknissen,kazzak,1050,warlock,destruction,18,11,7
Nelor,tarren-mill,1050,warlock,destruction,27,15,12
Oralnatqga,draenor,1050,warlock,destruction,76,31,45
Vraduk,malygos,1049,warlock,destruction,32,19,13
Jynni,blackhand,1048,warlock,destruction,18,11,7
Rylewl,draenor,1048,warlock,destruction,30,11,19
Рыжевласочка,eversong,1046,warlock,destruction,21,12,9
Kontanthjælp,tarren-mill,1046,warlock,destruction,30,11,19
Лойд,goldrinn,1046,warlock,destruction,30,11,19
Yénnéfér,ravencrest,1046,warlock,destruction,33,11,22
Diavoletta,pozzo-delleternità,1046,warlock,destruction,48,11,37
Esthrella,thrall,1044,warlock,destruction,85,45,40
Wòóni,ravencrest,1044,warlock,destruction,38,15,23
Happysrme,thrall,1043,warlock,destruction,79,29,50
Pff,emeriss,1042,warlock,destruction,47,24,23
Emmadotson,gorgonnash,1042,warlock,destruction,30,11,19
Ðear,blackrock,1041,warlock,destruction,18,11,7
Дулаан,blackscar,1041,warlock,destruction,46,17,29
Galaxywl,silvermoon,1041,warlock,destruction,30,11,19
Drainerlolx,outland,1040,warlock,destruction,19,11,8
Tbb,ravencrest,1040,warlock,destruction,24,11,13
Waîdo,blackhand,1040,warlock,destruction,30,11,19
Nefariousz,bloodfeather,1039,warlock,destruction,17,11,6
Riitaall,khaz-modan,1038,warlock,destruction,78,30,48
Pallma,tarren-mill,1038,warlock,destruction,30,11,19
Galagoat,archimonde,1036,warlock,destruction,54,28,26
Olympos,draenor,1036,warlock,destruction,66,30,36
Kokonix,defias-brotherhood,1033,warlock,destruction,24,11,13
Nathgar,drakthul,1032,warlock,destruction,72,27,45
Äzarel,khaz-modan,1031,warlock,destruction,48,29,19
Tommies,die-nachtwache,1031,warlock,destruction,57,24,33
Precks,eredar,1031,warlock,destruction,30,11,19
Discolocken,outland,1030,warlock,destruction,30,12,18
Killerbeez,burning-blade,1029,warlock,destruction,60,21,39
Sitosa,thrall,1027,warlock,destruction,18,11,7
Accursîus,blackmoore,1027,warlock,destruction,21,11,10
Schöp,der-rat-von-dalaran,1027,warlock,destruction,71,32,39
Demonoulis,bloodhoof,1026,warlock,destruction,18,11,7
Loliloz,les-clairvoyants,1026,warlock,destruction,35,18,17
Ainzlok,tarren-mill,1026,warlock,destruction,68,33,35
Maimonides,silvermoon,1025,warlock,destruction,35,17,18
Fromfuneral,anetheron,1024,warlock,destruction,200,105,95
Nava,stormscale,1024,warlock,destruction,28,12,16
Crippling,antonidas,1024,warlock,destruction,81,32,49
Fguldan,zuljin,1023,warlock,destruction,16,11,5
Orisess,bronze-dragonflight,1022,warlock,destruction,147,75,72
Bribon,sanguino,1019,warlock,destruction,128,49,79
Avati,sargeras,1018,warlock,destruction,30,14,16
Бигтедок,gordunni,1017,warlock,destruction,170,84,86
Kritcheq,alakir,1016,warlock,destruction,110,52,58
Klasikas,kazzak,1016,warlock,destruction,27,12,15
Tarot,terokkar,1015,warlock,destruction,24,11,13
Avoidsun,kazzak,1013,warlock,destruction,34,12,22
Zardøx,khaz-modan,1009,warlock,destruction,18,12,6
Oonz,sylvanas,1007,warlock,destruction,35,14,21
Condalini,runetotem,1005,warlock,destruction,80,40,40
Mângo,thunderhorn,1004,warlock,destruction,24,11,13
Ванфирмен,gordunni,1004,warlock,destruction,24,11,13
Llilith,bronzebeard,1003,warlock,destruction,24,11,13
Mïllâïneeqtx,archimonde,1002,warlock,destruction,19,13,6
Babayagaa,drakthul,1002,warlock,destruction,26,11,15
Iltharian,die-todeskrallen,1000,warlock,destruction,17,11,6
Jaqqy,blackmoore,997,warlock,destruction,56,30,26
Desolador,tyrande,996,warlock,destruction,23,11,12
Jackwizzer,dalaran,995,warlock,destruction,42,11,31
Petrosk,sanguino,990,warlock,destruction,26,11,15
Ottu,thrall,988,warlock,destruction,20,11,9
Lynchéd,argent-dawn,986,warlock,destruction,17,11,6
Ömegaa,hyjal,985,warlock,destruction,20,11,9
Sînâ,anubarak,984,warlock,destruction,36,11,25
Llilithh,draenor,983,warlock,destruction,16,11,5
Ileeo,kazzak,980,warlock,destruction,73,38,35
Dorothy,steamwheedle-cartel,978,warlock,destruction,24,15,9
Dakc,kazzak,978,warlock,destruction,60,22,38
Hêxêr,terrordar,977,warlock,destruction,54,27,27
Шайтанарба,blackscar,977,warlock,destruction,42,17,25
Scrabblee,dun-morogh,976,warlock,destruction,30,11,19
Thorins,sinstralis,972,warlock,destruction,30,12,18
Sickdotter,outland,971,warlock,destruction,77,29,48
Ахпорбес,gordunni,968,warlock,destruction,30,16,14
Gâlvâtorix,frostmourne,968,warlock,destruction,90,39,51
Huesecillo,sanguino,967,warlock,destruction,24,14,10
Àtreyù,daggerspine,966,warlock,destruction,128,53,75
Vinilio,kazzak,963,warlock,destruction,98,40,58
Blâckmagíc,thrall,962,warlock,destruction,26,13,13
Demox,arathor,962,warlock,destruction,26,11,15
Tchytcha,archimonde,961,warlock,destruction,59,28,31
Jamuhlee,der-abyssische-rat,960,warlock,destruction,12,10,2
Joinx,tarren-mill,960,warlock,destruction,12,10,2
Lurian,silvermoon,960,warlock,destruction,12,10,2
Slomg,sylvanas,960,warlock,destruction,12,10,2
Garb,stormreaver,960,warlock,destruction,12,10,2
Graystache,blackhand,960,warlock,destruction,12,10,2
Nerfmeplz,archimonde,960,warlock,destruction,12,10,2
Macklemore,twisting-nether,960,warlock,destruction,12,10,2
Botrotation,ravencrest,960,warlock,destruction,12,10,2
Korialstraz,sylvanas,960,warlock,destruction,12,10,2
Ðåñtåy,ravencrest,960,warlock,destruction,18,10,8
Dst,ravencrest,960,warlock,destruction,18,10,8
Trickytée,tarren-mill,960,warlock,destruction,18,10,8
Tøtøf,sargeras,960,warlock,destruction,18,10,8
Dmnw,antonidas,960,warlock,destruction,18,10,8
Adoxilock,twisting-nether,960,warlock,destruction,18,10,8
Gutrass,ragnaros,960,warlock,destruction,18,10,8
Ilovethena,hyjal,960,warlock,destruction,18,10,8
Zzooxxie,silvermoon,960,warlock,destruction,18,10,8
Chaotick,burning-legion,960,warlock,destruction,18,10,8
Zzooxx,silvermoon,960,warlock,destruction,18,10,8
Turdy,sylvanas,960,warlock,destruction,18,10,8
Ммоохх,gordunni,960,warlock,destruction,18,10,8
Imissbfa,stormscale,960,warlock,destruction,22,11,11
Destrolockz,tarren-mill,960,warlock,destruction,22,11,11
Chainlinc,turalyon,960,warlock,destruction,54,25,29
Skali,stormrage,960,warlock,destruction,24,10,14
Demonqueens,kazzak,959,warlock,destruction,12,10,2
Zízýéró,sylvanas,959,warlock,destruction,12,10,2
Ammilock,aszune,959,warlock,destruction,12,10,2
Droguri,darkspear,959,warlock,destruction,12,10,2
Femalenjoyer,tarren-mill,959,warlock,destruction,18,10,8
Kekbólt,twisting-nether,959,warlock,destruction,18,10,8
Dotáhoe,twisting-nether,959,warlock,destruction,18,10,8
Positivitywl,stormscale,959,warlock,destruction,18,10,8
Chaostrain,sylvanas,959,warlock,destruction,18,10,8
Boomdalf,silvermoon,959,warlock,destruction,18,10,8
Vät,kirin-tor,959,warlock,destruction,18,10,8
Vexsir,kazzak,959,warlock,destruction,21,11,10
Kaldun,outland,959,warlock,destruction,24,10,14
Колмидедди,gordunni,959,warlock,destruction,24,10,14
Ladlocklul,silvermoon,959,warlock,destruction,24,10,14
Shazalock,frostmane,959,warlock,destruction,24,10,14
Campanile,ravencrest,959,warlock,destruction,24,10,14
Dabolt,archimonde,959,warlock,destruction,24,10,14
Necromonger,blackrock,959,warlock,destruction,24,10,14
Clopot,ravencrest,959,warlock,destruction,24,10,14
Mèsmerize,tarren-mill,959,warlock,destruction,27,11,16
Ogrez,nemesis,959,warlock,destruction,30,10,20
Slâyâ,blackrock,958,warlock,destruction,12,10,2
Drainurlife,zenedar,958,warlock,destruction,18,10,8
Kenybalajze,the-maelstrom,958,warlock,destruction,18,10,8
Dampini,ravencrest,958,warlock,destruction,18,10,8
Релента,gordunni,958,warlock,destruction,18,10,8
Mozo,stormscale,958,warlock,destruction,18,10,8
Filippö,eredar,958,warlock,destruction,18,10,8
Revhy,ravencrest,958,warlock,destruction,18,10,8
Kwei,nemesis,958,warlock,destruction,18,10,8
Banette,sylvanas,958,warlock,destruction,18,10,8
Scryed,draenor,958,warlock,destruction,18,10,8
Cryks,blackmoore,958,warlock,destruction,21,11,10
Zartax,kazzak,958,warlock,destruction,24,10,14
Dèv,draenor,958,warlock,destruction,24,10,14
Марэд,howling-fjord,958,warlock,destruction,24,10,14
Nimmyjewtron,tarren-mill,957,warlock,destruction,18,10,8
Inhúman,kazzak,957,warlock,destruction,18,10,8
Hexdoc,alakir,957,warlock,destruction,18,10,8
Naabz,naxxramas,957,warlock,destruction,18,10,8
Schmexer,blutkessel,957,warlock,destruction,18,10,8
Capnaga,draenor,957,warlock,destruction,18,10,8
Телкадрейнх,gordunni,957,warlock,destruction,21,11,10
Allêgrâ,blackrock,957,warlock,destruction,20,10,10
Dollmak,hyjal,957,warlock,destruction,129,62,67
Dïna,silvermoon,956,warlock,destruction,24,10,14
Lisànna,nemesis,956,warlock,destruction,24,10,14
Absurdd,turalyon,955,warlock,destruction,16,11,5
Dâhrul,argent-dawn,955,warlock,destruction,24,10,14
Банкапевка,howling-fjord,955,warlock,destruction,24,10,14
Thranerm,ravencrest,955,warlock,destruction,24,10,14
Ezze,thrall,954,warlock,destruction,18,10,8
Nauriela,blackmoore,954,warlock,destruction,18,10,8
Chlöê,hyjal,954,warlock,destruction,18,10,8
Gerart,tarren-mill,953,warlock,destruction,18,10,8
Chaoscu,twisting-nether,952,warlock,destruction,18,10,8
Soulnia,defias-brotherhood,952,warlock,destruction,18,10,8
Hextrasa,blackmoore,952,warlock,destruction,24,10,14
Tzimice,hyjal,952,warlock,destruction,24,10,14
Lorock,rajaxx,952,warlock,destruction,30,10,20
Minniemøuse,silvermoon,951,warlock,destruction,18,10,8
Ihateyouguys,auchindoun,951,warlock,destruction,24,10,14
Skitless,blackmoore,951,warlock,destruction,24,10,14
Nahamma,tarren-mill,951,warlock,destruction,24,10,14
Деморвун,soulflayer,951,warlock,destruction,30,10,20
Zow,dun-modr,950,warlock,destruction,24,10,14
Шейп,fordragon,950,warlock,destruction,58,18,40
Fbomber,ravencrest,948,warlock,destruction,12,10,2
Elayjalock,twisting-nether,948,warlock,destruction,24,10,14
Trusting,archimonde,945,warlock,destruction,20,13,7
Delara,drakthul,943,warlock,destruction,18,10,8
Манапчик,soulflayer,942,warlock,destruction,24,10,14
Neuth,draenor,941,warlock,destruction,30,10,20
Fujiitøra,ysondre,939,warlock,destruction,39,17,22
Kypamu,outland,939,warlock,destruction,54,19,35
Мааверш,soulflayer,939,warlock,destruction,36,11,25
Gódríg,sylvanas,938,warlock,destruction,23,10,13
Peggybrown,turalyon,937,warlock,destruction,36,10,26
Belzébut,confrérie-du-thorium,935,warlock,destruction,34,13,21
Saleus,argent-dawn,934,warlock,destruction,21,11,10
Âpâchî,twisting-nether,934,warlock,destruction,30,10,20
Снчч,soulflayer,933,warlock,destruction,23,10,13
Äbsalom,hyjal,931,warlock,destruction,193,97,96
Demowlition,archimonde,931,warlock,destruction,42,14,28
Britneyfear,aegwynn,927,warlock,destruction,14,11,3
Racursed,outland,927,warlock,destruction,16,10,6
Mintimperial,alakir,927,warlock,destruction,29,10,19
Mádará,tarren-mill,926,warlock,destruction,20,11,9
Архидрако,gordunni,925,warlock,destruction,44,17,27
Wizdoom,outland,924,warlock,destruction,22,11,11
Sulnar,burning-legion,924,warlock,destruction,23,10,13
Zugwardo,defias-brotherhood,923,warlock,destruction,26,11,15
Thétior,kaelthas,922,warlock,destruction,23,10,13
Kárdur,blackmoore,912,warlock,destruction,20,11,9
Smithlock,blackrock,912,warlock,destruction,21,11,10
Lhester,outland,912,warlock,destruction,21,10,11
Purplemonkey,burning-blade,911,warlock,destruction,17,10,7
Фламмэнх,soulflayer,911,warlock,destruction,23,10,13
Cruckz,nathrezim,910,warlock,destruction,15,10,5
Troyana,chants-éternels,910,warlock,destruction,125,62,63
Caiiden,kazzak,905,warlock,destruction,18,11,7
Jesez,aegwynn,905,warlock,destruction,22,11,11
Janneraut,terokkar,905,warlock,destruction,36,14,22
Orcboltz,tarren-mill,903,warlock,destruction,110,48,62
Destroc,blackrock,902,warlock,destruction,23,11,12
Чернокай,gordunni,895,warlock,destruction,16,10,6
Реалсамка,gordunni,895,warlock,destruction,17,10,7
Würrzag,kazzak,894,warlock,destruction,17,10,7
Eyzu,stormscale,894,warlock,destruction,17,10,7
Felcollins,sylvanas,892,warlock,destruction,20,10,10
Zozano,draenor,891,warlock,destruction,22,10,12
Müsli,kiljaeden,887,warlock,destruction,33,10,23
Zanzarismo,nemesis,886,warlock,destruction,14,10,4
Müdür,burning-legion,880,warlock,destruction,20,10,10
Vogz,burning-legion,877,warlock,destruction,25,10,15
Zøhaz,burning-legion,876,warlock,destruction,110,48,62
Лооган,blackscar,864,warlock,destruction,12,9,3
Osclo,ravencrest,864,warlock,destruction,12,9,3
Zakazal,argent-dawn,864,warlock,destruction,12,9,3
Reizouka,twisting-nether,864,warlock,destruction,12,9,3
Boltmaster,burning-legion,864,warlock,destruction,12,9,3
Mìzengard,eredar,864,warlock,destruction,12,9,3
Koksmulle,sylvanas,864,warlock,destruction,12,9,3
Аменбрейк,gordunni,864,warlock,destruction,12,9,3
Predlocktwo,twisting-nether,864,warlock,destruction,12,9,3
Dboyy,tarren-mill,864,warlock,destruction,12,9,3
Lcollector,outland,864,warlock,destruction,12,9,3
Menocast,archimonde,864,warlock,destruction,12,9,3
Peon,blackrock,864,warlock,destruction,12,9,3
Atresta,blackrock,864,warlock,destruction,12,9,3
Jackalabrute,dalaran,864,warlock,destruction,12,9,3
Chàsx,archimonde,864,warlock,destruction,12,9,3
Unfeared,blackhand,864,warlock,destruction,12,9,3
Chaosboba,silvermoon,864,warlock,destruction,12,9,3
Trimar,archimonde,864,warlock,destruction,12,9,3
Vamanos,stormscale,864,warlock,destruction,12,9,3
Beltazhor,kazzak,864,warlock,destruction,16,10,6
Demonbot,kazzak,864,warlock,destruction,15,9,6
Aggressivé,twisting-nether,864,warlock,destruction,17,9,8
Mogens,ravencrest,864,warlock,destruction,18,9,9
Gremmus,outland,864,warlock,destruction,18,9,9
Fascino,nazjatar,864,warlock,destruction,18,9,9
Köftemec,blackrock,864,warlock,destruction,18,9,9
Gulzot,turalyon,864,warlock,destruction,18,9,9
Ubinaz,blackmoore,864,warlock,destruction,18,9,9
Joleptem,outland,864,warlock,destruction,18,9,9
Cursè,stormscale,864,warlock,destruction,18,9,9
Séxenmeister,argent-dawn,864,warlock,destruction,24,9,15
Milfhaunter,aegwynn,864,warlock,destruction,24,9,15
Metalac,tarren-mill,863,warlock,destruction,12,9,3
Elerodril,ysondre,863,warlock,destruction,12,9,3
Dezowenn,draenor,863,warlock,destruction,12,9,3
Castller,burning-legion,863,warlock,destruction,12,9,3
Elissa,skullcrusher,863,warlock,destruction,12,9,3
Felgibson,destromath,863,warlock,destruction,12,9,3
Narzok,kazzak,863,warlock,destruction,12,9,3
Fearpuss,dun-modr,863,warlock,destruction,12,9,3
Zxcursed,doomhammer,863,warlock,destruction,12,9,3
Goatpuss,stormrage,863,warlock,destruction,12,9,3
Zelyx,archimonde,863,warlock,destruction,12,9,3
Psykokwette,kirin-tor,863,warlock,destruction,12,9,3
Tyrantlol,sylvanas,863,warlock,destruction,18,9,9
Súícìdèbøy,colinas-pardas,863,warlock,destruction,18,9,9
Corruptizer,outland,863,warlock,destruction,18,9,9
Veichassur,twisting-nether,863,warlock,destruction,18,9,9
Burningdemon,kazzak,863,warlock,destruction,18,9,9
Zharae,thrall,863,warlock,destruction,18,9,9
Уанбаттон,gordunni,863,warlock,destruction,18,9,9
Острогриф,gordunni,863,warlock,destruction,18,9,9
Krähenpracht,die-aldor,863,warlock,destruction,18,9,9
Ralyz,archimonde,863,warlock,destruction,18,9,9
Тарои,howling-fjord,863,warlock,destruction,18,9,9
Vladov,ravencrest,863,warlock,destruction,18,9,9
Darkaltered,auchindoun,863,warlock,destruction,18,9,9
Wårlørd,ragnaros,863,warlock,destruction,18,9,9
Andrealphus,outland,863,warlock,destruction,18,9,9
Sethtarr,draenor,863,warlock,destruction,18,9,9
Nazrõth,stormscale,863,warlock,destruction,18,9,9
Hydock,twisting-nether,863,warlock,destruction,18,9,9
Squiddles,sylvanas,863,warlock,destruction,24,9,15
Meningitis,tyrande,863,warlock,destruction,24,9,15
Getfeared,draenor,863,warlock,destruction,24,9,15
Æternallock,nemesis,863,warlock,destruction,24,9,15
Uezzalock,nemesis,863,warlock,destruction,24,9,15
Мглавечная,soulflayer,863,warlock,destruction,31,9,22
Lanmarieberg,stormscale,862,warlock,destruction,12,9,3
Zeralia,nemesis,862,warlock,destruction,12,9,3
Biihz,ysondre,862,warlock,destruction,12,9,3
Bíggun,outland,862,warlock,destruction,12,9,3
Obefix,aegwynn,862,warlock,destruction,16,10,6
Otemlock,sanguino,862,warlock,destruction,18,9,9
Мистермогила,soulflayer,862,warlock,destruction,18,9,9
Mmorgana,sanguino,862,warlock,destruction,18,9,9
Voidllynx,sylvanas,862,warlock,destruction,18,9,9
Silarioblack,nemesis,862,warlock,destruction,18,9,9
Nili,dethecus,862,warlock,destruction,18,9,9
Enviroq,burning-legion,862,warlock,destruction,18,9,9
Deamions,ravencrest,862,warlock,destruction,18,9,9
Banton,blackmoore,862,warlock,destruction,24,9,15
Shæzé,antonidas,862,warlock,destruction,24,9,15
Zhadok,blackmoore,862,warlock,destruction,24,9,15
Grol,terokkar,861,warlock,destruction,18,11,7
Skizi,ysondre,861,warlock,destruction,18,9,9
Darkremorsez,alakir,861,warlock,destruction,24,9,15
Xeró,quelthalas,860,warlock,destruction,12,9,3
Theesixnine,twisting-nether,860,warlock,destruction,12,9,3
Locknroll,terokkar,860,warlock,destruction,18,9,9
Phoenixwrath,malfurion,859,warlock,destruction,12,9,3
Adafbhf,tichondrius,859,warlock,destruction,18,9,9
Zakuri,blackmoore,859,warlock,destruction,18,9,9
Swank,twisting-nether,859,warlock,destruction,18,9,9
Yoghurth,silvermoon,859,warlock,destruction,21,10,11
Arlu,blackrock,859,warlock,destruction,82,37,45
Solbærsaft,stormscale,859,warlock,destruction,24,9,15
Андурон,galakrond,859,warlock,destruction,27,10,17
Schluépfêr,blackrock,858,warlock,destruction,18,9,9
Helldozer,nordrassil,858,warlock,destruction,18,9,9
Хемираги,soulflayer,858,warlock,destruction,24,9,15
Ravendoor,grim-batol,856,warlock,destruction,24,9,15
Nefarata,twisting-nether,854,warlock,destruction,24,9,15
Xolìe,azshara,853,warlock,destruction,18,9,9
Flisiakm,exodar,851,warlock,destruction,105,51,54
Colevid,blackmoore,850,warlock,destruction,69,28,41
Ternisia,draenor,846,warlock,destruction,20,10,10
Декир,soulflayer,845,warlock,destruction,24,9,15
Лацерта,howling-fjord,838,warlock,destruction,12,9,3
Dalfgan,wildhammer,836,warlock,destruction,161,76,85
Overzunique,gorgonnash,836,warlock,destruction,30,14,16
Vêzor,twisting-nether,830,warlock,destruction,17,11,6
Lokelicious,ragnaros,829,warlock,destruction,23,9,14
Fadila,aegwynn,829,warlock,destruction,24,9,15
Dmondmg,kazzak,828,warlock,destruction,23,9,14
Oddchap,magtheridon,822,warlock,destruction,89,38,51
Indynamo,blackrock,815,warlock,destruction,17,9,8
Shakuroz,frostwolf,815,warlock,destruction,27,10,17
Silvercurse,azuremyst,814,warlock,destruction,23,9,14
Blëssed,aegwynn,799,warlock,destruction,20,10,10
Csøki,tarren-mill,798,warlock,destruction,14,10,4
Isendnukes,darkspear,798,warlock,destruction,14,9,5
Birraslad,silvermoon,797,warlock,destruction,16,9,7
Sacmaboltz,kazzak,797,warlock,destruction,22,9,13
Eisenkiefer,thrall,792,warlock,destruction,81,28,53
Ампе,blackscar,768,warlock,destruction,12,8,4
Журанайсбой,blackscar,768,warlock,destruction,12,8,4
Benafflock,veknilash,768,warlock,destruction,12,8,4
Trembly,alakir,768,warlock,destruction,12,8,4
Dáinsleif,dun-modr,768,warlock,destruction,12,8,4
Côr,twisting-nether,768,warlock,destruction,12,8,4
Socralol,blackrock,768,warlock,destruction,12,8,4
Винстролман,blackscar,768,warlock,destruction,12,8,4
Sebikqt,ravencrest,768,warlock,destruction,12,8,4
Firecast,kazzak,768,warlock,destruction,12,8,4
Verminosiss,stormscale,768,warlock,destruction,12,8,4
Emolord,ravencrest,768,warlock,destruction,12,8,4
Psychoduck,stormscale,768,warlock,destruction,12,8,4
Sniffy,stormreaver,768,warlock,destruction,12,8,4
Menescurse,blackhand,768,warlock,destruction,12,8,4
Disnyo,outland,768,warlock,destruction,12,8,4
Gambos,kazzak,768,warlock,destruction,12,8,4
Gebkan,hyjal,768,warlock,destruction,12,8,4
Miláâ,argent-dawn,768,warlock,destruction,12,8,4
Cheeseyballs,ravencrest,768,warlock,destruction,12,8,4
Kitingguru,stormscale,768,warlock,destruction,12,8,4
Ogiez,draenor,768,warlock,destruction,12,8,4
Soloni,outland,768,warlock,destruction,12,8,4
Nodavé,stormscale,768,warlock,destruction,12,8,4
Namarin,die-aldor,768,warlock,destruction,12,8,4
Rikuu,ravencrest,768,warlock,destruction,12,8,4
Vezmollo,stormscale,768,warlock,destruction,12,8,4
Dadylock,silvermoon,768,warlock,destruction,12,8,4
Læssêkøñgð,twisting-nether,768,warlock,destruction,12,8,4
Aket,kazzak,768,warlock,destruction,12,8,4
Muyutrix,eredar,768,warlock,destruction,12,8,4
Crunel,ragnaros,768,warlock,destruction,12,8,4
Миражлок,gordunni,768,warlock,destruction,12,8,4
Dmonlock,hyjal,768,warlock,destruction,12,8,4
Covidian,stormscale,768,warlock,destruction,12,8,4
Detoxa,outland,768,warlock,destruction,12,8,4
Doublebolt,the-maelstrom,768,warlock,destruction,12,8,4
Андаинг,soulflayer,768,warlock,destruction,12,8,4
Deathmahed,kazzak,768,warlock,destruction,12,8,4
Miniparanoik,silvermoon,768,warlock,destruction,12,8,4
Mosskok,kazzak,768,warlock,destruction,16,9,7
Melforius,tarren-mill,768,warlock,destruction,18,8,10
Эпсизануда,soulflayer,768,warlock,destruction,18,8,10
Syntaxzwo,blackmoore,768,warlock,destruction,18,8,10
Némésiø,archimonde,768,warlock,destruction,18,8,10
Sargasus,kazzak,768,warlock,destruction,18,8,10
Mcsmitelock,argent-dawn,768,warlock,destruction,18,8,10
Hsheam,kazzak,768,warlock,destruction,18,8,10
Dirtyjoe,doomhammer,768,warlock,destruction,18,8,10
Vexlock,rexxar,768,warlock,destruction,18,8,10
Nasalies,grim-batol,768,warlock,destruction,18,8,10
Guldãn,silvermoon,768,warlock,destruction,24,8,16
Nechli,malganis,767,warlock,destruction,12,8,4
Мастеркрс,gordunni,767,warlock,destruction,12,8,4
Эльбардо,soulflayer,767,warlock,destruction,12,8,4
Kalimsshar,ysondre,767,warlock,destruction,12,8,4
Арйман,gordunni,767,warlock,destruction,12,8,4
Кандидат,blackscar,767,warlock,destruction,12,8,4
Shadowburst,outland,767,warlock,destruction,12,8,4
Mentaldeadw,draenor,767,warlock,destruction,12,8,4
Aribethion,draenor,767,warlock,destruction,12,8,4
Grònkh,eredar,767,warlock,destruction,12,8,4
Svnlpowpow,kazzak,767,warlock,destruction,12,8,4
Ромзесхх,howling-fjord,767,warlock,destruction,12,8,4
Bellatrìxx,madmortem,767,warlock,destruction,12,8,4
Gimmê,dun-morogh,767,warlock,destruction,12,8,4
Hübschi,lothar,767,warlock,destruction,12,8,4
Xoregar,nemesis,767,warlock,destruction,12,8,4
Cocacoil,outland,767,warlock,destruction,12,8,4
Iblis,grim-batol,767,warlock,destruction,12,8,4
Skizofrenia,ysondre,767,warlock,destruction,12,8,4
Shakoth,draenor,767,warlock,destruction,12,8,4
Картытаро,azuregos,767,warlock,destruction,16,9,7
Lotud,drakthul,767,warlock,destruction,16,9,7
Sadisticlól,burning-legion,767,warlock,destruction,18,8,10
Heyggspal,draenor,767,warlock,destruction,18,8,10
Slamalock,stormscale,767,warlock,destruction,18,8,10
Stopfëar,ysondre,767,warlock,destruction,18,8,10
Rätlockx,blackhand,767,warlock,destruction,18,8,10
Orkeylock,blackrock,767,warlock,destruction,18,8,10
Debex,ravencrest,767,warlock,destruction,18,8,10
Eviloverlord,silvermoon,767,warlock,destruction,18,8,10
Bu,zirkel-des-cenarius,767,warlock,destruction,18,8,10
Surt,la-croisade-écarlate,767,warlock,destruction,18,8,10
Vertione,burning-legion,767,warlock,destruction,18,8,10
Herador,draenor,767,warlock,destruction,18,8,10
Флягаегеря,howling-fjord,767,warlock,destruction,18,8,10
Luqhex,blackrock,767,warlock,destruction,18,8,10
Crathar,kazzak,767,warlock,destruction,24,8,16
Infectius,kazzak,767,warlock,destruction,24,8,16
Fearmighty,kazzak,767,warlock,destruction,24,8,16
Sharion,silvermoon,766,warlock,destruction,12,8,4
Cameltoh,stormscale,766,warlock,destruction,12,8,4
Discordîân,twisting-nether,766,warlock,destruction,12,8,4
Xlara,argent-dawn,766,warlock,destruction,18,8,10
Yôi,nemesis,766,warlock,destruction,18,8,10
Justlock,tarren-mill,766,warlock,destruction,18,8,10
Warlockout,ravencrest,766,warlock,destruction,22,9,13
Dregx,twisting-nether,765,warlock,destruction,12,8,4
Darkspit,draenor,765,warlock,destruction,12,8,4
Bravehearrt,burning-legion,765,warlock,destruction,12,8,4
Рисли,deathweaver,765,warlock,destruction,12,8,4
Dotsle,argent-dawn,765,warlock,destruction,12,8,4
Däw,archimonde,765,warlock,destruction,18,8,10
Warlockzor,auchindoun,765,warlock,destruction,18,8,10
Drestan,twisting-nether,765,warlock,destruction,18,8,10
Mestaca,dun-modr,765,warlock,destruction,24,8,16
Toîlêt,proudmoore,764,warlock,destruction,18,8,10
Gendo,twisting-nether,764,warlock,destruction,18,8,10
Hexahydraten,draenor,764,warlock,destruction,18,8,10
Urgool,ravencrest,763,warlock,destruction,12,8,4
Юникна,gordunni,763,warlock,destruction,24,8,16
Dimkeldor,kazzak,762,warlock,destruction,18,8,10
Chaosboltfm,silvermoon,762,warlock,destruction,23,8,15
Nizha,sanguino,761,warlock,destruction,92,43,49
Kretuss,silvermoon,760,warlock,destruction,18,8,10
Meinfearer,drakthul,760,warlock,destruction,27,8,19
Ramurox,rexxar,759,warlock,destruction,22,9,13
Mekalin,minahonda,757,warlock,destruction,18,8,10
Safirae,blackmoore,756,warlock,destruction,25,8,17
Bësly,khaz-modan,752,warlock,destruction,18,8,10
Sladurana,eredar,744,warlock,destruction,48,18,30
Mindfreak,turalyon,736,warlock,destruction,16,8,8
Шадофлок,deathweaver,735,warlock,destruction,17,8,9
Shaodul,stormscale,735,warlock,destruction,17,8,9
Mindzsonghó,ragnaros,733,warlock,destruction,24,8,16
Bajaa,kazzak,720,warlock,destruction,15,9,6
Awon,aegwynn,719,warlock,destruction,17,8,9
Gutras,ragnaros,719,warlock,destruction,23,8,15
Kelek,anachronos,718,warlock,destruction,11,8,3
Chornota,ravencrest,715,warlock,destruction,23,8,15
Cursse,ahnqiraj,714,warlock,destruction,16,12,4
Skippity,ravencrest,714,warlock,destruction,14,9,5
Ironserious,blackrock,714,warlock,destruction,16,9,7
Тёмабиль,gordunni,714,warlock,destruction,23,10,13
Храбзар,gordunni,713,warlock,destruction,21,9,12
Warlocklordx,ravencrest,713,warlock,destruction,22,9,13
Snowflakesxs,draenor,711,warlock,destruction,18,9,9
Pederlock,defias-brotherhood,710,warlock,destruction,33,9,24
Rikta,stormscale,703,warlock,destruction,11,8,3
Manmilker,auchindoun,703,warlock,destruction,11,8,3
Джастсак,gordunni,703,warlock,destruction,11,8,3
Nightfire,aggra-português,702,warlock,destruction,17,8,9
Элварель,galakrond,695,warlock,destruction,22,8,14
Kemmler,steamwheedle-cartel,688,warlock,destruction,13,8,5
Trollóck,the-maelstrom,686,warlock,destruction,11,8,3
Trathos,minahonda,682,warlock,destruction,87,36,51
Lauro,blackmoore,680,warlock,destruction,16,10,6
Boltsofdoom,kazzak,672,warlock,destruction,12,7,5
Ansatz,kazzak,672,warlock,destruction,12,7,5
Castywl,blackrock,672,warlock,destruction,12,7,5
Destroylol,draenor,672,warlock,destruction,12,7,5
Følkman,twisting-nether,672,warlock,destruction,12,7,5
Numwiki,draenor,672,warlock,destruction,12,7,5
Diva,bloodscalp,672,warlock,destruction,12,7,5
Kradrog,nemesis,672,warlock,destruction,12,7,5
Gruldran,khaz-modan,672,warlock,destruction,12,7,5
Galeriana,twilights-hammer,672,warlock,destruction,12,7,5
Dexterlol,blackmoore,672,warlock,destruction,12,7,5
Lockizz,tarren-mill,672,warlock,destruction,12,7,5
Yokujîn,twisting-nether,672,warlock,destruction,12,7,5
Murrann,stormreaver,672,warlock,destruction,12,7,5
Xul,aggramar,672,warlock,destruction,12,7,5
Tindóme,blackmoore,672,warlock,destruction,12,7,5
Hèrmit,kazzak,672,warlock,destruction,12,7,5
Wacastwo,tarren-mill,672,warlock,destruction,12,7,5
Vilenia,doomhammer,672,warlock,destruction,12,7,5
Sneltjej,draenor,672,warlock,destruction,12,7,5
Lestebbes,frostwolf,672,warlock,destruction,12,7,5
Aoeenjoer,tarren-mill,672,warlock,destruction,12,7,5
Bâbâyâgâqtsd,hyjal,672,warlock,destruction,12,7,5
Pappabetaler,stormreaver,672,warlock,destruction,12,7,5
Cyliinia,die-aldor,672,warlock,destruction,12,7,5
Grâst,cthun,672,warlock,destruction,12,7,5
Skipperw,blackmoore,672,warlock,destruction,12,7,5
Jaleels,kazzak,672,warlock,destruction,12,7,5
Матрикспз,soulflayer,672,warlock,destruction,12,7,5
Iøløløløçk,tarren-mill,672,warlock,destruction,12,7,5
Uqrlock,twisting-nether,672,warlock,destruction,12,7,5
Remzin,silvermoon,672,warlock,destruction,12,7,5
Azerybedge,alexstrasza,672,warlock,destruction,12,7,5
Wakro,hyjal,672,warlock,destruction,12,7,5
Hehexd,steamwheedle-cartel,672,warlock,destruction,12,7,5
Arakaali,dentarg,672,warlock,destruction,12,7,5
Qumbaja,alleria,672,warlock,destruction,12,7,5
Venali,runetotem,672,warlock,destruction,12,7,5
Psykøø,shendralar,672,warlock,destruction,12,7,5
Fraky,frostwhisper,672,warlock,destruction,12,7,5
Abraðolf,blackrock,672,warlock,destruction,12,7,5
Oldmancletus,silvermoon,672,warlock,destruction,12,7,5
Pukemistress,tarren-mill,672,warlock,destruction,12,7,5
Nerreboltz,tarren-mill,672,warlock,destruction,12,7,5
Lickyicky,twisting-nether,672,warlock,destruction,12,7,5
Kaukauwa,blackmoore,672,warlock,destruction,12,7,5
Xjay,malorne,672,warlock,destruction,12,7,5
Fellord,chants-éternels,672,warlock,destruction,12,7,5
Demodan,aegwynn,672,warlock,destruction,12,7,5
Defenestros,ravencrest,672,warlock,destruction,12,7,5
Aunsá,archimonde,672,warlock,destruction,12,7,5
Itiswhatitis,ravencrest,672,warlock,destruction,12,7,5
Sötsugen,argent-dawn,672,warlock,destruction,12,7,5
Accardí,eredar,672,warlock,destruction,12,7,5
Nmmnmmnnmnmm,blackmoore,672,warlock,destruction,12,7,5
Damira,blackmoore,672,warlock,destruction,12,7,5
Ofgirl,ravencrest,672,warlock,destruction,12,7,5
Nürgle,stormscale,672,warlock,destruction,12,7,5
Shahsiyet,twisting-nether,672,warlock,destruction,12,7,5
Zilthon,dragonblight,672,warlock,destruction,12,7,5
Vixlock,tarren-mill,672,warlock,destruction,15,8,7
Bitshlog,draenor,672,warlock,destruction,18,7,11
Nahzz,ravencrest,672,warlock,destruction,18,7,11
Xuloth,ravencrest,672,warlock,destruction,18,7,11
Belakh,draenor,672,warlock,destruction,18,7,11
Ssneakydot,silvermoon,672,warlock,destruction,18,7,11
Локизло,gordunni,672,warlock,destruction,18,7,11
Hungtwink,argent-dawn,672,warlock,destruction,18,7,11
Lobbo,ravencrest,672,warlock,destruction,18,7,11
Haccu,ragnaros,672,warlock,destruction,18,7,11
Bansheera,blackmoore,672,warlock,destruction,18,7,11
Topmodelx,eredar,672,warlock,destruction,18,7,11
Dotschwingaa,eredar,672,warlock,destruction,18,7,11
Seyzz,eredar,672,warlock,destruction,18,7,11
Sweëk,blackhand,672,warlock,destruction,18,7,11
Mocfernando,ravencrest,672,warlock,destruction,18,7,11
Haedri,kazzak,672,warlock,destruction,18,7,11
Ssz,stormscale,672,warlock,destruction,18,7,11
Arizyoxot,twisting-nether,672,warlock,destruction,18,7,11
Mewarlock,bronze-dragonflight,672,warlock,destruction,18,7,11
Mixu,hakkar,672,warlock,destruction,21,8,13
Marripa,sanguino,672,warlock,destruction,24,7,17
Spikemasterd,doomhammer,672,warlock,destruction,24,7,17
Mesut,blackhand,672,warlock,destruction,24,7,17
Ðave,nemesis,672,warlock,destruction,24,7,17
Rázul,mannoroth,671,warlock,destruction,12,7,5
Baladas,nemesis,671,warlock,destruction,12,7,5
Aîds,kazzak,671,warlock,destruction,12,7,5
Raddock,ysondre,671,warlock,destruction,12,7,5
Fauxshow,ravencrest,671,warlock,destruction,12,7,5
Afflicted,trollbane,671,warlock,destruction,12,7,5
Омикс,gordunni,671,warlock,destruction,12,7,5
Jillyãn,hyjal,671,warlock,destruction,12,7,5
Cømps,blackrock,671,warlock,destruction,12,7,5
Drexo,drakthul,671,warlock,destruction,12,7,5
Gnimoz,silvermoon,671,warlock,destruction,12,7,5
Saadq,draenor,671,warlock,destruction,12,7,5
Zaruman,turalyon,671,warlock,destruction,12,7,5
Mirlax,twisting-nether,671,warlock,destruction,12,7,5
Äri,blackmoore,671,warlock,destruction,12,7,5
Náwwk,blackmoore,671,warlock,destruction,12,7,5
Sourpatchkid,the-maelstrom,671,warlock,destruction,15,8,7
Suaakylove,tyrande,671,warlock,destruction,18,7,11
Hampter,blackmoore,671,warlock,destruction,18,7,11
Kekihl,tarren-mill,671,warlock,destruction,18,7,11
Gimpy,sylvanas,671,warlock,destruction,18,7,11
Fireburner,der-mithrilorden,671,warlock,destruction,18,7,11
Гнумосятина,booty-bay,671,warlock,destruction,18,7,11
Cancerdotcom,kazzak,671,warlock,destruction,18,7,11
Vengidotcom,outland,671,warlock,destruction,18,7,11
Прогнившая,blackscar,671,warlock,destruction,18,7,11
Fràncis,dragonblight,671,warlock,destruction,18,7,11
Izilove,culte-de-la-rive-noire,671,warlock,destruction,18,7,11
Ziloc,silvermoon,671,warlock,destruction,18,7,11
Tce,ravencrest,671,warlock,destruction,18,7,11
Dwimmerlaikx,ragnaros,671,warlock,destruction,19,7,12
Kàiser,sanguino,671,warlock,destruction,23,7,16
Ajihn,sylvanas,671,warlock,destruction,24,7,17
Искусность,soulflayer,671,warlock,destruction,24,7,17
Ekatherini,blackhand,670,warlock,destruction,12,7,5
Cjnaz,twisting-nether,670,warlock,destruction,12,7,5
Olilock,drakthul,670,warlock,destruction,12,7,5
Нафлэпил,gordunni,670,warlock,destruction,12,7,5
Зародыш,razuvious,670,warlock,destruction,18,7,11
Rottman,dun-modr,670,warlock,destruction,18,7,11
Jondi,blackmoore,670,warlock,destruction,24,7,17
Itryan,elune,669,warlock,destruction,18,7,11
Валак,greymane,669,warlock,destruction,21,8,13
Demonzo,tarren-mill,669,warlock,destruction,23,8,15
Sheshii,argent-dawn,669,warlock,destruction,24,7,17
Badbeat,burning-legion,669,warlock,destruction,24,7,17
Сатаната,deepholm,668,warlock,destruction,12,7,5
Мракодел,deathguard,668,warlock,destruction,18,7,11
Mortori,tarren-mill,668,warlock,destruction,18,7,11
Hodille,argent-dawn,668,warlock,destruction,18,7,11
Buzztoon,doomhammer,668,warlock,destruction,24,7,17
Vladlevad,argent-dawn,667,warlock,destruction,12,7,5
Felzadros,dun-modr,667,warlock,destruction,18,7,11
Easymeat,silvermoon,666,warlock,destruction,12,7,5
Garbagebarge,krasus,666,warlock,destruction,12,7,5
Destri,blackmoore,660,warlock,destruction,12,7,5
Vinet,burning-legion,657,warlock,destruction,12,7,5
Bowhite,silvermoon,655,warlock,destruction,15,8,7
Драуктар,eversong,643,warlock,destruction,17,7,10
Saganelle,hyjal,639,warlock,destruction,11,7,4
Saucewalka,stormscale,638,warlock,destruction,11,7,4
Consfearacy,executus,636,warlock,destruction,11,7,4
Hansbrixx,magtheridon,623,warlock,destruction,9,8,1
Warplock,sanguino,623,warlock,destruction,11,7,4
Alsseharr,blackhand,623,warlock,destruction,11,7,4
Dikkdickens,ravencrest,623,warlock,destruction,15,7,8
Силксонг,soulflayer,622,warlock,destruction,17,7,10
Tydra,die-aldor,618,warlock,destruction,20,8,12
Icony,blackhand,618,warlock,destruction,22,8,14
Embero,blackrock,617,warlock,destruction,19,8,11
Timaggrox,dun-morogh,611,warlock,destruction,93,43,50
Bonnieparkêr,onyxia,607,warlock,destruction,11,7,4
Imatión,sylvanas,607,warlock,destruction,16,7,9
Indiasummerx,turalyon,606,warlock,destruction,14,7,7
Atlaon,kazzak,592,warlock,destruction,13,7,6
Dragonlvrx,kazzak,576,warlock,destruction,6,6,0
Zìì,silvermoon,576,warlock,destruction,6,6,0
Hibachi,twisting-nether,576,warlock,destruction,6,6,0
Bultenx,tarren-mill,576,warlock,destruction,6,6,0
Kennyfõx,ysondre,576,warlock,destruction,6,6,0
Zevranøss,dalaran,576,warlock,destruction,6,6,0
Aköyh,kazzak,576,warlock,destruction,6,6,0
Popecandy,archimonde,576,warlock,destruction,6,6,0
Zepsy,twisting-nether,576,warlock,destruction,6,6,0
Xute,ragnaros,576,warlock,destruction,6,6,0
Ceryss,argent-dawn,576,warlock,destruction,6,6,0
Kyiûu,archimonde,576,warlock,destruction,6,6,0
Cafardcancer,archimonde,576,warlock,destruction,6,6,0
Whaii,ravencrest,576,warlock,destruction,6,6,0
Solosuperr,ravencrest,576,warlock,destruction,6,6,0
Nighttusk,burning-legion,576,warlock,destruction,6,6,0
Mamasitica,ravencrest,576,warlock,destruction,6,6,0
Smaskens,trollbane,576,warlock,destruction,9,7,2
Klaier,dun-modr,576,warlock,destruction,9,7,2
Cræl,blackrock,576,warlock,destruction,12,6,6
Cropper,turalyon,576,warlock,destruction,12,6,6
Slyghtéria,dalaran,576,warlock,destruction,12,6,6
Drainforlife,blackrock,576,warlock,destruction,12,6,6
Kraayn,blackhand,576,warlock,destruction,12,6,6
Ooze,kazzak,576,warlock,destruction,12,6,6
Xyrønia,aegwynn,576,warlock,destruction,12,6,6
Malanapucana,kazzak,576,warlock,destruction,12,6,6
Erimdur,sanguino,576,warlock,destruction,12,6,6
Cali,ahnqiraj,576,warlock,destruction,12,6,6
Syñdrome,ragnaros,576,warlock,destruction,12,6,6
Wallirikx,kazzak,576,warlock,destruction,12,6,6
Ðuß,nemesis,576,warlock,destruction,12,6,6
Jànà,argent-dawn,576,warlock,destruction,12,6,6
Gatewatcher,argent-dawn,576,warlock,destruction,12,6,6
Мерзея,soulflayer,576,warlock,destruction,12,6,6
Slonertw,ragnaros,576,warlock,destruction,12,6,6
Chaudor,archimonde,576,warlock,destruction,12,6,6
Boltyboi,chamber-of-aspects,576,warlock,destruction,12,6,6
Scroobydoo,stormscale,576,warlock,destruction,12,6,6
Kurokison,twisting-nether,576,warlock,destruction,12,6,6
Ghosthound,stormscale,576,warlock,destruction,12,6,6
Aranax,thrall,576,warlock,destruction,12,6,6
Krebares,draenor,576,warlock,destruction,12,6,6
Liwerno,dunemaul,576,warlock,destruction,12,6,6
Diabolics,twisting-nether,576,warlock,destruction,12,6,6
Embercurse,ravencrest,576,warlock,destruction,12,6,6
Bigtastybacn,blackmoore,576,warlock,destruction,12,6,6
Zaklecie,silvermoon,576,warlock,destruction,12,6,6
Darkspiros,tarren-mill,576,warlock,destruction,12,6,6
Kroekoe,silvermoon,576,warlock,destruction,12,6,6
Zardonixz,stormscale,576,warlock,destruction,12,6,6
Mayden,uldum,576,warlock,destruction,12,6,6
Edgyrpname,argent-dawn,576,warlock,destruction,12,6,6
Atheliia,draenor,576,warlock,destruction,12,6,6
Thieulock,twisting-nether,576,warlock,destruction,12,6,6
Larrydotter,burning-legion,576,warlock,destruction,12,6,6
Smoq,stormscale,576,warlock,destruction,12,6,6
Lokki,xavius,576,warlock,destruction,12,6,6
Numel,chamber-of-aspects,576,warlock,destruction,12,6,6
Ravenglass,argent-dawn,576,warlock,destruction,12,6,6
Xalé,blackrock,576,warlock,destruction,12,6,6
Sentklol,sanguino,576,warlock,destruction,12,6,6
Kukkojapallo,ravencrest,576,warlock,destruction,12,6,6
Staudi,eredar,576,warlock,destruction,12,6,6
Mothor,blackrock,576,warlock,destruction,12,6,6
Deamonhein,alonsus,576,warlock,destruction,12,6,6
Koramu,blackrock,576,warlock,destruction,12,6,6
Podak,blackmoore,576,warlock,destruction,12,6,6
Janalice,hyjal,576,warlock,destruction,12,6,6
Fazol,terokkar,576,warlock,destruction,12,6,6
Orchid,burning-steppes,576,warlock,destruction,12,6,6
Zigfipszen,blackmoore,576,warlock,destruction,12,6,6
Нежныйафлик,gordunni,576,warlock,destruction,12,6,6
Goosebumps,aggramar,576,warlock,destruction,12,6,6
Silenozz,ragnaros,576,warlock,destruction,12,6,6
Mongodotz,sylvanas,576,warlock,destruction,12,6,6
Bulgyeøng,archimonde,576,warlock,destruction,12,6,6
Jöhanan,twisting-nether,576,warlock,destruction,12,6,6
Hasigome,blackmoore,576,warlock,destruction,12,6,6
Nutopia,stormreaver,576,warlock,destruction,12,6,6
Sanium,outland,576,warlock,destruction,12,6,6
Селфдестракт,howling-fjord,576,warlock,destruction,12,6,6
Gorakthul,drakthul,576,warlock,destruction,12,6,6
Элнуар,soulflayer,576,warlock,destruction,12,6,6
Спанчгэри,soulflayer,576,warlock,destruction,15,7,8
Shakaxz,kazzak,576,warlock,destruction,15,7,8
Velgart,dun-modr,576,warlock,destruction,18,6,12
Elnïa,conseil-des-ombres,576,warlock,destruction,18,6,12
Jörd,ravencrest,576,warlock,destruction,18,6,12
Naitix,argent-dawn,576,warlock,destruction,18,6,12
Shreedlock,blackmoore,576,warlock,destruction,18,6,12
Tartaros,bronzebeard,576,warlock,destruction,18,6,12
Zemial,draenor,576,warlock,destruction,18,6,12
Mashïro,zuljin,576,warlock,destruction,18,6,12
Icq,ravencrest,576,warlock,destruction,18,6,12
Alexcurse,draenor,576,warlock,destruction,18,6,12
Morwëk,ysondre,576,warlock,destruction,18,6,12
Lockowns,twisting-nether,576,warlock,destruction,18,6,12
Xsydewarlock,archimonde,576,warlock,destruction,18,6,12
Kriemias,malygos,576,warlock,destruction,18,6,12
Azmondan,ahnqiraj,576,warlock,destruction,18,6,12
Navara,thrall,576,warlock,destruction,24,6,18
Brarvile,zuljin,575,warlock,destruction,12,6,6
Hacknator,aegwynn,575,warlock,destruction,12,6,6
Zevil,emerald-dream,575,warlock,destruction,12,6,6
Endreth,outland,575,warlock,destruction,12,6,6
Дантеллия,gordunni,575,warlock,destruction,12,6,6
Hotoderdot,anubarak,575,warlock,destruction,12,6,6
Sweetfire,ragnaros,575,warlock,destruction,12,6,6
Necromanccer,mazrigos,575,warlock,destruction,12,6,6
Дракшара,soulflayer,575,warlock,destruction,12,6,6
Rhaznor,frostwolf,575,warlock,destruction,12,6,6
Huaraches,stormscale,575,warlock,destruction,12,6,6
Dottad,silvermoon,575,warlock,destruction,12,6,6
Thîras,tarren-mill,575,warlock,destruction,13,6,7
Nemssy,dun-modr,575,warlock,destruction,18,6,12
Dêgrââf,azshara,575,warlock,destruction,18,6,12
Marshieeyy,silvermoon,575,warlock,destruction,18,6,12
Maleff,sanguino,575,warlock,destruction,18,6,12
Crymora,antonidas,575,warlock,destruction,18,6,12
Démín,ravencrest,575,warlock,destruction,18,6,12
Inani,ragnaros,575,warlock,destruction,18,6,12
Klone,die-todeskrallen,575,warlock,destruction,18,6,12
Logice,hyjal,575,warlock,destruction,24,6,18
Clungesuck,argent-dawn,574,warlock,destruction,12,6,6
Goghlock,silvermoon,574,warlock,destruction,18,6,12
Baikabahta,kazzak,573,warlock,destruction,18,6,12
Attrappe,eredar,573,warlock,destruction,26,6,20
Rodrin,silvermoon,572,warlock,destruction,12,6,6
Taxalias,draenor,572,warlock,destruction,12,6,6
Esgül,draenor,572,warlock,destruction,12,6,6
Malfuryon,pozzo-delleternità,571,warlock,destruction,30,6,24
Грашек,soulflayer,570,warlock,destruction,12,6,6
Warlockkey,ravencrest,570,warlock,destruction,24,6,18
Migyardondup,exodar,568,warlock,destruction,12,6,6
Lockki,blades-edge,568,warlock,destruction,18,8,10
Олимта,blackscar,558,warlock,destruction,23,6,17
Homolarsen,tarren-mill,543,warlock,destruction,8,7,1
Jägerlock,draenor,543,warlock,destruction,11,6,5
Lockheedbao,outland,543,warlock,destruction,11,6,5
Boltimoore,magtheridon,543,warlock,destruction,11,6,5
Srbritoboy,burning-legion,540,warlock,destruction,11,6,5
Newyorkcity,antonidas,540,warlock,destruction,17,6,11
Типокакош,gordunni,528,warlock,destruction,21,7,14
Rozn,ravencrest,527,warlock,destruction,11,6,5
Synove,ragnaros,525,warlock,destruction,11,6,5
Diemilch,blackmoore,522,warlock,destruction,14,7,7
Брузир,gordunni,522,warlock,destruction,15,7,8
Тива,lich-king,522,warlock,destruction,21,7,14
Боррисовна,deathguard,512,warlock,destruction,16,6,10
Evilhippie,kazzak,511,warlock,destruction,11,6,5
Wanhëda,tarren-mill,511,warlock,destruction,11,6,5
Baxiaz,kazzak,511,warlock,destruction,11,6,5
Diddia,malganis,511,warlock,destruction,11,6,5
Noskillclass,stormscale,511,warlock,destruction,14,6,8
Shoøt,dalaran,480,warlock,destruction,6,5,1
Ionesdot,ravencrest,480,warlock,destruction,6,5,1
Mellown,blackrock,480,warlock,destruction,6,5,1
Sep,aegwynn,480,warlock,destruction,6,5,1
Idezis,ragnaros,480,warlock,destruction,6,5,1
Shuni,defias-brotherhood,480,warlock,destruction,6,5,1
Malzeva,ravencrest,480,warlock,destruction,6,5,1
Аннибет,gordunni,480,warlock,destruction,6,5,1
Carlitall,ravencrest,480,warlock,destruction,6,5,1
Soulmistress,stormscale,480,warlock,destruction,6,5,1
Lyns,hyjal,480,warlock,destruction,6,5,1
Mazuto,outland,480,warlock,destruction,6,5,1
Sâlty,stormscale,480,warlock,destruction,6,5,1
Lísbeth,sylvanas,480,warlock,destruction,6,5,1
Ashid,chamber-of-aspects,480,warlock,destruction,6,5,1
Smrdex,outland,480,warlock,destruction,6,5,1
Levinbrz,ravencrest,480,warlock,destruction,6,5,1
Darkbasilet,hyjal,480,warlock,destruction,6,5,1
Djløckgødx,ravencrest,480,warlock,destruction,6,5,1
Veafugg,blackmoore,480,warlock,destruction,6,5,1
Hannens,blackrock,480,warlock,destruction,6,5,1
Xenìi,malganis,480,warlock,destruction,6,5,1
Agresiw,twisting-nether,480,warlock,destruction,6,5,1
Klaab,hyjal,480,warlock,destruction,6,5,1
Sêrø,aegwynn,480,warlock,destruction,6,5,1
Struldan,outland,480,warlock,destruction,6,5,1
ßualock,sylvanas,480,warlock,destruction,6,5,1
Djolagourde,archimonde,480,warlock,destruction,6,5,1
Tobibolt,blackrock,480,warlock,destruction,6,5,1
Dogbolt,stormscale,480,warlock,destruction,6,5,1
Demoneralock,outland,480,warlock,destruction,6,5,1
Bigdondi,ravencrest,480,warlock,destruction,6,5,1
Harrydoter,kiljaeden,480,warlock,destruction,6,5,1
Reckony,ravencrest,480,warlock,destruction,6,5,1
Ingwert,frostwolf,480,warlock,destruction,6,5,1
Keltuzard,zuljin,480,warlock,destruction,6,5,1
Junglediffxd,ysondre,480,warlock,destruction,6,5,1
Hinsu,the-maelstrom,480,warlock,destruction,6,5,1
Enmaa,eredar,480,warlock,destruction,6,5,1
Rayser,shendralar,480,warlock,destruction,6,5,1
Фирвебало,soulflayer,480,warlock,destruction,6,5,1
Sumstone,kazzak,480,warlock,destruction,6,5,1
Avadakèdavra,kazzak,480,warlock,destruction,6,5,1
Lyndi,nerathor,480,warlock,destruction,6,5,1
Garbrandt,tarren-mill,480,warlock,destruction,6,5,1
Hypercaster,shattrath,480,warlock,destruction,6,5,1
Zurael,mannoroth,480,warlock,destruction,6,5,1
Jûnkz,ysondre,480,warlock,destruction,6,5,1
Chaosclasm,kazzak,480,warlock,destruction,6,5,1
Saf,ysondre,480,warlock,destruction,6,5,1
Ticktockboom,twilights-hammer,480,warlock,destruction,6,5,1
Nøøbslayer,kazzak,480,warlock,destruction,6,5,1
Bánánbánd,draenor,480,warlock,destruction,6,5,1
Hotdogvendor,kazzak,480,warlock,destruction,6,5,1
Kirtaçh,dun-modr,480,warlock,destruction,6,5,1
Buffdemolock,executus,480,warlock,destruction,6,5,1
Сладкийбилли,soulflayer,480,warlock,destruction,6,5,1
Devillsoull,kazzak,480,warlock,destruction,6,5,1
Kennay,talnivarr,480,warlock,destruction,6,5,1
Lazytown,silvermoon,480,warlock,destruction,6,5,1
Sizezero,tarren-mill,480,warlock,destruction,6,5,1
Shadowtrix,darksorrow,480,warlock,destruction,9,5,4
Jumskerbolts,outland,480,warlock,destruction,12,5,7
Franjah,alleria,480,warlock,destruction,12,5,7
Sanwich,dun-modr,480,warlock,destruction,12,5,7
Watchmecut,terenas,480,warlock,destruction,12,5,7
Ðazarøk,nethersturm,480,warlock,destruction,12,5,7
Whórélóck,ravencrest,480,warlock,destruction,12,5,7
Иммолэйтх,gordunni,480,warlock,destruction,12,5,7
Tëazle,chogall,480,warlock,destruction,12,5,7
Lyleath,ravencrest,480,warlock,destruction,12,5,7
Емс,gordunni,480,warlock,destruction,12,5,7
Pewmlock,antonidas,480,warlock,destruction,12,5,7
Semhein,twisting-nether,480,warlock,destruction,12,5,7
Mongulla,draenor,480,warlock,destruction,12,5,7
Zlok,silvermoon,480,warlock,destruction,12,5,7
Rela,arathor,480,warlock,destruction,12,5,7
Локомания,gordunni,480,warlock,destruction,12,5,7
Thorky,blackrock,480,warlock,destruction,12,5,7
Gorgoroð,outland,480,warlock,destruction,12,5,7
Tiwtera,draenor,480,warlock,destruction,12,5,7
Djshyasiañ,perenolde,480,warlock,destruction,12,5,7
Feardotfive,frostwolf,480,warlock,destruction,12,5,7
Ratnu,ragnaros,480,warlock,destruction,12,5,7
Hexenjoyer,antonidas,480,warlock,destruction,12,5,7
Марамойка,blackscar,480,warlock,destruction,12,5,7
Zeanort,zuljin,480,warlock,destruction,12,5,7
Nithandrys,argent-dawn,480,warlock,destruction,12,5,7
Braegnok,ravencrest,480,warlock,destruction,12,5,7
Bricktot,ragnaros,480,warlock,destruction,12,5,7
Mærie,hyjal,480,warlock,destruction,12,5,7
Vigneau,argent-dawn,480,warlock,destruction,12,5,7
Farudai,die-aldor,480,warlock,destruction,12,5,7
Rikudoua,malfurion,480,warlock,destruction,12,5,7
Nefalya,hyjal,480,warlock,destruction,12,5,7
Khardam,sylvanas,480,warlock,destruction,12,5,7
Salvyrigoth,kazzak,480,warlock,destruction,12,5,7
Sokyra,tarren-mill,480,warlock,destruction,12,5,7
Borovec,kazzak,480,warlock,destruction,12,5,7
Desrak,outland,480,warlock,destruction,12,5,7
Кайдзуки,howling-fjord,480,warlock,destruction,12,5,7
Bajsibyx,tarren-mill,480,warlock,destruction,12,5,7
Snoreghast,tarren-mill,480,warlock,destruction,12,5,7
Elmetro,ragnaros,480,warlock,destruction,12,5,7
Corruptcoil,argent-dawn,480,warlock,destruction,12,5,7
Belphagòr,nemesis,480,warlock,destruction,12,5,7
Xtrazâ,archimonde,480,warlock,destruction,12,5,7
Жижакабра,soulflayer,480,warlock,destruction,12,5,7
Infïnitýx,silvermoon,480,warlock,destruction,12,5,7
Cerberus,anetheron,480,warlock,destruction,12,5,7
Xtremelock,blackmoore,480,warlock,destruction,12,5,7
Atomik,drakthul,480,warlock,destruction,12,5,7
Pliagaa,drakthul,480,warlock,destruction,12,5,7
Purplehelmet,argent-dawn,480,warlock,destruction,12,5,7
Sidius,archimonde,480,warlock,destruction,12,5,7
Jiego,stormscale,480,warlock,destruction,12,5,7
Miezexy,aegwynn,480,warlock,destruction,12,5,7
Гулданоф,howling-fjord,480,warlock,destruction,12,5,7
Eilhart,aggramar,480,warlock,destruction,12,5,7
Динодотз,howling-fjord,480,warlock,destruction,12,5,7
Lik,forscherliga,480,warlock,destruction,12,5,7
Devilart,hellscream,480,warlock,destruction,12,5,7
Käristäjä,outland,480,warlock,destruction,12,5,7
Gularath,thrall,480,warlock,destruction,12,5,7
Claralock,silvermoon,480,warlock,destruction,12,5,7
Zêngâ,kazzak,480,warlock,destruction,12,5,7
Werra,ravencrest,480,warlock,destruction,17,6,11
Mambra,sylvanas,480,warlock,destruction,18,5,13
Händerå,ragnaros,480,warlock,destruction,18,5,13
Ciesare,draenor,480,warlock,destruction,18,5,13
Уфц,grom,480,warlock,destruction,18,5,13
Erèss,hyjal,480,warlock,destruction,18,5,13
Kineo,argent-dawn,480,warlock,destruction,18,5,13
Menzoberra,archimonde,480,warlock,destruction,18,5,13
Closetlock,the-maelstrom,480,warlock,destruction,18,5,13
Lillithx,stormscale,480,warlock,destruction,18,5,13
Brudèrtuk,das-syndikat,480,warlock,destruction,18,5,13
Maledictio,blackrock,480,warlock,destruction,18,5,13
Lockned,outland,480,warlock,destruction,18,5,13
Coviddotter,stormscale,480,warlock,destruction,18,5,13
Chaosborn,twisting-nether,479,warlock,destruction,6,5,1
Fruccia,hyjal,479,warlock,destruction,6,5,1
Archélion,silvermoon,479,warlock,destruction,12,5,7
Милуй,eversong,479,warlock,destruction,12,5,7
Januzoton,kazzak,479,warlock,destruction,12,5,7
Сенсация,ashenvale,479,warlock,destruction,12,5,7
Glitchpop,archimonde,479,warlock,destruction,12,5,7
Cêebêry,frostwolf,479,warlock,destruction,17,6,11
Selenene,norgannon,479,warlock,destruction,18,5,13
Fesse,draenor,479,warlock,destruction,18,5,13
Yenkorov,blackmoore,479,warlock,destruction,18,5,13
Shamhara,twisting-nether,479,warlock,destruction,18,5,13
Тэйлок,gordunni,479,warlock,destruction,18,5,13
Bope,the-maelstrom,479,warlock,destruction,18,5,13
Intina,dragonblight,479,warlock,destruction,18,5,13
Darkphoenix,the-maelstrom,479,warlock,destruction,18,5,13
Blugrey,nemesis,479,warlock,destruction,18,5,13
Lockpup,draenor,479,warlock,destruction,24,5,19
Лавамес,eversong,478,warlock,destruction,10,6,4
Soulsdeads,sylvanas,478,warlock,destruction,12,5,7
Yourdeaath,ravencrest,478,warlock,destruction,18,5,13
Espilocka,dun-modr,477,warlock,destruction,6,5,1
Ohanze,antonidas,477,warlock,destruction,12,5,7
Nukeem,karazhan,475,warlock,destruction,12,5,7
Syrax,darkmoon-faire,475,warlock,destruction,30,5,25
Garimberas,silvermoon,468,warlock,destruction,22,8,14
Helikopter,shattered-hand,463,warlock,destruction,12,6,6
Дыханиетени,soulflayer,463,warlock,destruction,12,5,7
Darkksaomon,sanguino,447,warlock,destruction,8,6,2
Hahahahah,draenor,447,warlock,destruction,11,5,6
Winterx,argent-dawn,447,warlock,destruction,11,5,6
Primdåhl,ravencrest,447,warlock,destruction,17,5,12
Hilfhëim,cthun,445,warlock,destruction,11,5,6
Secretninja,silvermoon,432,warlock,destruction,15,5,10
Syriån,kazzak,431,warlock,destruction,11,5,6
Qliimax,blackrock,416,warlock,destruction,10,5,5
Skadz,blackmoore,416,warlock,destruction,10,5,5
Hønneyjckk,hyjal,415,warlock,destruction,8,5,3
Greemwolf,doomhammer,413,warlock,destruction,23,6,17
Furrylóver,kazzak,399,warlock,destruction,5,5,0
Waöld,sylvanas,398,warlock,destruction,16,5,11
Fearylia,aegwynn,393,warlock,destruction,11,8,3
Darkwìngduck,ravencrest,384,warlock,destruction,6,4,2
Dotforgold,blackmoore,384,warlock,destruction,6,4,2
Ahollic,antonidas,384,warlock,destruction,6,4,2
Арматурааня,gordunni,384,warlock,destruction,6,4,2
Локкибальбоа,soulflayer,384,warlock,destruction,6,4,2
Iulu,sylvanas,384,warlock,destruction,6,4,2
Grixius,argent-dawn,384,warlock,destruction,6,4,2
Wromged,argent-dawn,384,warlock,destruction,6,4,2
Fatbaldold,ravencrest,384,warlock,destruction,6,4,2
Nãshor,kazzak,384,warlock,destruction,6,4,2
Mdrglock,ravencrest,384,warlock,destruction,6,4,2
Shelinda,earthen-ring,384,warlock,destruction,6,4,2
Cadrega,nemesis,384,warlock,destruction,6,4,2
Danthys,outland,384,warlock,destruction,6,4,2
Lynnqt,sylvanas,384,warlock,destruction,6,4,2
Lindastotch,kazzak,384,warlock,destruction,6,4,2
Shadowimpact,ravencrest,384,warlock,destruction,6,4,2
Auchaos,argent-dawn,384,warlock,destruction,6,4,2
Voídzero,hyjal,384,warlock,destruction,6,4,2
Azae,outland,384,warlock,destruction,6,4,2
Cappaoow,ravencrest,384,warlock,destruction,6,4,2
Nilsa,eredar,384,warlock,destruction,6,4,2
Gemja,onyxia,384,warlock,destruction,6,4,2
Zorphu,quelthalas,384,warlock,destruction,6,4,2
Veloces,defias-brotherhood,384,warlock,destruction,6,4,2
Xristianos,ravencrest,384,warlock,destruction,6,4,2
Slaìk,eredar,384,warlock,destruction,6,4,2
Focalortwo,ravencrest,384,warlock,destruction,6,4,2
Apeliction,eredar,384,warlock,destruction,6,4,2
Archalon,blackhand,384,warlock,destruction,6,4,2
Rngmåchinêx,ravencrest,384,warlock,destruction,6,4,2
Siyaa,eredar,384,warlock,destruction,6,4,2
Zíllakami,tarren-mill,384,warlock,destruction,6,4,2
Nosferatia,kult-der-verdammten,384,warlock,destruction,6,4,2
Teachluv,frostwolf,384,warlock,destruction,6,4,2
Échø,blackmoore,384,warlock,destruction,6,4,2
Born,ravencrest,384,warlock,destruction,6,4,2
Cannibalcook,blackmoore,384,warlock,destruction,6,4,2
Viscius,ysondre,384,warlock,destruction,6,4,2
Sunlicht,kazzak,384,warlock,destruction,6,4,2
Dotritos,tarren-mill,384,warlock,destruction,6,4,2
Holdmyféar,silvermoon,384,warlock,destruction,6,4,2
Suicidekings,draenor,384,warlock,destruction,6,4,2
Dashirø,drakthul,384,warlock,destruction,6,4,2
Warchilly,twisting-nether,384,warlock,destruction,6,4,2
Eizon,tarren-mill,384,warlock,destruction,6,4,2
Shaarak,blackrock,384,warlock,destruction,6,4,2
Feyreah,blackmoore,384,warlock,destruction,6,4,2
Zasajin,blackhand,384,warlock,destruction,6,4,2
Zaratraz,guldan,384,warlock,destruction,6,4,2
Пчелокнижник,howling-fjord,384,warlock,destruction,6,4,2
Kaiczar,draenor,384,warlock,destruction,6,4,2
Труупыч,gordunni,384,warlock,destruction,6,4,2
Lightsd,twisting-nether,384,warlock,destruction,6,4,2
Iryann,silvermoon,384,warlock,destruction,6,4,2
Mcdotnálds,thrall,384,warlock,destruction,6,4,2
Анрали,soulflayer,384,warlock,destruction,6,4,2
Hirasawa,archimonde,384,warlock,destruction,6,4,2
Varend,drakthul,384,warlock,destruction,6,4,2
Smittorisk,stormscale,384,warlock,destruction,6,4,2
Trimie,tarren-mill,384,warlock,destruction,6,4,2
Techlord,tarren-mill,384,warlock,destruction,6,4,2
Jøw,tarren-mill,384,warlock,destruction,6,4,2
Zéik,archimonde,384,warlock,destruction,6,4,2
Bicuriousdad,tarren-mill,384,warlock,destruction,6,4,2
Hiloqtlock,blackmoore,384,warlock,destruction,6,4,2
Notloveless,stormscale,384,warlock,destruction,6,4,2
Zezca,draenor,384,warlock,destruction,6,4,2
Cokkà,dalaran,384,warlock,destruction,6,4,2
Zodzinisbad,ragnaros,384,warlock,destruction,6,4,2
Soulbolt,ragnaros,384,warlock,destruction,6,4,2
Xskyrov,blackmoore,384,warlock,destruction,6,4,2
Døxz,blackrock,384,warlock,destruction,6,4,2
Xenastro,silvermoon,384,warlock,destruction,6,4,2
Garfs,stormscale,384,warlock,destruction,6,4,2
Helvild,draenor,384,warlock,destruction,6,4,2
Løba,kazzak,384,warlock,destruction,6,4,2
Keess,darksorrow,384,warlock,destruction,6,4,2
Getoutmaway,stormscale,384,warlock,destruction,6,4,2
Malthiria,silvermoon,384,warlock,destruction,6,4,2
Devørør,stormscale,384,warlock,destruction,6,4,2
Anthønyy,archimonde,384,warlock,destruction,6,4,2
Zeotrixie,stormscale,384,warlock,destruction,6,4,2
Кичи,gordunni,384,warlock,destruction,6,4,2
Miselinek,drakthul,384,warlock,destruction,6,4,2
Fîndelkind,blackrock,384,warlock,destruction,6,4,2
Drshegs,darkspear,384,warlock,destruction,6,4,2
Warpawn,twisting-nether,384,warlock,destruction,6,4,2
Sïlïthuss,ravencrest,384,warlock,destruction,6,4,2
Shílda,silvermoon,384,warlock,destruction,6,4,2
Sýrune,ragnaros,384,warlock,destruction,6,4,2
Бригада,howling-fjord,384,warlock,destruction,6,4,2
Критокнижник,lich-king,384,warlock,destruction,6,4,2
Gaaktah,ragnaros,384,warlock,destruction,6,4,2
Kukburet,silvermoon,384,warlock,destruction,6,4,2
Rayfears,draenor,384,warlock,destruction,6,4,2
Bockauflock,silvermoon,384,warlock,destruction,6,4,2
Spacecarry,archimonde,384,warlock,destruction,6,4,2
Omnípotens,silvermoon,384,warlock,destruction,12,6,6
Tekron,blackhand,384,warlock,destruction,12,4,8
Razhûl,blackhand,384,warlock,destruction,12,4,8
Стокыч,soulflayer,384,warlock,destruction,12,4,8
Waryald,dun-modr,384,warlock,destruction,12,4,8
Vsmna,ragnaros,384,warlock,destruction,12,4,8
Vanskor,argent-dawn,384,warlock,destruction,12,4,8
Warth,silvermoon,384,warlock,destruction,12,4,8
Demofox,ragnaros,384,warlock,destruction,12,4,8
Reviala,kazzak,384,warlock,destruction,12,4,8
Legiozock,draenor,384,warlock,destruction,12,4,8
Plaguezx,darkspear,384,warlock,destruction,12,4,8
Vorak,turalyon,384,warlock,destruction,12,4,8
Atúm,auchindoun,384,warlock,destruction,12,4,8
Déidara,emerald-dream,384,warlock,destruction,12,4,8
Pekenina,outland,384,warlock,destruction,12,4,8
Sellinia,culte-de-la-rive-noire,384,warlock,destruction,12,4,8
Impvader,argent-dawn,384,warlock,destruction,12,4,8
Tiktokér,kazzak,384,warlock,destruction,12,4,8
Ivesl,blackrock,384,warlock,destruction,12,4,8
Hòbó,outland,384,warlock,destruction,12,4,8
Cirihexer,area-52,384,warlock,destruction,12,4,8
Féárx,silvermoon,384,warlock,destruction,12,4,8
Oimera,frostwolf,384,warlock,destruction,12,4,8
Axy,dun-modr,384,warlock,destruction,12,4,8
Chäös,outland,384,warlock,destruction,12,4,8
Azzra,kazzak,384,warlock,destruction,12,4,8
Nicetime,nefarian,384,warlock,destruction,12,4,8
Hexovíc,blackmoore,384,warlock,destruction,12,4,8
Tilliâ,blackhand,384,warlock,destruction,12,4,8
Чиззихаос,soulflayer,384,warlock,destruction,12,4,8
Demoncius,dun-modr,384,warlock,destruction,12,4,8
Selur,ragnaros,384,warlock,destruction,12,4,8
Thalzur,ravencrest,384,warlock,destruction,12,4,8
Yifu,ravencrest,384,warlock,destruction,12,4,8
Thatscap,tarren-mill,384,warlock,destruction,12,4,8
Tiitz,blackmoore,384,warlock,destruction,12,4,8
Warket,ragnaros,384,warlock,destruction,12,4,8
Novkan,eredar,384,warlock,destruction,12,4,8
Impnapper,burning-legion,384,warlock,destruction,12,4,8
Roedin,tarren-mill,384,warlock,destruction,12,4,8
Бешентумай,goldrinn,384,warlock,destruction,12,4,8
Suêin,dun-modr,384,warlock,destruction,12,4,8
Ieatfel,archimonde,384,warlock,destruction,12,4,8
Древнина,greymane,384,warlock,destruction,12,4,8
Drogóth,blackmoore,384,warlock,destruction,12,4,8
Cptdotalot,tarren-mill,384,warlock,destruction,12,4,8
Yandihimir,silvermoon,384,warlock,destruction,12,4,8
Voidlocklol,magtheridon,384,warlock,destruction,12,4,8
Hheavens,ragnaros,384,warlock,destruction,12,4,8
Blubbajohnny,blackmoore,384,warlock,destruction,12,4,8
Darkmaw,drakthul,384,warlock,destruction,12,4,8
Harrydotterx,alakir,384,warlock,destruction,12,4,8
Nécron,ysondre,384,warlock,destruction,12,4,8
Мазаффак,gordunni,384,warlock,destruction,12,4,8
Kubbÿ,drakthul,384,warlock,destruction,12,4,8
Vextalock,drakthul,384,warlock,destruction,12,4,8
Elektrohæxe,blackmoore,384,warlock,destruction,12,4,8
Ranalock,blackrock,384,warlock,destruction,12,4,8
Mustalol,outland,384,warlock,destruction,12,4,8
Wepz,chamber-of-aspects,384,warlock,destruction,12,4,8
Awenthor,blackrock,384,warlock,destruction,12,4,8
Kakren,ysondre,384,warlock,destruction,12,4,8
Ksenìa,khaz-modan,384,warlock,destruction,12,4,8
Muninnus,archimonde,384,warlock,destruction,12,4,8
Tepelkwastje,twisting-nether,384,warlock,destruction,18,4,14
Таракай,eversong,384,warlock,destruction,18,4,14
Andrewtaint,twisting-nether,384,warlock,destruction,18,4,14
Dreadbøt,blackrock,384,warlock,destruction,18,4,14
Thinio,argent-dawn,384,warlock,destruction,18,4,14
Injecter,stormscale,383,warlock,destruction,6,4,2
Силаскверна,deathguard,383,warlock,destruction,6,4,2
Неиставая,deathguard,383,warlock,destruction,6,4,2
Okulus,quelthalas,383,warlock,destruction,6,4,2
Angrynoob,silvermoon,383,warlock,destruction,6,4,2
Sanguinis,theradras,383,warlock,destruction,6,4,2
Manikalinka,stormscale,383,warlock,destruction,6,4,2
Avel,dun-morogh,383,warlock,destruction,15,5,10
Feliciousx,draenor,383,warlock,destruction,12,4,8
Khandar,aegwynn,383,warlock,destruction,12,4,8
Grooptoop,draenor,383,warlock,destruction,18,4,14
Michtv,hyjal,383,warlock,destruction,18,4,14
Risujemma,stormreaver,383,warlock,destruction,18,4,14
Watchlock,burning-legion,382,warlock,destruction,26,9,17
Adizew,kazzak,382,warlock,destruction,18,4,14
Сатари,blackscar,378,warlock,destruction,20,9,11
Mostyn,tarren-mill,361,warlock,destruction,17,6,11
Boltsnhoes,drakthul,351,warlock,destruction,11,4,7
Easymode,archimonde,351,warlock,destruction,11,4,7
Antichoas,kazzak,351,warlock,destruction,17,4,13
Smolpussgodx,ragnaros,336,warlock,destruction,9,5,4
Afrolock,antonidas,336,warlock,destruction,9,5,4
Tabok,khazgoroth,336,warlock,destruction,21,4,17
Damßalla,cthun,330,warlock,destruction,11,8,3
Threeam,malganis,330,warlock,destruction,9,5,4
Рейнджр,eversong,330,warlock,destruction,15,6,9
Rikimancer,tarren-mill,330,warlock,destruction,15,5,10
Бургиявашрот,eversong,330,warlock,destruction,16,5,11
Velativ,silvermoon,330,warlock,destruction,16,5,11
Lockpz,sylvanas,330,warlock,destruction,18,5,13
Voib,silvermoon,329,warlock,destruction,21,7,14
Лвнг,gordunni,320,warlock,destruction,10,4,6
Malganas,sylvanas,320,warlock,destruction,16,4,12
Shasi,silvermoon,319,warlock,destruction,5,4,1
Reconnected,drakthul,319,warlock,destruction,8,4,4
Qateza,azjolnerub,288,warlock,destruction,6,3,3
Soezzlock,archimonde,288,warlock,destruction,6,3,3
Пувнэт,howling-fjord,288,warlock,destruction,6,3,3
Húxy,silvermoon,288,warlock,destruction,6,3,3
Dmger262947,twisting-nether,288,warlock,destruction,6,3,3
Windylol,drakthul,288,warlock,destruction,6,3,3
Gïzzmo,tarren-mill,288,warlock,destruction,6,3,3
Kaîdö,archimonde,288,warlock,destruction,6,3,3
Annkî,aegwynn,288,warlock,destruction,6,3,3
Nethros,ragnaros,288,warlock,destruction,6,3,3
Cgòw,ravencrest,288,warlock,destruction,6,3,3
Lockskalle,tarren-mill,288,warlock,destruction,6,3,3
Zizzbrah,ragnaros,288,warlock,destruction,6,3,3
Akdan,ragnaros,288,warlock,destruction,6,3,3
Гулдаанн,fordragon,288,warlock,destruction,6,3,3
Covidbolt,outland,288,warlock,destruction,6,3,3
Ninmockasin,stormscale,288,warlock,destruction,6,3,3
Ruinovino,outland,288,warlock,destruction,6,3,3
Decayden,twisting-nether,288,warlock,destruction,6,3,3
Slainzz,zuljin,288,warlock,destruction,6,3,3
Chaotyk,drakthul,288,warlock,destruction,6,3,3
Friendlylock,quelthalas,288,warlock,destruction,6,3,3
Demonologyz,ravencrest,288,warlock,destruction,6,3,3
Ctrlaltdelet,stormscale,288,warlock,destruction,6,3,3
Rokudaime,stormscale,288,warlock,destruction,6,3,3
Nargøf,outland,288,warlock,destruction,6,3,3
Mulax,aegwynn,288,warlock,destruction,6,3,3
Dekawa,ravencrest,288,warlock,destruction,6,3,3
Gneticz,aegwynn,288,warlock,destruction,6,3,3
Fearylicious,burning-legion,288,warlock,destruction,6,3,3
Гвадривер,howling-fjord,288,warlock,destruction,6,3,3
Huaian,darksorrow,288,warlock,destruction,6,3,3
Zblock,colinas-pardas,288,warlock,destruction,6,3,3
Whj,ravencrest,288,warlock,destruction,6,3,3
Marakh,stormscale,288,warlock,destruction,6,3,3
Bróbean,ravencrest,288,warlock,destruction,6,3,3
ßudßud,kazzak,288,warlock,destruction,6,3,3
Biancalawson,argent-dawn,288,warlock,destruction,6,3,3
Kudde,twisting-nether,288,warlock,destruction,6,3,3
Imissbfafour,stormscale,288,warlock,destruction,6,3,3
Ðiablð,tarren-mill,288,warlock,destruction,6,3,3
Anniemoon,silvermoon,288,warlock,destruction,6,3,3
Kariusbaktus,stormscale,288,warlock,destruction,6,3,3
Doomgrunt,magtheridon,288,warlock,destruction,6,3,3
Bitch,ravencrest,288,warlock,destruction,6,3,3
Adreal,burning-legion,288,warlock,destruction,6,3,3
Lockmex,outland,288,warlock,destruction,6,3,3
Amdownbad,kazzak,288,warlock,destruction,6,3,3
Dipsí,kazzak,288,warlock,destruction,6,3,3
Martyrre,archimonde,288,warlock,destruction,6,3,3
Dailylock,kazzak,288,warlock,destruction,6,3,3
Ðanilock,dun-modr,288,warlock,destruction,6,3,3
Dóni,chamber-of-aspects,288,warlock,destruction,6,3,3
Myzkâ,archimonde,288,warlock,destruction,6,3,3
Boldielocks,tarren-mill,288,warlock,destruction,6,3,3
Darnax,pozzo-delleternità,288,warlock,destruction,6,3,3
Calistria,argent-dawn,288,warlock,destruction,6,3,3
Hiroyukí,frostmane,288,warlock,destruction,6,3,3
Messire,ragnaros,288,warlock,destruction,6,3,3
Volontáry,stormscale,288,warlock,destruction,6,3,3
Lamboo,tarren-mill,288,warlock,destruction,6,3,3
Sharcoowl,antonidas,288,warlock,destruction,6,3,3
Hotwhileurot,silvermoon,288,warlock,destruction,6,3,3
Muridae,tarren-mill,288,warlock,destruction,6,3,3
Epoku,stormscale,288,warlock,destruction,6,3,3
Hypermectus,stormscale,288,warlock,destruction,6,3,3
Cthulhul,stormscale,288,warlock,destruction,6,3,3
Saymore,ragnaros,288,warlock,destruction,6,3,3
Belite,archimonde,288,warlock,destruction,6,3,3
Hairylock,outland,288,warlock,destruction,6,3,3
Besthun,drakthul,288,warlock,destruction,6,3,3
Jedlock,outland,288,warlock,destruction,6,3,3
Ароматныйх,howling-fjord,288,warlock,destruction,6,3,3
Spamfearxd,archimonde,288,warlock,destruction,6,3,3
Drbob,ravencrest,288,warlock,destruction,6,3,3
Rutena,ravencrest,288,warlock,destruction,6,3,3
Nêstêe,archimonde,288,warlock,destruction,6,3,3
Mïta,hyjal,288,warlock,destruction,6,3,3
Drybolt,argent-dawn,288,warlock,destruction,6,3,3
Omaleinfluch,antonidas,288,warlock,destruction,6,3,3
Исусилок,deathguard,288,warlock,destruction,6,3,3
Mightnáré,tarren-mill,288,warlock,destruction,6,3,3
Sodadogpìn,nemesis,288,warlock,destruction,6,3,3
Tibzx,stormscale,288,warlock,destruction,6,3,3
Hazzikosby,ravencrest,288,warlock,destruction,6,3,3
Jeepsee,outland,288,warlock,destruction,6,3,3
Soulslugger,twisting-nether,288,warlock,destruction,6,3,3
Greenjelly,ravencrest,288,warlock,destruction,6,3,3
Givënchy,archimonde,288,warlock,destruction,6,3,3
Simendimen,tarren-mill,288,warlock,destruction,6,3,3
Dement,sanguino,288,warlock,destruction,6,3,3
Hammern,haomarush,288,warlock,destruction,6,3,3
Cálamity,magtheridon,288,warlock,destruction,6,3,3
Tjockoloco,tarren-mill,288,warlock,destruction,6,3,3
Løvesøsa,ravencrest,288,warlock,destruction,6,3,3
Narlock,ravencrest,288,warlock,destruction,6,3,3
Bestwarlock,ravencrest,288,warlock,destruction,6,3,3
Stridson,shattered-hand,288,warlock,destruction,6,3,3
Fellouussion,dalaran,288,warlock,destruction,6,3,3
Deylanar,tarren-mill,288,warlock,destruction,6,3,3
Widot,ravencrest,288,warlock,destruction,6,3,3
Domyatus,chogall,288,warlock,destruction,6,3,3
Bäme,archimonde,288,warlock,destruction,6,3,3
Palmtri,stormscale,288,warlock,destruction,6,3,3
Brolter,blackhand,288,warlock,destruction,6,3,3
Schoolboizug,twisting-nether,288,warlock,destruction,6,3,3
Tigna,outland,288,warlock,destruction,6,3,3
Veggal,outland,288,warlock,destruction,6,3,3
Xyré,twisting-nether,288,warlock,destruction,6,3,3
Aghmar,ravencrest,288,warlock,destruction,6,3,3
Dragmetohêll,blackhand,288,warlock,destruction,6,3,3
Loq,frostwolf,288,warlock,destruction,6,3,3
Yippz,kazzak,288,warlock,destruction,6,3,3
Whitemagic,nemesis,288,warlock,destruction,6,3,3
Pokesndots,silvermoon,288,warlock,destruction,6,3,3
Muradona,nemesis,288,warlock,destruction,6,3,3
Mirezl,taerar,288,warlock,destruction,6,3,3
Mvplock,magtheridon,288,warlock,destruction,6,3,3
Impsgalore,ravencrest,288,warlock,destruction,6,3,3
Cpump,twisting-nether,288,warlock,destruction,6,3,3
Bluh,twisting-nether,288,warlock,destruction,6,3,3
Skizofrenia,zuljin,288,warlock,destruction,6,3,3
Lestroy,draenor,288,warlock,destruction,6,3,3
Viclock,kazzak,288,warlock,destruction,6,3,3
Zabani,das-syndikat,288,warlock,destruction,6,3,3
Deathrá,blackmoore,288,warlock,destruction,6,3,3
Ремайка,gordunni,288,warlock,destruction,6,3,3
Rindo,conseil-des-ombres,288,warlock,destruction,6,3,3
Safewagwan,auchindoun,288,warlock,destruction,6,3,3
Нэрфир,soulflayer,288,warlock,destruction,6,3,3
Drozhna,kaelthas,288,warlock,destruction,6,3,3
Aches,sylvanas,288,warlock,destruction,6,3,3
Iwy,anetheron,288,warlock,destruction,6,3,3
Grindelwald,blackmoore,288,warlock,destruction,6,3,3
Toskanoamani,blackmoore,288,warlock,destruction,6,3,3
Taylorg,blackmoore,288,warlock,destruction,6,3,3
Jazggzgirl,blackmoore,288,warlock,destruction,6,3,3
Кукурузямба,soulflayer,288,warlock,destruction,6,3,3
Дядяджонн,gordunni,288,warlock,destruction,6,3,3
Санядушнила,soulflayer,288,warlock,destruction,6,3,3
Fearhealer,blackmoore,288,warlock,destruction,6,3,3
Grîmløck,thrall,288,warlock,destruction,6,3,3
Demónfire,sylvanas,288,warlock,destruction,6,3,3
Heexmex,blackmoore,288,warlock,destruction,6,3,3
Ìí,blackmoore,288,warlock,destruction,6,3,3
Bixle,thrall,288,warlock,destruction,6,3,3
Нрг,blackscar,288,warlock,destruction,6,3,3
Solkarth,draenor,288,warlock,destruction,6,3,3
Флорэтт,gordunni,288,warlock,destruction,6,3,3
Aramnes,blackmoore,288,warlock,destruction,6,3,3
Lemuriel,arthas,288,warlock,destruction,6,3,3
Tschiko,blackrock,288,warlock,destruction,6,3,3
Thyron,gorgonnash,288,warlock,destruction,6,3,3
Lokdok,draenor,288,warlock,destruction,6,3,3
Kírth,blackmoore,288,warlock,destruction,6,3,3
Вандаллизмэ,blackscar,288,warlock,destruction,6,3,3
Колдую,gordunni,288,warlock,destruction,6,3,3
Динодотх,gordunni,288,warlock,destruction,6,3,3
Асальвэйд,gordunni,288,warlock,destruction,6,3,3
Mïta,culte-de-la-rive-noire,288,warlock,destruction,6,3,3
Cursify,doomhammer,288,warlock,destruction,6,3,3
Slem,aerie-peak,288,warlock,destruction,6,3,3
Jiruga,blackrock,288,warlock,destruction,6,3,3
Пачимучка,gordunni,288,warlock,destruction,6,3,3
Tenishia,blackrock,288,warlock,destruction,6,3,3
Moonliwl,blackrock,288,warlock,destruction,6,3,3
Димаанстейбл,gordunni,288,warlock,destruction,6,3,3
Митямассфир,soulflayer,288,warlock,destruction,6,3,3
Brudergottes,blackmoore,288,warlock,destruction,6,3,3
Ajc,draenor,288,warlock,destruction,6,3,3
Данябандит,soulflayer,288,warlock,destruction,6,3,3
Maquan,blackmoore,288,warlock,destruction,6,3,3
Tenshirou,blackrock,288,warlock,destruction,6,3,3
Drith,blades-edge,288,warlock,destruction,6,3,3
Knowfear,doomhammer,288,warlock,destruction,6,3,3
Bronnox,frostmane,288,warlock,destruction,9,4,5
Fêar,frostwhisper,288,warlock,destruction,9,4,5
Chaosinvain,burning-legion,288,warlock,destruction,7,3,4
Wolfdoom,cthun,288,warlock,destruction,9,3,6
Ятвояпогибел,soulflayer,288,warlock,destruction,10,3,7
Минструал,soulflayer,288,warlock,destruction,11,3,8
Lostmind,doomhammer,288,warlock,destruction,11,3,8
Freshh,burning-legion,288,warlock,destruction,12,3,9
Merelock,eonar,288,warlock,destruction,12,3,9
Shelbys,tyrande,288,warlock,destruction,12,3,9
Galadninon,drakthul,288,warlock,destruction,12,3,9
Крегтико,galakrond,288,warlock,destruction,12,3,9
Пучкова,azuregos,288,warlock,destruction,12,3,9
Brambam,stormrage,288,warlock,destruction,12,3,9
Daeneerys,skullcrusher,288,warlock,destruction,12,3,9
Faustes,alakir,288,warlock,destruction,12,3,9
Quief,silvermoon,288,warlock,destruction,12,3,9
Tiffyilock,blackrock,288,warlock,destruction,12,3,9
Xrathis,thunderhorn,288,warlock,destruction,12,3,9
Valgg,tarren-mill,288,warlock,destruction,12,3,9
Deabrus,silvermoon,288,warlock,destruction,12,3,9
Chaoschao,silvermoon,288,warlock,destruction,12,3,9
Werlock,sanguino,288,warlock,destruction,12,3,9
Isanê,blackrock,288,warlock,destruction,12,3,9
Aloxer,sanguino,288,warlock,destruction,12,3,9
Zhareeus,sanguino,288,warlock,destruction,12,3,9
Alicechaos,draenor,288,warlock,destruction,12,3,9
Gooey,magtheridon,288,warlock,destruction,12,3,9
Jaír,turalyon,288,warlock,destruction,12,3,9
Варикай,gordunni,288,warlock,destruction,12,3,9
Xas,teldrassil,288,warlock,destruction,12,3,9
Arwennia,malganis,288,warlock,destruction,12,3,9
Bytethisx,aggra-português,288,warlock,destruction,12,3,9
Britneý,stormscale,288,warlock,destruction,12,3,9
Маверрикк,gordunni,288,warlock,destruction,12,3,9
Mitrela,ravencrest,288,warlock,destruction,12,3,9
Purplerock,grim-batol,288,warlock,destruction,12,3,9
Sebi,kirin-tor,288,warlock,destruction,12,3,9
Rîyuk,hyjal,288,warlock,destruction,12,3,9
Xesch,proudmoore,288,warlock,destruction,12,3,9
Occult,terokkar,288,warlock,destruction,12,3,9
Nímdaa,stormscale,288,warlock,destruction,12,3,9
Leatherfvce,blackmoore,288,warlock,destruction,12,3,9
Dotzillâ,blackhand,288,warlock,destruction,12,3,9
Svartalfen,outland,288,warlock,destruction,12,3,9
Rogzon,eredar,288,warlock,destruction,12,3,9
Sarudan,ravencrest,288,warlock,destruction,12,3,9
Heldis,outland,288,warlock,destruction,12,3,9
Beybeyd,argent-dawn,288,warlock,destruction,12,3,9
Skyrender,argent-dawn,288,warlock,destruction,12,3,9
Swoksáar,blackmoore,288,warlock,destruction,12,3,9
Fear,outland,288,warlock,destruction,12,3,9
Киёкка,howling-fjord,288,warlock,destruction,12,3,9
Fewton,eonar,288,warlock,destruction,18,3,15
Нагибатель,howling-fjord,288,warlock,destruction,18,3,15
Naginii,sanguino,288,warlock,destruction,18,3,15
Imbasimba,sylvanas,287,warlock,destruction,8,4,4
Wegart,sylvanas,287,warlock,destruction,6,3,3
Grimzold,terokkar,287,warlock,destruction,6,3,3
Ashkaar,argent-dawn,287,warlock,destruction,6,3,3
Bluenote,colinas-pardas,287,warlock,destruction,12,3,9
Наруту,gordunni,287,warlock,destruction,18,3,15
Pottie,antonidas,286,warlock,destruction,18,3,15
Haysang,khaz-modan,274,warlock,destruction,22,7,15
Lockaria,zuljin,256,warlock,destruction,10,3,7
Хоратхе,soulflayer,255,warlock,destruction,8,4,4
Tanatos,tarren-mill,255,warlock,destruction,11,3,8
Shoobre,alakir,240,warlock,destruction,15,3,12
Nèssiè,sylvanas,239,warlock,destruction,5,3,2
Insertchaos,draenor,239,warlock,destruction,5,3,2
Alwaysbroken,archimonde,239,warlock,destruction,5,3,2
Brushiè,kazzak,239,warlock,destruction,5,3,2
Furrbidden,twisting-nether,239,warlock,destruction,5,3,2
Fearbly,tarren-mill,239,warlock,destruction,5,3,2
Opprimo,blackmoore,239,warlock,destruction,10,3,7
Chimera,mugthol,239,warlock,destruction,11,3,8
Darthdotz,outland,234,warlock,destruction,7,4,3
Talt,dalaran,234,warlock,destruction,15,6,9
Charmerx,kazzak,234,warlock,destruction,10,4,6
Arnoldswarce,doomhammer,234,warlock,destruction,12,4,8
Теймкрин,gordunni,234,warlock,destruction,13,4,9
Sineko,twisting-nether,233,warlock,destruction,11,6,5
Кингпинг,soulflayer,224,warlock,destruction,10,3,7
Kemuruss,kazzak,208,warlock,destruction,7,3,4
Ðankan,aegwynn,192,warlock,destruction,4,3,1
Герциер,soulflayer,192,warlock,destruction,4,3,1
Vortëxx,tarren-mill,192,warlock,destruction,9,3,6
Isotty,hyjal,192,warlock,destruction,9,3,6
Шэдоубёрн,soulflayer,192,warlock,destruction,6,2,4
Lockerby,kazzak,192,warlock,destruction,6,2,4
Nedhriix,drakthul,192,warlock,destruction,6,2,4
Skynoby,kazzak,192,warlock,destruction,6,2,4
Taralle,ysondre,192,warlock,destruction,6,2,4
Hytsulock,ysondre,192,warlock,destruction,6,2,4
Zmataryn,doomhammer,192,warlock,destruction,6,2,4
Angrythots,draenor,192,warlock,destruction,6,2,4
Øupas,ysondre,192,warlock,destruction,6,2,4
Omnipótent,moonglade,192,warlock,destruction,6,2,4
Cindela,eredar,192,warlock,destruction,6,2,4
Levitibus,argent-dawn,192,warlock,destruction,6,2,4
Cosec,silvermoon,192,warlock,destruction,6,2,4
Ambjørg,kazzak,192,warlock,destruction,6,2,4
Efekentli,frostwolf,192,warlock,destruction,6,2,4
Revvolt,tarren-mill,192,warlock,destruction,6,2,4
Necrochiller,tarren-mill,192,warlock,destruction,6,2,4
Zkrwl,kazzak,192,warlock,destruction,6,2,4
Zenaidaa,doomhammer,192,warlock,destruction,6,2,4
Kawaïí,frostwolf,192,warlock,destruction,6,2,4
Майдум,soulflayer,192,warlock,destruction,6,2,4
Heliphas,draenor,192,warlock,destruction,6,2,4
Vittaly,sargeras,192,warlock,destruction,6,2,4
Qullnius,kazzak,192,warlock,destruction,6,2,4
Balrokor,talnivarr,192,warlock,destruction,6,2,4
Бактэрия,soulflayer,192,warlock,destruction,6,2,4
Mákas,draenor,192,warlock,destruction,6,2,4
Kasolid,antonidas,192,warlock,destruction,6,2,4
Сладкийпир,soulflayer,192,warlock,destruction,6,2,4
Chuntlock,shadowsong,192,warlock,destruction,6,2,4
Meshekinoqua,tarren-mill,192,warlock,destruction,6,2,4
Rojas,trollbane,192,warlock,destruction,6,2,4
Degdeehei,draenor,192,warlock,destruction,6,2,4
Snoggä,antonidas,192,warlock,destruction,6,2,4
Bartoxus,antonidas,192,warlock,destruction,6,2,4
Contergan,arygos,192,warlock,destruction,6,2,4
Dinolock,antonidas,192,warlock,destruction,6,2,4
Houndread,kazzak,192,warlock,destruction,6,2,4
Lakataz,balnazzar,192,warlock,destruction,6,2,4
Silverghoul,draenor,192,warlock,destruction,6,2,4
Ashhlock,silvermoon,192,warlock,destruction,6,2,4
Tragus,ghostlands,192,warlock,destruction,6,2,4
Cuufi,silvermoon,192,warlock,destruction,6,2,4
Nâzgrel,tarren-mill,192,warlock,destruction,6,2,4
Splojf,the-maelstrom,192,warlock,destruction,6,2,4
Локеда,deathguard,192,warlock,destruction,6,2,4
Malliina,draenor,192,warlock,destruction,6,2,4
Draezharr,kazzak,192,warlock,destruction,6,2,4
Vextos,draenor,192,warlock,destruction,6,2,4
Kleing,dragonblight,192,warlock,destruction,6,2,4
Локгномус,azuregos,192,warlock,destruction,6,2,4
Haxs,ravencrest,192,warlock,destruction,6,2,4
Sinlockz,tarren-mill,192,warlock,destruction,6,2,4
Creamcleaner,tarren-mill,192,warlock,destruction,6,2,4
Kathrose,silvermoon,192,warlock,destruction,6,2,4
Ralys,draenor,192,warlock,destruction,6,2,4
Bigminimus,ravencrest,192,warlock,destruction,6,2,4
Felguy,ravencrest,192,warlock,destruction,6,2,4
Dêmön,arathi,192,warlock,destruction,6,2,4
Agonux,twisting-nether,192,warlock,destruction,6,2,4
Ívânguldán,twisting-nether,192,warlock,destruction,6,2,4
Prestige,nemesis,192,warlock,destruction,6,2,4
Guldän,quelthalas,192,warlock,destruction,6,2,4
Пухи,blackscar,192,warlock,destruction,6,2,4
Kazàar,archimonde,192,warlock,destruction,6,2,4
Fellanova,ravencrest,192,warlock,destruction,6,2,4
Kuzimu,aerie-peak,192,warlock,destruction,6,2,4
Lightswitchz,ravencrest,192,warlock,destruction,6,2,4
Сэльт,howling-fjord,192,warlock,destruction,6,2,4
Mommymílkers,archimonde,192,warlock,destruction,6,2,4
Ayôörts,archimonde,192,warlock,destruction,6,2,4
Getoffmedude,ravencrest,192,warlock,destruction,6,2,4
Aváne,outland,192,warlock,destruction,6,2,4
Merengue,uldum,192,warlock,destruction,6,2,4
Cheesefeet,ravencrest,192,warlock,destruction,6,2,4
Авиава,gordunni,192,warlock,destruction,6,2,4
Astralvoid,outland,192,warlock,destruction,6,2,4
Jubekah,sanguino,192,warlock,destruction,6,2,4
Reapex,lightbringer,192,warlock,destruction,6,2,4
Циарра,gordunni,192,warlock,destruction,6,2,4
Smoulville,sanguino,192,warlock,destruction,6,2,4
Antuan,sanguino,192,warlock,destruction,6,2,4
Sigred,sylvanas,192,warlock,destruction,6,2,4
Zhulthan,ravencrest,192,warlock,destruction,6,2,4
Eldrinar,twisting-nether,192,warlock,destruction,6,2,4
Ишла,gordunni,192,warlock,destruction,6,2,4
Шизуи,borean-tundra,192,warlock,destruction,6,2,4
Veladriss,sanguino,192,warlock,destruction,6,2,4
Incubith,ravencrest,192,warlock,destruction,6,2,4
Meapx,ragnaros,192,warlock,destruction,6,2,4
Zzebz,archimonde,192,warlock,destruction,6,2,4
Zagana,neptulon,192,warlock,destruction,6,2,4
Bloodysûgar,blackmoore,192,warlock,destruction,6,2,4
Cooviid,blackrock,192,warlock,destruction,6,2,4
Maldrium,zenedar,192,warlock,destruction,6,2,4
Æyna,thrall,192,warlock,destruction,6,2,4
Somalidog,ravencrest,192,warlock,destruction,6,2,4
Devadevam,twisting-nether,192,warlock,destruction,6,2,4
Belzedan,blackrock,192,warlock,destruction,6,2,4
Guttate,chamber-of-aspects,192,warlock,destruction,6,2,4
Werkx,archimonde,192,warlock,destruction,6,2,4
Letor,sanguino,192,warlock,destruction,6,2,4
Siìre,ravencrest,192,warlock,destruction,6,2,4
Grinige,twisting-nether,192,warlock,destruction,6,2,4
Syzt,ravencrest,192,warlock,destruction,6,2,4
Prydzor,archimonde,192,warlock,destruction,6,2,4
Velzevul,darksorrow,192,warlock,destruction,6,2,4
Grilljédén,blackrock,192,warlock,destruction,6,2,4
Kwanzaa,ravencrest,192,warlock,destruction,6,2,4
Kedrat,die-aldor,192,warlock,destruction,6,2,4
Elfex,ragnaros,192,warlock,destruction,6,2,4
Ght,outland,192,warlock,destruction,6,2,4
Kemel,thrall,192,warlock,destruction,6,2,4
Lokla,elune,192,warlock,destruction,6,2,4
Хашонмвп,gordunni,192,warlock,destruction,6,2,4
Фланка,gordunni,192,warlock,destruction,6,2,4
Saabnoolock,ragnaros,192,warlock,destruction,6,2,4
Zeall,twisting-nether,192,warlock,destruction,6,2,4
Öhö,blackrock,192,warlock,destruction,6,2,4
Lzeus,archimonde,192,warlock,destruction,6,2,4
Grandulf,ravencrest,192,warlock,destruction,6,2,4
Whydidudotha,ravencrest,192,warlock,destruction,6,2,4
Piouturass,hyjal,192,warlock,destruction,6,2,4
Benztruck,blackhand,192,warlock,destruction,6,2,4
Ðaddyy,stormscale,192,warlock,destruction,6,2,4
Vazelin,stormscale,192,warlock,destruction,6,2,4
Dééznuts,blackmoore,192,warlock,destruction,6,2,4
Laynih,blackrock,192,warlock,destruction,6,2,4
Nerflocks,aggra-português,192,warlock,destruction,6,2,4
Priszcilla,twisting-nether,192,warlock,destruction,6,2,4
Malfari,zuljin,192,warlock,destruction,6,2,4
Kabowie,twisting-nether,192,warlock,destruction,6,2,4
Dødheim,malganis,192,warlock,destruction,6,2,4
Hadexx,uldum,192,warlock,destruction,6,2,4
Sôshy,thrall,192,warlock,destruction,6,2,4
Toshiku,aggra-português,192,warlock,destruction,6,2,4
Sløck,blackhand,192,warlock,destruction,6,2,4
Pokidrain,twisting-nether,192,warlock,destruction,6,2,4
Darkenlock,burning-legion,192,warlock,destruction,6,2,4
Ezzrä,ragnaros,192,warlock,destruction,6,2,4
Ðestruction,chogall,192,warlock,destruction,6,2,4
Llyluna,hyjal,192,warlock,destruction,6,2,4
Pythius,destromath,192,warlock,destruction,6,2,4
Alauh,blackhand,192,warlock,destruction,6,2,4
Isâbell,destromath,192,warlock,destruction,6,2,4
Qvvu,blackmoore,192,warlock,destruction,10,3,7
Laventina,antonidas,192,warlock,destruction,12,3,9
Lykaos,baelgun,192,warlock,destruction,8,2,6
Amnésïa,eldrethalas,192,warlock,destruction,12,2,10
Srhal,blackmoore,192,warlock,destruction,12,2,10
Serkt,kazzak,192,warlock,destruction,12,2,10
Themits,executus,192,warlock,destruction,12,2,10
Bigusdicus,aszune,192,warlock,destruction,12,2,10
Kopfkissen,azshara,192,warlock,destruction,12,2,10
Shallän,dun-modr,192,warlock,destruction,12,2,10
Jerembro,hyjal,192,warlock,destruction,12,2,10
Kiriforce,blackmoore,192,warlock,destruction,12,2,10
Exodemon,stormscale,192,warlock,destruction,12,2,10
Sarómán,ravencrest,192,warlock,destruction,12,2,10
Agathaharkne,minahonda,192,warlock,destruction,12,2,10
Punishteens,blackmoore,192,warlock,destruction,12,2,10
Skratti,lightnings-blade,192,warlock,destruction,12,2,10
Necrophagus,outland,192,warlock,destruction,12,2,10
Sanghá,frostwolf,192,warlock,destruction,12,2,10
Нэйрокризиз,howling-fjord,192,warlock,destruction,12,2,10
Rubiloc,the-maelstrom,192,warlock,destruction,12,2,10
Titoss,archimonde,192,warlock,destruction,12,2,10
Nimwyn,argent-dawn,192,warlock,destruction,12,2,10
Valerga,zuljin,192,warlock,destruction,18,2,16
Zùrghan,elune,191,warlock,destruction,4,3,1
Uaelock,stormscale,191,warlock,destruction,6,2,4
Xaros,darksorrow,191,warlock,destruction,6,2,4
Ribtic,draenor,191,warlock,destruction,6,2,4
Karjarock,hyjal,191,warlock,destruction,12,2,10
Gaios,skullcrusher,191,warlock,destruction,18,2,16
Lockbubs,draenor,175,warlock,destruction,11,2,9
Qiymaster,silvermoon,160,warlock,destruction,10,2,8
Hp,ysondre,159,warlock,destruction,5,2,3
Grimlòck,antonidas,159,warlock,destruction,5,2,3
Lemonzx,stormscale,159,warlock,destruction,5,2,3
Lockimon,silvermoon,159,warlock,destruction,5,2,3
Dony,dun-morogh,159,warlock,destruction,5,2,3
Фримх,blackscar,159,warlock,destruction,5,2,3
Pewnedmpx,archimonde,159,warlock,destruction,5,2,3
Slìm,blackmoore,159,warlock,destruction,5,2,3
Jiltoks,blackmoore,159,warlock,destruction,5,2,3
Volkak,bladefist,159,warlock,destruction,5,2,3
Kalilumpa,festung-der-stürme,144,warlock,destruction,9,2,7
Elvilaino,archimonde,138,warlock,destruction,6,3,3
Vahk,uldum,138,warlock,destruction,7,3,4
Neveah,festung-der-stürme,138,warlock,destruction,8,3,5
Frankieboi,drakthul,138,warlock,destruction,8,3,5
Rb,anachronos,138,warlock,destruction,8,3,5
Darkpush,outland,138,warlock,destruction,11,4,7
Jabalock,mazrigos,138,warlock,destruction,15,5,10
Wdauwg,nazjatar,138,warlock,destruction,9,3,6
Hhogyoku,dentarg,138,warlock,destruction,10,3,7
Sigge,auchindoun,138,warlock,destruction,10,3,7
Belzzebuth,silvermoon,128,warlock,destruction,10,2,8
Dzeju,burning-legion,128,warlock,destruction,10,2,8
Перегном,blackscar,127,warlock,destruction,8,2,6
Neijihbolt,blackrock,112,warlock,destruction,7,2,5
Mqsxw,stormscale,112,warlock,destruction,7,2,5
Faustenburg,blackmoore,96,warlock,destruction,3,2,1
Fabz,aggra-português,96,warlock,destruction,3,2,1
Lockitz,kazzak,96,warlock,destruction,3,2,1
Dannyboi,drakthul,96,warlock,destruction,3,2,1
Mergon,ravencrest,96,warlock,destruction,3,2,1
Aenygma,jaedenar,96,warlock,destruction,6,1,5
Walchia,kazzak,96,warlock,destruction,6,1,5
Narkozz,archimonde,96,warlock,destruction,6,1,5
Tyranuzz,norgannon,96,warlock,destruction,6,1,5
Redî,kazzak,96,warlock,destruction,6,1,5
Cruello,ragnaros,96,warlock,destruction,6,1,5
Buyala,stormscale,96,warlock,destruction,6,1,5
Bigsuckergg,norgannon,96,warlock,destruction,6,1,5
Pssycho,defias-brotherhood,96,warlock,destruction,6,1,5
Antagor,dalaran,96,warlock,destruction,6,1,5
Gulzgan,kazzak,96,warlock,destruction,6,1,5
Shompaqzan,kazzak,96,warlock,destruction,6,1,5
Krabauf,eredar,96,warlock,destruction,6,1,5
Artery,tarren-mill,96,warlock,destruction,6,1,5
Zeirat,tarren-mill,96,warlock,destruction,6,1,5
Chaostheory,stormscale,96,warlock,destruction,6,1,5
Cresen,tarren-mill,96,warlock,destruction,6,1,5
Jujalari,stormscale,96,warlock,destruction,6,1,5
Patyalaka,archimonde,96,warlock,destruction,6,1,5
Zytomegalie,blackrock,96,warlock,destruction,6,1,5
Haisten,ravencrest,96,warlock,destruction,6,1,5
Lomendro,blackmoore,96,warlock,destruction,6,1,5
Seriasa,blackmoore,96,warlock,destruction,6,1,5
Xvron,tarren-mill,96,warlock,destruction,6,1,5
Indifférence,archimonde,96,warlock,destruction,6,1,5
Aerethes,twisting-nether,96,warlock,destruction,6,1,5
Meisterhexe,taerar,96,warlock,destruction,6,1,5
Fell,outland,96,warlock,destruction,6,1,5
Nulo,aggra-português,96,warlock,destruction,6,1,5
Heißerheinz,blackhand,96,warlock,destruction,6,1,5
Lemonhase,frostwolf,96,warlock,destruction,6,1,5
Lialda,twisting-nether,96,warlock,destruction,6,1,5
Artèm,ysondre,96,warlock,destruction,6,1,5
Nècrøphila,kazzak,96,warlock,destruction,6,1,5
Jolette,hyjal,96,warlock,destruction,6,1,5
Сквиртонитх,howling-fjord,96,warlock,destruction,6,1,5
Язлаякиска,soulflayer,96,warlock,destruction,6,1,5
Zapplock,frostwolf,96,warlock,destruction,6,1,5
Цетрелисс,gordunni,96,warlock,destruction,6,1,5
Pf,talnivarr,96,warlock,destruction,6,1,5
Löck,kirin-tor,96,warlock,destruction,6,1,5
Maidson,blackrock,96,warlock,destruction,6,1,5
Utuklululu,archimonde,96,warlock,destruction,6,1,5
Ezgamebruh,turalyon,96,warlock,destruction,6,1,5
Noxregina,antonidas,96,warlock,destruction,6,1,5
Gibbio,emerald-dream,96,warlock,destruction,6,1,5
Rêihdon,antonidas,96,warlock,destruction,6,1,5
Dadcrush,antonidas,96,warlock,destruction,6,1,5
Raest,arygos,96,warlock,destruction,6,1,5
Tiig,blackrock,96,warlock,destruction,6,1,5
Thaliä,tarren-mill,96,warlock,destruction,6,1,5
Ramuhn,antonidas,96,warlock,destruction,6,1,5
Kathuum,outland,96,warlock,destruction,6,1,5
Yerslock,twisting-nether,96,warlock,destruction,6,1,5
Mortvivants,kirin-tor,96,warlock,destruction,6,1,5
Snollerboy,antonidas,96,warlock,destruction,6,1,5
Ackorax,kilrogg,96,warlock,destruction,6,1,5
Reiukh,frostwolf,96,warlock,destruction,6,1,5
Enmakorogi,twisting-nether,96,warlock,destruction,6,1,5
Bigbabalock,frostwolf,96,warlock,destruction,6,1,5
Satânius,les-sentinelles,96,warlock,destruction,6,1,5
Vîerdotcom,blackrock,96,warlock,destruction,6,1,5
Znaj,tarren-mill,96,warlock,destruction,6,1,5
Ceean,silvermoon,96,warlock,destruction,6,1,5
Növnöv,madmortem,96,warlock,destruction,6,1,5
Wt,twisting-nether,96,warlock,destruction,6,1,5
Bönnie,ravencrest,96,warlock,destruction,6,1,5
Chaotick,bronze-dragonflight,96,warlock,destruction,6,1,5
Malefic,ravencrest,96,warlock,destruction,6,1,5
Shelancîá,blackmoore,96,warlock,destruction,6,1,5
Candyforkid,hyjal,96,warlock,destruction,6,1,5
Hørcrux,ravencrest,96,warlock,destruction,6,1,5
Mahishi,ravencrest,96,warlock,destruction,6,1,5
Malfarien,blackmoore,96,warlock,destruction,6,1,5
Harrasmus,ravencrest,96,warlock,destruction,6,1,5
Sunsero,exodar,96,warlock,destruction,6,1,5
Артекриолок,gordunni,96,warlock,destruction,6,1,5
Битриксс,soulflayer,96,warlock,destruction,6,1,5
Mursha,auchindoun,96,warlock,destruction,6,1,5
Tinaufatlard,ravencrest,96,warlock,destruction,6,1,5
Bigtitzes,ravencrest,96,warlock,destruction,6,1,5
Matfey,twisting-nether,96,warlock,destruction,6,1,5
Dabezdwl,outland,96,warlock,destruction,6,1,5
Ájszmen,ravencrest,96,warlock,destruction,6,1,5
Pablø,silvermoon,96,warlock,destruction,6,1,5
Милбон,gordunni,96,warlock,destruction,6,1,5
Тапкидеда,gordunni,96,warlock,destruction,6,1,5
Totephia,kazzak,96,warlock,destruction,6,1,5
Kostur,defias-brotherhood,96,warlock,destruction,6,1,5
Kopfschmerz,twisting-nether,96,warlock,destruction,6,1,5
Shmaney,silvermoon,96,warlock,destruction,6,1,5
Tectite,sporeggar,96,warlock,destruction,6,1,5
Murol,dalaran,96,warlock,destruction,6,1,5
Finea,sanguino,96,warlock,destruction,6,1,5
Kyyte,draenor,96,warlock,destruction,6,1,5
Daemonic,shattered-hand,96,warlock,destruction,6,1,5
Forzaken,bladefist,96,warlock,destruction,6,1,5
Taelesh,draenor,96,warlock,destruction,6,1,5
Белыймаг,grom,96,warlock,destruction,6,1,5
Прозерппина,azuregos,96,warlock,destruction,6,1,5
Rigour,silvermoon,96,warlock,destruction,6,1,5
Cutewife,burning-legion,96,warlock,destruction,6,1,5
Wake,bladefist,96,warlock,destruction,6,1,5
Cromanjonac,draenor,96,warlock,destruction,6,1,5
Pichwise,draenor,96,warlock,destruction,6,1,5
Wolramir,thrall,96,warlock,destruction,6,1,5
Kyyuss,burning-legion,96,warlock,destruction,6,1,5
Omnath,alakir,96,warlock,destruction,6,1,5
Yashâ,thrall,96,warlock,destruction,6,1,5
Czteryka,silvermoon,96,warlock,destruction,6,1,5
Lilskunk,draenor,96,warlock,destruction,6,1,5
Gothgul,sanguino,96,warlock,destruction,6,1,5
Mattihoh,rexxar,96,warlock,destruction,6,1,5
Lockydotty,silvermoon,96,warlock,destruction,6,1,5
Wiha,sanguino,96,warlock,destruction,6,1,5
Варатах,grom,96,warlock,destruction,6,1,5
Млечный,blackscar,96,warlock,destruction,6,1,5
Krasawitch,onyxia,96,warlock,destruction,7,1,6
Kickfear,kazzak,96,warlock,destruction,7,1,6
Ozzycrøwly,illidan,96,warlock,destruction,15,2,13
Harrydotterr,aegwynn,96,warlock,destruction,11,1,10
Democraft,the-maelstrom,96,warlock,destruction,12,1,11
Wellmannered,kazzak,96,warlock,destruction,12,1,11
Deathdawning,draenor,96,warlock,destruction,12,1,11
Gainel,exodar,96,warlock,destruction,12,1,11
Wuahlock,doomhammer,96,warlock,destruction,12,1,11
Alithia,sylvanas,96,warlock,destruction,12,1,11
Árkan,thrall,96,warlock,destruction,12,1,11
Niights,sylvanas,96,warlock,destruction,12,1,11
Реймей,blackscar,96,warlock,destruction,12,1,11
Rîas,hyjal,96,warlock,destruction,12,1,11
Sithlin,frostwhisper,96,warlock,destruction,12,1,11
Kehldor,blackmoore,96,warlock,destruction,12,1,11
Malagate,sylvanas,96,warlock,destruction,12,1,11
Feltox,auchindoun,96,warlock,destruction,12,1,11
Grêenbull,eredar,96,warlock,destruction,15,1,14
Dadadots,ravenholdt,79,warlock,destruction,5,1,4
Magosnik,archimonde,79,warlock,destruction,5,1,4
Valinskej,drakthul,79,warlock,destruction,5,1,4
Okmybad,outland,79,warlock,destruction,5,1,4
Mesîkatayut,outland,79,warlock,destruction,11,1,10
Woodoodoll,silvermoon,64,warlock,destruction,4,1,3
Néca,blackmoore,64,warlock,destruction,4,1,3
Tranas,ragnaros,64,warlock,destruction,4,1,3
Malariaa,defias-brotherhood,63,warlock,destruction,2,2,0
Coolfayce,draenor,48,warlock,destruction,3,1,2
Coblac,outland,48,warlock,destruction,3,1,2
Zereff,kragjin,48,warlock,destruction,3,1,2
Ðøtfearløl,blackmoore,42,warlock,destruction,6,2,4
Stonedup,alonsus,42,warlock,destruction,8,2,6
Anthor,tarren-mill,42,warlock,destruction,8,2,6
Obichamcici,tarren-mill,42,warlock,destruction,8,2,6
Rockstarr,dalaran,42,warlock,destruction,10,2,8
Zaross,khaz-modan,41,warlock,destruction,8,2,6
Demospîrît,outland,40,warlock,destruction,17,3,14
Zuldiá,stormscale,32,warlock,destruction,2,2,0
Dottiedot,kazzak,31,warlock,destruction,2,1,1
Chandelierh,kazzak,31,warlock,destruction,2,1,1
Ukicha,burning-blade,31,warlock,destruction,2,1,1
Pereat,blackmoore,31,warlock,destruction,2,1,1
Slockoló,ragnaros,31,warlock,destruction,2,1,1
Førgøtten,ragnaros,31,warlock,destruction,2,1,1
Kiraxplode,nemesis,31,warlock,destruction,2,1,1
Valw,ravencrest,16,warlock,destruction,1,1,0
Níkâ,aegwynn,16,warlock,destruction,1,1,0
Orkamorfin,silvermoon,16,warlock,destruction,1,1,0
Tágsy,ravencrest,2309,warlock,affliction,138,79,59
Langneur,ysondre,2247,warlock,affliction,114,63,51
Micol,doomhammer,2181,warlock,affliction,132,68,64
Härèsß,dun-modr,2174,warlock,affliction,124,73,51
Hædês,antonidas,2171,warlock,affliction,180,97,83
Bualock,sylvanas,2168,warlock,affliction,108,64,44
Exoldboss,outland,2155,warlock,affliction,102,54,48
Steckenpferd,blackmoore,2149,warlock,affliction,66,39,27
Hirasawa,archimonde,2105,warlock,affliction,73,38,35
Arukekz,blackmoore,2093,warlock,affliction,126,65,61
Chobitas,ravencrest,2076,warlock,affliction,150,78,72
Celebí,blackmoore,2075,warlock,affliction,90,56,34
Darksooul,xavius,2063,warlock,affliction,107,64,43
Buffdemo,blackmoore,2059,warlock,affliction,71,49,22
Glooness,burning-legion,2058,warlock,affliction,102,59,43
Kärme,archimonde,2056,warlock,affliction,467,238,229
Kaspersdame,ravencrest,2038,warlock,affliction,237,122,115
Rutena,ravencrest,2023,warlock,affliction,96,51,45
Southylol,stormscale,2020,warlock,affliction,197,105,92
Мрорбит,howling-fjord,2018,warlock,affliction,143,71,72
Arussj,blackrock,2018,warlock,affliction,116,57,59
Southylolz,stormscale,2015,warlock,affliction,71,36,35
Magonyth,ravencrest,2014,warlock,affliction,102,56,46
Ánderx,dun-modr,2014,warlock,affliction,114,56,58
Magonyth,tarren-mill,2008,warlock,affliction,130,72,58
Alliyâh,archimonde,1999,warlock,affliction,260,132,128
Nickrosh,terokkar,1989,warlock,affliction,66,39,27
Angryfránk,outland,1982,warlock,affliction,263,134,129
Тагочи,gordunni,1979,warlock,affliction,83,40,43
Gulgiann,nemesis,1977,warlock,affliction,72,38,34
Skrumpis,draenor,1976,warlock,affliction,353,181,172
Watchmecut,terenas,1971,warlock,affliction,69,41,28
Мануил,eversong,1967,warlock,affliction,65,38,27
Консидёро,gordunni,1961,warlock,affliction,163,85,78
Sehk,stormreaver,1958,warlock,affliction,97,52,45
Yokûjin,twisting-nether,1956,warlock,affliction,79,41,38
Toutanpapier,ysondre,1955,warlock,affliction,48,28,20
Perpetual,eredar,1950,warlock,affliction,60,33,27
Southyx,stormscale,1950,warlock,affliction,107,56,51
Nesme,sylvanas,1938,warlock,affliction,95,46,49
Qyburn,drekthar,1934,warlock,affliction,84,48,36
Laokoon,blackmoore,1933,warlock,affliction,170,99,71
Southy,stormscale,1918,warlock,affliction,48,25,23
Shadowflamez,argent-dawn,1914,warlock,affliction,54,34,20
Фламмэнх,soulflayer,1914,warlock,affliction,78,47,31
Boogeyboyx,stormscale,1914,warlock,affliction,125,65,60
Fruits,ysondre,1914,warlock,affliction,198,93,105
Рашчер,gordunni,1909,warlock,affliction,48,25,23
Infïnitýx,silvermoon,1907,warlock,affliction,155,85,70
Sad,lightnings-blade,1906,warlock,affliction,106,47,59
Mïta,hyjal,1904,warlock,affliction,48,27,21
Gulzot,turalyon,1903,warlock,affliction,197,101,96
Fredé,kazzak,1899,warlock,affliction,54,29,25
Garebigger,blackrock,1898,warlock,affliction,337,166,171
Kajanova,stormscale,1895,warlock,affliction,152,89,63
Plsdîe,twisting-nether,1895,warlock,affliction,95,52,43
Sêro,aegwynn,1893,warlock,affliction,150,83,67
Infernion,stormscale,1891,warlock,affliction,51,33,18
Kresyda,dun-modr,1887,warlock,affliction,60,27,33
Gøzù,antonidas,1884,warlock,affliction,52,30,22
Hladankurac,twisting-nether,1878,warlock,affliction,84,47,37
Mediumpotato,blackhand,1878,warlock,affliction,54,30,24
Limoges,archimonde,1874,warlock,affliction,90,55,35
Demónfire,sylvanas,1873,warlock,affliction,70,40,30
Bäle,stormreaver,1869,warlock,affliction,54,32,22
Debz,twisting-nether,1864,warlock,affliction,118,71,47
Langneur,archimonde,1862,warlock,affliction,54,25,29
Kitingguru,stormscale,1860,warlock,affliction,48,25,23
Nêverse,archimonde,1857,warlock,affliction,36,22,14
Yokujîn,twisting-nether,1851,warlock,affliction,60,31,29
Bwc,aegwynn,1850,warlock,affliction,140,70,70
Yosiya,draenor,1848,warlock,affliction,127,74,53
Monsterz,archimonde,1847,warlock,affliction,135,72,63
Блудгэнг,blackscar,1847,warlock,affliction,48,21,27
Vregor,twisting-nether,1844,warlock,affliction,64,35,29
Oarz,blackrock,1837,warlock,affliction,179,100,79
Kasoy,doomhammer,1837,warlock,affliction,160,84,76
Wällaar,ragnaros,1834,warlock,affliction,104,54,50
Cassen,outland,1833,warlock,affliction,60,31,29
Getfaked,nordrassil,1832,warlock,affliction,54,28,26
Пчелокнижник,howling-fjord,1831,warlock,affliction,42,25,17
Tuskawl,stormreaver,1829,warlock,affliction,65,40,25
Dst,ravencrest,1824,warlock,affliction,72,40,32
Halfwai,ravencrest,1824,warlock,affliction,78,43,35
Незерлок,soulflayer,1821,warlock,affliction,72,51,21
Dualla,aegwynn,1821,warlock,affliction,100,59,41
Xvq,twisting-nether,1819,warlock,affliction,106,67,39
Гивмисоул,soulflayer,1819,warlock,affliction,95,53,42
Fsandtwo,ravencrest,1817,warlock,affliction,74,38,36
Асальвэйд,gordunni,1815,warlock,affliction,136,79,57
Robertóoo,burning-legion,1814,warlock,affliction,128,79,49
Malddog,turalyon,1813,warlock,affliction,131,75,56
Bfaexpert,ravencrest,1808,warlock,affliction,34,22,12
Deadpapi,outland,1804,warlock,affliction,58,30,28
Valthorion,arthas,1803,warlock,affliction,29,20,9
Wldot,ravencrest,1802,warlock,affliction,42,24,18
Jlcreverso,eredar,1789,warlock,affliction,58,29,29
Neoe,stormscale,1786,warlock,affliction,300,153,147
Ragdoll,twisting-nether,1783,warlock,affliction,69,39,30
Sweetlõck,ravencrest,1783,warlock,affliction,317,168,149
Decayez,thrall,1782,warlock,affliction,54,27,27
Bankstair,stormscale,1779,warlock,affliction,111,61,50
Gezer,tarren-mill,1778,warlock,affliction,152,77,75
Korander,argent-dawn,1776,warlock,affliction,51,30,21
Funcky,terokkar,1773,warlock,affliction,72,47,25
Dersdog,twisting-nether,1770,warlock,affliction,35,22,13
ßualock,sylvanas,1767,warlock,affliction,47,25,22
Oldboy,auchindoun,1758,warlock,affliction,201,105,96
Jïñ,ravencrest,1757,warlock,affliction,30,20,10
Sakkrethxd,hyjal,1757,warlock,affliction,35,19,16
Graveflesh,burning-blade,1756,warlock,affliction,340,170,170
Xfz,stormscale,1755,warlock,affliction,191,99,92
Marcoil,kazzak,1751,warlock,affliction,68,40,28
Rias,ragnaros,1744,warlock,affliction,75,32,43
Fredé,outland,1743,warlock,affliction,36,23,13
Firochek,ravencrest,1743,warlock,affliction,42,25,17
Влицотьмой,gordunni,1739,warlock,affliction,67,39,28
Purplemafia,burning-blade,1734,warlock,affliction,58,29,29
Nightìngale,silvermoon,1733,warlock,affliction,152,79,73
Fearing,malganis,1730,warlock,affliction,66,36,30
Balding,blackhand,1723,warlock,affliction,64,37,27
Zodiiacc,ravencrest,1723,warlock,affliction,66,32,34
Yamadea,stormscale,1719,warlock,affliction,48,26,22
Baz,anubarak,1717,warlock,affliction,56,24,32
Lockwkrok,burning-legion,1702,warlock,affliction,343,182,161
Архкингсдум,galakrond,1702,warlock,affliction,108,52,56
Ммоохх,gordunni,1702,warlock,affliction,42,18,24
Wallirik,kazzak,1697,warlock,affliction,35,22,13
Shyleen,argent-dawn,1687,warlock,affliction,30,18,12
Dededot,ysondre,1686,warlock,affliction,50,26,24
Gremmus,outland,1684,warlock,affliction,35,19,16
Рауваскх,howling-fjord,1681,warlock,affliction,48,28,20
Depresive,aggra-português,1680,warlock,affliction,361,196,165
Fear,auchindoun,1676,warlock,affliction,41,22,19
Requeims,outland,1676,warlock,affliction,34,18,16
Lurkkis,ravencrest,1675,warlock,affliction,52,25,27
Robertóó,burning-legion,1673,warlock,affliction,101,54,47
Fyxs,talnivarr,1672,warlock,affliction,48,26,22
Дагира,booty-bay,1671,warlock,affliction,24,18,6
Mowxll,blackrock,1670,warlock,affliction,42,19,23
Vîmø,antonidas,1669,warlock,affliction,118,64,54
Emreys,argent-dawn,1668,warlock,affliction,198,103,95
Brainsoup,burning-blade,1668,warlock,affliction,150,78,72
Hellseven,emeriss,1666,warlock,affliction,51,24,27
Нэрфир,soulflayer,1662,warlock,affliction,122,65,57
Сайденас,gordunni,1662,warlock,affliction,163,84,79
Darkwìngduck,ravencrest,1661,warlock,affliction,30,19,11
Дестроварлок,blackscar,1661,warlock,affliction,36,21,15
Trâshxd,sanguino,1660,warlock,affliction,84,49,35
Htaedfo,tarren-mill,1660,warlock,affliction,99,56,43
Bulgyeøng,archimonde,1659,warlock,affliction,41,27,14
Modernmisery,kazzak,1658,warlock,affliction,333,170,163
Сентимент,gordunni,1656,warlock,affliction,138,73,65
Fercon,kazzak,1653,warlock,affliction,48,28,20
Млечный,blackscar,1652,warlock,affliction,108,64,44
Shannzo,stormscale,1651,warlock,affliction,36,19,17
Helventti,sylvanas,1651,warlock,affliction,40,21,19
Pinacholadá,norgannon,1648,warlock,affliction,126,71,55
Khoug,blackmoore,1647,warlock,affliction,36,24,12
Nekrosd,tarren-mill,1646,warlock,affliction,84,46,38
Apathia,stormscale,1644,warlock,affliction,60,32,28
Jaines,forscherliga,1643,warlock,affliction,47,29,18
Sïeur,archimonde,1643,warlock,affliction,56,32,24
Глумливый,howling-fjord,1643,warlock,affliction,260,125,135
Навидд,howling-fjord,1641,warlock,affliction,119,66,53
Phenolock,blackhand,1634,warlock,affliction,238,132,106
Dondot,frostmane,1632,warlock,affliction,108,60,48
Сзот,howling-fjord,1632,warlock,affliction,60,32,28
Franta,chromaggus,1631,warlock,affliction,83,50,33
Nerfwarriors,stormscale,1628,warlock,affliction,53,37,16
Laoganma,outland,1627,warlock,affliction,236,122,114
Дакиса,gordunni,1627,warlock,affliction,118,55,63
Ketzu,hyjal,1626,warlock,affliction,118,59,59
Midgetlockx,ravencrest,1625,warlock,affliction,42,24,18
Itiswhatitis,ravencrest,1624,warlock,affliction,42,20,22
Slàsh,hyjal,1623,warlock,affliction,120,70,50
Прогнившая,blackscar,1623,warlock,affliction,212,119,93
Lánfeár,draenor,1623,warlock,affliction,727,372,355
Likee,eredar,1623,warlock,affliction,48,22,26
Mangolicious,twisting-nether,1622,warlock,affliction,42,23,19
Termss,ravencrest,1622,warlock,affliction,397,204,193
Prelest,arathor,1620,warlock,affliction,24,17,7
Bossmanluke,defias-brotherhood,1617,warlock,affliction,42,26,16
Gayskyline,blackrock,1617,warlock,affliction,48,23,25
Corbbolt,drakthul,1616,warlock,affliction,74,40,34
Boglock,argent-dawn,1615,warlock,affliction,90,47,43
Ashhlock,silvermoon,1613,warlock,affliction,42,24,18
Zeinth,sanguino,1612,warlock,affliction,102,54,48
Оксси,fordragon,1612,warlock,affliction,114,59,55
Nate,stormscale,1610,warlock,affliction,111,61,50
Mortvivants,kirin-tor,1610,warlock,affliction,79,43,36
Rottndot,stormscale,1609,warlock,affliction,114,61,53
Orsoyopoyo,nemesis,1607,warlock,affliction,30,20,10
Mîná,ravencrest,1607,warlock,affliction,51,30,21
Apokalyps,eldrethalas,1607,warlock,affliction,678,352,326
Gate,blackrock,1606,warlock,affliction,41,20,21
Аиджинка,blackscar,1605,warlock,affliction,48,28,20
Дотдозор,howling-fjord,1603,warlock,affliction,178,95,83
Prestige,nemesis,1600,warlock,affliction,46,22,24
Ánderxyo,dun-modr,1599,warlock,affliction,30,19,11
Журанайсбой,blackscar,1598,warlock,affliction,30,21,9
Dontargetme,draenor,1596,warlock,affliction,49,30,19
Shayexen,tarren-mill,1596,warlock,affliction,53,31,22
Methroz,burning-legion,1592,warlock,affliction,60,28,32
Dispellthat,burning-legion,1588,warlock,affliction,41,22,19
Vizour,tarren-mill,1585,warlock,affliction,42,19,23
Soezzlock,archimonde,1584,warlock,affliction,182,99,83
Мокито,grom,1581,warlock,affliction,42,20,22
Drainsouls,stormscale,1579,warlock,affliction,84,45,39
Олимта,blackscar,1579,warlock,affliction,166,85,81
Жасминдос,blackscar,1578,warlock,affliction,40,19,21
Ремайка,gordunni,1577,warlock,affliction,146,73,73
Articfox,outland,1574,warlock,affliction,90,47,43
Nhw,archimonde,1573,warlock,affliction,151,86,65
Yôi,nemesis,1568,warlock,affliction,94,52,42
Exorbïtant,blackrock,1567,warlock,affliction,186,97,89
Waatschnbaam,eredar,1567,warlock,affliction,114,56,58
Passwoord,kazzak,1566,warlock,affliction,30,21,9
Getfeared,stormscale,1560,warlock,affliction,141,71,70
Olympïe,archimonde,1559,warlock,affliction,83,38,45
Smøkê,tarren-mill,1556,warlock,affliction,476,248,228
Trevium,nemesis,1555,warlock,affliction,76,43,33
Slf,the-maelstrom,1554,warlock,affliction,62,38,24
Raspalakuja,kazzak,1553,warlock,affliction,31,19,12
Grimus,azuremyst,1550,warlock,affliction,108,55,53
Lollock,teldrassil,1549,warlock,affliction,24,17,7
Stromzii,silvermoon,1544,warlock,affliction,91,51,40
Axapnon,ragnaros,1543,warlock,affliction,280,142,138
Infectius,kazzak,1542,warlock,affliction,115,63,52
Gneticz,aegwynn,1542,warlock,affliction,78,42,36
Бауглирх,howling-fjord,1542,warlock,affliction,83,41,42
Rottenbooty,argent-dawn,1541,warlock,affliction,65,35,30
Demonkïng,archimonde,1539,warlock,affliction,137,64,73
Acentro,stormscale,1538,warlock,affliction,63,35,28
Belíos,stormscale,1536,warlock,affliction,105,60,45
Krismer,silvermoon,1535,warlock,affliction,43,23,20
Wspolnax,ravencrest,1534,warlock,affliction,30,17,13
Shanyor,kazzak,1534,warlock,affliction,114,64,50
Lokic,draenor,1534,warlock,affliction,108,56,52
Osyx,ravencrest,1534,warlock,affliction,36,16,20
Zetsubo,drakthul,1533,warlock,affliction,147,80,67
Бжк,gordunni,1532,warlock,affliction,67,33,34
Pumpfake,ravencrest,1530,warlock,affliction,24,16,8
Drututt,the-maelstrom,1530,warlock,affliction,30,16,14
Kayako,kul-tiras,1529,warlock,affliction,74,32,42
Ghachi,draenor,1528,warlock,affliction,185,95,90
Heavylock,sylvanas,1527,warlock,affliction,30,19,11
Сартеккс,gordunni,1525,warlock,affliction,155,87,68
Twnia,the-maelstrom,1524,warlock,affliction,59,39,20
Кокобан,howling-fjord,1524,warlock,affliction,42,17,25
Darkrorr,drakthul,1523,warlock,affliction,30,16,14
Tôpsecret,aegwynn,1522,warlock,affliction,30,16,14
Drazol,sylvanas,1520,warlock,affliction,60,34,26
Разъелвал,blackscar,1518,warlock,affliction,223,123,100
Nightsnake,deathwing,1516,warlock,affliction,114,50,64
Белучи,howling-fjord,1515,warlock,affliction,48,31,17
Höfmänn,kazzak,1514,warlock,affliction,42,27,15
Крэдоу,soulflayer,1514,warlock,affliction,54,27,27
Zevil,emerald-dream,1509,warlock,affliction,78,42,36
Винстролман,blackscar,1507,warlock,affliction,162,93,69
Warlockoloco,blackmoore,1506,warlock,affliction,65,32,33
Soulslugger,twisting-nether,1506,warlock,affliction,48,23,25
Katâra,tarren-mill,1505,warlock,affliction,80,36,44
Bowti,ravencrest,1504,warlock,affliction,66,27,39
Soffie,blackrock,1503,warlock,affliction,66,32,34
Jumbodot,tarren-mill,1502,warlock,affliction,36,17,19
Ðemðnia,antonidas,1498,warlock,affliction,24,20,4
Marklock,drakthul,1497,warlock,affliction,96,58,38
Berkobaggins,ravencrest,1496,warlock,affliction,72,34,38
Бенлоел,borean-tundra,1493,warlock,affliction,60,29,31
Drekkrog,chogall,1490,warlock,affliction,30,16,14
Soldmygranny,kazzak,1489,warlock,affliction,72,36,36
Боризыч,gordunni,1487,warlock,affliction,125,67,58
Tøpdmg,die-aldor,1486,warlock,affliction,53,27,26
Idcboutmeta,draenor,1484,warlock,affliction,47,23,24
Ascètic,kazzak,1484,warlock,affliction,101,49,52
Itsfiftycent,outland,1482,warlock,affliction,114,65,49
Датри,grom,1481,warlock,affliction,130,74,56
Муза,gordunni,1481,warlock,affliction,60,28,32
Werkx,archimonde,1479,warlock,affliction,48,22,26
Damira,blackmoore,1478,warlock,affliction,36,23,13
Kasuni,sanguino,1478,warlock,affliction,119,67,52
Sánas,blackhand,1478,warlock,affliction,102,57,45
Brútality,nethersturm,1478,warlock,affliction,95,48,47
Априфф,soulflayer,1477,warlock,affliction,36,16,20
Saraconnor,burning-legion,1475,warlock,affliction,78,43,35
Лысыйлокоть,soulflayer,1475,warlock,affliction,36,18,18
Mty,bronze-dragonflight,1475,warlock,affliction,105,51,54
Адоха,howling-fjord,1474,warlock,affliction,47,25,22
Drozhna,kaelthas,1473,warlock,affliction,54,27,27
Валлцея,galakrond,1471,warlock,affliction,36,22,14
Tøtøf,sargeras,1471,warlock,affliction,27,16,11
Talt,dalaran,1469,warlock,affliction,116,66,50
Локбезног,soulflayer,1468,warlock,affliction,84,42,42
Spiritawayx,lightbringer,1467,warlock,affliction,24,18,6
Xakhmet,hellscream,1466,warlock,affliction,234,125,109
Pruegelharry,blackrock,1466,warlock,affliction,54,26,28
Lockíe,twisting-nether,1465,warlock,affliction,65,33,32
Lickyicky,twisting-nether,1465,warlock,affliction,78,39,39
Shaarak,blackrock,1464,warlock,affliction,69,33,36
Taýle,ravencrest,1463,warlock,affliction,24,16,8
Deathfløw,draenor,1462,warlock,affliction,30,16,14
Kopfschmerz,twisting-nether,1461,warlock,affliction,59,31,28
Ржоммба,soulflayer,1460,warlock,affliction,154,77,77
Нешутисвуду,blackscar,1459,warlock,affliction,64,29,35
Feardinkum,twisting-nether,1458,warlock,affliction,30,17,13
Brustlino,nemesis,1458,warlock,affliction,36,20,16
Maidson,blackrock,1458,warlock,affliction,44,22,22
Floron,silvermoon,1453,warlock,affliction,127,63,64
Zakuri,blackmoore,1452,warlock,affliction,48,32,16
Omnath,alakir,1449,warlock,affliction,36,18,18
Lockyy,karazhan,1448,warlock,affliction,83,48,35
Müdür,burning-legion,1448,warlock,affliction,239,128,111
Prekt,ragnaros,1447,warlock,affliction,35,22,13
Wezen,stormscale,1446,warlock,affliction,140,73,67
Vladov,ravencrest,1443,warlock,affliction,54,31,23
Колдунишка,fordragon,1443,warlock,affliction,431,229,202
Domdon,stormscale,1440,warlock,affliction,26,16,10
Azurma,tarren-mill,1439,warlock,affliction,24,15,9
Hivxherpes,ravencrest,1439,warlock,affliction,127,60,67
Гуслин,soulflayer,1437,warlock,affliction,183,98,85
Degdeehei,draenor,1436,warlock,affliction,112,61,51
Dracsu,dun-modr,1436,warlock,affliction,160,82,78
Kakiamagisa,twisting-nether,1433,warlock,affliction,58,38,20
Ryûsuke,dun-modr,1433,warlock,affliction,24,15,9
Candyman,bronze-dragonflight,1433,warlock,affliction,342,170,172
Vicktorious,stormscale,1432,warlock,affliction,206,108,98
Birimbau,outland,1432,warlock,affliction,63,32,31
Azastarax,archimonde,1432,warlock,affliction,114,54,60
Flyps,stormscale,1431,warlock,affliction,53,26,27
Warlokk,tarren-mill,1430,warlock,affliction,163,86,77
Rune,aegwynn,1430,warlock,affliction,30,15,15
Zèlêph,archimonde,1428,warlock,affliction,42,26,16
Bemelial,culte-de-la-rive-noire,1428,warlock,affliction,39,18,21
Filianore,azjolnerub,1427,warlock,affliction,60,35,25
Ebolara,aegwynn,1427,warlock,affliction,47,23,24
Çüñ,shattered-hand,1426,warlock,affliction,48,24,24
Gódríg,sylvanas,1425,warlock,affliction,93,56,37
Нафлэпил,gordunni,1425,warlock,affliction,59,32,27
Miazmii,ragnaros,1422,warlock,affliction,24,15,9
Mundunugu,sanguino,1422,warlock,affliction,30,15,15
Шизуи,borean-tundra,1420,warlock,affliction,109,62,47
Inani,ragnaros,1420,warlock,affliction,60,31,29
Avoidsun,kazzak,1418,warlock,affliction,42,20,22
Бонони,blackscar,1417,warlock,affliction,42,19,23
Bigdamndots,twisting-nether,1417,warlock,affliction,42,16,26
Demonologyz,ravencrest,1416,warlock,affliction,24,19,5
Lilofee,anetheron,1414,warlock,affliction,48,21,27
Titoss,archimonde,1411,warlock,affliction,120,60,60
Wäisted,ravencrest,1410,warlock,affliction,24,15,9
Лейссина,eversong,1406,warlock,affliction,183,92,91
Zeotrixie,stormscale,1405,warlock,affliction,84,43,41
Dondada,aggra-português,1404,warlock,affliction,102,52,50
Kyyuss,burning-legion,1403,warlock,affliction,60,25,35
Felsturm,twisting-nether,1402,warlock,affliction,88,52,36
Tarilinwelli,les-sentinelles,1401,warlock,affliction,116,65,51
Cringetamer,silvermoon,1401,warlock,affliction,48,20,28
Cazzo,burning-blade,1399,warlock,affliction,186,91,95
Vivek,grim-batol,1398,warlock,affliction,208,99,109
Enviroq,burning-legion,1398,warlock,affliction,42,19,23
Girgol,draenor,1393,warlock,affliction,78,30,48
Øprøx,sanguino,1392,warlock,affliction,35,21,14
Sluba,stormscale,1391,warlock,affliction,54,36,18
Murphloc,silvermoon,1391,warlock,affliction,84,41,43
Véstheim,saurfang,1388,warlock,affliction,56,34,22
Murua,silvermoon,1387,warlock,affliction,30,15,15
Harrydôtta,blackmoore,1382,warlock,affliction,42,23,19
Deathcoîl,the-maelstrom,1381,warlock,affliction,23,15,8
Hatenkou,silvermoon,1379,warlock,affliction,89,49,40
Пухи,blackscar,1379,warlock,affliction,48,20,28
Necronomicon,illidan,1378,warlock,affliction,72,34,38
Zêngâ,kazzak,1377,warlock,affliction,72,36,36
Kavalierr,stormscale,1377,warlock,affliction,70,35,35
Teddyruineur,khaz-modan,1376,warlock,affliction,42,25,17
Pokifanone,tarren-mill,1376,warlock,affliction,29,16,13
Mazaear,stormscale,1373,warlock,affliction,100,51,49
Киёкка,howling-fjord,1372,warlock,affliction,114,62,52
Cârmondai,alleria,1371,warlock,affliction,55,19,36
Sadisticlól,burning-legion,1369,warlock,affliction,35,17,18
Potterhotter,outland,1368,warlock,affliction,209,103,106
Dannyel,mazrigos,1367,warlock,affliction,595,302,293
Tiwtera,draenor,1366,warlock,affliction,72,35,37
Císuh,stormreaver,1365,warlock,affliction,36,15,21
Nàughty,ragnaros,1361,warlock,affliction,101,53,48
Бестий,fordragon,1361,warlock,affliction,62,30,32
Vîerdotcom,blackrock,1359,warlock,affliction,24,18,6
Trythislock,crushridge,1359,warlock,affliction,71,37,34
Xanatas,nemesis,1359,warlock,affliction,48,25,23
Cadrega,nemesis,1357,warlock,affliction,58,37,21
Nîghtmare,outland,1353,warlock,affliction,35,20,15
Hòbó,outland,1353,warlock,affliction,51,28,23
Kemel,thrall,1353,warlock,affliction,42,23,19
Gôttlîn,blackmoore,1352,warlock,affliction,42,20,22
Akdan,ragnaros,1351,warlock,affliction,50,21,29
Dropxpvp,blackrock,1350,warlock,affliction,113,54,59
Антарриэль,howling-fjord,1349,warlock,affliction,51,26,25
Dailylock,kazzak,1349,warlock,affliction,32,15,17
Elmstreet,gilneas,1346,warlock,affliction,48,31,17
Skräp,twisting-nether,1346,warlock,affliction,73,30,43
Demonoulis,bloodhoof,1345,warlock,affliction,40,25,15
Roglash,eredar,1345,warlock,affliction,182,97,85
Hathatchi,sylvanas,1343,warlock,affliction,52,29,23
Øzze,ysondre,1343,warlock,affliction,181,97,84
Rudikiaz,sanguino,1343,warlock,affliction,36,14,22
Томрэдл,howling-fjord,1342,warlock,affliction,491,252,239
Jegfaller,wildhammer,1341,warlock,affliction,102,53,49
Xxjz,ravencrest,1339,warlock,affliction,24,14,10
Whaii,ravencrest,1339,warlock,affliction,24,14,10
Anabolicbaby,draenor,1339,warlock,affliction,27,15,12
Hèrmit,kazzak,1333,warlock,affliction,86,49,37
Gryme,dalaran,1333,warlock,affliction,72,30,42
Kharless,kazzak,1331,warlock,affliction,29,15,14
Dezznut,blackhand,1331,warlock,affliction,131,63,68
Eltharis,burning-legion,1331,warlock,affliction,30,14,16
Darkwootex,draenor,1330,warlock,affliction,45,25,20
Mayline,kult-der-verdammten,1330,warlock,affliction,42,23,19
Bh,ragnaros,1327,warlock,affliction,24,14,10
Staenkymayne,blackhand,1326,warlock,affliction,24,14,10
Sanghá,frostwolf,1323,warlock,affliction,157,87,70
Gash,malganis,1323,warlock,affliction,174,88,86
Délidumrul,stormscale,1322,warlock,affliction,46,27,19
Gaminex,kazzak,1322,warlock,affliction,171,82,89
Ginnwick,argent-dawn,1321,warlock,affliction,18,14,4
Morgan,jaedenar,1320,warlock,affliction,144,84,60
Primdåhl,ravencrest,1314,warlock,affliction,76,39,37
Themits,executus,1314,warlock,affliction,34,15,19
Dotieks,draenor,1313,warlock,affliction,132,70,62
Balgo,blackmoore,1312,warlock,affliction,60,30,30
Chaostrain,sylvanas,1312,warlock,affliction,40,16,24
Náwwk,blackmoore,1311,warlock,affliction,36,20,16
Перегном,blackscar,1311,warlock,affliction,60,28,32
Abuzyaka,kazzak,1311,warlock,affliction,36,14,22
Hiimsûso,dun-modr,1309,warlock,affliction,113,59,54
Ketem,zuljin,1308,warlock,affliction,167,86,81
Azkarr,defias-brotherhood,1308,warlock,affliction,30,14,16
Nesveti,kazzak,1305,warlock,affliction,29,20,9
Ukicha,burning-blade,1305,warlock,affliction,101,50,51
Irnx,tarren-mill,1303,warlock,affliction,68,36,32
Pcbbwarlock,sylvanas,1302,warlock,affliction,198,106,92
Nihale,arakarahm,1301,warlock,affliction,106,50,56
Dxz,silvermoon,1300,warlock,affliction,36,14,22
Krombo,kazzak,1299,warlock,affliction,28,15,13
Urssul,kazzak,1298,warlock,affliction,36,22,14
Swagzz,silvermoon,1298,warlock,affliction,96,55,41
Sublînê,blackmoore,1298,warlock,affliction,92,39,53
Scaevóla,ravencrest,1297,warlock,affliction,42,24,18
Локистраик,borean-tundra,1296,warlock,affliction,107,52,55
Morganounete,archimonde,1296,warlock,affliction,58,21,37
Ogkenii,ragnaros,1295,warlock,affliction,54,26,28
Bästkusten,kazzak,1294,warlock,affliction,28,16,12
Cooviid,blackrock,1294,warlock,affliction,33,15,18
Grimréaper,outland,1288,warlock,affliction,42,19,23
Tathyanna,archimonde,1287,warlock,affliction,26,15,11
Tsumde,dalaran,1285,warlock,affliction,110,53,57
Лютыйглад,blackscar,1284,warlock,affliction,69,32,37
Sleethy,destromath,1283,warlock,affliction,48,24,24
Моргррет,soulflayer,1282,warlock,affliction,48,28,20
Sanas,blackhand,1279,warlock,affliction,54,18,36
Jisera,kiljaeden,1278,warlock,affliction,28,14,14
Äsmødée,dalaran,1278,warlock,affliction,209,99,110
Robodot,eredar,1277,warlock,affliction,90,45,45
Smileyfacè,silvermoon,1276,warlock,affliction,53,25,28
Izyguldamn,blackmoore,1276,warlock,affliction,48,16,32
Asmodex,dun-modr,1271,warlock,affliction,36,18,18
Zelhala,draenor,1270,warlock,affliction,36,16,20
Drestek,uldum,1268,warlock,affliction,72,34,38
Assuz,eredar,1267,warlock,affliction,86,42,44
Стафилокок,deepholm,1262,warlock,affliction,55,29,26
Ainos,twisting-nether,1260,warlock,affliction,145,74,71
Whocarezlock,stormscale,1260,warlock,affliction,32,15,17
Cgane,archimonde,1259,warlock,affliction,46,24,22
Qena,outland,1259,warlock,affliction,54,26,28
Letzterlude,thrall,1257,warlock,affliction,21,14,7
Mendozaah,kazzak,1257,warlock,affliction,102,42,60
Blackmagic,stormscale,1256,warlock,affliction,378,196,182
Mooncrásh,blackrock,1256,warlock,affliction,162,80,82
Androxus,eredar,1255,warlock,affliction,25,14,11
Braneiotqq,kazzak,1255,warlock,affliction,38,15,23
Demoas,antonidas,1253,warlock,affliction,32,15,17
Nicetime,nefarian,1250,warlock,affliction,90,51,39
Kerway,outland,1249,warlock,affliction,24,14,10
Datendariza,kazzak,1248,warlock,affliction,74,30,44
Miauwu,stormscale,1247,warlock,affliction,18,13,5
Мужицкаясила,howling-fjord,1247,warlock,affliction,103,44,59
Ðïÿëñbïëñfüû,suramar,1246,warlock,affliction,30,13,17
Deathpoid,draenor,1245,warlock,affliction,71,28,43
Mjabowf,outland,1240,warlock,affliction,24,13,11
Satanizm,silvermoon,1240,warlock,affliction,69,32,37
Hacklock,silvermoon,1239,warlock,affliction,175,87,88
Actelia,the-venture-co,1237,warlock,affliction,38,15,23
Тафуби,deathweaver,1234,warlock,affliction,30,18,12
Yowifeinmedm,draenor,1234,warlock,affliction,36,13,23
Варатах,grom,1233,warlock,affliction,90,43,47
Hitomitanaká,kazzak,1233,warlock,affliction,34,13,21
Whaine,kult-der-verdammten,1231,warlock,affliction,29,16,13
Elleanor,los-errantes,1231,warlock,affliction,24,13,11
Чупачупакаб,soulflayer,1230,warlock,affliction,30,13,17
Shakuroz,frostwolf,1229,warlock,affliction,28,14,14
Shreklock,burning-blade,1227,warlock,affliction,24,13,11
Mæphysto,blackrock,1227,warlock,affliction,163,85,78
Weedmaniac,kazzak,1227,warlock,affliction,174,81,93
Modéus,ysondre,1225,warlock,affliction,100,52,48
Ностра,gordunni,1223,warlock,affliction,32,22,10
Bakal,vashj,1223,warlock,affliction,47,22,25
Mephísto,kilrogg,1223,warlock,affliction,48,20,28
Ongo,frostwolf,1220,warlock,affliction,30,13,17
Zéphon,blades-edge,1219,warlock,affliction,24,13,11
Kozhul,argent-dawn,1218,warlock,affliction,24,13,11
Klone,die-todeskrallen,1218,warlock,affliction,115,58,57
Bono,frostwhisper,1215,warlock,affliction,24,13,11
Xlara,argent-dawn,1215,warlock,affliction,226,116,110
Sesshouin,alakir,1212,warlock,affliction,72,34,38
Phelola,sylvanas,1210,warlock,affliction,116,54,62
Solitariøus,arathi,1207,warlock,affliction,90,44,46
Agonux,twisting-nether,1205,warlock,affliction,67,37,30
Diseez,bronzebeard,1205,warlock,affliction,51,25,26
Etsanctum,blackmoore,1204,warlock,affliction,48,17,31
Priszcilla,twisting-nether,1203,warlock,affliction,61,35,26
Fealer,magtheridon,1203,warlock,affliction,348,179,169
Friendlylock,quelthalas,1198,warlock,affliction,21,13,8
Soultire,ravencrest,1198,warlock,affliction,126,58,68
Âkâl,ravencrest,1194,warlock,affliction,23,13,10
Kyiüû,archimonde,1194,warlock,affliction,27,14,13
Vaukras,stormscale,1194,warlock,affliction,74,35,39
Voost,aegwynn,1194,warlock,affliction,51,18,33
Toryon,archimonde,1191,warlock,affliction,40,14,26
Møärdötd,aggra-português,1190,warlock,affliction,30,13,17
Solomohn,steamwheedle-cartel,1189,warlock,affliction,30,14,16
Malagate,sylvanas,1187,warlock,affliction,72,32,40
Luzi,arthas,1186,warlock,affliction,59,27,32
Purplehasse,draenor,1185,warlock,affliction,88,36,52
Gulgash,blackrock,1183,warlock,affliction,24,13,11
Lockinasock,stormscale,1183,warlock,affliction,31,16,15
Глянемче,deathguard,1182,warlock,affliction,75,43,32
Nexyra,silvermoon,1182,warlock,affliction,218,106,112
Bu,zirkel-des-cenarius,1181,warlock,affliction,29,17,12
Dhraven,thrall,1179,warlock,affliction,105,51,54
Kerthan,malorne,1176,warlock,affliction,80,35,45
Warlockgødx,silvermoon,1173,warlock,affliction,40,20,20
Wedlock,stormscale,1171,warlock,affliction,29,19,10
Antoniolm,cthun,1171,warlock,affliction,48,28,20
Huaian,darksorrow,1170,warlock,affliction,56,26,30
Yahata,nethersturm,1169,warlock,affliction,84,46,38
Цзинкэ,gordunni,1168,warlock,affliction,24,13,11
Purenutz,twisting-nether,1165,warlock,affliction,24,13,11
Neyó,teldrassil,1164,warlock,affliction,30,17,13
Sulvar,draenor,1164,warlock,affliction,102,50,52
Draklack,turalyon,1160,warlock,affliction,115,57,58
Ашимал,soulflayer,1158,warlock,affliction,62,28,34
Juod,frostmane,1156,warlock,affliction,30,17,13
Самантаглу,blackscar,1155,warlock,affliction,93,47,46
Xristianos,ravencrest,1152,warlock,affliction,18,12,6
Anderxyo,sanguino,1152,warlock,affliction,24,12,12
Feardotbye,stormscale,1151,warlock,affliction,18,12,6
Turdy,sylvanas,1151,warlock,affliction,18,12,6
Faermorn,kazzak,1151,warlock,affliction,18,12,6
Toppluva,shattered-hand,1151,warlock,affliction,21,13,8
Kumamoto,tarren-mill,1151,warlock,affliction,24,12,12
Xskyrov,blackmoore,1151,warlock,affliction,24,12,12
Stankaemayne,blackhand,1150,warlock,affliction,18,12,6
Lockimon,silvermoon,1150,warlock,affliction,21,13,8
Thereya,dun-morogh,1150,warlock,affliction,24,12,12
Cdztuwu,outland,1147,warlock,affliction,18,12,6
Walchia,kazzak,1147,warlock,affliction,83,44,39
Lockingcute,tarren-mill,1147,warlock,affliction,24,12,12
Lipstickx,kul-tiras,1147,warlock,affliction,36,12,24
Voodooskull,kazzak,1146,warlock,affliction,18,12,6
Valcan,ragnaros,1144,warlock,affliction,18,12,6
Trinox,teldrassil,1144,warlock,affliction,24,15,9
Cutt,chogall,1144,warlock,affliction,89,46,43
Банкапевка,howling-fjord,1144,warlock,affliction,36,14,22
ßatt,dalaran,1143,warlock,affliction,34,21,13
Scheele,twisting-nether,1143,warlock,affliction,32,13,19
Enyras,nemesis,1143,warlock,affliction,30,12,18
Auxi,the-maelstrom,1142,warlock,affliction,57,35,22
Yasa,khaz-modan,1142,warlock,affliction,51,31,20
Squadala,kaelthas,1142,warlock,affliction,42,22,20
Noqufiel,malygos,1142,warlock,affliction,30,13,17
Suskive,kaelthas,1141,warlock,affliction,24,12,12
Öxygen,outland,1140,warlock,affliction,24,12,12
Ìzanamí,archimonde,1139,warlock,affliction,18,12,6
Asmonmald,stormscale,1139,warlock,affliction,120,52,68
Arelas,dragonblight,1139,warlock,affliction,30,12,18
Bobleechaos,darkspear,1136,warlock,affliction,42,17,25
Eveline,onyxia,1136,warlock,affliction,34,13,21
Clungesuck,argent-dawn,1132,warlock,affliction,24,12,12
Lonepath,doomhammer,1129,warlock,affliction,25,15,10
Slowfatlock,ravencrest,1129,warlock,affliction,47,20,27
Zukau,argent-dawn,1129,warlock,affliction,46,15,31
Xjms,darksorrow,1127,warlock,affliction,37,16,21
Smoulville,sanguino,1121,warlock,affliction,29,12,17
Xerxia,blackrock,1120,warlock,affliction,63,33,30
Дрын,gordunni,1118,warlock,affliction,25,19,6
Noobgg,kazzak,1118,warlock,affliction,22,13,9
Greenlock,la-croisade-écarlate,1117,warlock,affliction,18,12,6
Cryingface,ragnaros,1117,warlock,affliction,35,12,23
Toké,blackmoore,1116,warlock,affliction,52,24,28
Principle,dunemaul,1114,warlock,affliction,89,53,36
Nydek,cthun,1112,warlock,affliction,80,36,44
Mjojo,khaz-modan,1110,warlock,affliction,34,17,17
Таракай,eversong,1107,warlock,affliction,66,25,41
Wintheirl,argent-dawn,1105,warlock,affliction,35,15,20
Identîty,ravencrest,1104,warlock,affliction,64,27,37
Gamunkul,destromath,1101,warlock,affliction,115,47,68
Carlman,hyjal,1099,warlock,affliction,30,15,15
Sunetta,silvermoon,1097,warlock,affliction,80,37,43
Brryant,colinas-pardas,1095,warlock,affliction,49,31,18
Diablotiin,hyjal,1095,warlock,affliction,48,20,28
Cahoa,archimonde,1093,warlock,affliction,39,17,22
Горенджо,eversong,1092,warlock,affliction,26,13,13
Dótcom,draenor,1089,warlock,affliction,102,51,51
Fraky,frostwhisper,1087,warlock,affliction,23,16,7
Zxcursed,doomhammer,1087,warlock,affliction,23,12,11
Diegomojes,silvermoon,1081,warlock,affliction,110,59,51
Dotfearcom,blackrock,1077,warlock,affliction,69,29,40
Lefttorot,garrosh,1077,warlock,affliction,33,13,20
Darkháte,blackhand,1074,warlock,affliction,24,13,11
Iyanda,argent-dawn,1074,warlock,affliction,24,12,12
Аксиманд,howling-fjord,1073,warlock,affliction,47,23,24
Ladodida,darkspear,1072,warlock,affliction,53,28,25
Askanios,twisting-nether,1069,warlock,affliction,58,28,30
Хефрак,deathguard,1069,warlock,affliction,107,43,64
Hazelock,draenor,1068,warlock,affliction,17,12,5
Felboar,quelthalas,1068,warlock,affliction,44,24,20
Díme,kazzak,1068,warlock,affliction,64,29,35
Bësly,khaz-modan,1067,warlock,affliction,26,16,10
Venoc,kazzak,1067,warlock,affliction,150,77,73
Rhyana,sylvanas,1065,warlock,affliction,28,12,16
Pipêz,blackmoore,1060,warlock,affliction,34,12,22
Smuutil,drakthul,1058,warlock,affliction,55,28,27
Lökjävel,twisting-nether,1058,warlock,affliction,34,16,18
Elmîr,blackmoore,1057,warlock,affliction,36,13,23
Йоранс,gordunni,1056,warlock,affliction,24,11,13
Ourados,kazzak,1055,warlock,affliction,18,11,7
Fräddan,draenor,1054,warlock,affliction,12,11,1
Coilxo,ravencrest,1054,warlock,affliction,30,11,19
Beleghost,sylvanas,1054,warlock,affliction,30,11,19
Dabolt,archimonde,1053,warlock,affliction,18,11,7
Mariahscary,auchindoun,1053,warlock,affliction,18,11,7
Tanón,sanguino,1053,warlock,affliction,24,11,13
Belastiz,blackmoore,1052,warlock,affliction,18,11,7
Skufi,uldum,1052,warlock,affliction,69,35,34
Искусность,soulflayer,1051,warlock,affliction,18,11,7
Snackstickz,twisting-nether,1051,warlock,affliction,18,11,7
Exørzist,blackmoore,1051,warlock,affliction,124,66,58
Mykóla,terokkar,1051,warlock,affliction,24,11,13
Zatella,ravencrest,1050,warlock,affliction,24,11,13
Lubosz,silvermoon,1049,warlock,affliction,18,11,7
Hodille,argent-dawn,1046,warlock,affliction,18,11,7
Lemuriel,arthas,1046,warlock,affliction,77,37,40
Richrichy,outland,1044,warlock,affliction,66,34,32
Wildo,grim-batol,1044,warlock,affliction,30,13,17
Midnigthh,sanguino,1044,warlock,affliction,33,12,21
Mannennille,eonar,1043,warlock,affliction,24,11,13
Pfizer,varimathras,1043,warlock,affliction,67,28,39
Araphel,twisting-nether,1042,warlock,affliction,78,38,40
Letor,sanguino,1041,warlock,affliction,27,12,15
Blaizen,outland,1038,warlock,affliction,22,12,10
Backblech,wrathbringer,1038,warlock,affliction,33,15,18
Демонтёлка,grom,1034,warlock,affliction,26,16,10
Nerdbane,blackrock,1033,warlock,affliction,18,11,7
Selenene,norgannon,1031,warlock,affliction,63,31,32
Шайтанарба,blackscar,1027,warlock,affliction,77,42,35
Favris,antonidas,1024,warlock,affliction,170,85,85
Nozzos,zuluhed,1022,warlock,affliction,42,13,29
Korlox,antonidas,1019,warlock,affliction,60,32,28
Oonz,sylvanas,1017,warlock,affliction,74,37,37
Сувала,soulflayer,1015,warlock,affliction,104,52,52
Олдриг,ashenvale,1013,warlock,affliction,39,18,21
Санявахтовик,blackscar,1006,warlock,affliction,21,11,10
Cokoladuocka,silvermoon,1005,warlock,affliction,72,30,42
Тэйлок,gordunni,1003,warlock,affliction,45,26,19
Габиель,greymane,1003,warlock,affliction,36,17,19
Sovrìn,blackrock,1002,warlock,affliction,23,11,12
Loriene,trollbane,1001,warlock,affliction,41,16,25
Vendømlørd,archimonde,993,warlock,affliction,36,19,17
Мракодел,deathguard,990,warlock,affliction,45,21,24
Brítneyfears,azjolnerub,986,warlock,affliction,17,11,6
Bluenote,colinas-pardas,985,warlock,affliction,63,31,32
Vahgaz,burning-legion,973,warlock,affliction,172,82,90
Qullnius,kazzak,971,warlock,affliction,34,12,22
Hôköno,archimonde,970,warlock,affliction,36,17,19
Exoticaa,blackhand,968,warlock,affliction,48,27,21
Lacruum,ragnaros,963,warlock,affliction,29,12,17
Cappaoww,ravencrest,960,warlock,affliction,12,10,2
Peonpedro,malganis,960,warlock,affliction,12,10,2
Slipx,aegwynn,960,warlock,affliction,18,10,8
Murdee,kazzak,960,warlock,affliction,18,10,8
Dreamnyâsha,tarren-mill,960,warlock,affliction,18,10,8
Телола,gordunni,960,warlock,affliction,18,10,8
Веномхх,lich-king,959,warlock,affliction,12,10,2
Plâytïmè,stormscale,959,warlock,affliction,18,10,8
Brubbenbachx,twisting-nether,959,warlock,affliction,18,10,8
Nineinchlock,silvermoon,959,warlock,affliction,24,10,14
Hannen,blackrock,959,warlock,affliction,24,10,14
Drstyx,anetheron,959,warlock,affliction,30,10,20
Azaïdun,khaz-modan,958,warlock,affliction,18,10,8
Коплюнапони,blackscar,958,warlock,affliction,18,10,8
Arizyoxot,twisting-nether,957,warlock,affliction,18,10,8
Kazyn,archimonde,957,warlock,affliction,24,10,14
Снэйк,deathguard,956,warlock,affliction,18,10,8
Lúcìfér,stormscale,956,warlock,affliction,24,10,14
Dotloca,draenor,955,warlock,affliction,12,10,2
Sylrathas,burning-legion,953,warlock,affliction,24,10,14
Prickster,kazzak,952,warlock,affliction,18,10,8
Cgòw,ravencrest,950,warlock,affliction,22,11,11
Sinsemilla,kazzak,949,warlock,affliction,78,34,44
Хичхкок,gordunni,947,warlock,affliction,44,19,25
Waryald,dun-modr,945,warlock,affliction,30,10,20
Warrworg,darkmoon-faire,943,warlock,affliction,102,54,48
Cêebêry,frostwolf,941,warlock,affliction,24,10,14
Valadair,sanguino,941,warlock,affliction,30,10,20
Phéar,deathwing,938,warlock,affliction,18,10,8
Warlockyone,silvermoon,937,warlock,affliction,18,10,8
Uthdae,archimonde,933,warlock,affliction,36,13,23
Luckriel,draenor,932,warlock,affliction,24,11,13
Artèm,ysondre,930,warlock,affliction,30,10,20
Adizew,kazzak,929,warlock,affliction,68,26,42
Битриксс,soulflayer,928,warlock,affliction,85,37,48
Ванадий,soulflayer,926,warlock,affliction,17,10,7
Akumako,stormscale,926,warlock,affliction,22,11,11
Xrathis,thunderhorn,925,warlock,affliction,22,10,12
Icritmore,stormscale,924,warlock,affliction,20,11,9
Ashgron,burning-legion,924,warlock,affliction,30,16,14
Disrupted,blackmoore,923,warlock,affliction,23,10,13
Слававдвх,blackscar,914,warlock,affliction,59,28,31
Kenthal,nemesis,908,warlock,affliction,22,10,12
Trusting,archimonde,906,warlock,affliction,36,19,17
Nukeem,karazhan,906,warlock,affliction,165,78,87
Artyrus,burning-legion,904,warlock,affliction,30,16,14
Letoupet,la-croisade-écarlate,904,warlock,affliction,42,21,21
Cencible,twisting-nether,893,warlock,affliction,31,14,17
Lockpup,draenor,888,warlock,affliction,40,21,19
Rasputia,thunderhorn,871,warlock,affliction,57,29,28
Abinsur,drakthul,864,warlock,affliction,12,9,3
Тапкидеда,gordunni,864,warlock,affliction,12,9,3
Парачо,eversong,864,warlock,affliction,12,9,3
Belial,minahonda,864,warlock,affliction,18,9,9
Zzooxx,silvermoon,864,warlock,affliction,24,9,15
Díablø,blackmoore,863,warlock,affliction,12,9,3
Fearlólz,stormscale,863,warlock,affliction,12,9,3
Whippet,nemesis,863,warlock,affliction,12,9,3
Zöyarüm,outland,863,warlock,affliction,18,9,9
Зензирил,galakrond,863,warlock,affliction,18,9,9
Zblock,colinas-pardas,863,warlock,affliction,18,9,9
Gaargamelo,blackmoore,863,warlock,affliction,24,9,15
Luwuock,twisting-nether,863,warlock,affliction,24,9,15
Merdotz,outland,862,warlock,affliction,18,9,9
Golhok,archimonde,862,warlock,affliction,18,9,9
Skuvee,archimonde,862,warlock,affliction,18,9,9
Esmuel,argent-dawn,862,warlock,affliction,18,9,9
Cucu,tarren-mill,862,warlock,affliction,18,9,9
Aagon,antonidas,862,warlock,affliction,24,9,15
Tolgaa,draenor,862,warlock,affliction,28,10,18
Ívânguldán,twisting-nether,861,warlock,affliction,12,9,3
Hooligain,aegwynn,861,warlock,affliction,62,28,34
Яичнаялапша,soulflayer,860,warlock,affliction,12,9,3
Graell,drakthul,860,warlock,affliction,12,9,3
Mumutoaster,blackrock,860,warlock,affliction,12,9,3
Нирон,grom,860,warlock,affliction,18,9,9
Skrikipanik,kazzak,860,warlock,affliction,18,9,9
Iml,grim-batol,859,warlock,affliction,28,10,18
Локомания,gordunni,859,warlock,affliction,30,9,21
Therelda,sanguino,857,warlock,affliction,18,9,9
Tedor,ysondre,856,warlock,affliction,18,9,9
Sladurana,eredar,855,warlock,affliction,96,46,50
Primitivaa,dun-modr,855,warlock,affliction,30,9,21
Yourdeaath,ravencrest,854,warlock,affliction,30,9,21
Iyna,blackmoore,853,warlock,affliction,18,9,9
Alithia,sylvanas,851,warlock,affliction,12,9,3
Ezhjyr,anubarak,851,warlock,affliction,18,9,9
Silurus,bloodscalp,846,warlock,affliction,24,9,15
Warlocker,anachronos,844,warlock,affliction,24,10,14
Makuss,turalyon,835,warlock,affliction,38,9,29
Shazem,tarren-mill,830,warlock,affliction,23,9,14
Parley,frostmane,825,warlock,affliction,22,9,13
Savith,defias-brotherhood,821,warlock,affliction,58,25,33
Pøzzi,hyjal,807,warlock,affliction,22,10,12
Аркейнмизери,howling-fjord,801,warlock,affliction,16,11,5
Mércé,stormscale,800,warlock,affliction,16,9,7
Muc,sanguino,793,warlock,affliction,23,9,14
Qoltz,twisting-nether,768,warlock,affliction,12,8,4
Zzooxxie,silvermoon,768,warlock,affliction,12,8,4
Felcamino,outland,768,warlock,affliction,12,8,4
Noxtarius,thrall,768,warlock,affliction,12,8,4
Buâlock,stormscale,768,warlock,affliction,12,8,4
Zlomozg,laughing-skull,768,warlock,affliction,12,8,4
Schlopp,zenedar,768,warlock,affliction,18,8,10
Bytethisx,aggra-português,768,warlock,affliction,18,8,10
Rtsnmt,alakir,768,warlock,affliction,18,8,10
Zefirer,ravencrest,767,warlock,affliction,12,8,4
Adipure,blackrock,767,warlock,affliction,12,8,4
Pistone,nemesis,767,warlock,affliction,12,8,4
Bandìtten,alakir,767,warlock,affliction,12,8,4
Juïcylucy,kazzak,767,warlock,affliction,18,8,10
Pitharo,magtheridon,767,warlock,affliction,18,8,10
Jinchi,outland,767,warlock,affliction,18,8,10
Salemlel,sanguino,767,warlock,affliction,18,8,10
Кейкегенкай,gordunni,767,warlock,affliction,18,8,10
Desingerica,kazzak,767,warlock,affliction,21,9,12
Dreggsow,blackmoore,767,warlock,affliction,24,8,16
Bëllatrïx,zuljin,767,warlock,affliction,30,8,22
Azauriel,argent-dawn,766,warlock,affliction,12,8,4
Graveshaker,quelthalas,766,warlock,affliction,12,8,4
Jagerlock,doomhammer,766,warlock,affliction,18,8,10
Маларгас,soulflayer,765,warlock,affliction,18,8,10
Димаварлок,gordunni,765,warlock,affliction,22,9,13
Leahs,antonidas,764,warlock,affliction,18,8,10
Dorilo,draenor,764,warlock,affliction,18,8,10
Promethazine,nemesis,764,warlock,affliction,18,8,10
Diåbló,stormscale,764,warlock,affliction,24,8,16
Dexterr,sylvanas,763,warlock,affliction,18,8,10
Matheus,zenedar,763,warlock,affliction,18,8,10
Tzimice,hyjal,763,warlock,affliction,18,8,10
Samigina,argent-dawn,762,warlock,affliction,24,8,16
Squát,kazzak,750,warlock,affliction,18,8,10
Hunbeliever,ragnaros,746,warlock,affliction,12,8,4
Yenex,blackhand,745,warlock,affliction,23,8,15
Arlu,blackrock,736,warlock,affliction,24,9,15
Wiberglock,ravencrest,735,warlock,affliction,14,9,5
Crimss,silvermoon,734,warlock,affliction,14,9,5
Satia,sylvanas,730,warlock,affliction,18,8,10
Hexxenschuss,thrall,728,warlock,affliction,49,8,41
Ogrez,nemesis,720,warlock,affliction,21,8,13
Diwi,area-52,720,warlock,affliction,102,35,67
Dráintráin,burning-blade,714,warlock,affliction,25,9,16
Grinchlock,nagrand,712,warlock,affliction,17,8,9
Carelock,chamber-of-aspects,672,warlock,affliction,9,8,1
Skizi,ysondre,672,warlock,affliction,12,7,5
Ethanolix,burning-blade,672,warlock,affliction,12,7,5
Gnargamehl,nemesis,672,warlock,affliction,12,7,5
Kiriana,archimonde,672,warlock,affliction,12,7,5
Kimkold,twisting-nether,672,warlock,affliction,12,7,5
Ilikebolts,blackmoore,672,warlock,affliction,12,7,5
Усубени,greymane,672,warlock,affliction,18,7,11
Mønarch,argent-dawn,672,warlock,affliction,18,7,11
Venaarus,antonidas,672,warlock,affliction,18,7,11
Amdownbad,kazzak,672,warlock,affliction,18,7,11
Desimp,drakthul,672,warlock,affliction,18,7,11
Neg,sylvanas,672,warlock,affliction,24,7,17
Äri,blackmoore,671,warlock,affliction,12,7,5
Someonepro,tarren-mill,671,warlock,affliction,12,7,5
Cropper,turalyon,671,warlock,affliction,12,7,5
Catcalling,die-nachtwache,671,warlock,affliction,12,7,5
Flocca,archimonde,671,warlock,affliction,12,7,5
Azalock,ragnaros,671,warlock,affliction,12,7,5
Opiumers,kazzak,671,warlock,affliction,13,7,6
Proctolock,garona,670,warlock,affliction,12,7,5
Lockgamerx,ravencrest,670,warlock,affliction,12,7,5
Алануэйк,deathguard,669,warlock,affliction,12,7,5
Zywarlock,silvermoon,669,warlock,affliction,18,7,11
Necrolon,senjin,668,warlock,affliction,12,7,5
Нэйрокризиз,howling-fjord,668,warlock,affliction,12,7,5
Nerône,die-todeskrallen,667,warlock,affliction,18,7,11
Дольпико,howling-fjord,665,warlock,affliction,12,7,5
Nocîf,conseil-des-ombres,662,warlock,affliction,12,7,5
Seadoorxt,sanguino,661,warlock,affliction,18,7,11
Vinilio,kazzak,660,warlock,affliction,18,7,11
Garbageclass,outland,655,warlock,affliction,11,7,4
Sallêy,blackhand,654,warlock,affliction,23,7,16
Affllction,auchindoun,639,warlock,affliction,23,7,16
Mvplock,magtheridon,624,warlock,affliction,15,7,8
Малгат,howling-fjord,623,warlock,affliction,23,7,16
Anthh,doomhammer,608,warlock,affliction,16,7,9
Bäcck,silvermoon,607,warlock,affliction,17,7,10
Dömza,kazzak,607,warlock,affliction,20,7,13
Teemzen,tarren-mill,576,warlock,affliction,6,6,0
Debbskidjur,tarren-mill,576,warlock,affliction,6,6,0
Hérrin,teldrassil,576,warlock,affliction,6,6,0
Dimmybyrger,stormreaver,576,warlock,affliction,12,6,6
Cetreros,minahonda,576,warlock,affliction,12,6,6
Векста,gordunni,576,warlock,affliction,12,6,6
Nicker,antonidas,576,warlock,affliction,12,6,6
Multibuyer,tarren-mill,576,warlock,affliction,12,6,6
Keybump,outland,576,warlock,affliction,12,6,6
Tenishia,blackrock,576,warlock,affliction,12,6,6
Alcringe,kazzak,576,warlock,affliction,12,6,6
Xoram,kult-der-verdammten,576,warlock,affliction,12,6,6
Raevax,ravencrest,576,warlock,affliction,12,6,6
Тьмазвёздная,gordunni,576,warlock,affliction,12,6,6
Hasla,stormreaver,576,warlock,affliction,12,6,6
Dslap,grim-batol,576,warlock,affliction,12,6,6
Christoph,tichondrius,576,warlock,affliction,12,6,6
Инферналках,gordunni,576,warlock,affliction,12,6,6
Malfarien,blackmoore,576,warlock,affliction,12,6,6
Boonzor,ravencrest,576,warlock,affliction,12,6,6
Hp,ysondre,576,warlock,affliction,12,6,6
Aches,sylvanas,576,warlock,affliction,15,7,8
Lannik,stormscale,576,warlock,affliction,16,7,9
Louên,dun-modr,576,warlock,affliction,18,6,12
Guccie,ravencrest,575,warlock,affliction,12,6,6
Impazzita,pozzo-delleternità,575,warlock,affliction,12,6,6
Брилс,grom,575,warlock,affliction,12,6,6
Talindra,stormscale,575,warlock,affliction,12,6,6
Afflicted,trollbane,575,warlock,affliction,12,6,6
Raggnarlock,ravencrest,575,warlock,affliction,12,6,6
Ooliver,kazzak,575,warlock,affliction,18,6,12
Аминадиаль,gordunni,575,warlock,affliction,18,6,12
Millhaus,gorgonnash,575,warlock,affliction,18,6,12
Môzoc,frostwolf,575,warlock,affliction,18,6,12
Flinkmongo,kazzak,575,warlock,affliction,18,6,12
Cocacoil,outland,575,warlock,affliction,18,6,12
Toskanoamani,blackmoore,575,warlock,affliction,18,6,12
Hisgobussy,argent-dawn,575,warlock,affliction,24,6,18
Труупыч,gordunni,575,warlock,affliction,24,6,18
Lulokko,nemesis,574,warlock,affliction,18,6,12
Consfearacy,executus,574,warlock,affliction,24,6,18
Hexovíc,blackmoore,574,warlock,affliction,24,6,18
Kiégetlek,ragnaros,573,warlock,affliction,18,6,12
Цветника,deathguard,569,warlock,affliction,12,6,6
Smaúg,archimonde,563,warlock,affliction,24,10,14
Bigbøø,archimonde,543,warlock,affliction,16,6,10
Rëol,blackmoore,527,warlock,affliction,17,7,10
Alarmlock,silvermoon,519,warlock,affliction,12,7,5
Бриант,gordunni,512,warlock,affliction,22,6,16
Скверногрик,fordragon,511,warlock,affliction,10,6,4
Mjuklock,ravencrest,510,warlock,affliction,20,6,14
Jolette,hyjal,508,warlock,affliction,26,6,20
Quadalahara,ravencrest,480,warlock,affliction,6,5,1
Ranchiëk,ravencrest,480,warlock,affliction,6,5,1
Upsahl,twisting-nether,480,warlock,affliction,6,5,1
Uqrlock,twisting-nether,480,warlock,affliction,6,5,1
Drarken,sylvanas,480,warlock,affliction,6,5,1
Nhervojack,hyjal,480,warlock,affliction,6,5,1
Lolock,archimonde,480,warlock,affliction,6,5,1
Theolteckoc,burning-blade,480,warlock,affliction,6,5,1
Chaozvx,kazzak,480,warlock,affliction,12,5,7
Dardec,hyjal,480,warlock,affliction,12,5,7
Kyiûu,archimonde,480,warlock,affliction,12,5,7
Dontlockonme,frostmane,480,warlock,affliction,12,5,7
Negatiiv,outland,480,warlock,affliction,12,5,7
Demoner,tarren-mill,480,warlock,affliction,12,5,7
Druno,archimonde,480,warlock,affliction,12,5,7
Nybbx,frostmane,480,warlock,affliction,12,5,7
Nozx,thrall,480,warlock,affliction,12,5,7
Donase,khaz-modan,480,warlock,affliction,12,5,7
Felrazer,silvermoon,480,warlock,affliction,12,5,7
Chaøsbølt,archimonde,480,warlock,affliction,12,5,7
Hyøsei,hyjal,480,warlock,affliction,12,5,7
Daubi,ravencrest,480,warlock,affliction,12,5,7
Kwoleriker,norgannon,480,warlock,affliction,12,5,7
Ethiq,blackrock,480,warlock,affliction,12,5,7
Asyncbuddy,azjolnerub,480,warlock,affliction,12,5,7
Iatedora,ahnqiraj,480,warlock,affliction,12,5,7
Cyliinia,die-aldor,480,warlock,affliction,12,5,7
Bigglock,aszune,480,warlock,affliction,12,5,7
Exerji,twisting-nether,480,warlock,affliction,12,5,7
Báthori,ravencrest,480,warlock,affliction,12,5,7
Cárrymemommy,ravencrest,480,warlock,affliction,12,5,7
Enzyw,drakthul,480,warlock,affliction,12,5,7
Drbangerz,ravencrest,480,warlock,affliction,12,5,7
Freshplanga,kazzak,480,warlock,affliction,16,6,10
Moredøts,blackrock,480,warlock,affliction,14,5,9
Dwoorf,ravencrest,480,warlock,affliction,14,5,9
Stavrogina,ravencrest,480,warlock,affliction,18,5,13
Muninnus,archimonde,480,warlock,affliction,18,5,13
Buffmeplease,nagrand,480,warlock,affliction,18,5,13
Doomkicksin,haomarush,480,warlock,affliction,18,5,13
Lywov,stormscale,480,warlock,affliction,18,5,13
Necroless,shadowsong,480,warlock,affliction,24,5,19
Wumz,sylvanas,480,warlock,affliction,24,5,19
Lókí,nagrand,479,warlock,affliction,6,5,1
Silås,hyjal,479,warlock,affliction,9,6,3
Trickyy,azjolnerub,479,warlock,affliction,12,5,7
Demonflickan,silvermoon,479,warlock,affliction,12,5,7
Jacobí,defias-brotherhood,479,warlock,affliction,12,5,7
Dreamage,exodar,479,warlock,affliction,12,5,7
Cedrea,ravencrest,479,warlock,affliction,30,5,25
Myristica,die-todeskrallen,478,warlock,affliction,12,5,7
Lewdrumpslap,kazzak,478,warlock,affliction,15,6,9
Üserper,chamber-of-aspects,478,warlock,affliction,30,5,25
Guttate,chamber-of-aspects,476,warlock,affliction,12,5,7
Ketriicken,argent-dawn,447,warlock,affliction,14,6,8
Selur,ragnaros,447,warlock,affliction,17,6,11
Garbrandt,tarren-mill,432,warlock,affliction,9,6,3
Murol,dalaran,431,warlock,affliction,17,5,12
Ackorax,kilrogg,426,warlock,affliction,13,6,7
Covidbolt,outland,426,warlock,affliction,22,8,14
Danidelarge,blackmoore,426,warlock,affliction,21,6,15
Migyardondup,exodar,416,warlock,affliction,14,6,8
Lazyblue,hyjal,415,warlock,affliction,14,5,9
Amatet,sanguino,415,warlock,affliction,16,5,11
Attributivum,blackhand,410,warlock,affliction,16,5,11
Ariyasuke,drakthul,399,warlock,affliction,7,5,2
Nøx,quelthalas,393,warlock,affliction,14,8,6
Tharor,forscherliga,384,warlock,affliction,6,4,2
Humpers,kazzak,384,warlock,affliction,6,4,2
Rilette,dun-morogh,384,warlock,affliction,6,4,2
Noemia,defias-brotherhood,384,warlock,affliction,6,4,2
Turbonion,archimonde,384,warlock,affliction,6,4,2
Lopari,aegwynn,384,warlock,affliction,6,4,2
Mooncrushed,stormscale,384,warlock,affliction,6,4,2
Aljonah,antonidas,384,warlock,affliction,6,4,2
Førgøtten,ragnaros,384,warlock,affliction,6,4,2
Chickoz,eredar,384,warlock,affliction,6,4,2
Doompianist,ghostlands,384,warlock,affliction,6,4,2
Dusken,kazzak,384,warlock,affliction,6,4,2
Krëkk,silvermoon,384,warlock,affliction,6,4,2
Hacknator,aegwynn,384,warlock,affliction,6,4,2
Вервлоекте,soulflayer,384,warlock,affliction,6,4,2
Justlock,tarren-mill,384,warlock,affliction,6,4,2
Veros,kazzak,384,warlock,affliction,6,4,2
Strýder,ragnaros,384,warlock,affliction,6,4,2
Wizdoom,outland,384,warlock,affliction,6,4,2
Мглавечная,soulflayer,384,warlock,affliction,6,4,2
Фейкгодх,soulflayer,384,warlock,affliction,6,4,2
Jujalari,stormscale,384,warlock,affliction,6,4,2
Tekrowdy,blackmoore,384,warlock,affliction,6,4,2
Melkorh,twisting-nether,384,warlock,affliction,6,4,2
Panda,aegwynn,384,warlock,affliction,6,4,2
Uselèss,die-arguswacht,384,warlock,affliction,6,4,2
Feargone,magtheridon,384,warlock,affliction,6,4,2
Hâres,anetheron,384,warlock,affliction,6,4,2
Datty,grim-batol,384,warlock,affliction,6,4,2
Dilox,draenor,384,warlock,affliction,6,4,2
Telodotto,nemesis,384,warlock,affliction,6,4,2
Dotboxdeluxe,blackmoore,384,warlock,affliction,6,4,2
Патокдрысни,howling-fjord,384,warlock,affliction,6,4,2
Bubalock,kazzak,384,warlock,affliction,6,4,2
Hopéléss,aggra-português,384,warlock,affliction,6,4,2
Ethrac,draenor,384,warlock,affliction,6,4,2
Discordîân,twisting-nether,384,warlock,affliction,6,4,2
Adotroz,magtheridon,384,warlock,affliction,6,4,2
Kêkèkékêk,kazzak,384,warlock,affliction,6,4,2
Langneur,kazzak,384,warlock,affliction,6,4,2
Talriun,kazzak,384,warlock,affliction,6,4,2
Zerøskil,blackrock,384,warlock,affliction,6,4,2
Sanshukar,ravencrest,384,warlock,affliction,6,4,2
Ralyz,archimonde,384,warlock,affliction,6,4,2
Dotritos,tarren-mill,384,warlock,affliction,6,4,2
Benafflockk,kirin-tor,384,warlock,affliction,6,4,2
Pablø,silvermoon,384,warlock,affliction,6,4,2
Psychoduck,stormscale,384,warlock,affliction,7,4,3
Djhanzó,outland,384,warlock,affliction,7,4,3
Тевон,gordunni,384,warlock,affliction,12,4,8
Dotshok,aegwynn,384,warlock,affliction,12,4,8
Pause,ysondre,384,warlock,affliction,12,4,8
Zoh,archimonde,384,warlock,affliction,12,4,8
Gorakthul,drakthul,384,warlock,affliction,12,4,8
Силорий,howling-fjord,384,warlock,affliction,12,4,8
Сатенекс,soulflayer,384,warlock,affliction,12,4,8
Cptdotalot,tarren-mill,384,warlock,affliction,12,4,8
Dontfearme,frostwolf,384,warlock,affliction,12,4,8
Mortibal,dalvengyr,384,warlock,affliction,12,4,8
Eleriya,argent-dawn,384,warlock,affliction,12,4,8
Shazes,blutkessel,384,warlock,affliction,12,4,8
Xyzzy,silvermoon,384,warlock,affliction,12,4,8
Thepureone,blades-edge,384,warlock,affliction,12,4,8
Voidlocklol,magtheridon,384,warlock,affliction,12,4,8
Zeddy,draenor,384,warlock,affliction,12,4,8
Seriasa,blackmoore,384,warlock,affliction,12,4,8
Славеномен,howling-fjord,384,warlock,affliction,12,4,8
Supergeîl,blackrock,384,warlock,affliction,12,4,8
Ммотаро,soulflayer,384,warlock,affliction,12,4,8
Purplemonkey,burning-blade,384,warlock,affliction,18,4,14
Roedin,tarren-mill,384,warlock,affliction,18,4,14
Nokzhul,blackrock,384,warlock,affliction,18,4,14
Сорзи,thermaplugg,384,warlock,affliction,18,4,14
Энтропилька,azuregos,383,warlock,affliction,6,4,2
Whisperswerd,blackrock,383,warlock,affliction,6,4,2
Джигуза,howling-fjord,383,warlock,affliction,6,4,2
Freyjå,confrérie-du-thorium,383,warlock,affliction,19,7,12
Дарунг,greymane,383,warlock,affliction,12,4,8
Saltybagel,draenor,383,warlock,affliction,12,4,8
Divvaa,tarren-mill,383,warlock,affliction,12,4,8
Lünatix,archimonde,383,warlock,affliction,18,4,14
Сварожевич,galakrond,383,warlock,affliction,18,4,14
Аннирина,eversong,382,warlock,affliction,6,4,2
Lifesteal,auchindoun,382,warlock,affliction,12,4,8
Saymore,ragnaros,372,warlock,affliction,16,8,8
Gonzoqt,tarren-mill,352,warlock,affliction,10,5,5
Dotyboi,tarren-mill,351,warlock,affliction,8,5,3
Feyras,turalyon,351,warlock,affliction,17,4,13
Tepelkwastje,twisting-nether,350,warlock,affliction,16,5,11
Fearu,kazzak,336,warlock,affliction,15,4,11
Imbasimba,sylvanas,335,warlock,affliction,11,4,7
Hellsplat,tarren-mill,330,warlock,affliction,14,6,8
Marakh,stormscale,320,warlock,affliction,10,4,6
Shalazar,dun-modr,319,warlock,affliction,8,4,4
Fabiov,nemesis,319,warlock,affliction,10,4,6
Nardowick,kazzak,318,warlock,affliction,16,4,12
Nainbusdemil,dalaran,304,warlock,affliction,19,4,15
Mordonna,blades-edge,304,warlock,affliction,19,4,15
Dóni,chamber-of-aspects,297,warlock,affliction,17,5,12
Lubomirek,turalyon,288,warlock,affliction,8,4,4
Siyaa,eredar,288,warlock,affliction,6,3,3
Aniq,eredar,288,warlock,affliction,6,3,3
Kigro,burning-legion,288,warlock,affliction,6,3,3
Clonia,nemesis,288,warlock,affliction,6,3,3
Xurea,ravencrest,288,warlock,affliction,6,3,3
Azmondan,ahnqiraj,288,warlock,affliction,6,3,3
Meleno,die-aldor,288,warlock,affliction,6,3,3
Staynecro,malfurion,288,warlock,affliction,6,3,3
Полтарашкаа,blackscar,288,warlock,affliction,6,3,3
Shirruun,the-maelstrom,288,warlock,affliction,6,3,3
Шрэкс,blackscar,288,warlock,affliction,6,3,3
Ratjamming,drakthul,288,warlock,affliction,6,3,3
Boltsnhoes,tarren-mill,288,warlock,affliction,6,3,3
Darkgrave,the-maelstrom,288,warlock,affliction,6,3,3
Собачкаболи,gordunni,288,warlock,affliction,6,3,3
Dâìñ,antonidas,288,warlock,affliction,6,3,3
Maintarget,blackrock,288,warlock,affliction,6,3,3
Marador,drakthul,288,warlock,affliction,6,3,3
Babayagâ,sanguino,288,warlock,affliction,6,3,3
Bocello,nemesis,288,warlock,affliction,6,3,3
Джастсак,gordunni,288,warlock,affliction,6,3,3
Manikalinka,stormscale,288,warlock,affliction,6,3,3
Kalaslars,draenor,288,warlock,affliction,6,3,3
Cálamity,magtheridon,288,warlock,affliction,6,3,3
Демоник,deathguard,288,warlock,affliction,6,3,3
Фримех,soulflayer,288,warlock,affliction,6,3,3
Vajalock,twisting-nether,288,warlock,affliction,6,3,3
Marenov,kazzak,288,warlock,affliction,6,3,3
Conditions,tarren-mill,288,warlock,affliction,6,3,3
Энжелз,soulflayer,288,warlock,affliction,6,3,3
Dxfive,tarren-mill,288,warlock,affliction,6,3,3
Flayør,ravencrest,288,warlock,affliction,6,3,3
Pprwl,tarren-mill,288,warlock,affliction,6,3,3
Nayolana,argent-dawn,288,warlock,affliction,6,3,3
Ajgreedyy,grim-batol,288,warlock,affliction,6,3,3
Veoxohr,argent-dawn,288,warlock,affliction,6,3,3
Zélroth,argent-dawn,288,warlock,affliction,6,3,3
Зуи,blackscar,288,warlock,affliction,6,3,3
Twisted,malganis,288,warlock,affliction,6,3,3
Velv,nagrand,288,warlock,affliction,6,3,3
Kalagorn,azshara,288,warlock,affliction,6,3,3
Ooze,kazzak,288,warlock,affliction,6,3,3
Kariusbaktus,stormscale,288,warlock,affliction,6,3,3
Zagren,antonidas,288,warlock,affliction,6,3,3
Slavecry,silvermoon,288,warlock,affliction,6,3,3
Sazamia,ravencrest,288,warlock,affliction,6,3,3
Katypery,stormscale,288,warlock,affliction,6,3,3
Moonpoxlock,nerathor,288,warlock,affliction,6,3,3
Vigget,burning-legion,288,warlock,affliction,6,3,3
Dubbzy,outland,288,warlock,affliction,6,3,3
Guciflipflop,twisting-nether,288,warlock,affliction,6,3,3
Hepheisto,blackmoore,288,warlock,affliction,6,3,3
Necksi,archimonde,288,warlock,affliction,6,3,3
Rawsauce,outland,288,warlock,affliction,6,3,3
Trimar,archimonde,288,warlock,affliction,6,3,3
Kurioula,twisting-nether,288,warlock,affliction,6,3,3
Retrosatanas,archimonde,288,warlock,affliction,6,3,3
Ðæthpäct,dalaran,288,warlock,affliction,6,3,3
Absúrd,turalyon,288,warlock,affliction,6,3,3
Madridistaß,outland,288,warlock,affliction,6,3,3
Tigna,outland,288,warlock,affliction,6,3,3
Nachtreich,thrall,288,warlock,affliction,6,3,3
Sanium,outland,288,warlock,affliction,6,3,3
Feyreah,blackmoore,288,warlock,affliction,6,3,3
Eldrinar,twisting-nether,288,warlock,affliction,6,3,3
Itsakikus,twisting-nether,288,warlock,affliction,6,3,3
Imphugger,kazzak,288,warlock,affliction,6,3,3
Databricks,kazzak,288,warlock,affliction,6,3,3
Darksoll,hyjal,288,warlock,affliction,6,3,3
Ulio,outland,288,warlock,affliction,6,3,3
Zikkhejj,ragnaros,288,warlock,affliction,6,3,3
Velënne,kirin-tor,288,warlock,affliction,6,3,3
Fîgøk,conseil-des-ombres,288,warlock,affliction,6,3,3
Doodingus,archimonde,288,warlock,affliction,6,3,3
Favorizlmp,archimonde,288,warlock,affliction,6,3,3
Gigabolt,turalyon,288,warlock,affliction,6,3,3
Bixik,ravencrest,288,warlock,affliction,8,3,5
Lifedriller,drakthul,288,warlock,affliction,10,3,7
Zdrac,stormscale,288,warlock,affliction,12,3,9
Zìì,silvermoon,288,warlock,affliction,12,3,9
Mïtä,hyjal,288,warlock,affliction,12,3,9
Pinketo,kazzak,288,warlock,affliction,12,3,9
Vorcariel,argent-dawn,288,warlock,affliction,12,3,9
Choise,ravencrest,288,warlock,affliction,12,3,9
Kotihoitaja,stormreaver,288,warlock,affliction,12,3,9
Ymersai,stormscale,288,warlock,affliction,12,3,9
Mîjagî,blackhand,288,warlock,affliction,12,3,9
Tzeeñtch,tarren-mill,288,warlock,affliction,12,3,9
Михасяпевпев,gordunni,288,warlock,affliction,12,3,9
Этожедру,howling-fjord,288,warlock,affliction,12,3,9
Troo,daggerspine,287,warlock,affliction,7,5,2
Nedivh,stormscale,287,warlock,affliction,8,4,4
Kritcheq,alakir,287,warlock,affliction,6,3,3
Divinehâmmer,hyjal,287,warlock,affliction,6,3,3
Tyranuzz,norgannon,287,warlock,affliction,12,3,9
Dotmasterz,outland,287,warlock,affliction,18,3,15
Killerbeez,burning-blade,287,warlock,affliction,18,3,15
Márinho,aggra-português,276,warlock,affliction,16,6,10
Cerberus,argent-dawn,271,warlock,affliction,11,3,8
Wartem,sylvanas,271,warlock,affliction,17,3,14
Áéé,kazzak,255,warlock,affliction,8,4,4
Евнухоидизм,gordunni,234,warlock,affliction,11,4,7
Snaga,culte-de-la-rive-noire,233,warlock,affliction,15,5,10
Nimmyjewtron,tarren-mill,224,warlock,affliction,10,3,7
Lockas,ravencrest,222,warlock,affliction,8,3,5
Pøx,nemesis,208,warlock,affliction,13,3,10
Dêmön,arathi,192,warlock,affliction,6,2,4
Razkann,confrérie-du-thorium,192,warlock,affliction,6,2,4
Ðankan,aegwynn,192,warlock,affliction,6,2,4
Numidia,tarren-mill,192,warlock,affliction,6,2,4
Кериген,gordunni,192,warlock,affliction,6,2,4
Kastón,dun-modr,192,warlock,affliction,6,2,4
Гумал,howling-fjord,192,warlock,affliction,6,2,4
Ozax,doomhammer,192,warlock,affliction,6,2,4
Cafardcancer,archimonde,192,warlock,affliction,6,2,4
Скверножмых,gordunni,192,warlock,affliction,6,2,4
Иммолэйтх,gordunni,192,warlock,affliction,6,2,4
Айнзуалгоун,gordunni,192,warlock,affliction,6,2,4
Аидка,gordunni,192,warlock,affliction,6,2,4
Bigbagelbob,archimonde,192,warlock,affliction,6,2,4
Malumbra,argent-dawn,192,warlock,affliction,6,2,4
Дьяволоман,blackscar,192,warlock,affliction,6,2,4
Shore,ragnaros,192,warlock,affliction,6,2,4
Wutili,dun-morogh,192,warlock,affliction,6,2,4
Alxor,archimonde,192,warlock,affliction,6,2,4
Imatión,sylvanas,192,warlock,affliction,6,2,4
Recko,zuljin,192,warlock,affliction,6,2,4
Twistedfate,norgannon,192,warlock,affliction,6,2,4
Cruello,ragnaros,192,warlock,affliction,6,2,4
Endherkonk,sanguino,192,warlock,affliction,6,2,4
Жериновсский,gordunni,192,warlock,affliction,6,2,4
Malédictiøns,temple-noir,192,warlock,affliction,6,2,4
Фатан,razuvious,192,warlock,affliction,6,2,4
Lakasytos,sanguino,192,warlock,affliction,6,2,4
Elvània,eredar,192,warlock,affliction,6,2,4
Dotsfired,aegwynn,192,warlock,affliction,6,2,4
Zhareeus,sanguino,192,warlock,affliction,6,2,4
Hexus,teldrassil,192,warlock,affliction,6,2,4
Ezy,auchindoun,192,warlock,affliction,6,2,4
Legend,trollbane,192,warlock,affliction,6,2,4
Morcey,sylvanas,192,warlock,affliction,6,2,4
Soundmagic,silvermoon,192,warlock,affliction,6,2,4
Чернокнжник,soulflayer,192,warlock,affliction,6,2,4
Sotapen,ragnaros,192,warlock,affliction,6,2,4
Шеизла,borean-tundra,192,warlock,affliction,6,2,4
Kivilock,dun-modr,192,warlock,affliction,6,2,4
Бирел,soulflayer,192,warlock,affliction,6,2,4
Tremmérs,outland,192,warlock,affliction,6,2,4
Amited,drakthul,192,warlock,affliction,6,2,4
Flockyy,draenor,192,warlock,affliction,6,2,4
Nuckki,antonidas,192,warlock,affliction,6,2,4
Norgebrur,draenor,192,warlock,affliction,6,2,4
Khazgrom,guldan,192,warlock,affliction,6,2,4
Jexa,silvermoon,192,warlock,affliction,6,2,4
Healél,sanguino,192,warlock,affliction,6,2,4
Finea,sanguino,192,warlock,affliction,6,2,4
Калестонх,soulflayer,192,warlock,affliction,6,2,4
Volomar,darkspear,192,warlock,affliction,6,2,4
Tattered,draenor,192,warlock,affliction,6,2,4
Âpâchî,twisting-nether,192,warlock,affliction,6,2,4
Azerybedge,alexstrasza,192,warlock,affliction,6,2,4
Wycked,azshara,192,warlock,affliction,6,2,4
Hellcatherin,ghostlands,192,warlock,affliction,6,2,4
Сатаната,deepholm,192,warlock,affliction,6,2,4
Pichwise,draenor,192,warlock,affliction,6,2,4
Mariahscary,sylvanas,192,warlock,affliction,6,2,4
Тарои,howling-fjord,192,warlock,affliction,6,2,4
Born,ravencrest,192,warlock,affliction,6,2,4
Tørcal,hyjal,192,warlock,affliction,6,2,4
Trollóck,the-maelstrom,192,warlock,affliction,6,2,4
Potatowl,ravencrest,192,warlock,affliction,6,2,4
Валак,greymane,192,warlock,affliction,6,2,4
Narstia,archimonde,192,warlock,affliction,6,2,4
Absurdity,twisting-nether,192,warlock,affliction,6,2,4
Onlylock,outland,192,warlock,affliction,6,2,4
Vellerian,twisting-nether,192,warlock,affliction,6,2,4
Swèét,draenor,192,warlock,affliction,6,2,4
Бесстолоч,ashenvale,192,warlock,affliction,6,2,4
Хастла,ashenvale,192,warlock,affliction,6,2,4
Setharon,burning-legion,192,warlock,affliction,6,2,4
Portyx,archimonde,192,warlock,affliction,6,2,4
Furïeuse,archimonde,192,warlock,affliction,6,2,4
Meisterhexe,taerar,192,warlock,affliction,6,2,4
Lesgrossman,draenor,192,warlock,affliction,6,2,4
Vibori,twisting-nether,192,warlock,affliction,6,2,4
Dwimmerlaikx,ragnaros,192,warlock,affliction,6,2,4
Marroux,malganis,192,warlock,affliction,6,2,4
Армдэд,galakrond,192,warlock,affliction,6,2,4
Мамхаус,howling-fjord,192,warlock,affliction,6,2,4
Шадофлок,deathweaver,192,warlock,affliction,6,2,4
Vhordrai,kazzak,192,warlock,affliction,6,2,4
Bowhite,silvermoon,192,warlock,affliction,6,2,4
Mafteryo,blackrock,192,warlock,affliction,6,2,4
Slurvefar,kazzak,192,warlock,affliction,6,2,4
Dedalus,zuluhed,192,warlock,affliction,6,2,4
Tokarrus,blackmoore,192,warlock,affliction,6,2,4
Kortsoet,silvermoon,192,warlock,affliction,6,2,4
Dréadful,kazzak,192,warlock,affliction,6,2,4
Howareyou,blackrock,192,warlock,affliction,6,2,4
Coochieii,kazzak,192,warlock,affliction,6,2,4
Ruvy,twisting-nether,192,warlock,affliction,6,2,4
ßatocko,kazzak,192,warlock,affliction,6,2,4
Paintherapy,blackrock,192,warlock,affliction,6,2,4
Brudèrtuk,das-syndikat,192,warlock,affliction,6,2,4
Zartax,kazzak,192,warlock,affliction,6,2,4
Hellcake,kazzak,192,warlock,affliction,6,2,4
Yzïah,blackrock,192,warlock,affliction,6,2,4
Désolaté,kazzak,192,warlock,affliction,6,2,4
Slâyâ,blackrock,192,warlock,affliction,6,2,4
Dmondmg,kazzak,192,warlock,affliction,6,2,4
Malgus,veknilash,192,warlock,affliction,6,2,4
Lockbitch,archimonde,192,warlock,affliction,8,2,6
Adafbhf,tichondrius,192,warlock,affliction,8,2,6
Gemja,onyxia,192,warlock,affliction,15,3,12
Рыжевласочка,eversong,192,warlock,affliction,12,2,10
Djadizpunish,stormscale,192,warlock,affliction,12,2,10
Баммес,galakrond,192,warlock,affliction,12,2,10
Felember,stormscale,192,warlock,affliction,12,2,10
Müsli,kiljaeden,192,warlock,affliction,12,2,10
Harrydotterx,alakir,192,warlock,affliction,12,2,10
Dupony,antonidas,192,warlock,affliction,12,2,10
Nùdex,ravencrest,192,warlock,affliction,12,2,10
Branduir,ragnaros,192,warlock,affliction,12,2,10
Wizesson,shadowsong,192,warlock,affliction,12,2,10
Drdotalot,twisting-nether,192,warlock,affliction,12,2,10
Ribtic,draenor,191,warlock,affliction,6,2,4
Trinxs,blackmoore,191,warlock,affliction,12,2,10
Bildimar,drekthar,190,warlock,affliction,6,4,2
Zorlon,frostmane,169,warlock,affliction,8,4,4
Røiheenøk,archimonde,159,warlock,affliction,5,2,3
Overbuffed,wildhammer,159,warlock,affliction,5,2,3
Аоепампгодх,howling-fjord,159,warlock,affliction,11,2,9
Mïllâïneeqtx,archimonde,138,warlock,affliction,8,4,4
Nürgle,stormscale,138,warlock,affliction,8,3,5
Malariaa,defias-brotherhood,128,warlock,affliction,4,2,2
Paveru,tarren-mill,128,warlock,affliction,4,2,2
Hokoreuw,echsenkessel,112,warlock,affliction,7,2,5
Infernó,aerie-peak,96,warlock,affliction,3,2,1
Mergon,ravencrest,96,warlock,affliction,3,2,1
Lamagieduzub,ysondre,96,warlock,affliction,3,2,1
Noahh,kazzak,96,warlock,affliction,6,1,5
Kalifh,kazzak,96,warlock,affliction,6,1,5
Вандаллизмэ,blackscar,96,warlock,affliction,6,1,5
Oralnatqga,draenor,96,warlock,affliction,6,1,5
Irwene,argent-dawn,96,warlock,affliction,6,1,5
Grimzeh,silvermoon,96,warlock,affliction,6,1,5
Kiritsugi,aszune,96,warlock,affliction,6,1,5
Acohab,draenor,96,warlock,affliction,6,1,5
Werzel,frostmane,96,warlock,affliction,6,1,5
Scud,frostwolf,96,warlock,affliction,6,1,5
Goefaz,blackrock,96,warlock,affliction,6,1,5
Zozano,draenor,96,warlock,affliction,6,1,5
Ðemise,antonidas,96,warlock,affliction,6,1,5
Quadraxer,antonidas,96,warlock,affliction,6,1,5
Эвеленс,soulflayer,96,warlock,affliction,6,1,5
Mirrorz,kazzak,96,warlock,affliction,6,1,5
Cruckz,nathrezim,96,warlock,affliction,6,1,5
Veridy,kazzak,96,warlock,affliction,6,1,5
Alotami,frostwolf,96,warlock,affliction,6,1,5
Ottu,thrall,96,warlock,affliction,6,1,5
Fearco,ravencrest,96,warlock,affliction,6,1,5
Berthi,doomhammer,96,warlock,affliction,6,1,5
Pidlwick,turalyon,96,warlock,affliction,6,1,5
Crucify,dun-morogh,96,warlock,affliction,6,1,5
Merelock,eonar,96,warlock,affliction,6,1,5
Warlockkey,ravencrest,96,warlock,affliction,6,1,5
Contergan,arygos,96,warlock,affliction,6,1,5
Nevergladtra,darksorrow,96,warlock,affliction,6,1,5
Blackwizard,theradras,96,warlock,affliction,6,1,5
Agitosan,defias-brotherhood,96,warlock,affliction,6,1,5
Huesecillo,sanguino,96,warlock,affliction,6,1,5
Shblakk,outland,96,warlock,affliction,6,1,5
Hhip,sanguino,96,warlock,affliction,6,1,5
Plaguee,outland,96,warlock,affliction,6,1,5
Fêâr,dun-modr,96,warlock,affliction,6,1,5
Pederlock,defias-brotherhood,96,warlock,affliction,6,1,5
Бигсмоук,howling-fjord,96,warlock,affliction,6,1,5
Opprimo,blackmoore,96,warlock,affliction,6,1,5
Kretuss,silvermoon,96,warlock,affliction,6,1,5
Shadeshanox,blackmoore,96,warlock,affliction,6,1,5
Чернаяскала,howling-fjord,96,warlock,affliction,6,1,5
Doturanal,blackmoore,96,warlock,affliction,6,1,5
Fearrari,ragnaros,96,warlock,affliction,6,1,5
Matslie,argent-dawn,96,warlock,affliction,6,1,5
Numlockz,jaedenar,96,warlock,affliction,6,1,5
Händerå,ragnaros,96,warlock,affliction,6,1,5
Inagony,twisting-nether,96,warlock,affliction,6,1,5
Mobiq,twisting-nether,96,warlock,affliction,6,1,5
Amonshii,ragnaros,96,warlock,affliction,6,1,5
Zxò,twisting-nether,96,warlock,affliction,8,1,7
Adøume,ysondre,96,warlock,affliction,15,1,14
Guldauni,tarren-mill,96,warlock,affliction,18,1,17
Dotex,zuljin,84,warlock,affliction,12,4,8
Kapitshi,frostwhisper,79,warlock,affliction,5,1,4
Warlockholms,archimonde,79,warlock,affliction,5,1,4
Guntherheim,stormreaver,73,warlock,affliction,11,3,8
Pufulet,sylvanas,64,warlock,affliction,4,1,3
Poulebar,ysondre,64,warlock,affliction,4,1,3
Natpoesje,azjolnerub,64,warlock,affliction,4,1,3
Araqt,thrall,48,warlock,affliction,3,1,2
Petrosk,sanguino,42,warlock,affliction,6,2,4
Yhazel,archimonde,42,warlock,affliction,7,2,5
Ltany,drakthul,31,warlock,affliction,2,1,1
Omegachad,draenor,31,warlock,affliction,2,1,1
Hamex,draenor,16,warlock,affliction,1,1,0
Ryurans,cthun,9,warlock,affliction,8,2,6
Vitezandro,stormscale,2288,warrior,fury,84,59,25
Dyingdogs,kazzak,2285,warrior,fury,120,66,54
Høvdingen,outland,2252,warrior,fury,114,70,44
Wodwod,kazzak,2227,warrior,fury,106,71,35
Dõxlol,kazzak,2224,warrior,fury,108,64,44
Joeférnandes,ragnaros,2220,warrior,fury,168,90,78
Dõxqt,kazzak,2215,warrior,fury,116,70,46
Sublex,blackrock,2169,warrior,fury,129,75,54
Syltetballe,kazzak,2161,warrior,fury,149,87,62
Krônm,dun-modr,2153,warrior,fury,71,47,24
Tanja,bronzebeard,2145,warrior,fury,84,53,31
Heartmemphis,stormscale,2137,warrior,fury,93,59,34
Blîxtgordon,tarren-mill,2131,warrior,fury,90,52,38
Thezug,blackmoore,2131,warrior,fury,132,73,59
Gewyon,ragnaros,2131,warrior,fury,201,111,90
Sublex,aegwynn,2125,warrior,fury,114,73,41
Gottdustin,lothar,2124,warrior,fury,143,78,65
Eidzo,tarren-mill,2121,warrior,fury,119,73,46
Nodrip,stormscale,2117,warrior,fury,180,108,72
Ðênnis,ravencrest,2110,warrior,fury,68,40,28
Corvínus,blackrock,2106,warrior,fury,176,95,81
Богвойны,razuvious,2104,warrior,fury,132,77,55
Quanny,die-aldor,2102,warrior,fury,114,67,47
Níghtfúry,ravencrest,2102,warrior,fury,84,43,41
Hawkman,outland,2097,warrior,fury,85,46,39
Pòóòóòóòópz,dun-modr,2090,warrior,fury,76,42,34
Hangart,argent-dawn,2088,warrior,fury,201,108,93
Schultze,kazzak,2088,warrior,fury,262,128,134
Maxwall,twisting-nether,2086,warrior,fury,442,221,221
Релайк,gordunni,2079,warrior,fury,90,51,39
Dyingdog,kazzak,2073,warrior,fury,143,72,71
Орвинг,soulflayer,2052,warrior,fury,157,88,69
Kwesta,kazzak,2043,warrior,fury,78,48,30
Morbaac,archimonde,2043,warrior,fury,173,98,75
Кавайтити,blackscar,2032,warrior,fury,103,50,53
Grulbash,stormscale,2030,warrior,fury,72,38,34
Ibunnyone,blackrock,2023,warrior,fury,152,81,71
Dreasus,ragnaros,2007,warrior,fury,202,109,93
Elsensør,thrall,2002,warrior,fury,303,153,150
Vrynn,nemesis,1999,warrior,fury,564,293,271
Gregorez,silvermoon,1998,warrior,fury,186,101,85
Vykoz,sylvanas,1994,warrior,fury,78,47,31
Sockerbagarn,zenedar,1989,warrior,fury,244,127,117
Kronmw,dun-modr,1987,warrior,fury,102,56,46
Insanedmg,dun-modr,1985,warrior,fury,132,69,63
Sporctaco,nemesis,1983,warrior,fury,160,87,73
Immørtalx,area-52,1981,warrior,fury,66,30,36
Ironbound,silvermoon,1978,warrior,fury,102,56,46
Apacolata,outland,1977,warrior,fury,72,41,31
Käïzën,dun-modr,1976,warrior,fury,77,50,27
Kenryu,argent-dawn,1969,warrior,fury,78,43,35
Warrez,azuremyst,1966,warrior,fury,413,223,190
Hanìbal,ravencrest,1962,warrior,fury,291,158,133
Мигнт,howling-fjord,1961,warrior,fury,84,42,42
Allthèwayup,kazzak,1960,warrior,fury,66,36,30
Dreams,auchindoun,1958,warrior,fury,108,62,46
Nerfrend,stormscale,1958,warrior,fury,72,35,37
Wruxar,bronzebeard,1955,warrior,fury,72,37,35
Chaosedge,terokkar,1953,warrior,fury,154,92,62
Palmexwar,drakthul,1952,warrior,fury,84,46,38
Linzao,archimonde,1949,warrior,fury,96,53,43
Stephabibi,kazzak,1943,warrior,fury,315,161,154
Waterquéen,outland,1938,warrior,fury,36,24,12
Hugeman,stormscale,1937,warrior,fury,120,62,58
Дахирарг,fordragon,1937,warrior,fury,258,132,126
Beasterbunny,outland,1936,warrior,fury,163,95,68
Schlauberg,azshara,1936,warrior,fury,167,92,75
Ðunhammer,blackmoore,1936,warrior,fury,186,97,89
Yaler,alakir,1934,warrior,fury,107,61,46
Sonnyzz,sanguino,1933,warrior,fury,113,64,49
Pivcuga,kazzak,1928,warrior,fury,92,56,36
Castlevania,ravencrest,1916,warrior,fury,145,78,67
Rawrstorm,silvermoon,1914,warrior,fury,48,28,20
Dwarfsteel,stormscale,1914,warrior,fury,83,42,41
Shinychan,silvermoon,1913,warrior,fury,48,30,18
Arthoc,sanguino,1913,warrior,fury,135,77,58
Zyalen,stormscale,1911,warrior,fury,143,75,68
Borndet,eredar,1908,warrior,fury,183,107,76
Cesr,bloodhoof,1908,warrior,fury,156,88,68
Miquellá,die-aldor,1900,warrior,fury,103,58,45
Zidbi,argent-dawn,1898,warrior,fury,321,168,153
Трэйдар,blackscar,1895,warrior,fury,54,31,23
Moldamis,blackhand,1895,warrior,fury,60,30,30
Risara,outland,1893,warrior,fury,127,74,53
Yserá,auchindoun,1893,warrior,fury,112,56,56
Rocketx,blackrock,1892,warrior,fury,79,44,35
Kiha,argent-dawn,1887,warrior,fury,60,35,25
Violentfunky,ravencrest,1886,warrior,fury,120,65,55
Picciocino,nemesis,1886,warrior,fury,239,124,115
Злопиканка,gordunni,1885,warrior,fury,115,61,54
Lilshockwave,argent-dawn,1882,warrior,fury,77,53,24
Uretirips,archimonde,1879,warrior,fury,243,130,113
Dronikos,ravencrest,1878,warrior,fury,60,39,21
Stansmash,kazzak,1878,warrior,fury,54,32,22
Manaskhan,tarren-mill,1878,warrior,fury,71,38,33
Нерморрог,howling-fjord,1876,warrior,fury,60,43,17
Варплеер,gordunni,1875,warrior,fury,76,39,37
Elsensor,sylvanas,1873,warrior,fury,177,81,96
Mitu,sanguino,1871,warrior,fury,87,51,36
Рэйлет,gordunni,1871,warrior,fury,66,36,30
Pflanzling,nozdormu,1870,warrior,fury,274,136,138
Tooski,sylvanas,1869,warrior,fury,119,64,55
Gozgu,stormscale,1867,warrior,fury,62,37,25
Zadirich,burning-blade,1867,warrior,fury,138,74,64
Гринфинч,galakrond,1866,warrior,fury,237,129,108
Sonnylolxd,dun-modr,1865,warrior,fury,119,58,61
Budgetassa,stormscale,1864,warrior,fury,54,30,24
Vulcán,aerie-peak,1863,warrior,fury,73,40,33
Émalkay,tarren-mill,1863,warrior,fury,48,26,22
Ranyl,blackmoore,1863,warrior,fury,71,34,37
Ampw,ravencrest,1861,warrior,fury,90,56,34
Faraam,sunstrider,1861,warrior,fury,90,43,47
Løktær,ravencrest,1859,warrior,fury,108,55,53
Thundersword,sylvanas,1858,warrior,fury,140,78,62
Bloodhorn,blackhand,1857,warrior,fury,54,36,18
Nitojutsu,blackrock,1856,warrior,fury,54,30,24
Xark,drakthul,1852,warrior,fury,102,56,46
Jeco,tarren-mill,1851,warrior,fury,143,78,65
Vegansmasher,stormscale,1851,warrior,fury,46,25,21
Kragrâu,kazzak,1851,warrior,fury,170,89,81
Morganãrogán,ragnaros,1850,warrior,fury,42,23,19
Boos,burning-legion,1849,warrior,fury,54,32,22
Dizzq,burning-legion,1849,warrior,fury,83,38,45
Kocmochka,tarren-mill,1848,warrior,fury,117,62,55
Kennyföx,ysondre,1846,warrior,fury,29,20,9
Bözzy,stormreaver,1846,warrior,fury,410,219,191
Warzzor,auchindoun,1846,warrior,fury,42,21,21
Ørìgíñälgøðx,archimonde,1845,warrior,fury,54,32,22
Уэсгар,blackscar,1844,warrior,fury,54,31,23
Shhimbanned,doomhammer,1843,warrior,fury,78,45,33
Luxurious,argent-dawn,1843,warrior,fury,114,64,50
Фктп,blackscar,1843,warrior,fury,60,33,27
Oneoneseven,archimonde,1841,warrior,fury,78,49,29
Gatts,krasus,1841,warrior,fury,150,85,65
Propanex,kazzak,1837,warrior,fury,84,52,32
Strife,ravencrest,1836,warrior,fury,47,31,16
Àlexander,ravencrest,1836,warrior,fury,40,21,19
Fondugodx,archimonde,1836,warrior,fury,111,54,57
Rhâpsodyw,ravencrest,1835,warrior,fury,36,27,9
Lair,zuljin,1835,warrior,fury,106,67,39
Wismerx,kazzak,1835,warrior,fury,71,44,27
Elian,ragnaros,1835,warrior,fury,72,36,36
Chargeyou,ragnaros,1834,warrior,fury,59,36,23
Wøðhërõhâhåh,kazzak,1834,warrior,fury,39,22,17
Kizzyo,draenor,1834,warrior,fury,108,58,50
Vardias,pozzo-delleternità,1833,warrior,fury,46,28,18
Méido,argent-dawn,1833,warrior,fury,325,172,153
Poggsaron,kazzak,1831,warrior,fury,213,114,99
Krazosh,die-aldor,1831,warrior,fury,42,22,20
Êssâ,stormscale,1831,warrior,fury,90,47,43
Caméltoe,frostwolf,1829,warrior,fury,129,76,53
Vajira,blackrock,1828,warrior,fury,41,25,16
Wargoth,draenor,1828,warrior,fury,84,46,38
Anakhas,archimonde,1828,warrior,fury,60,30,30
Durif,argent-dawn,1827,warrior,fury,48,35,13
Ufu,outland,1827,warrior,fury,42,26,16
Svënja,ysondre,1826,warrior,fury,192,107,85
Каосвар,howling-fjord,1826,warrior,fury,60,31,29
Imolderthenu,blackrock,1825,warrior,fury,166,91,75
Рыгатрон,galakrond,1825,warrior,fury,84,46,38
Deatheart,ysondre,1824,warrior,fury,76,41,35
Karny,argent-dawn,1824,warrior,fury,66,34,32
Geneazyx,silvermoon,1823,warrior,fury,116,70,46
Дестингл,gordunni,1823,warrior,fury,123,67,56
Kibb,sylvanas,1820,warrior,fury,104,64,40
Jésusiskíng,amanthul,1820,warrior,fury,89,48,41
Grimlok,sylvanas,1820,warrior,fury,71,36,35
Tizh,twisting-nether,1819,warrior,fury,104,73,31
Ryghar,silvermoon,1819,warrior,fury,161,88,73
Gladius,blutkessel,1819,warrior,fury,156,80,76
Jaý,draenor,1818,warrior,fury,74,42,32
Протектор,soulflayer,1818,warrior,fury,196,102,94
Bleaja,tarren-mill,1817,warrior,fury,72,45,27
Тиран,howling-fjord,1817,warrior,fury,48,27,21
Xåb,dun-morogh,1817,warrior,fury,170,87,83
Bráïnléss,silvermoon,1816,warrior,fury,135,79,56
Spartaz,eredar,1816,warrior,fury,65,38,27
Pouckette,hyjal,1816,warrior,fury,126,70,56
Monnee,silvermoon,1815,warrior,fury,78,53,25
Gigatscheb,eredar,1815,warrior,fury,149,82,67
Tsuperman,tarren-mill,1815,warrior,fury,59,28,31
Dangeruos,ragnaros,1814,warrior,fury,54,34,20
Siuzy,blackrock,1814,warrior,fury,66,39,27
Granlach,sunstrider,1814,warrior,fury,48,26,22
Luigistar,naxxramas,1814,warrior,fury,190,99,91
Adian,ravencrest,1813,warrior,fury,42,26,16
Panzerpung,outland,1813,warrior,fury,48,29,19
Tweran,drakthul,1813,warrior,fury,83,41,42
Suduri,drakthul,1812,warrior,fury,42,26,16
Pizdatos,ravencrest,1812,warrior,fury,148,83,65
Zednos,twilights-hammer,1812,warrior,fury,184,102,82
Decapitatëd,outland,1812,warrior,fury,130,70,60
Ymaa,argent-dawn,1811,warrior,fury,30,19,11
Xzwarr,silvermoon,1810,warrior,fury,38,21,17
Троммтар,howling-fjord,1810,warrior,fury,71,35,36
Кокдиллак,soulflayer,1809,warrior,fury,66,41,25
Cuzyxtwo,blackrock,1809,warrior,fury,60,35,25
Irontouch,draenor,1809,warrior,fury,117,66,51
Rofos,hellscream,1808,warrior,fury,150,85,65
Clellin,silvermoon,1807,warrior,fury,139,80,59
Oldcockball,argent-dawn,1807,warrior,fury,136,78,58
Leelazero,argent-dawn,1807,warrior,fury,78,44,34
Ragepath,ragnaros,1807,warrior,fury,72,39,33
Rhynot,argent-dawn,1806,warrior,fury,60,41,19
Stressfulx,silvermoon,1806,warrior,fury,91,58,33
Очепенец,soulflayer,1806,warrior,fury,212,114,98
Владикчардж,gordunni,1805,warrior,fury,166,94,72
Хенгард,gordunni,1805,warrior,fury,128,71,57
Quadfather,kazzak,1805,warrior,fury,60,31,29
Licious,outland,1804,warrior,fury,30,19,11
Köftemecx,blackrock,1804,warrior,fury,223,130,93
Tpyñåöädxzd,the-maelstrom,1803,warrior,fury,41,25,16
Oogaboogadps,silvermoon,1803,warrior,fury,249,134,115
Solaje,dun-modr,1802,warrior,fury,54,33,21
Nóvamh,draenor,1802,warrior,fury,42,24,18
Capitalista,das-konsortium,1802,warrior,fury,125,68,57
Discoklaus,blackmoore,1801,warrior,fury,415,214,201
Letiis,blackrock,1800,warrior,fury,243,126,117
Timewarrior,ravencrest,1799,warrior,fury,90,46,44
Котаче,soulflayer,1798,warrior,fury,202,107,95
Warrzor,auchindoun,1797,warrior,fury,54,27,27
Bufdefstance,kazzak,1795,warrior,fury,86,43,43
Анжинерх,gordunni,1794,warrior,fury,132,70,62
Woddeywar,blackmoore,1792,warrior,fury,65,37,28
Kûno,stormscale,1792,warrior,fury,102,57,45
Elbicho,ravencrest,1791,warrior,fury,47,30,17
Picklejuicer,argent-dawn,1791,warrior,fury,48,25,23
Wabisabì,silvermoon,1789,warrior,fury,117,67,50
Imorphius,silvermoon,1787,warrior,fury,206,113,93
Боссберс,soulflayer,1786,warrior,fury,162,91,71
Vory,ravencrest,1786,warrior,fury,54,29,25
Blázedblack,twisting-nether,1783,warrior,fury,150,89,61
Serveywar,twisting-nether,1783,warrior,fury,42,24,18
Badon,burning-legion,1782,warrior,fury,66,41,25
Raïgã,hyjal,1782,warrior,fury,167,83,84
Джакир,howling-fjord,1781,warrior,fury,127,67,60
Späns,ragnaros,1779,warrior,fury,77,36,41
Immørtálx,tarren-mill,1779,warrior,fury,48,21,27
Tóffèl,thrall,1773,warrior,fury,48,32,16
Vesnãpusic,draenor,1773,warrior,fury,117,68,49
Ryonâgai,aegwynn,1773,warrior,fury,54,30,24
Ulrid,draenor,1772,warrior,fury,42,22,20
Shadroq,auchindoun,1771,warrior,fury,36,23,13
Aléxsandra,ravencrest,1771,warrior,fury,36,21,15
Kwedrowar,burning-legion,1768,warrior,fury,294,155,139
Ntouziera,silvermoon,1767,warrior,fury,60,29,31
Atrôcithy,silvermoon,1766,warrior,fury,58,36,22
Gôrilla,kazzak,1764,warrior,fury,44,25,19
Noisey,sanguino,1763,warrior,fury,54,42,12
Shadokaa,stormscale,1762,warrior,fury,249,133,116
Geez,burning-blade,1761,warrior,fury,54,28,26
Fatmikez,aggra-português,1759,warrior,fury,53,35,18
Nobodyx,tarren-mill,1757,warrior,fury,144,86,58
Alexdgreat,tarren-mill,1756,warrior,fury,107,63,44
Emune,blackhand,1755,warrior,fury,69,39,30
Spørctacø,nemesis,1754,warrior,fury,72,40,32
Vÿnk,ysondre,1753,warrior,fury,266,142,124
Грамол,soulflayer,1753,warrior,fury,156,82,74
Щекорез,soulflayer,1752,warrior,fury,66,36,30
Frozenliøn,twisting-nether,1751,warrior,fury,107,58,49
Studzianki,argent-dawn,1750,warrior,fury,41,26,15
Drittsekken,sylvanas,1750,warrior,fury,30,19,11
Элинглир,gordunni,1750,warrior,fury,177,95,82
Дарккардинал,deathguard,1750,warrior,fury,163,83,80
Sumis,stormreaver,1749,warrior,fury,54,20,34
Maarshl,ysondre,1747,warrior,fury,54,31,23
Eekz,haomarush,1747,warrior,fury,146,82,64
Nukerz,kirin-tor,1746,warrior,fury,36,23,13
Rãzmø,hyjal,1746,warrior,fury,96,51,45
Osha,hyjal,1746,warrior,fury,449,229,220
Кофесмолоком,ashenvale,1746,warrior,fury,48,24,24
Crîxús,silvermoon,1743,warrior,fury,48,29,19
Nakedwarrior,silvermoon,1739,warrior,fury,30,20,10
Дралк,gordunni,1739,warrior,fury,136,73,63
Emix,arygos,1738,warrior,fury,96,51,45
Lyrv,ravencrest,1737,warrior,fury,54,31,23
Hasbullá,kazzak,1737,warrior,fury,72,39,33
Derentis,echsenkessel,1736,warrior,fury,198,105,93
Basiletha,hyjal,1736,warrior,fury,95,44,51
Cøbain,eredar,1735,warrior,fury,54,29,25
Xzurgster,twisting-nether,1735,warrior,fury,148,75,73
Tidarius,twisting-nether,1735,warrior,fury,54,27,27
Helleon,twisting-nether,1734,warrior,fury,48,26,22
Taurenboii,ravencrest,1733,warrior,fury,43,24,19
Shilix,twisting-nether,1733,warrior,fury,48,26,22
Cavo,drakthul,1732,warrior,fury,41,25,16
Sagethi,blackrock,1732,warrior,fury,86,42,44
Brbtoilet,kazzak,1731,warrior,fury,84,48,36
Harimà,antonidas,1731,warrior,fury,42,22,20
Goorila,kazzak,1731,warrior,fury,90,46,44
Soakmybeet,archimonde,1730,warrior,fury,130,67,63
Scusi,burning-blade,1729,warrior,fury,104,63,41
Sorkk,kazzak,1729,warrior,fury,68,40,28
Брокскрим,soulflayer,1729,warrior,fury,60,34,26
Eddíemòrphin,kazzak,1728,warrior,fury,58,34,24
Prixor,grim-batol,1728,warrior,fury,60,28,32
Jetman,ravencrest,1727,warrior,fury,107,56,51
Juna,hellscream,1726,warrior,fury,91,47,44
Inconcussae,drakthul,1725,warrior,fury,59,39,20
Trundledaddy,silvermoon,1725,warrior,fury,60,38,22
Ffected,blackmoore,1725,warrior,fury,143,86,57
Даймонддогс,gordunni,1725,warrior,fury,64,36,28
Двапеченька,soulflayer,1724,warrior,fury,54,32,22
Üzzy,dun-modr,1724,warrior,fury,290,168,122
Гигасмэш,greymane,1724,warrior,fury,78,43,35
Balltas,drakthul,1723,warrior,fury,132,67,65
Toptier,drakthul,1722,warrior,fury,83,48,35
Фомори,howling-fjord,1720,warrior,fury,48,30,18
Connorzqt,ravencrest,1720,warrior,fury,42,25,17
Ciuez,tarren-mill,1719,warrior,fury,60,35,25
Cathériné,drakthul,1718,warrior,fury,36,22,14
Emcix,aszune,1718,warrior,fury,72,38,34
Eskiler,burning-legion,1717,warrior,fury,54,30,24
Варынеопэ,gordunni,1717,warrior,fury,65,35,30
Ironmásk,tarren-mill,1716,warrior,fury,42,21,21
Rïmxøxø,haomarush,1715,warrior,fury,60,36,24
Djpuggerino,outland,1715,warrior,fury,74,43,31
Dödgrävarn,stormscale,1714,warrior,fury,142,78,64
Galous,burning-blade,1713,warrior,fury,114,64,50
Silq,zuljin,1713,warrior,fury,36,18,18
Måydåy,twisting-nether,1712,warrior,fury,139,72,67
Chelby,argent-dawn,1711,warrior,fury,36,23,13
Легендор,howling-fjord,1711,warrior,fury,42,26,16
Susugar,ysondre,1711,warrior,fury,120,62,58
Iagô,argent-dawn,1710,warrior,fury,291,152,139
Fluffycute,blackhand,1709,warrior,fury,271,146,125
Vágópityu,ragnaros,1708,warrior,fury,72,39,33
Velcorn,ravencrest,1708,warrior,fury,36,18,18
Koljach,sylvanas,1707,warrior,fury,255,133,122
Станазалол,blackscar,1707,warrior,fury,196,102,94
Ragnaraya,chamber-of-aspects,1707,warrior,fury,128,61,67
Lucywar,ravencrest,1705,warrior,fury,35,19,16
Рэйвисмашина,gordunni,1704,warrior,fury,42,19,23
Athoc,dun-modr,1703,warrior,fury,36,26,10
Çon,ravencrest,1703,warrior,fury,293,151,142
Agoobagoo,alakir,1702,warrior,fury,53,38,15
Crandalius,kazzak,1702,warrior,fury,76,36,40
Klanky,draenor,1700,warrior,fury,98,56,42
Jengaa,draenor,1698,warrior,fury,36,24,12
Agrias,burning-legion,1698,warrior,fury,166,87,79
Тьмасвятая,gordunni,1698,warrior,fury,120,53,67
Wardruine,dun-modr,1697,warrior,fury,71,40,31
Daymio,twisting-nether,1697,warrior,fury,59,31,28
Prestà,archimonde,1696,warrior,fury,120,65,55
Raynhorn,silvermoon,1695,warrior,fury,54,30,24
Bigbugatti,draenor,1695,warrior,fury,83,38,45
Mävïs,ravencrest,1693,warrior,fury,48,30,18
Waegon,twisting-nether,1693,warrior,fury,66,37,29
Honzakesl,drakthul,1693,warrior,fury,93,51,42
Testicouy,archimonde,1692,warrior,fury,36,28,8
Margon,aegwynn,1692,warrior,fury,48,29,19
Slamborghini,twisting-nether,1691,warrior,fury,36,25,11
Большеярости,blackscar,1691,warrior,fury,41,23,18
Incense,silvermoon,1690,warrior,fury,39,21,18
Fúri,turalyon,1689,warrior,fury,48,33,15
Васяжелезо,gordunni,1689,warrior,fury,48,26,22
Yousainsbolt,blackrock,1688,warrior,fury,98,54,44
Футжисубо,razuvious,1688,warrior,fury,198,98,100
Âshnâzgðûr,burning-blade,1688,warrior,fury,129,60,69
Harbee,stormscale,1685,warrior,fury,266,146,120
Aramý,argent-dawn,1684,warrior,fury,29,21,8
Пупссяо,gordunni,1684,warrior,fury,51,33,18
Mômsboy,tarren-mill,1684,warrior,fury,42,23,19
Deadyet,mugthol,1681,warrior,fury,36,23,13
Хуфхорнс,soulflayer,1681,warrior,fury,99,49,50
Магрейн,grom,1680,warrior,fury,408,211,197
Эйримор,gordunni,1679,warrior,fury,191,98,93
Мундэфэндэр,lich-king,1679,warrior,fury,117,59,58
Дейдулус,soulflayer,1678,warrior,fury,54,29,25
Байсал,gordunni,1677,warrior,fury,127,68,59
Wøokz,argent-dawn,1677,warrior,fury,306,158,148
Штурмгешутц,deathweaver,1674,warrior,fury,69,41,28
Даркслеерх,howling-fjord,1674,warrior,fury,36,18,18
Tåÿ,stormscale,1672,warrior,fury,36,22,14
Dontrundie,kazzak,1672,warrior,fury,42,23,19
Архиватор,gordunni,1672,warrior,fury,153,83,70
Xgs,archimonde,1671,warrior,fury,137,74,63
Bobswag,tarren-mill,1670,warrior,fury,72,35,37
Connorzw,blackmoore,1669,warrior,fury,29,20,9
Mélyssia,dalaran,1668,warrior,fury,40,25,15
Даювзадницу,soulflayer,1668,warrior,fury,60,34,26
Kyraxe,silvermoon,1668,warrior,fury,57,31,26
Súbzéro,argent-dawn,1667,warrior,fury,66,36,30
Oowar,burning-legion,1667,warrior,fury,48,26,22
Суицидгодх,howling-fjord,1667,warrior,fury,60,29,31
Alpairx,aegwynn,1667,warrior,fury,107,47,60
Walexmaryk,ragnaros,1666,warrior,fury,161,87,74
Telrion,silvermoon,1666,warrior,fury,48,24,24
Ананаслорд,blackscar,1665,warrior,fury,79,46,33
Абабоба,gordunni,1665,warrior,fury,143,74,69
Dataproffs,outland,1664,warrior,fury,31,19,12
Aleextrasza,silvermoon,1664,warrior,fury,43,24,19
Nuclearrage,outland,1664,warrior,fury,97,53,44
Ironak,malganis,1664,warrior,fury,68,37,31
Берззлой,gordunni,1661,warrior,fury,52,30,22
Yodabär,blackmoore,1661,warrior,fury,144,73,71
Mazzkze,silvermoon,1661,warrior,fury,99,48,51
Suichôken,archimonde,1660,warrior,fury,54,28,26
Biturboo,blackrock,1660,warrior,fury,138,65,73
Brutalizator,talnivarr,1658,warrior,fury,30,19,11
Yfy,outland,1658,warrior,fury,36,22,14
Fullztrap,hyjal,1657,warrior,fury,24,19,5
Ðènlos,destromath,1657,warrior,fury,198,102,96
Táÿ,stormscale,1656,warrior,fury,36,22,14
Heavymetal,tarren-mill,1656,warrior,fury,114,60,54
Azahi,dun-morogh,1656,warrior,fury,57,28,29
Slaycon,sanguino,1656,warrior,fury,87,37,50
Xendyo,frostmourne,1655,warrior,fury,83,51,32
Galenthor,ravencrest,1655,warrior,fury,66,35,31
Hirurg,thrall,1654,warrior,fury,40,22,18
Rottenfall,azjolnerub,1654,warrior,fury,108,58,50
Jokkul,tarren-mill,1652,warrior,fury,36,24,12
Mokate,kazzak,1652,warrior,fury,54,33,21
Broley,blackhand,1652,warrior,fury,118,65,53
Роудс,soulflayer,1652,warrior,fury,42,22,20
Zionto,draenor,1652,warrior,fury,270,131,139
Wgdx,ravencrest,1650,warrior,fury,110,54,56
Темнозорь,ashenvale,1649,warrior,fury,107,55,52
Glupakrava,sylvanas,1647,warrior,fury,36,21,15
Radamantys,drakthul,1646,warrior,fury,93,51,42
Andzone,alakir,1646,warrior,fury,49,23,26
Kerando,tirion,1645,warrior,fury,113,64,49
Zerberos,drakthul,1645,warrior,fury,131,69,62
Вуриор,howling-fjord,1645,warrior,fury,48,25,23
Phalekxox,twisting-nether,1644,warrior,fury,39,22,17
Явараа,howling-fjord,1644,warrior,fury,192,102,90
Dreadoran,voljin,1644,warrior,fury,126,62,64
Xiiver,burning-legion,1643,warrior,fury,60,38,22
Dragonfly,nathrezim,1642,warrior,fury,54,31,23
Projectchad,draenor,1641,warrior,fury,36,23,13
Reider,twisting-nether,1641,warrior,fury,190,99,91
Lepetitwar,hyjal,1641,warrior,fury,124,63,61
Каоссвар,howling-fjord,1641,warrior,fury,48,24,24
Fenzed,hyjal,1641,warrior,fury,60,29,31
Bartins,magtheridon,1640,warrior,fury,117,68,49
Usz,thunderhorn,1639,warrior,fury,114,74,40
Атаир,deathweaver,1638,warrior,fury,42,24,18
Mystylez,silvermoon,1638,warrior,fury,34,19,15
Bloodbath,burning-legion,1637,warrior,fury,42,26,16
Rectangle,blackrock,1636,warrior,fury,52,31,21
Lunätic,sylvanas,1636,warrior,fury,46,27,19
Summerkarma,wildhammer,1636,warrior,fury,137,74,63
Seraphys,ravencrest,1636,warrior,fury,71,38,33
Gromex,stormscale,1636,warrior,fury,120,56,64
Геркавоин,eversong,1635,warrior,fury,84,48,36
Ididntbindit,stormscale,1635,warrior,fury,75,40,35
Berré,ragnaros,1635,warrior,fury,102,54,48
Bananapower,aszune,1635,warrior,fury,125,64,61
Lyriae,argent-dawn,1634,warrior,fury,36,27,9
Bastquirage,dalaran,1633,warrior,fury,42,24,18
Goomby,argent-dawn,1633,warrior,fury,83,42,41
Xiny,blackrock,1632,warrior,fury,79,47,32
Кладбошаа,gordunni,1632,warrior,fury,133,66,67
Yopa,draenor,1632,warrior,fury,110,54,56
Рэкла,grom,1631,warrior,fury,103,59,44
Mulfwarrior,darksorrow,1631,warrior,fury,51,29,22
Megabrux,colinas-pardas,1631,warrior,fury,36,18,18
Ifir,hyjal,1631,warrior,fury,94,45,49
Лимпс,gordunni,1630,warrior,fury,24,17,7
Orkboii,ravencrest,1630,warrior,fury,42,23,19
Криккс,greymane,1630,warrior,fury,166,82,84
Senshin,sanguino,1629,warrior,fury,103,54,49
Littlebugger,ravencrest,1629,warrior,fury,72,35,37
Sanngridr,defias-brotherhood,1629,warrior,fury,66,32,34
Nímera,nemesis,1628,warrior,fury,29,18,11
Astven,blackmoore,1628,warrior,fury,40,21,19
Hasmocaru,silvermoon,1628,warrior,fury,90,46,44
Taeshalach,der-abyssische-rat,1628,warrior,fury,143,72,71
Peli,burning-blade,1628,warrior,fury,228,114,114
Zodiakós,burning-legion,1628,warrior,fury,79,39,40
Agnetta,burning-legion,1628,warrior,fury,120,58,62
Bloodmyst,kazzak,1627,warrior,fury,121,70,51
Zerenaty,antonidas,1627,warrior,fury,36,20,16
Eygón,silvermoon,1627,warrior,fury,174,88,86
Megalann,silvermoon,1627,warrior,fury,84,41,43
Bogié,stormreaver,1626,warrior,fury,42,23,19
Hleljuskoos,hyjal,1625,warrior,fury,30,21,9
Kût,les-sentinelles,1625,warrior,fury,72,41,31
Göttännadåva,stormscale,1625,warrior,fury,72,41,31
Uwansum,bronzebeard,1625,warrior,fury,194,105,89
Faithless,azshara,1625,warrior,fury,88,46,42
Noproblem,ragnaros,1625,warrior,fury,89,45,44
Gantór,blackrock,1625,warrior,fury,84,40,44
Bønecleaver,blackrock,1624,warrior,fury,129,68,61
Taskov,tarren-mill,1624,warrior,fury,78,41,37
Skylexs,burning-legion,1624,warrior,fury,48,22,26
Bóobagodx,tarren-mill,1623,warrior,fury,36,23,13
Swofty,arygos,1622,warrior,fury,24,17,7
Leàn,nemesis,1622,warrior,fury,77,45,32
Philatou,antonidas,1622,warrior,fury,54,31,23
Мамкингерой,howling-fjord,1622,warrior,fury,84,46,38
Hardlokers,silvermoon,1622,warrior,fury,84,46,38
Вульрайс,deepholm,1622,warrior,fury,66,34,32
Mybigcow,darkspear,1622,warrior,fury,81,38,43
Виттурус,howling-fjord,1622,warrior,fury,52,24,28
Тактоядобрый,ashenvale,1622,warrior,fury,53,24,29
Imperiousjr,draenor,1621,warrior,fury,36,22,14
Wrathfül,terokkar,1621,warrior,fury,42,23,19
Zbra,draenor,1621,warrior,fury,220,112,108
Металлие,howling-fjord,1621,warrior,fury,48,21,27
Мигнт,blackscar,1620,warrior,fury,30,17,13
Alkuwaity,outland,1620,warrior,fury,60,33,27
Warriorri,haomarush,1619,warrior,fury,36,21,15
Varøkka,aegwynn,1618,warrior,fury,30,21,9
Tehmountain,ravencrest,1618,warrior,fury,36,22,14
Ðöç,argent-dawn,1618,warrior,fury,30,17,13
Alcathras,doomhammer,1618,warrior,fury,123,63,60
Divinvibra,dalaran,1618,warrior,fury,43,21,22
Ñegan,proudmoore,1618,warrior,fury,36,17,19
Flexbot,blackmoore,1617,warrior,fury,38,23,15
Aler,alakir,1617,warrior,fury,30,17,13
Notvisionary,ravencrest,1617,warrior,fury,40,18,22
Skullsmasher,stormscale,1616,warrior,fury,37,23,14
Cortix,blackmoore,1616,warrior,fury,75,45,30
Popola,ravencrest,1615,warrior,fury,42,23,19
Discølove,frostwolf,1615,warrior,fury,35,19,16
Averenx,frostwolf,1615,warrior,fury,171,86,85
Watrux,outland,1614,warrior,fury,24,17,7
Trollboii,ravencrest,1614,warrior,fury,60,36,24
Нарезаю,blackscar,1614,warrior,fury,36,19,17
Имеравета,gordunni,1613,warrior,fury,30,19,11
Riyan,lothar,1613,warrior,fury,64,33,31
Shará,eredar,1612,warrior,fury,101,58,43
Niklaüs,ysondre,1612,warrior,fury,106,56,50
Unstopablle,twisting-nether,1611,warrior,fury,154,81,73
Xeraaya,kirin-tor,1611,warrior,fury,168,79,89
Dracømort,dalaran,1610,warrior,fury,42,24,18
Monbun,silvermoon,1610,warrior,fury,43,24,19
Baoni,hyjal,1610,warrior,fury,58,30,28
Flippingout,stormscale,1610,warrior,fury,155,76,79
Féélmyfury,tarren-mill,1609,warrior,fury,29,20,9
Søil,tarren-mill,1609,warrior,fury,36,22,14
Nazyna,blackmoore,1609,warrior,fury,172,93,79
Indicaflower,ahnqiraj,1609,warrior,fury,143,75,68
Шлифую,howling-fjord,1609,warrior,fury,72,35,37
Raoh,archimonde,1608,warrior,fury,66,43,23
Ssnakeess,silvermoon,1608,warrior,fury,107,64,43
Flaggerware,stormscale,1608,warrior,fury,134,78,56
Celn,silvermoon,1608,warrior,fury,145,80,65
Дугмар,gordunni,1608,warrior,fury,78,43,35
Æç,argent-dawn,1608,warrior,fury,59,32,27
Едигейй,gordunni,1608,warrior,fury,184,99,85
Moorgoth,ysondre,1608,warrior,fury,60,31,29
Blinkcharge,frostmane,1607,warrior,fury,36,26,10
Pinkíe,blackmoore,1607,warrior,fury,42,21,21
Вадло,soulflayer,1607,warrior,fury,96,47,49
Гацс,soulflayer,1606,warrior,fury,40,23,17
Фурианка,galakrond,1606,warrior,fury,75,40,35
Джоулирэдблу,howling-fjord,1606,warrior,fury,42,22,20
Istenn,stormscale,1606,warrior,fury,42,20,22
Prox,blackrock,1605,warrior,fury,36,21,15
Krathox,kazzak,1605,warrior,fury,30,17,13
Voffsen,tarren-mill,1605,warrior,fury,339,173,166
Гронвер,soulflayer,1604,warrior,fury,194,105,89
Uwuwarrior,alleria,1604,warrior,fury,264,137,127
Certavus,antonidas,1604,warrior,fury,172,89,83
Артен,ashenvale,1604,warrior,fury,145,74,71
Wornag,argent-dawn,1604,warrior,fury,89,44,45
Плотность,howling-fjord,1604,warrior,fury,48,22,26
Árkantos,ravencrest,1603,warrior,fury,24,18,6
Thorazin,deathwing,1603,warrior,fury,30,20,10
Tah,hyjal,1603,warrior,fury,36,20,16
Крагар,soulflayer,1603,warrior,fury,36,19,17
Бубаигавар,gordunni,1603,warrior,fury,48,22,26
Гангстарэпер,gordunni,1602,warrior,fury,60,36,24
Msbrr,blackrock,1602,warrior,fury,68,39,29
Xalont,doomhammer,1602,warrior,fury,66,37,29
Chàrgex,blackrock,1602,warrior,fury,58,30,28
Fraq,tarren-mill,1602,warrior,fury,66,30,36
Pogoyê,blackmoore,1601,warrior,fury,30,17,13
Kalakalle,twisting-nether,1601,warrior,fury,48,18,30
Nihe,stormreaver,1600,warrior,fury,34,21,13
Junjunw,archimonde,1600,warrior,fury,30,17,13
Narukeratnik,draenor,1600,warrior,fury,108,60,48
Bourbimrgllr,hyjal,1600,warrior,fury,45,25,20
Zhenshii,blackmoore,1600,warrior,fury,83,44,39
Vjs,blackhand,1600,warrior,fury,48,24,24
Halfbroken,moonglade,1600,warrior,fury,96,46,50
Ebonheart,argent-dawn,1599,warrior,fury,59,32,27
Мастерион,soulflayer,1599,warrior,fury,48,25,23
Overgear,twisting-nether,1599,warrior,fury,278,142,136
Chisatø,ravencrest,1598,warrior,fury,30,17,13
Spitonem,blackrock,1597,warrior,fury,36,21,15
Khanox,twisting-nether,1597,warrior,fury,47,22,25
Liper,silvermoon,1596,warrior,fury,66,29,37
Rowr,argent-dawn,1595,warrior,fury,90,51,39
Roxxyy,stormreaver,1595,warrior,fury,71,39,32
Madaxe,kazzak,1595,warrior,fury,88,46,42
Oldestglad,stormscale,1595,warrior,fury,36,18,18
Nuijija,stormscale,1594,warrior,fury,84,47,37
Abnôrmus,tarren-mill,1594,warrior,fury,114,53,61
Stronkmon,silvermoon,1593,warrior,fury,60,31,29
Lífelover,tarren-mill,1593,warrior,fury,66,30,36
Ânaxi,silvermoon,1592,warrior,fury,30,19,11
Enzja,nazjatar,1592,warrior,fury,67,39,28
Sodium,pozzo-delleternità,1592,warrior,fury,54,27,27
Creativenot,outland,1591,warrior,fury,76,40,36
Warorc,eredar,1591,warrior,fury,66,33,33
Shalahed,outland,1591,warrior,fury,42,20,22
Chillycheesy,blackmoore,1590,warrior,fury,30,17,13
Аскагорт,soulflayer,1590,warrior,fury,30,17,13
Cazaril,kazzak,1590,warrior,fury,60,29,31
Perinel,draenor,1590,warrior,fury,202,95,107
Velgrim,ravencrest,1589,warrior,fury,62,35,27
Bloodwatchêr,kazzak,1589,warrior,fury,54,29,25
Bosniakk,ravencrest,1589,warrior,fury,221,118,103
Kåïdø,ravencrest,1588,warrior,fury,48,30,18
Azazelslayer,dethecus,1587,warrior,fury,77,47,30
Stérkkû,stormscale,1587,warrior,fury,306,151,155
Børomir,silvermoon,1586,warrior,fury,125,67,58
Nocturia,archimonde,1585,warrior,fury,50,30,20
Savarøx,blackmoore,1585,warrior,fury,48,28,20
Alexandrrior,rexxar,1585,warrior,fury,93,54,39
Teljii,blackmoore,1585,warrior,fury,102,57,45
Vallahan,argent-dawn,1585,warrior,fury,196,106,90
Råzor,blackhand,1585,warrior,fury,264,138,126
Níká,bronzebeard,1585,warrior,fury,145,74,71
Bobitybob,ravencrest,1584,warrior,fury,111,64,47
Duarel,blackmoore,1583,warrior,fury,47,26,21
Mörkölä,ravencrest,1583,warrior,fury,40,22,18
Waralert,kazzak,1583,warrior,fury,42,21,21
Teliese,argent-dawn,1581,warrior,fury,30,20,10
Spokowar,hyjal,1581,warrior,fury,97,50,47
Латахо,gordunni,1581,warrior,fury,85,43,42
Kaîus,blackrock,1581,warrior,fury,60,26,34
Вундеркитти,soulflayer,1580,warrior,fury,140,71,69
Imondiet,ragnaros,1579,warrior,fury,30,18,12
Синнэр,blackscar,1579,warrior,fury,66,33,33
Arthagore,archimonde,1579,warrior,fury,48,23,25
Ёнморт,gordunni,1578,warrior,fury,50,27,23
Nozuki,archimonde,1578,warrior,fury,249,131,118
Orwarrio,thrall,1577,warrior,fury,42,20,22
Genç,ysondre,1576,warrior,fury,77,46,31
Roxxón,teldrassil,1576,warrior,fury,53,27,26
Cyruk,blackmoore,1576,warrior,fury,114,58,56
Noriela,archimonde,1575,warrior,fury,30,17,13
Thorgaz,blackmoore,1574,warrior,fury,60,35,25
Нордгаар,howling-fjord,1574,warrior,fury,92,53,39
Raizy,frostwolf,1574,warrior,fury,69,38,31
Dævedoff,sanguino,1574,warrior,fury,161,85,76
Esrinx,the-maelstrom,1574,warrior,fury,36,19,17
Инфлэймх,gordunni,1574,warrior,fury,48,24,24
Udig,twisting-nether,1573,warrior,fury,70,45,25
Titza,silvermoon,1573,warrior,fury,132,60,72
Justsquat,twisting-nether,1572,warrior,fury,109,63,46
Killhound,argent-dawn,1572,warrior,fury,42,21,21
Nitheriá,draenor,1571,warrior,fury,36,20,16
Asmoche,archimonde,1571,warrior,fury,72,35,37
Horovoko,kazzak,1570,warrior,fury,40,26,14
Grâkul,twisting-nether,1570,warrior,fury,589,301,288
Valkyvia,sylvanas,1569,warrior,fury,30,17,13
Асау,ashenvale,1569,warrior,fury,232,122,110
Miko,ysondre,1569,warrior,fury,66,31,35
Dárkhammer,tarren-mill,1568,warrior,fury,64,36,28
Broxshar,shendralar,1568,warrior,fury,42,21,21
Гаррим,blackscar,1568,warrior,fury,73,34,39
Warmâchine,burning-legion,1567,warrior,fury,106,61,45
Fattysw,argent-dawn,1567,warrior,fury,81,43,38
Zupkaztrópka,burning-legion,1567,warrior,fury,150,76,74
Krøn,stormscale,1566,warrior,fury,107,66,41
Читора,blackscar,1566,warrior,fury,143,70,73
Unqlolz,kazzak,1566,warrior,fury,39,19,20
Krigerhans,ravencrest,1565,warrior,fury,42,24,18
Иктиннос,gordunni,1565,warrior,fury,57,21,36
Garlogar,twisting-nether,1564,warrior,fury,138,75,63
Вимор,soulflayer,1563,warrior,fury,183,92,91
Daxarian,twisting-nether,1563,warrior,fury,44,19,25
Касюлин,gordunni,1562,warrior,fury,53,31,22
Qiz,silvermoon,1562,warrior,fury,208,110,98
Вменяемый,gordunni,1562,warrior,fury,112,57,55
Dirtyjoe,khaz-modan,1561,warrior,fury,81,46,35
Izurritea,tarren-mill,1561,warrior,fury,48,24,24
Jinrok,turalyon,1559,warrior,fury,141,78,63
Dríx,hyjal,1557,warrior,fury,30,19,11
Bordi,nemesis,1557,warrior,fury,54,28,26
Beinis,twisting-nether,1557,warrior,fury,57,29,28
Swayzze,frostwolf,1557,warrior,fury,84,42,42
Bennybryt,frostmane,1557,warrior,fury,84,40,44
Bobshaggins,stormscale,1557,warrior,fury,36,17,19
Тралмош,razuvious,1556,warrior,fury,93,52,41
Чиллх,gordunni,1556,warrior,fury,175,93,82
Carmino,khazgoroth,1556,warrior,fury,83,43,40
Methodxd,outland,1556,warrior,fury,84,40,44
Bursch,ravencrest,1555,warrior,fury,90,44,46
Beanzz,blackmoore,1554,warrior,fury,30,19,11
Dikata,stormscale,1553,warrior,fury,82,49,33
Takagødx,archimonde,1553,warrior,fury,36,19,17
Jiñnx,outland,1552,warrior,fury,29,17,12
Агтеррокк,deathweaver,1552,warrior,fury,36,19,17
Неуно,howling-fjord,1550,warrior,fury,72,42,30
Shadowfiend,argent-dawn,1550,warrior,fury,54,30,24
Discordîan,twisting-nether,1549,warrior,fury,54,31,23
Ahaks,draenor,1548,warrior,fury,68,36,32
Kiljhimari,twisting-nether,1548,warrior,fury,68,35,33
Лаинвуд,soulflayer,1547,warrior,fury,87,47,40
Варрвик,howling-fjord,1547,warrior,fury,109,56,53
Anabolika,stormrage,1546,warrior,fury,36,22,14
Saîx,garrosh,1546,warrior,fury,703,365,338
Разплюхан,gordunni,1546,warrior,fury,66,33,33
Cêlty,aegwynn,1546,warrior,fury,155,77,78
Crazykind,kazzak,1546,warrior,fury,42,20,22
Zwareboy,frostmane,1546,warrior,fury,48,20,28
Plackø,draenor,1545,warrior,fury,292,149,143
Димасфури,howling-fjord,1544,warrior,fury,63,34,29
Shedzo,tarren-mill,1544,warrior,fury,42,20,22
Mash,hyjal,1543,warrior,fury,60,36,24
Reapo,blackhand,1543,warrior,fury,107,60,47
Eleborn,tarren-mill,1543,warrior,fury,106,57,49
Groll,aegwynn,1543,warrior,fury,36,17,19
Hejduk,frostmane,1542,warrior,fury,75,43,32
Vatolocoese,dun-morogh,1542,warrior,fury,45,24,21
Богадорога,howling-fjord,1542,warrior,fury,38,20,18
Sköldpaddor,tarren-mill,1542,warrior,fury,88,44,44
Áwe,draenor,1541,warrior,fury,97,53,44
Krilza,terrordar,1541,warrior,fury,61,32,29
Baluste,culte-de-la-rive-noire,1541,warrior,fury,96,49,47
Satabasse,marécage-de-zangar,1541,warrior,fury,50,25,25
Krauus,silvermoon,1540,warrior,fury,155,87,68
Cianna,silvermoon,1539,warrior,fury,36,23,13
Gronos,silvermoon,1539,warrior,fury,128,67,61
Bäiley,drakthul,1538,warrior,fury,78,31,47
Blaktarr,dunemaul,1537,warrior,fury,115,62,53
Theolcostaud,archimonde,1537,warrior,fury,42,17,25
Myrîna,zuluhed,1536,warrior,fury,66,36,30
Jezsov,ravencrest,1536,warrior,fury,66,29,37
Азаргатан,soulflayer,1535,warrior,fury,54,30,24
Tbones,kazzak,1535,warrior,fury,112,49,63
Trixwar,ragnaros,1534,warrior,fury,33,18,15
Thorken,ragnaros,1534,warrior,fury,89,43,46
Илийя,razuvious,1533,warrior,fury,65,28,37
Белославный,gordunni,1532,warrior,fury,55,38,17
Hynish,doomhammer,1532,warrior,fury,115,59,56
ßbç,ysondre,1532,warrior,fury,84,41,43
Bigbibbs,tarren-mill,1531,warrior,fury,158,77,81
Héraclès,ravencrest,1531,warrior,fury,42,20,22
Itchiiz,alonsus,1530,warrior,fury,82,46,36
Miz,dun-modr,1529,warrior,fury,52,33,19
Exzecute,outland,1529,warrior,fury,66,40,26
Fantol,stormscale,1529,warrior,fury,48,27,21
Antismoke,silvermoon,1529,warrior,fury,165,85,80
Totheside,blackrock,1529,warrior,fury,53,27,26
Trôth,kazzak,1528,warrior,fury,24,16,8
Gaiuscaesar,stormscale,1528,warrior,fury,27,17,10
Griffar,malorne,1528,warrior,fury,87,43,44
Веоленс,gordunni,1527,warrior,fury,22,17,5
Jorund,archimonde,1527,warrior,fury,89,45,44
Qweoamsd,sylvanas,1526,warrior,fury,36,20,16
Woghard,drakthul,1526,warrior,fury,54,27,27
Bigbannerhoe,blackmoore,1525,warrior,fury,76,44,32
Cocojumbo,azuremyst,1525,warrior,fury,138,73,65
Nokla,kazzak,1525,warrior,fury,56,26,30
Белхэнд,soulflayer,1524,warrior,fury,36,19,17
Nonow,silvermoon,1524,warrior,fury,58,26,32
Fürchtenix,blackmoore,1523,warrior,fury,54,30,24
Workout,nemesis,1523,warrior,fury,35,19,16
Skarsnaga,tarren-mill,1523,warrior,fury,54,28,26
Kaazzuraa,hyjal,1522,warrior,fury,48,26,22
Добиватель,howling-fjord,1522,warrior,fury,140,75,65
Biscuitoliva,hyjal,1522,warrior,fury,42,22,20
Mïîäm,archimonde,1521,warrior,fury,51,29,22
Hemèra,hyjal,1521,warrior,fury,103,53,50
Jeronimoe,blackmoore,1520,warrior,fury,41,24,17
Wowbert,frostwolf,1520,warrior,fury,54,30,24
Stupidguy,garrosh,1520,warrior,fury,53,29,24
Gachiwarri,blackhand,1520,warrior,fury,48,25,23
Рекиро,blackscar,1520,warrior,fury,47,24,23
Syfér,grim-batol,1519,warrior,fury,94,54,40
Cleaner,blackmoore,1519,warrior,fury,44,23,21
Mirpz,doomhammer,1519,warrior,fury,47,24,23
Baldmano,twisting-nether,1518,warrior,fury,54,30,24
Uncontested,argent-dawn,1518,warrior,fury,46,25,21
Гопниг,deepholm,1518,warrior,fury,70,38,32
Platinpunch,kazzak,1518,warrior,fury,53,26,27
Креспекс,gordunni,1518,warrior,fury,43,20,23
Halalmeat,minahonda,1518,warrior,fury,71,32,39
Baldemort,antonidas,1517,warrior,fury,217,113,104
Khosn,ravencrest,1516,warrior,fury,87,44,43
Cromvi,draenor,1515,warrior,fury,78,39,39
Wärfäcë,blades-edge,1513,warrior,fury,118,68,50
Чпонькмашина,soulflayer,1513,warrior,fury,152,85,67
Zwecko,malganis,1513,warrior,fury,30,16,14
Raicho,dentarg,1513,warrior,fury,36,18,18
Сариату,soulflayer,1513,warrior,fury,102,47,55
Ðeadyet,mugthol,1512,warrior,fury,30,16,14
Worgenalpha,garona,1511,warrior,fury,30,20,10
Skillclapped,ravencrest,1511,warrior,fury,38,21,17
Давдейт,howling-fjord,1511,warrior,fury,63,31,32
Karentneuf,khaz-modan,1510,warrior,fury,41,25,16
Pokopo,blackrock,1510,warrior,fury,42,23,19
Wärlør,ravencrest,1509,warrior,fury,78,49,29
Gollyboy,ravencrest,1509,warrior,fury,66,33,33
Bronix,blackrock,1509,warrior,fury,67,30,37
Втораянатура,howling-fjord,1508,warrior,fury,36,22,14
Deeper,twisting-nether,1508,warrior,fury,84,47,37
Toundrâa,archimonde,1508,warrior,fury,215,111,104
Ravenpaw,burning-legion,1507,warrior,fury,36,27,9
Gamöra,kirin-tor,1507,warrior,fury,104,59,45
Orcoddio,kazzak,1507,warrior,fury,66,34,32
Màlt,hyjal,1507,warrior,fury,46,20,26
Fromagekipue,draenor,1506,warrior,fury,110,59,51
Нириэла,howling-fjord,1506,warrior,fury,114,60,54
Адлайг,soulflayer,1506,warrior,fury,58,29,29
Gabbz,aggra-português,1506,warrior,fury,63,29,34
Warthur,silvermoon,1505,warrior,fury,60,32,28
Bravestarrz,ungoro,1505,warrior,fury,194,98,96
Книфэк,howling-fjord,1504,warrior,fury,43,30,13
Notajinx,ravencrest,1504,warrior,fury,36,21,15
Oravedenes,draenor,1504,warrior,fury,301,162,139
Деимосин,howling-fjord,1504,warrior,fury,93,49,44
Truckfury,ravencrest,1504,warrior,fury,88,46,42
Roidspam,outland,1504,warrior,fury,76,32,44
Dizzyndumb,draenor,1503,warrior,fury,171,93,78
Gromaak,draenor,1503,warrior,fury,66,32,34
Мурмадонио,soulflayer,1503,warrior,fury,78,35,43
Grumpy,lightbringer,1502,warrior,fury,50,33,17
Rëvenge,burning-legion,1502,warrior,fury,147,75,72
Maruma,frostwolf,1501,warrior,fury,24,16,8
Souler,burning-legion,1501,warrior,fury,42,24,18
Jarggyül,culte-de-la-rive-noire,1500,warrior,fury,36,21,15
Schuy,silvermoon,1500,warrior,fury,108,61,47
Krigarjag,kazzak,1499,warrior,fury,109,64,45
Пыпыса,gordunni,1499,warrior,fury,61,29,32
Тегриско,goldrinn,1499,warrior,fury,120,57,63
Crriminal,ravencrest,1498,warrior,fury,24,16,8
Divyx,tarren-mill,1498,warrior,fury,113,59,54
Clapkar,antonidas,1498,warrior,fury,72,35,37
Sebastian,ravencrest,1498,warrior,fury,60,29,31
Ranmaru,kazzak,1498,warrior,fury,133,61,72
Kestialezin,archimonde,1497,warrior,fury,80,50,30
Darvi,burning-legion,1497,warrior,fury,48,26,22
Mezen,stormscale,1497,warrior,fury,135,70,65
Zenìa,argent-dawn,1495,warrior,fury,76,45,31
Pacosky,burning-legion,1495,warrior,fury,99,53,46
Gely,silvermoon,1495,warrior,fury,30,16,14
Stratoz,ragnaros,1495,warrior,fury,67,31,36
Neoni,defias-brotherhood,1495,warrior,fury,36,16,20
Mvi,frostmane,1494,warrior,fury,104,56,48
Røronøa,hyjal,1494,warrior,fury,99,53,46
Jilias,blackrock,1494,warrior,fury,49,26,23
Zaithironwar,tarren-mill,1493,warrior,fury,43,24,19
Vexxenn,outland,1493,warrior,fury,58,32,26
Лазба,gordunni,1493,warrior,fury,58,31,27
Баджераа,soulflayer,1493,warrior,fury,88,44,44
Evrybodydown,draenor,1492,warrior,fury,148,77,71
Axislips,draenor,1492,warrior,fury,59,28,31
Erosdulko,silvermoon,1492,warrior,fury,66,29,37
Ramhadat,hyjal,1490,warrior,fury,42,24,18
Forerunner,silvermoon,1490,warrior,fury,42,22,20
Youups,twisting-nether,1490,warrior,fury,75,38,37
Nemecic,arathor,1490,warrior,fury,95,48,47
Conanh,pozzo-delleternità,1490,warrior,fury,60,29,31
Klasiùs,outland,1490,warrior,fury,52,23,29
Noout,elune,1489,warrior,fury,60,33,27
Gypsykìng,darksorrow,1489,warrior,fury,50,27,23
Tsé,aegwynn,1489,warrior,fury,42,20,22
Jodocus,arygos,1489,warrior,fury,40,19,21
Cemule,doomhammer,1488,warrior,fury,90,49,41
ßloodz,hyjal,1488,warrior,fury,39,20,19
Traez,tarren-mill,1488,warrior,fury,145,73,72
Груббоб,booty-bay,1488,warrior,fury,152,76,76
Fizzywarrior,blackmoore,1488,warrior,fury,60,29,31
Лимор,howling-fjord,1488,warrior,fury,42,16,26
Fatspacka,argent-dawn,1487,warrior,fury,38,18,20
Letzgo,ravencrest,1486,warrior,fury,30,17,13
Вардеспетчер,razuvious,1486,warrior,fury,153,83,70
Rommick,guldan,1486,warrior,fury,96,49,47
Хёда,eversong,1486,warrior,fury,108,52,56
Штормскейл,soulflayer,1485,warrior,fury,42,24,18
Corrin,frostmourne,1485,warrior,fury,134,74,60
Varyian,sporeggar,1485,warrior,fury,393,203,190
Nerfslam,stormscale,1485,warrior,fury,34,17,17
Ууша,soulflayer,1485,warrior,fury,59,29,30
Sonczo,defias-brotherhood,1485,warrior,fury,36,16,20
Oyrojan,blackmoore,1484,warrior,fury,88,52,36
Raoh,blackrock,1484,warrior,fury,36,21,15
Freddie,baelgun,1484,warrior,fury,48,26,22
Акурра,gordunni,1484,warrior,fury,73,38,35
Rimvar,alleria,1484,warrior,fury,60,28,32
Carljøhnson,dalaran,1483,warrior,fury,78,45,33
Zeliøn,elune,1483,warrior,fury,173,95,78
Kyorengoku,antonidas,1483,warrior,fury,64,32,32
Undeadboii,ravencrest,1483,warrior,fury,34,17,17
Thagzar,burning-legion,1483,warrior,fury,217,107,110
Grimic,quelthalas,1483,warrior,fury,45,18,27
Slidmacka,twisting-nether,1482,warrior,fury,48,28,20
Graxn,blackhand,1482,warrior,fury,245,128,117
Thezug,twisting-nether,1482,warrior,fury,66,32,34
Warsteng,ragnaros,1481,warrior,fury,99,52,47
Gids,silvermoon,1479,warrior,fury,52,29,23
Hofmanntv,alakir,1479,warrior,fury,90,45,45
Акози,fordragon,1478,warrior,fury,96,56,40
Kazzim,blackmoore,1478,warrior,fury,73,39,34
Ðønøvan,sanguino,1478,warrior,fury,139,72,67
Tweegles,argent-dawn,1478,warrior,fury,179,89,90
Shadowcacau,aggra-português,1477,warrior,fury,248,127,121
Jeepzinc,blackmoore,1476,warrior,fury,72,32,40
Даарак,gordunni,1474,warrior,fury,62,30,32
Hexj,tarren-mill,1473,warrior,fury,46,24,22
Арристокррат,soulflayer,1473,warrior,fury,105,53,52
Ärmodäuss,norgannon,1473,warrior,fury,81,40,41
Lilrâge,doomhammer,1473,warrior,fury,54,24,30
Zân,stormscale,1470,warrior,fury,48,29,19
Sorryforwhat,stormscale,1469,warrior,fury,64,34,30
Straya,malorne,1469,warrior,fury,72,37,35
Ruzbie,silvermoon,1469,warrior,fury,90,43,47
Dasyana,drakthul,1468,warrior,fury,60,35,25
Ganas,drakthul,1468,warrior,fury,32,17,15
Bukisan,sylvanas,1467,warrior,fury,119,61,58
Ochocinco,quelthalas,1467,warrior,fury,135,68,67
Седунг,gordunni,1467,warrior,fury,61,30,31
Nighat,sanguino,1466,warrior,fury,111,66,45
Kytee,draenor,1466,warrior,fury,65,33,32
Raoh,malganis,1466,warrior,fury,101,48,53
Nurti,silvermoon,1465,warrior,fury,36,21,15
Rakherus,silvermoon,1465,warrior,fury,78,42,36
Búlldozér,kazzak,1465,warrior,fury,111,55,56
Dasdabane,twisting-nether,1464,warrior,fury,154,79,75
Èrzà,sanguino,1464,warrior,fury,251,127,124
Blayr,tarren-mill,1464,warrior,fury,41,20,21
Otiep,blackmoore,1464,warrior,fury,52,25,27
Deadlyanger,kazzak,1464,warrior,fury,44,18,26
Mustar,alexstrasza,1463,warrior,fury,100,57,43
Mentálist,blackmoore,1463,warrior,fury,69,34,35
Utero,drakthul,1462,warrior,fury,36,19,17
Chrissey,argent-dawn,1462,warrior,fury,45,21,24
Astoch,outland,1462,warrior,fury,74,29,45
Xtu,kazzak,1461,warrior,fury,33,20,13
Hrodulf,moonglade,1461,warrior,fury,83,38,45
Akînos,kazzak,1460,warrior,fury,99,50,49
Broksigarr,ragnaros,1460,warrior,fury,78,39,39
Horymir,ravencrest,1460,warrior,fury,39,17,22
Xanatos,khazgoroth,1459,warrior,fury,46,24,22
Екзобайт,gordunni,1458,warrior,fury,29,18,11
Drekh,kazzak,1458,warrior,fury,54,26,28
Zaximos,twisting-nether,1458,warrior,fury,80,38,42
Kobeni,ysondre,1457,warrior,fury,50,30,20
Gensur,skullcrusher,1457,warrior,fury,177,96,81
Hidaykus,bronzebeard,1457,warrior,fury,124,65,59
Irondahr,silvermoon,1455,warrior,fury,48,21,27
Histe,thrall,1454,warrior,fury,60,34,26
Skaurmosh,draenor,1454,warrior,fury,113,62,51
Pistolpenny,stormscale,1454,warrior,fury,39,19,20
Boadicèe,archimonde,1453,warrior,fury,29,17,12
Faylania,tarren-mill,1453,warrior,fury,88,49,39
Lyfttokyo,tarren-mill,1453,warrior,fury,94,50,44
Dranosha,nemesis,1453,warrior,fury,51,24,27
Orengo,blackrock,1452,warrior,fury,78,50,28
Спайкуссь,goldrinn,1452,warrior,fury,149,79,70
Rum,talnivarr,1452,warrior,fury,114,59,55
Timmessenger,draenor,1451,warrior,fury,41,24,17
Kriticah,sanguino,1451,warrior,fury,42,23,19
Bigrooster,argent-dawn,1451,warrior,fury,177,95,82
Ходячийвар,gordunni,1451,warrior,fury,57,29,28
Меняло,fordragon,1450,warrior,fury,96,53,43
Vanheimsgard,ragnaros,1450,warrior,fury,60,31,29
Оркнарос,soulflayer,1449,warrior,fury,68,38,30
Aeyon,burning-blade,1449,warrior,fury,37,17,20
Buzzingorc,tarren-mill,1448,warrior,fury,107,62,45
Zugbro,stormscale,1448,warrior,fury,84,43,41
Doronas,der-rat-von-dalaran,1448,warrior,fury,42,21,21
Kagsteelfist,twisting-nether,1447,warrior,fury,29,16,13
Arturdayne,sanguino,1447,warrior,fury,70,38,32
Vegilhenvin,stormscale,1447,warrior,fury,151,81,70
Èscøbar,dalaran,1447,warrior,fury,61,29,32
Buffury,twisting-nether,1446,warrior,fury,48,30,18
Sunzí,alakir,1446,warrior,fury,48,24,24
Leapmaster,blackrock,1445,warrior,fury,57,29,28
Beogor,grim-batol,1445,warrior,fury,41,16,25
Grahatia,magtheridon,1444,warrior,fury,84,46,38
Gìlgamesh,dun-modr,1444,warrior,fury,55,30,25
Vandalismee,draenor,1443,warrior,fury,28,19,9
Honör,sylvanas,1443,warrior,fury,82,41,41
Зэрок,howling-fjord,1443,warrior,fury,42,21,21
Хастонер,howling-fjord,1442,warrior,fury,54,29,25
Фузо,gordunni,1442,warrior,fury,78,40,38
Трафалльгар,gordunni,1442,warrior,fury,56,27,29
Kllinac,kazzak,1440,warrior,fury,114,65,49
Throck,drakthul,1440,warrior,fury,66,36,30
Аканок,soulflayer,1440,warrior,fury,38,18,20
Dajnatarcze,burning-legion,1439,warrior,fury,48,25,23
Stahlhund,silvermoon,1439,warrior,fury,140,69,71
Blizo,tarren-mill,1438,warrior,fury,24,15,9
Franzbardon,archimonde,1438,warrior,fury,121,61,60
Filira,silvermoon,1437,warrior,fury,66,36,30
Grubshak,burning-legion,1437,warrior,fury,100,48,52
Shostka,draenor,1435,warrior,fury,46,29,17
Babb,kazzak,1435,warrior,fury,24,15,9
Скехит,blackscar,1435,warrior,fury,144,71,73
Artheim,silvermoon,1435,warrior,fury,84,37,47
Swàck,mazrigos,1434,warrior,fury,46,26,20
Ксапур,soulflayer,1434,warrior,fury,76,42,34
Shabir,sylvanas,1434,warrior,fury,222,115,107
Chidòri,tarren-mill,1434,warrior,fury,53,22,31
Варгуш,ashenvale,1434,warrior,fury,47,17,30
Bloodyedge,sanguino,1433,warrior,fury,134,68,66
Lathsmash,zenedar,1433,warrior,fury,36,18,18
Bigpapapap,kazzak,1433,warrior,fury,93,39,54
Skîêl,archimonde,1433,warrior,fury,36,15,21
Rheinart,nemesis,1433,warrior,fury,83,32,51
Roronoâ,twisting-nether,1432,warrior,fury,22,16,6
Floppikatten,kazzak,1432,warrior,fury,24,17,7
Alegral,ravencrest,1432,warrior,fury,24,15,9
Deviles,nemesis,1432,warrior,fury,42,19,23
Dírectdash,draenor,1432,warrior,fury,59,26,33
Wätras,drakthul,1431,warrior,fury,30,16,14
Gromrigg,draenor,1431,warrior,fury,148,71,77
Ulvenpeter,ravencrest,1431,warrior,fury,96,46,50
Jeonsoyeon,argent-dawn,1431,warrior,fury,43,16,27
Сонечко,galakrond,1430,warrior,fury,42,21,21
Makote,uldum,1429,warrior,fury,27,16,11
Føxis,aegwynn,1428,warrior,fury,22,16,6
Howdoyouløse,stormscale,1428,warrior,fury,24,15,9
Mikogød,ravencrest,1428,warrior,fury,140,72,68
Andjuu,doomhammer,1428,warrior,fury,139,62,77
Fridaax,lightbringer,1427,warrior,fury,24,15,9
Labodor,blackhand,1426,warrior,fury,75,43,32
Dayz,draenor,1426,warrior,fury,30,15,15
Tf,kazzak,1426,warrior,fury,78,32,46
Taei,argent-dawn,1425,warrior,fury,48,27,21
Каган,gordunni,1425,warrior,fury,99,54,45
Болтегар,soulflayer,1425,warrior,fury,89,48,41
Микермат,howling-fjord,1425,warrior,fury,134,66,68
Мастерпве,blackscar,1425,warrior,fury,36,17,19
Ellissari,tirion,1425,warrior,fury,53,25,28
Mamox,archimonde,1424,warrior,fury,73,39,34
Bördz,blackhand,1424,warrior,fury,108,55,53
Amagaddon,draenor,1424,warrior,fury,41,19,22
Fortressa,ravencrest,1424,warrior,fury,60,26,34
Лордэнгри,howling-fjord,1424,warrior,fury,65,28,37
Dènethor,draenor,1423,warrior,fury,134,73,61
Craghak,twisting-nether,1423,warrior,fury,184,92,92
Brainbug,drakthul,1423,warrior,fury,36,17,19
Paynzx,blackrock,1422,warrior,fury,25,16,9
Stormboltjk,blackrock,1422,warrior,fury,24,15,9
Elénir,dalaran,1422,warrior,fury,120,64,56
Sindrener,ysondre,1422,warrior,fury,30,15,15
Shurubel,outland,1422,warrior,fury,36,17,19
Pinkvae,doomhammer,1422,warrior,fury,47,22,25
Touguro,aggra-português,1422,warrior,fury,57,26,31
Gîdra,stormscale,1421,warrior,fury,24,15,9
Где,blackscar,1421,warrior,fury,24,15,9
Haewon,burning-legion,1421,warrior,fury,96,52,44
Golward,grim-batol,1421,warrior,fury,74,40,34
Tyrâdus,kiljaeden,1421,warrior,fury,126,66,60
Соджиро,howling-fjord,1421,warrior,fury,30,15,15
Текайко,eversong,1421,warrior,fury,39,19,20
Hjondon,argent-dawn,1421,warrior,fury,78,36,42
Fuur,drakthul,1421,warrior,fury,55,22,33
Tatabaf,ysondre,1420,warrior,fury,60,32,28
Тестостеронх,soulflayer,1419,warrior,fury,24,15,9
Slaktârn,ragnaros,1419,warrior,fury,87,46,41
Ørkk,pozzo-delleternità,1419,warrior,fury,54,27,27
Анакронокс,howling-fjord,1419,warrior,fury,112,54,58
Enderyx,blackhand,1418,warrior,fury,137,69,68
Hatefull,onyxia,1418,warrior,fury,46,20,26
Fishaco,frostwhisper,1417,warrior,fury,24,15,9
Orcarinté,draenor,1417,warrior,fury,59,26,33
Luunk,ravencrest,1416,warrior,fury,90,48,42
Thehans,grim-batol,1416,warrior,fury,198,103,95
Альмас,galakrond,1416,warrior,fury,107,49,58
Prîde,kazzak,1415,warrior,fury,72,41,31
Sebotagelol,twisting-nether,1415,warrior,fury,54,29,25
Massiveape,argent-dawn,1415,warrior,fury,36,15,21
Sway,eonar,1414,warrior,fury,336,176,160
Rîiper,ysondre,1414,warrior,fury,48,24,24
Bluemango,ragnaros,1414,warrior,fury,60,29,31
Léonie,arakarahm,1414,warrior,fury,36,15,21
Vhargdrohpee,argent-dawn,1414,warrior,fury,53,22,31
Kragar,anetheron,1413,warrior,fury,57,34,23
Ederes,silvermoon,1412,warrior,fury,36,18,18
Naazwar,stormscale,1412,warrior,fury,30,15,15
Sasorí,blackrock,1412,warrior,fury,42,19,23
Hobbó,draenor,1411,warrior,fury,159,74,85
Painswift,blackhand,1410,warrior,fury,60,28,32
Жироштемп,gordunni,1409,warrior,fury,120,58,62
Inelegant,tarren-mill,1409,warrior,fury,36,17,19
Jokis,dun-modr,1409,warrior,fury,42,19,23
Rèckless,argent-dawn,1408,warrior,fury,35,25,10
Вайрон,blackscar,1408,warrior,fury,108,52,56
Achérus,varimathras,1407,warrior,fury,80,37,43
Sonyd,tarren-mill,1406,warrior,fury,42,25,17
Bigmercy,ragnaros,1406,warrior,fury,66,39,27
Jamesclarke,silvermoon,1406,warrior,fury,66,29,37
Hellocritty,blackmoore,1405,warrior,fury,24,15,9
Atlizz,twisting-nether,1405,warrior,fury,30,15,15
Ènma,ravencrest,1405,warrior,fury,96,46,50
Fullepixx,outland,1405,warrior,fury,58,23,35
Maclaine,ravencrest,1404,warrior,fury,48,30,18
Антурим,howling-fjord,1404,warrior,fury,40,21,19
Oesche,frostmourne,1404,warrior,fury,30,15,15
Gamepresa,silvermoon,1404,warrior,fury,67,33,34
Shán,defias-brotherhood,1403,warrior,fury,78,43,35
Nmwar,turalyon,1403,warrior,fury,51,28,23
Rìsàs,draenor,1403,warrior,fury,180,89,91
Warrouner,khaz-modan,1403,warrior,fury,144,71,73
Torok,antonidas,1402,warrior,fury,36,25,11
Борзило,howling-fjord,1402,warrior,fury,36,21,15
Rarrio,kazzak,1402,warrior,fury,54,27,27
Sabijach,kazzak,1402,warrior,fury,30,15,15
Betonica,burning-legion,1402,warrior,fury,72,33,39
Profär,archimonde,1402,warrior,fury,48,22,26
Thrallhall,kazzak,1402,warrior,fury,182,81,101
Проводникдуш,gordunni,1402,warrior,fury,78,32,46
Virgolibra,grim-batol,1401,warrior,fury,55,23,32
Snakewins,stormscale,1400,warrior,fury,29,18,11
Бьернтрел,gordunni,1400,warrior,fury,105,61,44
Развалочка,howling-fjord,1400,warrior,fury,41,21,20
Dorya,aegwynn,1400,warrior,fury,42,21,21
Auglok,twisting-nether,1400,warrior,fury,173,85,88
Bouafia,archimonde,1400,warrior,fury,47,23,24
Thørïn,dun-modr,1400,warrior,fury,36,16,20
Bergthora,antonidas,1399,warrior,fury,48,28,20
Fükz,ysondre,1399,warrior,fury,30,15,15
Inflacija,grim-batol,1399,warrior,fury,42,15,27
Midvînter,silvermoon,1397,warrior,fury,87,41,46
Elayjaa,twisting-nether,1396,warrior,fury,48,26,22
Harmstring,twisting-nether,1396,warrior,fury,63,30,33
Nellyqt,draenor,1396,warrior,fury,81,38,43
Smackaroon,draenor,1395,warrior,fury,28,16,12
Alevucerdaa,draenor,1395,warrior,fury,71,37,34
Buddysnaax,ravencrest,1395,warrior,fury,42,18,24
Goblinussy,silvermoon,1394,warrior,fury,46,17,29
Thaddaus,ravencrest,1393,warrior,fury,183,90,93
Thodak,blackrock,1393,warrior,fury,48,17,31
Bellzter,outland,1392,warrior,fury,91,50,41
Дизроуз,gordunni,1392,warrior,fury,92,50,42
Ój,ravencrest,1392,warrior,fury,60,24,36
Ðèxs,ravencrest,1390,warrior,fury,36,23,13
Raaoo,blackmoore,1390,warrior,fury,72,32,40
Facepálm,kazzak,1389,warrior,fury,24,15,9
Ikkr,kazzak,1389,warrior,fury,114,60,54
Keriane,garona,1389,warrior,fury,65,33,32
Gàbrânth,frostwolf,1389,warrior,fury,78,37,41
Tandrall,rexxar,1388,warrior,fury,36,15,21
Cáylin,amanthul,1387,warrior,fury,68,29,39
Chadgarrosh,tarren-mill,1387,warrior,fury,77,30,47
Dgyfh,dun-morogh,1386,warrior,fury,42,23,19
Somalisktjur,tarren-mill,1386,warrior,fury,88,47,41
Reidunøks,kazzak,1386,warrior,fury,89,46,43
Pitii,burning-legion,1385,warrior,fury,56,32,24
Boostbywar,archimonde,1385,warrior,fury,47,22,25
Dragão,kazzak,1385,warrior,fury,72,32,40
Onga,frostwolf,1384,warrior,fury,53,28,25
Воинстик,soulflayer,1383,warrior,fury,52,21,31
Hervor,les-sentinelles,1382,warrior,fury,90,49,41
Golias,argent-dawn,1381,warrior,fury,72,40,32
Reylanor,argent-dawn,1381,warrior,fury,169,90,79
Baylis,kazzak,1380,warrior,fury,29,15,14
Reccey,blackrock,1379,warrior,fury,30,16,14
Bxnx,aegwynn,1379,warrior,fury,99,46,53
Армсец,howling-fjord,1379,warrior,fury,36,16,20
Ligthblâd,hyjal,1378,warrior,fury,63,34,29
Æsterius,blackmoore,1377,warrior,fury,101,49,52
Ratgor,twisting-nether,1376,warrior,fury,54,27,27
Suknur,silvermoon,1376,warrior,fury,98,46,52
Isnookzl,blackmoore,1376,warrior,fury,54,25,29
Botgrinder,blackhand,1375,warrior,fury,212,112,100
Offpants,drakthul,1375,warrior,fury,145,73,72
Candan,norgannon,1375,warrior,fury,62,27,35
Ffrostwolff,azjolnerub,1374,warrior,fury,48,28,20
Angryvirgin,ravencrest,1374,warrior,fury,35,16,19
Вархаус,blackscar,1373,warrior,fury,64,36,28
Дедсдрыном,howling-fjord,1372,warrior,fury,262,137,125
Мембершримп,howling-fjord,1371,warrior,fury,66,33,33
Calel,ravencrest,1371,warrior,fury,48,24,24
Янесними,soulflayer,1370,warrior,fury,36,20,16
Мутобой,soulflayer,1370,warrior,fury,74,40,34
Коньвпальто,greymane,1370,warrior,fury,81,42,39
Ralzung,twisting-nether,1370,warrior,fury,54,26,28
Чюнилингус,soulflayer,1369,warrior,fury,43,15,28
Firebladë,ravencrest,1368,warrior,fury,41,23,18
Goldenarm,doomhammer,1368,warrior,fury,140,77,63
Ryù,dun-modr,1368,warrior,fury,105,50,55
Têtebruler,archimonde,1366,warrior,fury,30,16,14
Infecwarr,stormscale,1366,warrior,fury,29,15,14
Astreimehns,sanguino,1366,warrior,fury,30,15,15
Pimagnum,stormscale,1366,warrior,fury,43,20,23
Kante,frostmane,1365,warrior,fury,36,22,14
Happyhour,sargeras,1365,warrior,fury,34,18,16
Svênsk,argent-dawn,1364,warrior,fury,50,28,22
Selkie,tirion,1364,warrior,fury,54,29,25
Darriuso,kazzak,1364,warrior,fury,129,64,65
Бшпокд,soulflayer,1363,warrior,fury,96,47,49
Kelmyst,ragnaros,1363,warrior,fury,45,22,23
Сэч,gordunni,1362,warrior,fury,34,22,12
Cathalb,quelthalas,1361,warrior,fury,40,26,14
Motorhead,tirion,1361,warrior,fury,96,53,43
Màrduk,pozzo-delleternità,1361,warrior,fury,42,23,19
Diioxyde,temple-noir,1361,warrior,fury,91,47,44
Андервульф,booty-bay,1360,warrior,fury,56,24,32
Reckless,tarren-mill,1358,warrior,fury,54,30,24
Килджаеден,deathguard,1358,warrior,fury,34,17,17
Эрисихтон,soulflayer,1358,warrior,fury,64,31,33
Злопиканкин,gordunni,1357,warrior,fury,36,20,16
Rudor,la-croisade-écarlate,1357,warrior,fury,36,20,16
Zhyral,malygos,1357,warrior,fury,30,16,14
Jhaiteiro,dun-modr,1357,warrior,fury,111,52,59
Skefe,archimonde,1356,warrior,fury,52,31,21
Эфириад,soulflayer,1356,warrior,fury,48,26,22
Rerøn,dun-modr,1356,warrior,fury,68,32,36
Jakedo,outland,1356,warrior,fury,35,15,20
Ribastur,blackmoore,1355,warrior,fury,168,89,79
Grák,bronze-dragonflight,1354,warrior,fury,54,31,23
Toecutter,defias-brotherhood,1354,warrior,fury,37,19,18
Arzes,draenor,1354,warrior,fury,71,33,38
Achonar,draenor,1353,warrior,fury,49,25,24
Calwar,sanguino,1352,warrior,fury,99,49,50
Eyolf,thunderhorn,1352,warrior,fury,82,38,44
Gridra,dun-morogh,1350,warrior,fury,37,16,21
Heinzwarrior,ravencrest,1350,warrior,fury,70,29,41
Tigron,burning-legion,1349,warrior,fury,60,35,25
Gorgulg,stormscale,1349,warrior,fury,107,60,47
Gëaldýr,kazzak,1348,warrior,fury,92,43,49
Flexecutie,silvermoon,1348,warrior,fury,54,25,29
Djayson,hyjal,1347,warrior,fury,41,20,21
Hagoxfit,los-errantes,1347,warrior,fury,105,51,54
Terisá,blackmoore,1347,warrior,fury,64,31,33
Deadchïld,drakthul,1347,warrior,fury,52,23,29
Tazkax,archimonde,1346,warrior,fury,95,55,40
Джэкмен,soulflayer,1346,warrior,fury,113,62,51
Murotan,dalaran,1346,warrior,fury,42,19,23
Cokeaddict,argent-dawn,1345,warrior,fury,66,32,34
Habaneroo,zuljin,1345,warrior,fury,42,15,27
Gruttak,aegwynn,1344,warrior,fury,30,18,12
Монгуру,howling-fjord,1343,warrior,fury,59,29,30
Kastraveci,outland,1343,warrior,fury,102,46,56
Zêke,thrall,1342,warrior,fury,24,18,6
Jisoowar,blackhand,1342,warrior,fury,47,18,29
Xladérz,ravencrest,1341,warrior,fury,18,14,4
Rustlord,twisting-nether,1341,warrior,fury,24,14,10
Stretch,thrall,1341,warrior,fury,31,15,16
Ентил,gordunni,1341,warrior,fury,81,37,44
Otzmokk,blackmoore,1341,warrior,fury,79,36,43
Krieg,garrosh,1341,warrior,fury,61,21,40
Wallach,darkspear,1340,warrior,fury,24,14,10
Васильна,soulflayer,1340,warrior,fury,50,27,23
Gorroth,chamber-of-aspects,1340,warrior,fury,36,17,19
Валъдемар,gordunni,1339,warrior,fury,30,20,10
Kënnyföx,ysondre,1339,warrior,fury,24,14,10
Çhoke,blackrock,1338,warrior,fury,24,14,10
Feckdech,blackrock,1338,warrior,fury,24,14,10
Фокатопх,blackscar,1338,warrior,fury,30,14,16
Brigitá,argent-dawn,1338,warrior,fury,30,14,16
Lothbrok,haomarush,1338,warrior,fury,36,14,22
Bror,dentarg,1337,warrior,fury,48,26,22
Fîlzlaus,area-52,1337,warrior,fury,270,132,138
Andry,draenor,1337,warrior,fury,103,40,63
Zhear,kazzak,1336,warrior,fury,83,36,47
Blacko,eldrethalas,1336,warrior,fury,36,15,21
Врэкклив,gordunni,1335,warrior,fury,71,34,37
Xurainzone,eredar,1335,warrior,fury,30,14,16
Fragmeista,ragnaros,1334,warrior,fury,24,14,10
Lzdmfckmeazy,blackmoore,1334,warrior,fury,27,15,12
Hirbz,silvermoon,1333,warrior,fury,66,34,32
Affewithwaff,blackmoore,1333,warrior,fury,91,46,45
Taoke,ravencrest,1333,warrior,fury,30,14,16
Elpap,draenor,1333,warrior,fury,73,34,39
Eliyahu,ghostlands,1332,warrior,fury,54,26,28
Fivejee,ravencrest,1331,warrior,fury,48,26,22
Напутанность,soulflayer,1331,warrior,fury,48,24,24
Бисовыйармен,soulflayer,1330,warrior,fury,30,14,16
Symphius,ravencrest,1330,warrior,fury,30,14,16
Фелёр,gordunni,1330,warrior,fury,60,25,35
Ларджсворд,eversong,1329,warrior,fury,88,46,42
Antraex,zuljin,1329,warrior,fury,139,71,68
Kundrak,blackhand,1329,warrior,fury,79,40,39
Аесоо,gordunni,1329,warrior,fury,323,162,161
Topfury,stormscale,1329,warrior,fury,86,41,45
Tharokk,blackmoore,1328,warrior,fury,84,44,40
Ganaroth,tarren-mill,1328,warrior,fury,42,21,21
Qvate,twisting-nether,1327,warrior,fury,80,36,44
Moggorr,nemesis,1326,warrior,fury,58,30,28
Джелорд,howling-fjord,1326,warrior,fury,30,14,16
Wotulko,blackrock,1325,warrior,fury,41,24,17
Thraxus,azjolnerub,1325,warrior,fury,42,23,19
Gimlee,kul-tiras,1325,warrior,fury,44,22,22
Wanzzeur,hyjal,1325,warrior,fury,63,31,32
Роконишу,gordunni,1324,warrior,fury,78,42,36
Behemoht,tarren-mill,1324,warrior,fury,114,58,56
Тцара,howling-fjord,1324,warrior,fury,40,19,21
Свободатоп,howling-fjord,1323,warrior,fury,30,16,14
Nazdrago,draenor,1323,warrior,fury,30,14,16
Грош,deepholm,1322,warrior,fury,24,14,10
Зэйсс,gordunni,1321,warrior,fury,30,14,16
Откат,grom,1321,warrior,fury,119,55,64
Brúgar,antonidas,1321,warrior,fury,42,18,24
Temprament,ravencrest,1320,warrior,fury,78,43,35
Aldébbarann,archimonde,1320,warrior,fury,83,44,39
Tato,frostmourne,1320,warrior,fury,58,28,30
Punks,ravencrest,1320,warrior,fury,30,14,16
Traflgardlaw,kazzak,1319,warrior,fury,79,38,41
Кроуфури,gordunni,1318,warrior,fury,60,34,26
Exeter,nagrand,1318,warrior,fury,78,41,37
Ayyub,antonidas,1318,warrior,fury,33,16,17
Lasanká,sylvanas,1318,warrior,fury,36,17,19
Конвержн,howling-fjord,1317,warrior,fury,30,17,13
Watntietnn,burning-blade,1317,warrior,fury,61,32,29
Borntothis,zuljin,1317,warrior,fury,134,70,64
Xsasuke,ragnaros,1317,warrior,fury,36,17,19
Razza,ravencrest,1317,warrior,fury,49,23,26
Furiousspear,tarren-mill,1317,warrior,fury,54,21,33
Barragan,sanguino,1316,warrior,fury,41,24,17
Kokaspincha,aggra-português,1316,warrior,fury,30,15,15
Триног,gordunni,1316,warrior,fury,30,14,16
Stuck,argent-dawn,1316,warrior,fury,30,14,16
Bigbanz,outland,1316,warrior,fury,30,14,16
Hellguarrd,silvermoon,1316,warrior,fury,65,29,36
Getonxnxx,quelthalas,1316,warrior,fury,73,31,42
Саурканг,howling-fjord,1316,warrior,fury,52,21,31
Fortësque,uldaman,1315,warrior,fury,59,22,37
Realz,malganis,1314,warrior,fury,119,60,59
Mortalclaw,kazzak,1314,warrior,fury,135,65,70
Zíreael,ravencrest,1314,warrior,fury,72,34,38
Geraltf,tarren-mill,1314,warrior,fury,102,48,54
Vivaladirt,argent-dawn,1313,warrior,fury,36,17,19
Покручука,blackscar,1312,warrior,fury,24,15,9
Kaeo,lordaeron,1311,warrior,fury,48,22,26
Xugzug,blackmoore,1311,warrior,fury,54,24,30
Lippir,stormrage,1310,warrior,fury,86,47,39
Ælvstan,argent-dawn,1310,warrior,fury,59,30,29
Драмур,gordunni,1310,warrior,fury,52,18,34
Bealin,the-venture-co,1309,warrior,fury,36,16,20
Ghoster,kazzak,1308,warrior,fury,42,19,23
Izmadfurax,archimonde,1307,warrior,fury,130,71,59
Thors,deathwing,1306,warrior,fury,208,108,100
Vohnkar,emeriss,1306,warrior,fury,87,40,47
Кимиюки,gordunni,1306,warrior,fury,48,17,31
Agamemnon,frostmane,1305,warrior,fury,51,25,26
Slapperr,frostwolf,1305,warrior,fury,41,20,21
Gudvin,terokkar,1304,warrior,fury,117,63,54
Килоагр,gordunni,1304,warrior,fury,66,28,38
Grimli,burning-legion,1303,warrior,fury,42,24,18
Kaerz,ysondre,1302,warrior,fury,60,33,27
Blairne,burning-blade,1302,warrior,fury,48,22,26
Sørø,sargeras,1301,warrior,fury,82,44,38
Сэрг,gordunni,1301,warrior,fury,48,20,28
Кровостокхх,gordunni,1301,warrior,fury,42,17,25
Griswarr,draenor,1300,warrior,fury,26,15,11
Greensmash,hyjal,1300,warrior,fury,133,62,71
Tragix,hyjal,1300,warrior,fury,42,18,24
Умфи,howling-fjord,1299,warrior,fury,83,46,37
Neíd,malganis,1297,warrior,fury,24,14,10
Oughn,silvermoon,1295,warrior,fury,147,73,74
Аштау,howling-fjord,1295,warrior,fury,208,100,108
Варёнок,soulflayer,1294,warrior,fury,79,44,35
Старопрамен,thermaplugg,1294,warrior,fury,277,140,137
Блиблоб,eversong,1293,warrior,fury,83,46,37
Феоника,azuregos,1293,warrior,fury,106,54,52
Guruw,tarren-mill,1293,warrior,fury,132,66,66
Sunakaary,drakthul,1292,warrior,fury,41,27,14
Bjorsert,dun-modr,1292,warrior,fury,58,24,34
Exsomnis,outland,1291,warrior,fury,30,17,13
Drexx,ragnaros,1291,warrior,fury,40,21,19
Арестант,soulflayer,1291,warrior,fury,137,69,68
Cdreww,thrall,1289,warrior,fury,24,18,6
Машамеч,blackscar,1289,warrior,fury,84,42,42
Ratko,auchindoun,1289,warrior,fury,60,30,30
Hudsonn,sylvanas,1289,warrior,fury,29,14,15
Fatøuwar,archimonde,1289,warrior,fury,39,18,21
Shkørwi,drakthul,1289,warrior,fury,48,22,26
Dyspó,sanguino,1287,warrior,fury,70,32,38
Ragecrit,ragnaros,1287,warrior,fury,52,23,29
Kydecnick,kazzak,1285,warrior,fury,290,150,140
Добрыйборов,booty-bay,1285,warrior,fury,72,37,35
Unchåined,burning-legion,1285,warrior,fury,117,59,58
Mouliard,archimonde,1285,warrior,fury,36,17,19
Fraeydís,silvermoon,1285,warrior,fury,57,26,31
Rqyz,tarren-mill,1283,warrior,fury,36,21,15
Sammäel,eldrethalas,1281,warrior,fury,36,19,17
Megaboss,blackrock,1281,warrior,fury,44,20,24
Mokaro,rexxar,1280,warrior,fury,30,18,12
Deusi,garrosh,1280,warrior,fury,129,67,62
Azëlls,archimonde,1280,warrior,fury,42,19,23
Soldegaard,drakthul,1279,warrior,fury,32,16,16
Optimai,kazzak,1279,warrior,fury,174,84,90
Zedori,stormrage,1279,warrior,fury,36,15,21
Juggernot,archimonde,1278,warrior,fury,43,24,19
Unn,ragnaros,1278,warrior,fury,99,49,50
Skullfondler,argent-dawn,1278,warrior,fury,30,14,16
Skrboslav,tarren-mill,1278,warrior,fury,42,15,27
Oglisten,archimonde,1277,warrior,fury,30,15,15
Armirtile,twisting-nether,1277,warrior,fury,36,17,19
Drswing,kazzak,1277,warrior,fury,93,42,51
Andij,blackmoore,1276,warrior,fury,114,57,57
Houndburger,drakthul,1276,warrior,fury,90,38,52
Fightinghell,stormrage,1274,warrior,fury,54,26,28
Sindo,dalaran,1274,warrior,fury,66,31,35
Exeldians,burning-legion,1273,warrior,fury,20,14,6
Fenr,sanguino,1273,warrior,fury,58,37,21
Bluntsword,twisting-nether,1273,warrior,fury,30,19,11
Gardom,doomhammer,1272,warrior,fury,114,66,48
Familyguy,sylvanas,1272,warrior,fury,59,32,27
Darzuh,dun-modr,1272,warrior,fury,60,29,31
Furyre,ysondre,1271,warrior,fury,37,17,20
Лимэй,blackscar,1271,warrior,fury,74,32,42
Honeymew,draenor,1271,warrior,fury,66,27,39
Céck,ravencrest,1270,warrior,fury,58,29,29
Hatenest,argent-dawn,1269,warrior,fury,408,196,212
Säl,ragnaros,1268,warrior,fury,123,67,56
Ipes,blackmoore,1268,warrior,fury,55,28,27
Ninja,bronze-dragonflight,1268,warrior,fury,98,46,52
Warinator,ravencrest,1267,warrior,fury,115,60,55
Akkamagosh,argent-dawn,1266,warrior,fury,70,31,39
Fvkundercutt,xavius,1265,warrior,fury,42,26,16
Ausrastus,blackhand,1265,warrior,fury,34,15,19
Azzog,archimonde,1264,warrior,fury,92,51,41
Doryen,blackmoore,1264,warrior,fury,36,17,19
Larrydankin,draenor,1263,warrior,fury,101,56,45
Zerm,draenor,1262,warrior,fury,24,15,9
Banecrush,silvermoon,1262,warrior,fury,60,33,27
Wilæm,ravencrest,1261,warrior,fury,71,34,37
Ztranger,the-maelstrom,1261,warrior,fury,42,20,22
Бормормуш,gordunni,1261,warrior,fury,73,30,43
Schmetterina,proudmoore,1260,warrior,fury,120,65,55
Pufy,ravencrest,1260,warrior,fury,79,42,37
Anubisra,alakir,1260,warrior,fury,56,29,27
Bobzillah,kazzak,1259,warrior,fury,24,16,8
Delinde,cthun,1259,warrior,fury,182,91,91
Tarrior,shattered-halls,1259,warrior,fury,170,84,86
Авентадорх,deathguard,1258,warrior,fury,24,15,9
Vàriam,argent-dawn,1258,warrior,fury,30,14,16
Номер,eversong,1257,warrior,fury,271,133,138
Hazarku,colinas-pardas,1257,warrior,fury,49,22,27
Lacrima,earthen-ring,1257,warrior,fury,87,37,50
Ivâar,archimonde,1256,warrior,fury,26,14,12
Zuchtrind,blackrock,1256,warrior,fury,39,19,20
Dundulinka,outland,1255,warrior,fury,46,17,29
Runkkusukka,defias-brotherhood,1254,warrior,fury,101,54,47
Saey,malorne,1254,warrior,fury,110,55,55
Насувака,deathguard,1254,warrior,fury,59,29,30
Теокрафт,howling-fjord,1254,warrior,fury,62,30,32
Toughwar,tarren-mill,1253,warrior,fury,66,35,31
Mutuh,ravenholdt,1253,warrior,fury,48,24,24
Panexecute,ragnaros,1248,warrior,fury,36,16,20
Рагнарульв,gordunni,1248,warrior,fury,36,15,21
Фокатоп,blackscar,1247,warrior,fury,24,13,11
Slambadicoot,draenor,1247,warrior,fury,45,20,25
Stóna,blackmoore,1247,warrior,fury,36,13,23
Moowar,eredar,1246,warrior,fury,18,13,5
Kapuchino,twisting-nether,1246,warrior,fury,24,13,11
Аэска,deathweaver,1246,warrior,fury,27,14,13
Larvalis,blackmoore,1246,warrior,fury,95,43,52
Tagavaga,tarren-mill,1246,warrior,fury,60,26,34
Cuuz,outland,1246,warrior,fury,70,30,40
Thorock,magtheridon,1245,warrior,fury,24,13,11
Avgålöfvén,stormscale,1245,warrior,fury,24,13,11
Wariio,khaz-modan,1245,warrior,fury,71,38,33
Poniroula,burning-legion,1245,warrior,fury,32,14,18
Hulflon,pozzo-delleternità,1243,warrior,fury,36,20,16
Yosiwa,draenor,1243,warrior,fury,24,13,11
Барабумм,soulflayer,1243,warrior,fury,125,63,62
Nuijara,blackrock,1243,warrior,fury,66,30,36
Draxxann,ravencrest,1242,warrior,fury,91,54,37
Innos,gorgonnash,1242,warrior,fury,38,21,17
Mertik,twisting-nether,1242,warrior,fury,24,13,11
Xxeqtr,kazzak,1242,warrior,fury,24,13,11
Freemoney,blackrock,1242,warrior,fury,30,13,17
Schaufelørc,blackrock,1242,warrior,fury,30,13,17
Ragnurk,draenor,1242,warrior,fury,60,20,40
Tàuruss,blackhand,1241,warrior,fury,40,21,19
Слайдус,gordunni,1241,warrior,fury,68,34,34
Рсдрпб,eversong,1241,warrior,fury,30,15,15
Timidman,kazzak,1240,warrior,fury,24,13,11
Kvintor,bloodscalp,1240,warrior,fury,136,70,66
Bitololz,kaelthas,1239,warrior,fury,36,17,19
Xqtwar,blackhand,1239,warrior,fury,30,13,17
Contrariety,ravencrest,1238,warrior,fury,71,43,28
Ptp,argent-dawn,1238,warrior,fury,24,13,11
Balsor,frostmane,1238,warrior,fury,34,17,17
Carras,confrérie-du-thorium,1237,warrior,fury,48,28,20
Warrosh,defias-brotherhood,1237,warrior,fury,24,13,11
Toporceanul,kazzak,1236,warrior,fury,70,27,43
Slûff,draenor,1235,warrior,fury,24,13,11
Gritzi,dragonblight,1235,warrior,fury,71,34,37
Renji,proudmoore,1234,warrior,fury,18,13,5
Kamú,twisting-nether,1234,warrior,fury,24,13,11
Kurzen,voljin,1234,warrior,fury,74,39,35
Valhrann,dalaran,1234,warrior,fury,54,28,26
Krionos,ravencrest,1233,warrior,fury,22,14,8
Kurko,blackmoore,1233,warrior,fury,83,37,46
Dxc,blackhand,1233,warrior,fury,30,13,17
Nykyro,draenor,1232,warrior,fury,105,53,52
Йомхар,howling-fjord,1231,warrior,fury,72,32,40
Whimbux,stormscale,1231,warrior,fury,114,49,65
Rimadi,silvermoon,1231,warrior,fury,36,13,23
Claptheheal,silvermoon,1230,warrior,fury,24,13,11
Стано,booty-bay,1230,warrior,fury,44,23,21
Batourga,marécage-de-zangar,1230,warrior,fury,49,21,28
Aìrwave,blackmoore,1229,warrior,fury,24,13,11
Madfu,draenor,1229,warrior,fury,36,19,17
Федорссумкин,gordunni,1229,warrior,fury,74,34,40
Gvngx,zuljin,1229,warrior,fury,77,34,43
Димаказнь,gordunni,1229,warrior,fury,30,13,17
Krasark,blackmoore,1229,warrior,fury,78,33,45
Onyi,onyxia,1228,warrior,fury,36,18,18
Viqi,alleria,1228,warrior,fury,30,13,17
Szpindah,ragnaros,1228,warrior,fury,36,13,23
Firience,silvermoon,1226,warrior,fury,24,13,11
Зулльварн,thermaplugg,1224,warrior,fury,36,13,23
Noseringer,frostwolf,1223,warrior,fury,21,15,6
Lâppön,blackmoore,1223,warrior,fury,36,20,16
Lâmy,khaz-modan,1223,warrior,fury,125,58,67
Bløckqt,archimonde,1223,warrior,fury,30,13,17
Stormíe,outland,1221,warrior,fury,24,13,11
Thôras,anetheron,1221,warrior,fury,45,23,22
Rayeron,sanguino,1221,warrior,fury,97,48,49
Corpsecount,stormrage,1221,warrior,fury,72,31,41
Kebra,blackmoore,1220,warrior,fury,87,49,38
Dríppy,aegwynn,1220,warrior,fury,36,20,16
Bolss,silvermoon,1220,warrior,fury,79,32,47
Экзэкутэр,howling-fjord,1219,warrior,fury,18,13,5
Riptide,aggra-português,1219,warrior,fury,58,30,28
Ouryuu,hyjal,1218,warrior,fury,56,25,31
Gèrralt,hyjal,1218,warrior,fury,59,21,38
Grimdur,kirin-tor,1217,warrior,fury,243,116,127
Arinator,les-sentinelles,1217,warrior,fury,82,36,46
Sjekac,stormscale,1216,warrior,fury,58,29,29
Копенгаген,ashenvale,1215,warrior,fury,87,49,38
Dabliu,burning-legion,1215,warrior,fury,102,48,54
Imora,silvermoon,1214,warrior,fury,74,37,37
Turmund,turalyon,1213,warrior,fury,48,25,23
Ульданианин,gordunni,1213,warrior,fury,30,15,15
Warrmax,darksorrow,1211,warrior,fury,108,55,53
Vagor,draenor,1211,warrior,fury,35,16,19
Lissanna,ravencrest,1207,warrior,fury,24,14,10
Marklarstar,ragnaros,1207,warrior,fury,96,46,50
Warriorc,hellfire,1205,warrior,fury,48,26,22
Garmal,nemesis,1205,warrior,fury,30,16,14
Paralel,tarren-mill,1205,warrior,fury,56,29,27
Skeeby,ravencrest,1205,warrior,fury,30,13,17
Yenïa,argent-dawn,1205,warrior,fury,33,14,19
Помойник,gordunni,1204,warrior,fury,368,197,171
Quigatron,frostmane,1204,warrior,fury,77,41,36
Prater,draenor,1204,warrior,fury,33,14,19
Stweye,frostmane,1203,warrior,fury,24,13,11
Hangovar,thrall,1203,warrior,fury,51,25,26
Mfull,tarren-mill,1203,warrior,fury,63,30,33
Варнубар,eversong,1202,warrior,fury,66,32,34
Gortigard,archimonde,1201,warrior,fury,87,40,47
Vhy,antonidas,1201,warrior,fury,48,22,26
Dmskodame,doomhammer,1201,warrior,fury,42,18,24
Aliáto,sanguino,1200,warrior,fury,30,13,17
Bwonsàmdí,ragnaros,1200,warrior,fury,48,16,32
Sinesterá,blackhand,1199,warrior,fury,67,31,36
Jasonnes,argent-dawn,1198,warrior,fury,52,23,29
Отнулядоста,gordunni,1198,warrior,fury,61,25,36
Драбун,howling-fjord,1197,warrior,fury,30,14,16
Assyriá,ravencrest,1196,warrior,fury,23,13,10
Buzzingwarr,tarren-mill,1195,warrior,fury,126,58,68
Djiozz,khaz-modan,1194,warrior,fury,65,29,36
Артуша,blackscar,1193,warrior,fury,60,29,31
Blaying,ravencrest,1192,warrior,fury,23,13,10
Saykage,blackhand,1191,warrior,fury,48,24,24
Prime,outland,1191,warrior,fury,48,21,27
Grumpwarrior,draenor,1191,warrior,fury,60,23,37
Cogneur,archimonde,1191,warrior,fury,42,16,26
Иллидансер,howling-fjord,1190,warrior,fury,60,29,31
Zoink,burning-blade,1190,warrior,fury,27,13,14
Daramir,turalyon,1189,warrior,fury,54,25,29
Gagatchar,die-silberne-hand,1188,warrior,fury,44,17,27
Agitoyami,defias-brotherhood,1187,warrior,fury,127,66,61
Mocagressiva,draenor,1187,warrior,fury,48,23,25
Manston,sanguino,1187,warrior,fury,36,13,23
Illydan,turalyon,1186,warrior,fury,89,43,46
Азктор,soulflayer,1186,warrior,fury,35,15,20
Humanoç,dun-modr,1186,warrior,fury,37,15,22
Iamanorc,silvermoon,1185,warrior,fury,37,20,17
Nubá,bronze-dragonflight,1185,warrior,fury,204,108,96
Элейд,thermaplugg,1184,warrior,fury,42,22,20
Ragedotcom,archimonde,1184,warrior,fury,122,61,61
Sadgex,kazzak,1184,warrior,fury,29,13,16
Moknar,alonsus,1184,warrior,fury,71,29,42
Axtuz,malorne,1184,warrior,fury,42,17,25
Westwyde,hyjal,1183,warrior,fury,22,13,9
Anarki,kaelthas,1183,warrior,fury,24,14,10
Эпитафорх,blackscar,1181,warrior,fury,22,13,9
Morishcrak,kazzak,1181,warrior,fury,39,14,25
Leonidæs,frostwolf,1180,warrior,fury,66,30,36
Ryûjin,draenor,1178,warrior,fury,54,26,28
Суммрак,grom,1178,warrior,fury,41,17,24
Дерзкаяфурия,gordunni,1177,warrior,fury,41,17,24
Truedamagé,blackrock,1176,warrior,fury,54,25,29
Coyle,eredar,1176,warrior,fury,246,113,133
Thibow,hyjal,1175,warrior,fury,66,35,31
Garosh,drakthul,1173,warrior,fury,72,39,33
Coasterupte,draenor,1169,warrior,fury,134,60,74
Осгаард,gordunni,1169,warrior,fury,60,25,35
Tejecuto,sanguino,1166,warrior,fury,24,13,11
Berseak,dalaran,1166,warrior,fury,49,25,24
Суферна,howling-fjord,1166,warrior,fury,33,16,17
Drolaret,zuljin,1166,warrior,fury,69,31,38
Fatbeard,twilights-hammer,1165,warrior,fury,52,24,28
Спунжио,ashenvale,1164,warrior,fury,114,60,54
Tdanielt,burning-legion,1164,warrior,fury,204,103,101
Xentos,kirin-tor,1163,warrior,fury,38,21,17
Greatsword,turalyon,1162,warrior,fury,24,14,10
Grobler,blackhand,1161,warrior,fury,54,25,29
Shieldlord,kazzak,1160,warrior,fury,160,73,87
Sairos,kirin-tor,1158,warrior,fury,174,92,82
Stonlocked,blackhand,1158,warrior,fury,48,19,29
Gahal,tyrande,1157,warrior,fury,54,22,32
Vyseniä,dalaran,1156,warrior,fury,36,15,21
Ragnòk,eredar,1153,warrior,fury,78,36,42
Trâshwarriør,blackhand,1152,warrior,fury,18,12,6
Devìlscandy,stormscale,1152,warrior,fury,18,12,6
Waríos,blackrock,1152,warrior,fury,54,25,29
Uselessblâme,archimonde,1151,warrior,fury,18,12,6
Kotechnik,ysondre,1151,warrior,fury,18,12,6
Naronnas,drakthul,1151,warrior,fury,18,12,6
Urmack,ravencrest,1151,warrior,fury,18,12,6
Whýsøsîlêñt,ragnaros,1151,warrior,fury,18,12,6
Midly,hellfire,1151,warrior,fury,54,26,28
Исскатель,gordunni,1150,warrior,fury,12,12,0
Vvulf,eredar,1150,warrior,fury,24,12,12
Feydal,thrall,1150,warrior,fury,185,83,102
Denwar,ravencrest,1150,warrior,fury,36,13,23
Dramiél,tarren-mill,1148,warrior,fury,29,15,14
Ranndall,blackrock,1148,warrior,fury,62,31,31
Jasperr,nemesis,1148,warrior,fury,165,79,86
Talanora,ravencrest,1147,warrior,fury,18,12,6
Orkoje,argent-dawn,1147,warrior,fury,24,12,12
Zercher,tarren-mill,1147,warrior,fury,30,12,18
Evilez,ravencrest,1146,warrior,fury,18,12,6
Litkis,silvermoon,1146,warrior,fury,101,59,42
Melferas,silvermoon,1146,warrior,fury,89,46,43
Thunderage,stormscale,1146,warrior,fury,44,20,24
Ragecap,rexxar,1145,warrior,fury,50,21,29
Schmackes,terrordar,1144,warrior,fury,18,12,6
Ragnarr,ravencrest,1144,warrior,fury,24,12,12
Wåks,dalaran,1144,warrior,fury,24,12,12
Neoballâc,uldum,1144,warrior,fury,24,12,12
Kiaravnr,garona,1143,warrior,fury,18,12,6
Kioskmupp,ravencrest,1143,warrior,fury,24,12,12
Ragnacore,ravencrest,1142,warrior,fury,24,12,12
Rasvamaksa,stormscale,1142,warrior,fury,24,12,12
Waroworgen,terokkar,1142,warrior,fury,26,12,14
Kristinas,tarren-mill,1141,warrior,fury,24,12,12
Marlßørø,twisting-nether,1141,warrior,fury,24,12,12
Инфиль,howling-fjord,1140,warrior,fury,30,12,18
Селттик,grom,1139,warrior,fury,130,68,62
Axamo,ragnaros,1139,warrior,fury,24,12,12
Kamatâ,kazzak,1139,warrior,fury,30,12,18
Крешер,howling-fjord,1138,warrior,fury,86,36,50
Sparkss,sylvanas,1137,warrior,fury,30,15,15
Moustachu,kirin-tor,1137,warrior,fury,51,25,26
Zpárta,ragnaros,1136,warrior,fury,47,31,16
Edwsan,cthun,1136,warrior,fury,84,46,38
Sadex,blackmoore,1136,warrior,fury,24,13,11
Nurychïc,twisting-nether,1135,warrior,fury,30,15,15
Жужащий,howling-fjord,1135,warrior,fury,158,71,87
Kharzak,ungoro,1134,warrior,fury,29,16,13
Urabrask,stormscale,1134,warrior,fury,24,12,12
Madhardy,chamber-of-aspects,1133,warrior,fury,24,12,12
Torinborison,ysera,1132,warrior,fury,18,12,6
Nakkelam,twisting-nether,1131,warrior,fury,18,12,6
Reinharth,dalaran,1131,warrior,fury,48,26,22
Sekecmazec,turalyon,1129,warrior,fury,63,22,41
Pybal,stormscale,1128,warrior,fury,18,12,6
Tavywar,the-maelstrom,1128,warrior,fury,98,45,53
Justviktor,ravencrest,1128,warrior,fury,99,45,54
Weezing,argent-dawn,1128,warrior,fury,57,24,33
Wrathchild,blackrock,1126,warrior,fury,47,22,25
Xiszos,ravencrest,1126,warrior,fury,30,12,18
Sadjoke,draenor,1125,warrior,fury,30,13,17
Execútie,argent-dawn,1124,warrior,fury,36,13,23
Nukêr,dun-modr,1123,warrior,fury,90,34,56
Arnoldalois,neptulon,1122,warrior,fury,99,44,55
Well,kult-der-verdammten,1121,warrior,fury,24,12,12
Фейловый,gordunni,1121,warrior,fury,30,12,18
Khaalo,blackhand,1120,warrior,fury,32,19,13
Kirkwood,terokkar,1120,warrior,fury,77,34,43
Itimu,blackrock,1119,warrior,fury,44,26,18
Téldrus,blackrock,1116,warrior,fury,18,12,6
Auauau,arthas,1116,warrior,fury,30,12,18
Warnox,dun-modr,1113,warrior,fury,60,31,29
Ganian,stormscale,1113,warrior,fury,30,14,16
Pahanâ,arygos,1111,warrior,fury,24,12,12
Fetidoman,zuljin,1110,warrior,fury,27,13,14
Lobotomywar,drakthul,1109,warrior,fury,36,24,12
Subot,frostmane,1109,warrior,fury,20,12,8
Sabrewølf,blackmoore,1107,warrior,fury,106,54,52
Houftasir,eredar,1106,warrior,fury,45,19,26
Бодяня,gordunni,1105,warrior,fury,54,22,32
Zetsurin,sylvanas,1105,warrior,fury,66,23,43
Crushonyou,aegwynn,1103,warrior,fury,21,13,8
Hágríd,ragnaros,1103,warrior,fury,36,13,23
Vazzile,silvermoon,1100,warrior,fury,65,34,31
Barsok,sanguino,1100,warrior,fury,72,29,43
Bozcô,draenor,1099,warrior,fury,23,12,11
Tatya,drekthar,1098,warrior,fury,27,13,14
Cmonbrah,ravencrest,1097,warrior,fury,21,13,8
Красемир,deepholm,1097,warrior,fury,47,23,24
Telmó,blackhand,1095,warrior,fury,72,40,32
Seka,nozdormu,1095,warrior,fury,522,267,255
Chloade,burning-legion,1095,warrior,fury,108,55,53
Oxascand,kazzak,1095,warrior,fury,117,50,67
Isenstrider,burning-legion,1093,warrior,fury,22,13,9
Macgull,ysondre,1092,warrior,fury,90,42,48
Mistawolf,ravencrest,1090,warrior,fury,30,16,14
Exhumator,blackhand,1090,warrior,fury,84,32,52
Aaàaàaàa,stormscale,1088,warrior,fury,22,12,10
Damonx,draenor,1088,warrior,fury,90,42,48
Shalren,nordrassil,1087,warrior,fury,62,32,30
Armoricus,argent-dawn,1084,warrior,fury,54,30,24
Evilmowaio,tarren-mill,1084,warrior,fury,33,12,21
Evasni,magtheridon,1082,warrior,fury,20,13,7
Onslaught,pozzo-delleternità,1082,warrior,fury,64,29,35
Gylfanders,the-maelstrom,1081,warrior,fury,22,12,10
Midasch,dun-morogh,1080,warrior,fury,66,30,36
Мухалии,howling-fjord,1073,warrior,fury,28,13,15
Killpieric,krasus,1072,warrior,fury,90,38,52
Garstus,die-silberne-hand,1072,warrior,fury,66,22,44
Солоовей,gordunni,1071,warrior,fury,88,42,46
Surp,hyjal,1071,warrior,fury,84,37,47
Зарган,howling-fjord,1071,warrior,fury,56,20,36
Приветсемье,deathguard,1068,warrior,fury,19,12,7
Tiapollo,dun-modr,1068,warrior,fury,58,19,39
Xienia,dun-morogh,1065,warrior,fury,142,63,79
Serpentheron,stormscale,1064,warrior,fury,73,35,38
Krlebajker,tarren-mill,1061,warrior,fury,33,19,14
Giimlii,hyjal,1060,warrior,fury,36,12,24
Snoopdad,ravencrest,1059,warrior,fury,51,30,21
Dräparren,ragnaros,1057,warrior,fury,32,12,20
Luphrek,ysondre,1056,warrior,fury,30,11,19
Зенобий,gordunni,1055,warrior,fury,12,11,1
Maroux,malganis,1055,warrior,fury,18,11,7
Paaki,archimonde,1055,warrior,fury,18,11,7
Chíppéd,draenor,1055,warrior,fury,18,11,7
Slux,outland,1055,warrior,fury,18,11,7
Sparkzu,twisting-nether,1055,warrior,fury,18,11,7
Bersekerstan,tarren-mill,1055,warrior,fury,18,11,7
Wardropeeh,argent-dawn,1055,warrior,fury,30,15,15
Precel,burning-legion,1055,warrior,fury,24,11,13
Sànkâ,ysondre,1055,warrior,fury,24,11,13
Trexzor,argent-dawn,1054,warrior,fury,18,11,7
Ангрол,grom,1054,warrior,fury,18,11,7
Grimilax,hellscream,1054,warrior,fury,18,11,7
Мираксус,soulflayer,1054,warrior,fury,18,11,7
Xarmog,hyjal,1054,warrior,fury,18,11,7
Yildiz,kargath,1054,warrior,fury,197,100,97
Redwraith,stormscale,1054,warrior,fury,24,11,13
Manneen,outland,1054,warrior,fury,108,45,63
Shalaceco,nemesis,1054,warrior,fury,71,24,47
Snuzzygeezer,ravencrest,1053,warrior,fury,18,11,7
Rahtok,blackrock,1053,warrior,fury,18,11,7
Circumcist,dragonblight,1053,warrior,fury,18,11,7
Byedriver,kazzak,1053,warrior,fury,24,11,13
Oksimbillah,blackrock,1053,warrior,fury,24,11,13
Derkarle,azshara,1052,warrior,fury,18,11,7
Zalumorth,magtheridon,1052,warrior,fury,79,41,38
Arta,arthas,1052,warrior,fury,72,34,38
Míngxuan,tarren-mill,1051,warrior,fury,18,11,7
Kridi,stormreaver,1051,warrior,fury,18,11,7
Warriorgaro,khaz-modan,1051,warrior,fury,84,40,44
Elainax,eredar,1051,warrior,fury,24,11,13
Craíne,antonidas,1051,warrior,fury,24,11,13
Jesster,blackmoore,1050,warrior,fury,18,11,7
Röell,draenor,1050,warrior,fury,18,11,7
Хэлвид,soulflayer,1050,warrior,fury,24,11,13
Kuangbaozhan,dun-morogh,1050,warrior,fury,30,11,19
Геленфорд,soulflayer,1049,warrior,fury,24,11,13
Keilore,hyjal,1049,warrior,fury,24,11,13
Sweeyz,elune,1048,warrior,fury,18,11,7
Obox,ravencrest,1048,warrior,fury,18,11,7
Lecorrecteur,archimonde,1048,warrior,fury,24,11,13
Ginroi,sunstrider,1048,warrior,fury,24,11,13
Wheelbarrow,eredar,1047,warrior,fury,24,11,13
Кэйвон,gordunni,1047,warrior,fury,50,18,32
Algethar,archimonde,1046,warrior,fury,18,11,7
Wikò,blackrock,1046,warrior,fury,27,12,15
Largeblade,kazzak,1045,warrior,fury,18,11,7
Áosr,ravencrest,1045,warrior,fury,43,25,18
Kratosz,bloodscalp,1045,warrior,fury,157,84,73
Waltharius,das-syndikat,1045,warrior,fury,96,48,48
Koliastra,magtheridon,1044,warrior,fury,27,12,15
Whysospicey,lightbringer,1043,warrior,fury,21,12,9
Eliyel,silvermoon,1042,warrior,fury,18,11,7
Himä,burning-legion,1042,warrior,fury,18,11,7
Daywoe,spinebreaker,1042,warrior,fury,24,11,13
Swizzlecrack,draenor,1042,warrior,fury,24,11,13
Bleckwarrior,ravencrest,1040,warrior,fury,16,12,4
Romanondo,doomhammer,1039,warrior,fury,18,11,7
Жиестьдон,soulflayer,1036,warrior,fury,74,35,39
Galdir,ravencrest,1035,warrior,fury,54,28,26
Sonnyammo,turalyon,1034,warrior,fury,80,38,42
Златоцветта,gordunni,1034,warrior,fury,24,11,13
Moonkak,hyjal,1034,warrior,fury,120,54,66
Bootyclapper,runetotem,1032,warrior,fury,18,11,7
Afofaifadx,cthun,1029,warrior,fury,30,11,19
Akinewan,twisting-nether,1028,warrior,fury,24,11,13
Каргрогар,eversong,1027,warrior,fury,30,11,19
Anastor,ragnaros,1026,warrior,fury,24,11,13
Kuljapro,ravencrest,1025,warrior,fury,42,19,23
Sazox,drakthul,1023,warrior,fury,17,11,6
Tenvee,outland,1021,warrior,fury,23,11,12
Zyzie,argent-dawn,1020,warrior,fury,29,11,18
Amsti,doomhammer,1019,warrior,fury,24,16,8
Ogerit,blackmoore,1019,warrior,fury,117,62,55
Bogangains,outland,1018,warrior,fury,20,12,8
Whiteebeardd,draenor,1018,warrior,fury,156,76,80
Громорашман,grom,1017,warrior,fury,20,12,8
Fknmoo,kazzak,1017,warrior,fury,211,107,104
Kabbuki,die-aldor,1015,warrior,fury,58,33,25
Sperta,frostmourne,1011,warrior,fury,59,31,28
Manfred,burning-legion,1009,warrior,fury,18,11,7
Kharmog,hyjal,1009,warrior,fury,98,40,58
Hellscreamer,auchindoun,1008,warrior,fury,17,11,6
Рыджеральд,howling-fjord,1008,warrior,fury,51,24,27
Nogo,nagrand,1004,warrior,fury,62,36,26
Whitewash,sylvanas,1003,warrior,fury,27,11,16
Josephoise,hyjal,1001,warrior,fury,23,11,12
Marrowhead,ragnaros,998,warrior,fury,23,11,12
Thànagor,malfurion,993,warrior,fury,24,13,11
Taleria,malygos,993,warrior,fury,34,13,21
Warfield,draenor,992,warrior,fury,30,11,19
Orcgrim,nozdormu,989,warrior,fury,48,22,26
Dj,ragnaros,986,warrior,fury,24,13,11
Nakro,hyjal,984,warrior,fury,20,11,9
Nicperh,dun-modr,984,warrior,fury,29,12,17
Bablos,kul-tiras,983,warrior,fury,34,18,16
Khòrne,sanguino,983,warrior,fury,37,17,20
Wardén,argent-dawn,977,warrior,fury,60,23,37
Rogmash,confrérie-du-thorium,973,warrior,fury,31,11,20
Luküs,dun-modr,972,warrior,fury,25,13,12
Destrzadora,exodar,971,warrior,fury,24,12,12
Zeppek,dalaran,969,warrior,fury,161,83,78
Merdé,blackhand,969,warrior,fury,125,64,61
Kungeen,silvermoon,968,warrior,fury,180,81,99
Malvred,eredar,968,warrior,fury,72,26,46
Solidier,archimonde,967,warrior,fury,95,41,54
Tronhaur,stormscale,967,warrior,fury,41,13,28
Maniacwar,silvermoon,966,warrior,fury,66,20,46
Торакусу,gordunni,963,warrior,fury,113,57,56
Baelyx,silvermoon,963,warrior,fury,27,13,14
Thrownn,daggerspine,962,warrior,fury,19,11,8
Boxersene,blackmoore,962,warrior,fury,34,14,20
Pj,sanguino,960,warrior,fury,12,10,2
Nazhar,kult-der-verdammten,960,warrior,fury,12,10,2
Фрейз,deathweaver,960,warrior,fury,12,10,2
Ástriax,ravencrest,960,warrior,fury,18,10,8
Nazrihk,ravencrest,960,warrior,fury,18,10,8
Phalek,argent-dawn,960,warrior,fury,18,10,8
Изикол,blackscar,960,warrior,fury,21,11,10
Highoverlord,aggra-português,959,warrior,fury,18,10,8
Wutraa,kazzak,959,warrior,fury,18,10,8
Buckiesøde,twisting-nether,959,warrior,fury,18,10,8
Tenicx,ravencrest,959,warrior,fury,18,10,8
Ramboramon,silvermoon,959,warrior,fury,18,10,8
Googas,aegwynn,959,warrior,fury,18,10,8
Galatan,kazzak,959,warrior,fury,18,10,8
Scelletonx,silvermoon,959,warrior,fury,18,10,8
Осадчийофдес,soulflayer,959,warrior,fury,18,10,8
Psixi,stormscale,959,warrior,fury,18,10,8
Belmønt,archimonde,959,warrior,fury,18,10,8
Bím,archimonde,959,warrior,fury,18,10,8
Giardi,zuljin,959,warrior,fury,21,11,10
Nrog,blackrock,959,warrior,fury,20,10,10
Vandarms,archimonde,959,warrior,fury,24,10,14
Bøgatyr,draenor,959,warrior,fury,24,10,14
Xurainlol,eredar,958,warrior,fury,12,10,2
Dimethefoxx,argent-dawn,958,warrior,fury,16,11,5
Kaveli,tarren-mill,958,warrior,fury,18,10,8
Supremas,eonar,958,warrior,fury,18,10,8
Avgorcgodx,stormscale,958,warrior,fury,18,10,8
Antilopkräm,kazzak,958,warrior,fury,18,10,8
Hundar,archimonde,958,warrior,fury,18,10,8
Profwar,drakthul,958,warrior,fury,18,10,8
Гневиболь,gordunni,958,warrior,fury,18,10,8
Korama,emerald-dream,958,warrior,fury,24,10,14
Taaø,ravencrest,958,warrior,fury,24,10,14
Zvt,argent-dawn,958,warrior,fury,24,10,14
Оргрриммар,soulflayer,958,warrior,fury,24,10,14
Razoo,stormscale,958,warrior,fury,30,10,20
Immera,silvermoon,957,warrior,fury,18,10,8
Freeorc,blackmoore,957,warrior,fury,18,10,8
Budwise,stormscale,957,warrior,fury,18,10,8
Лотархард,gordunni,957,warrior,fury,18,10,8
Etelä,stormreaver,957,warrior,fury,18,10,8
Sørêy,aegwynn,957,warrior,fury,21,11,10
Pakusrage,defias-brotherhood,957,warrior,fury,24,10,14
Viviora,blackmoore,956,warrior,fury,12,10,2
Settin,silvermoon,956,warrior,fury,18,10,8
Haraldjuhnke,frostwolf,956,warrior,fury,18,10,8
Вардроу,howling-fjord,956,warrior,fury,18,10,8
Chrobochrot,burning-blade,956,warrior,fury,24,10,14
Kurenn,tarren-mill,956,warrior,fury,30,10,20
Nætøx,ravencrest,955,warrior,fury,18,10,8
Julmawarru,twisting-nether,955,warrior,fury,24,10,14
Lortèn,stormscale,955,warrior,fury,24,10,14
Nozhar,stormscale,955,warrior,fury,24,10,14
Dreadnova,tarren-mill,954,warrior,fury,24,10,14
Herkalandor,ragnaros,954,warrior,fury,86,33,53
Ампутиль,gordunni,953,warrior,fury,18,10,8
Xonnico,ravencrest,953,warrior,fury,30,11,19
Raksor,hyjal,952,warrior,fury,21,11,10
Byorr,marécage-de-zangar,952,warrior,fury,24,10,14
Thebiggreen,twisting-nether,951,warrior,fury,18,10,8
Cesaro,blackhand,951,warrior,fury,24,10,14
Лизерус,eversong,949,warrior,fury,12,10,2
Uknowmeh,twisting-nether,949,warrior,fury,21,13,8
Inexo,blackrock,949,warrior,fury,42,18,24
Allric,sylvanas,949,warrior,fury,24,10,14
Potátonerd,kazzak,949,warrior,fury,24,10,14
Zhubaiji,ravencrest,948,warrior,fury,30,10,20
Mikylothar,kazzak,945,warrior,fury,18,10,8
Erenowski,twisting-nether,945,warrior,fury,24,10,14
Xaturesw,twisting-nether,943,warrior,fury,12,10,2
Mane,thunderhorn,943,warrior,fury,24,14,10
Gunnarre,khaz-modan,941,warrior,fury,24,10,14
Gueboparado,sanguino,941,warrior,fury,36,10,26
Miotyz,ahnqiraj,940,warrior,fury,24,10,14
Гаргончик,gordunni,939,warrior,fury,30,10,20
Killaa,magtheridon,937,warrior,fury,30,10,20
Эребб,howling-fjord,935,warrior,fury,96,46,50
Schildwall,aegwynn,933,warrior,fury,24,10,14
Hazl,balnazzar,931,warrior,fury,62,33,29
Dolora,ragnaros,930,warrior,fury,50,23,27
Alepou,talnivarr,930,warrior,fury,24,10,14
Titanhaut,frostwolf,929,warrior,fury,18,10,8
Oxandrolona,argent-dawn,926,warrior,fury,30,10,20
Cleaver,tarren-mill,925,warrior,fury,23,10,13
Solatika,alexstrasza,924,warrior,fury,201,102,99
Ocelote,elune,923,warrior,fury,36,19,17
Deamonn,kazzak,923,warrior,fury,23,10,13
Colluba,frostwolf,922,warrior,fury,65,37,28
Niozihex,the-maelstrom,921,warrior,fury,63,27,36
Dirtybugga,nagrand,916,warrior,fury,16,11,5
Fwgzl,silvermoon,913,warrior,fury,226,103,123
Falaliss,elune,912,warrior,fury,80,35,45
Tgabor,ragnaros,911,warrior,fury,15,10,5
Skorm,mugthol,911,warrior,fury,17,10,7
Aciu,doomhammer,911,warrior,fury,18,10,8
Arlan,dragonblight,907,warrior,fury,59,15,44
Sleeplessjx,blackmoore,906,warrior,fury,27,11,16
Лилслайм,gordunni,905,warrior,fury,48,25,23
Taurras,nathrezim,900,warrior,fury,162,82,80
Dullegriet,veknilash,897,warrior,fury,43,11,32
Арнвальд,galakrond,896,warrior,fury,36,18,18
Pinkblast,sylvanas,895,warrior,fury,11,10,1
Gardur,blackrock,895,warrior,fury,15,11,4
Murgrimm,die-silberne-hand,895,warrior,fury,99,48,51
Ezop,burning-blade,894,warrior,fury,16,10,6
Zeteta,sanguino,894,warrior,fury,68,19,49
Rüüd,mannoroth,892,warrior,fury,14,10,4
Gnompower,archimonde,892,warrior,fury,17,10,7
Warallari,khaz-modan,892,warrior,fury,56,27,29
Jhoakim,argent-dawn,892,warrior,fury,27,10,17
Djranji,kazzak,891,warrior,fury,22,10,12
Jacklyhn,kazzak,891,warrior,fury,26,10,16
Bëlzé,les-clairvoyants,887,warrior,fury,38,14,24
Kirix,aegwynn,883,warrior,fury,41,20,21
Shinnok,stormreaver,879,warrior,fury,48,20,28
Mélin,ravencrest,876,warrior,fury,19,10,9
Jâbs,hyjal,875,warrior,fury,36,11,25
Горячийогонь,soulflayer,867,warrior,fury,27,10,17
Stroj,aerie-peak,865,warrior,fury,90,45,45
Navarius,defias-brotherhood,864,warrior,fury,12,9,3
Planina,ravencrest,864,warrior,fury,12,9,3
Kaieh,argent-dawn,864,warrior,fury,12,9,3
Kihili,twisting-nether,864,warrior,fury,12,9,3
Ønlyfâns,stormscale,864,warrior,fury,12,9,3
Домино,thermaplugg,864,warrior,fury,12,9,3
Лёшавор,howling-fjord,864,warrior,fury,18,9,9
Sjet,terrordar,864,warrior,fury,18,9,9
Lildaddypump,ravencrest,864,warrior,fury,18,9,9
Мираккл,borean-tundra,864,warrior,fury,24,9,15
Watergate,ysondre,864,warrior,fury,24,9,15
Nalx,tarren-mill,863,warrior,fury,12,9,3
Âshkä,ysondre,863,warrior,fury,12,9,3
Tölkki,stormscale,863,warrior,fury,12,9,3
Lubomir,kazzak,863,warrior,fury,12,9,3
Therealskull,grim-batol,863,warrior,fury,18,9,9
Gargaflike,aggra-português,863,warrior,fury,18,9,9
Balyndâ,aegwynn,863,warrior,fury,18,9,9
Nallepúh,silvermoon,863,warrior,fury,18,9,9
Showerfresh,silvermoon,863,warrior,fury,18,9,9
Khvor,blackmoore,863,warrior,fury,18,9,9
Littlewar,hyjal,863,warrior,fury,18,9,9
Грэйм,gordunni,863,warrior,fury,18,9,9
Нейв,blackscar,863,warrior,fury,18,9,9
Пепежаа,gordunni,863,warrior,fury,18,9,9
Skylåw,archimonde,863,warrior,fury,18,9,9
Baboonqt,hyjal,863,warrior,fury,18,9,9
Micromachine,argent-dawn,863,warrior,fury,18,9,9
Furanos,blackrock,863,warrior,fury,18,9,9
Preliator,outland,863,warrior,fury,18,9,9
Incendix,stormscale,863,warrior,fury,18,9,9
Qred,darksorrow,863,warrior,fury,18,9,9
Landstar,silvermoon,863,warrior,fury,18,9,9
Khrund,burning-legion,863,warrior,fury,32,14,18
Warhero,burning-legion,862,warrior,fury,12,9,3
Badwarr,blackhand,862,warrior,fury,12,9,3
Realstars,tichondrius,862,warrior,fury,12,9,3
Grimleaper,twisting-nether,862,warrior,fury,18,9,9
Rândy,confrérie-du-thorium,862,warrior,fury,18,9,9
Obitron,argent-dawn,862,warrior,fury,18,9,9
Melted,ravencrest,862,warrior,fury,18,9,9
Bladestormxx,blackmoore,862,warrior,fury,18,9,9
Raley,ragnaros,862,warrior,fury,18,9,9
Pílot,ravencrest,862,warrior,fury,21,10,11
Bigblackmooh,tarren-mill,862,warrior,fury,20,9,11
Urdeadbro,blackhand,862,warrior,fury,24,9,15
Vìbe,archimonde,862,warrior,fury,24,9,15
Abubrhm,kazzak,861,warrior,fury,12,9,3
Denshyel,dun-modr,861,warrior,fury,15,10,5
Zehirjin,sargeras,861,warrior,fury,18,9,9
Dieselengine,draenor,861,warrior,fury,18,9,9
Bruxus,blackhand,861,warrior,fury,18,9,9
Lugalkien,nemesis,861,warrior,fury,30,9,21
Afk,emeriss,860,warrior,fury,18,9,9
Warpath,drakthul,860,warrior,fury,18,9,9
Scorpiom,draenor,860,warrior,fury,24,9,15
Кингкраш,gordunni,860,warrior,fury,24,9,15
Deathrazór,stormscale,859,warrior,fury,18,9,9
Божэство,gordunni,859,warrior,fury,24,9,15
Valkirya,arthas,859,warrior,fury,30,9,21
Warrasy,zenedar,858,warrior,fury,15,10,5
Bigoö,dun-modr,858,warrior,fury,18,9,9
Iwts,archimonde,858,warrior,fury,18,9,9
Fïreflý,kazzak,857,warrior,fury,24,9,15
Celean,darksorrow,855,warrior,fury,12,9,3
Keaile,tarren-mill,855,warrior,fury,18,9,9
Mihari,kirin-tor,853,warrior,fury,30,9,21
Dakul,earthen-ring,852,warrior,fury,18,9,9
Semanor,aegwynn,852,warrior,fury,18,9,9
Откачкакала,blackscar,846,warrior,fury,17,9,8
Glavý,burning-legion,845,warrior,fury,23,9,14
Rédsonja,chamber-of-aspects,844,warrior,fury,76,35,41
Giemb,doomhammer,844,warrior,fury,78,28,50
Telamonas,haomarush,839,warrior,fury,18,9,9
Tiscanno,nemesis,833,warrior,fury,134,64,70
Apocrypha,darkspear,830,warrior,fury,23,9,14
Boomslane,twisting-nether,829,warrior,fury,17,9,8
Pollverizer,ghostlands,827,warrior,fury,51,21,30
Albabhaltair,quelthalas,826,warrior,fury,42,18,24
Nainpossible,marécage-de-zangar,825,warrior,fury,18,9,9
Endro,burning-legion,822,warrior,fury,17,9,8
Iæ,perenolde,818,warrior,fury,18,9,9
Jøtawarrior,sanguino,815,warrior,fury,17,9,8
Варриорнир,howling-fjord,814,warrior,fury,14,10,4
Kímó,silvermoon,814,warrior,fury,15,9,6
Pixelknight,argent-dawn,813,warrior,fury,15,10,5
Zerathos,emerald-dream,807,warrior,fury,114,40,74
Zames,ravencrest,804,warrior,fury,29,11,18
Miina,blutkessel,802,warrior,fury,18,9,9
Gunma,ragnaros,788,warrior,fury,66,27,39
Filador,wildhammer,788,warrior,fury,30,12,18
Parteyunques,sanguino,783,warrior,fury,19,9,10
Коттэлаттэ,gordunni,771,warrior,fury,33,10,23
Sargul,ragnaros,768,warrior,fury,12,8,4
Cleavnseagal,ravencrest,768,warrior,fury,12,8,4
Zern,draenor,768,warrior,fury,12,8,4
Solairexc,ravencrest,768,warrior,fury,12,8,4
Бигдэм,howling-fjord,768,warrior,fury,12,8,4
Grkpwh,silvermoon,768,warrior,fury,12,8,4
Grundbulten,tarren-mill,768,warrior,fury,12,8,4
ßladex,azshara,768,warrior,fury,12,8,4
Nagibon,drakthul,768,warrior,fury,12,8,4
Chaseheal,frostwolf,768,warrior,fury,12,8,4
Бэнчпресс,soulflayer,768,warrior,fury,12,8,4
Pasor,ysondre,768,warrior,fury,12,8,4
Zeldius,kazzak,768,warrior,fury,12,8,4
Xecutie,antonidas,768,warrior,fury,12,8,4
Trensexual,twisting-nether,768,warrior,fury,12,8,4
Grroom,tarren-mill,768,warrior,fury,12,8,4
Ironfangs,argent-dawn,768,warrior,fury,12,8,4
Lzp,ravencrest,768,warrior,fury,12,8,4
Гатал,howling-fjord,768,warrior,fury,18,8,10
Цикламея,blackscar,768,warrior,fury,18,8,10
Tweaked,argent-dawn,768,warrior,fury,18,8,10
Untiltèd,ravencrest,768,warrior,fury,18,8,10
Mobyl,twisting-nether,768,warrior,fury,18,8,10
Kondomi,stormreaver,768,warrior,fury,18,8,10
Nightvision,skullcrusher,768,warrior,fury,18,8,10
Joéfernandés,sylvanas,768,warrior,fury,18,8,10
Keññyfðx,ysondre,768,warrior,fury,18,8,10
Zimbabakunda,ravencrest,768,warrior,fury,18,8,10
Shazzang,kazzak,768,warrior,fury,18,8,10
Visari,kiljaeden,768,warrior,fury,18,8,10
Azladan,sylvanas,768,warrior,fury,30,9,21
Birikkin,draenor,767,warrior,fury,12,8,4
Kìrìtosan,pozzo-delleternità,767,warrior,fury,12,8,4
Skeptikal,argent-dawn,767,warrior,fury,12,8,4
Intensive,blackmoore,767,warrior,fury,12,8,4
Rooflolly,argent-dawn,767,warrior,fury,12,8,4
Báshx,outland,767,warrior,fury,12,8,4
Онатолька,eversong,767,warrior,fury,16,9,7
Manomamix,archimonde,767,warrior,fury,15,8,7
Nainculay,kaelthas,767,warrior,fury,16,8,8
Gonutz,sylvanas,767,warrior,fury,18,8,10
Jagannath,stormscale,767,warrior,fury,18,8,10
Youras,outland,767,warrior,fury,18,8,10
Ðíscøwârrìør,nethersturm,767,warrior,fury,18,8,10
Dallion,azjolnerub,767,warrior,fury,18,8,10
Rndname,malganis,767,warrior,fury,18,8,10
Akril,kelthuzad,767,warrior,fury,18,8,10
Vãnquish,archimonde,767,warrior,fury,18,8,10
Kosush,archimonde,767,warrior,fury,18,8,10
Saarhoy,silvermoon,767,warrior,fury,18,8,10
Ødên,frostmane,767,warrior,fury,18,8,10
Bstgame,frostmane,767,warrior,fury,18,8,10
Bravest,ragnaros,767,warrior,fury,18,8,10
Dollybúrster,aegwynn,767,warrior,fury,18,8,10
Bulgrash,blackmoore,767,warrior,fury,18,8,10
Изберг,soulflayer,767,warrior,fury,18,8,10
Arandyr,archimonde,767,warrior,fury,18,8,10
Гантелявухо,blackscar,767,warrior,fury,20,8,12
Rîdler,ravencrest,767,warrior,fury,24,8,16
Furiousbele,burning-legion,767,warrior,fury,24,8,16
Глинм,gordunni,767,warrior,fury,24,8,16
Warriur,silvermoon,766,warrior,fury,12,8,4
Hekto,burning-legion,766,warrior,fury,12,8,4
Sarkan,ravencrest,766,warrior,fury,18,8,10
Pitbonez,archimonde,766,warrior,fury,18,8,10
Deadwaifu,ragnaros,766,warrior,fury,18,8,10
Pahgorim,blackhand,766,warrior,fury,18,8,10
Throndin,dun-modr,766,warrior,fury,24,8,16
Hardwørk,kazzak,765,warrior,fury,12,8,4
Knussnacker,sanguino,765,warrior,fury,12,8,4
Naevus,aszune,765,warrior,fury,18,8,10
Roninwar,the-maelstrom,764,warrior,fury,18,8,10
Imelite,antonidas,764,warrior,fury,18,8,10
Malasortë,sylvanas,764,warrior,fury,18,8,10
Уравниттель,gordunni,764,warrior,fury,18,8,10
Ryuma,lordaeron,764,warrior,fury,18,8,10
Furginox,argent-dawn,764,warrior,fury,24,8,16
Tsu,karazhan,763,warrior,fury,18,8,10
Cazzpowa,frostmane,762,warrior,fury,12,8,4
Theunknown,eonar,762,warrior,fury,24,8,16
Rammaxx,tarren-mill,761,warrior,fury,18,8,10
Ксартус,gordunni,760,warrior,fury,24,8,16
Ремарус,fordragon,759,warrior,fury,12,8,4
Катахцифури,blackscar,759,warrior,fury,27,9,18
Czarian,ragnaros,759,warrior,fury,36,8,28
Guinnasse,khaz-modan,757,warrior,fury,26,10,16
Армирован,howling-fjord,757,warrior,fury,24,8,16
Ошинай,gordunni,756,warrior,fury,18,8,10
Uleixoshark,argent-dawn,754,warrior,fury,18,8,10
Zarkos,onyxia,754,warrior,fury,24,8,16
Jebiga,forscherliga,751,warrior,fury,30,8,22
Worcan,blackmoore,749,warrior,fury,21,9,12
Xguildone,magtheridon,749,warrior,fury,124,51,73
Gobloater,draenor,747,warrior,fury,30,8,22
Tysónfury,draenor,734,warrior,fury,17,8,9
Aedin,ravencrest,734,warrior,fury,17,8,9
Branzei,darkspear,731,warrior,fury,22,8,14
Fawa,argent-dawn,719,warrior,fury,15,8,7
Padzwarr,kazzak,719,warrior,fury,15,8,7
Вагранна,soulflayer,719,warrior,fury,17,8,9
Bragush,shattrath,718,warrior,fury,11,8,3
Quebradita,tyrande,715,warrior,fury,21,8,13
Stix,nemesis,713,warrior,fury,33,9,24
Abus,zuljin,703,warrior,fury,22,8,14
Manelar,draenor,702,warrior,fury,14,8,6
Weaknezz,aegwynn,701,warrior,fury,16,8,8
Kilkov,emeriss,701,warrior,fury,16,8,8
Grekowar,dalaran,700,warrior,fury,17,8,9
Amédé,ysondre,697,warrior,fury,17,8,9
Isgrah,kazzak,696,warrior,fury,11,8,3
Leyenda,steamwheedle-cartel,689,warrior,fury,23,8,15
Giltiné,runetotem,687,warrior,fury,13,8,5
Balro,blackmoore,680,warrior,fury,23,9,14
Bubbsi,turalyon,674,warrior,fury,24,8,16
Дмидрашх,howling-fjord,672,warrior,fury,10,8,2
Thighbreaker,silvermoon,672,warrior,fury,12,7,5
Holtzman,dun-modr,672,warrior,fury,12,7,5
Dortenz,ragnaros,672,warrior,fury,12,7,5
Jollypig,stormscale,672,warrior,fury,12,7,5
Инкула,gordunni,672,warrior,fury,12,7,5
Pizzadoros,twisting-nether,672,warrior,fury,12,7,5
Beached,outland,672,warrior,fury,12,7,5
Paindrain,burning-blade,672,warrior,fury,12,7,5
Rasmoos,twisting-nether,672,warrior,fury,12,7,5
Harbor,burning-blade,672,warrior,fury,12,7,5
Fragsonic,stormscale,672,warrior,fury,12,7,5
Alyx,mugthol,672,warrior,fury,12,7,5
Pablitø,silvermoon,672,warrior,fury,12,7,5
Synnsan,eredar,672,warrior,fury,12,7,5
Khrtw,silvermoon,672,warrior,fury,12,7,5
Vjack,azjolnerub,672,warrior,fury,12,7,5
Escapeartíst,ravencrest,672,warrior,fury,12,7,5
Hortswarr,drakthul,672,warrior,fury,12,7,5
Думслэер,gordunni,672,warrior,fury,12,7,5
Blitzmarck,ragnaros,672,warrior,fury,12,7,5
Yuuta,ravencrest,672,warrior,fury,12,7,5
Norwegian,silvermoon,672,warrior,fury,12,7,5
Karpzug,stormscale,672,warrior,fury,12,7,5
Hàssard,outland,672,warrior,fury,12,7,5
Shaqtastic,burning-legion,672,warrior,fury,12,7,5
Ézélya,dalaran,672,warrior,fury,12,7,5
Rektdrum,ravencrest,672,warrior,fury,12,7,5
Parafilia,uldum,672,warrior,fury,12,7,5
Кефтеме,fordragon,672,warrior,fury,12,7,5
Wutrajunior,kazzak,672,warrior,fury,12,7,5
Lamettaheini,tichondrius,672,warrior,fury,12,7,5
Youstupide,drekthar,672,warrior,fury,12,7,5
Saurens,twisting-nether,672,warrior,fury,12,7,5
Yaune,ravencrest,672,warrior,fury,18,7,11
Destruct,tarren-mill,672,warrior,fury,18,7,11
Devso,ravencrest,672,warrior,fury,18,7,11
Arcreign,kazzak,672,warrior,fury,18,7,11
Учихагодх,howling-fjord,672,warrior,fury,18,7,11
Ретвир,gordunni,672,warrior,fury,18,7,11
Shintuargar,blackrock,672,warrior,fury,18,7,11
Foboa,archimonde,672,warrior,fury,18,7,11
Corlo,uldaman,672,warrior,fury,18,7,11
Gramrosh,eredar,672,warrior,fury,18,7,11
Banshe,ragnaros,672,warrior,fury,18,7,11
Дернианус,gordunni,672,warrior,fury,18,7,11
Rarae,kazzak,672,warrior,fury,18,7,11
Omcat,dun-modr,672,warrior,fury,18,7,11
Awan,malygos,672,warrior,fury,18,7,11
Кэйкан,gordunni,672,warrior,fury,18,7,11
Zathoro,thunderhorn,672,warrior,fury,18,7,11
Himarsenko,silvermoon,672,warrior,fury,24,7,17
Timmyda,dalaran,671,warrior,fury,12,7,5
Sargonas,burning-blade,671,warrior,fury,12,7,5
Sniperwølf,tyrande,671,warrior,fury,12,7,5
Lôreex,ravencrest,671,warrior,fury,12,7,5
Rryba,blackrock,671,warrior,fury,12,7,5
Broknagar,draenor,671,warrior,fury,12,7,5
Repzcanor,silvermoon,671,warrior,fury,12,7,5
Roitz,tarren-mill,671,warrior,fury,12,7,5
Showneck,blackmoore,671,warrior,fury,12,7,5
Sâfe,malganis,671,warrior,fury,12,7,5
Shayarielle,zirkel-des-cenarius,671,warrior,fury,12,7,5
Pépêloup,archimonde,671,warrior,fury,12,7,5
Septymyya,eredar,671,warrior,fury,15,8,7
Kajizo,frostmane,671,warrior,fury,15,7,8
Kröma,hyjal,671,warrior,fury,16,7,9
Ancore,kilrogg,671,warrior,fury,18,7,11
Dupnica,kazzak,671,warrior,fury,18,7,11
Wakarimaszka,ragnaros,671,warrior,fury,18,7,11
Рипаю,howling-fjord,671,warrior,fury,18,7,11
Zonash,kazzak,671,warrior,fury,18,7,11
Rangnarr,doomhammer,671,warrior,fury,18,7,11
Lurchusrexus,ysera,671,warrior,fury,18,7,11
Âxti,blackrock,671,warrior,fury,18,7,11
Auguston,argent-dawn,671,warrior,fury,18,7,11
Grimdorf,frostmane,671,warrior,fury,18,7,11
Jaowa,blackmoore,671,warrior,fury,18,7,11
Spaltero,blackhand,671,warrior,fury,18,7,11
Zkb,zuljin,671,warrior,fury,18,7,11
Bonnejournée,stormscale,671,warrior,fury,18,7,11
Lagiovanni,draenor,671,warrior,fury,21,8,13
Hzdwarr,kazzak,671,warrior,fury,24,7,17
Ukloth,sanguino,671,warrior,fury,25,7,18
Izrael,alakir,670,warrior,fury,12,7,5
Ölaff,ravencrest,670,warrior,fury,12,7,5
Chadchadsson,ravencrest,670,warrior,fury,12,7,5
Obaru,antonidas,670,warrior,fury,12,7,5
Terminatòr,pozzo-delleternità,670,warrior,fury,16,8,8
Кейнорин,howling-fjord,670,warrior,fury,18,7,11
Masster,argent-dawn,670,warrior,fury,18,7,11
Zargala,stormscale,670,warrior,fury,18,7,11
Xayyen,azjolnerub,670,warrior,fury,18,7,11
Bloódángel,frostwolf,670,warrior,fury,18,7,11
Durus,burning-blade,670,warrior,fury,18,7,11
Saisahan,hyjal,670,warrior,fury,21,8,13
Starqq,blackrock,670,warrior,fury,24,7,17
Bankaju,burning-legion,669,warrior,fury,18,7,11
Wilmazutschn,nethersturm,669,warrior,fury,18,7,11
Wasok,antonidas,669,warrior,fury,24,7,17
Grenad,kazzak,668,warrior,fury,18,7,11
Хенесии,soulflayer,667,warrior,fury,21,8,13
Juanvaco,tarren-mill,667,warrior,fury,30,7,23
Squart,wrathbringer,663,warrior,fury,18,7,11
Kasi,blackmoore,656,warrior,fury,18,7,11
Strânge,gorgonnash,654,warrior,fury,17,7,10
Gozga,twisting-nether,639,warrior,fury,11,7,4
Mongojones,outland,623,warrior,fury,11,7,4
Lynnie,doomhammer,623,warrior,fury,33,7,26
Nèssa,outland,607,warrior,fury,14,7,7
Scofiéld,lordaeron,601,warrior,fury,11,7,4
Lykevil,medivh,598,warrior,fury,20,7,13
Quarantino,ysondre,590,warrior,fury,23,7,16
Córswain,silvermoon,576,warrior,fury,6,6,0
Vyndari,argent-dawn,576,warrior,fury,6,6,0
Rhagnok,archimonde,576,warrior,fury,6,6,0
Tìtànìà,blackmoore,576,warrior,fury,6,6,0
Thomasman,nerathor,576,warrior,fury,6,6,0
Артэкриогг,soulflayer,576,warrior,fury,6,6,0
Асгинор,gordunni,576,warrior,fury,12,6,6
Lanahan,argent-dawn,576,warrior,fury,12,6,6
Kalho,ravencrest,576,warrior,fury,12,6,6
Rexonawarr,kazzak,576,warrior,fury,12,6,6
Ðummy,argent-dawn,576,warrior,fury,12,6,6
Reyhan,nemesis,576,warrior,fury,12,6,6
Azudaddy,blackmoore,576,warrior,fury,12,6,6
Maowiecki,burning-legion,576,warrior,fury,12,6,6
Timagno,nemesis,576,warrior,fury,12,6,6
Texcitwow,sylvanas,576,warrior,fury,12,6,6
Sakumo,sylvanas,576,warrior,fury,12,6,6
Thogrêy,archimonde,576,warrior,fury,12,6,6
Weendslash,draenor,576,warrior,fury,12,6,6
Geckoo,emerald-dream,576,warrior,fury,12,6,6
Pirovolo,twilights-hammer,576,warrior,fury,12,6,6
Rudvard,hyjal,576,warrior,fury,12,6,6
Braindeady,burning-legion,576,warrior,fury,12,6,6
Gnomet,auchindoun,576,warrior,fury,12,6,6
Дуглимон,gordunni,576,warrior,fury,12,6,6
Rarcus,chamber-of-aspects,576,warrior,fury,12,6,6
Æriø,dalaran,576,warrior,fury,12,6,6
Masida,senjin,576,warrior,fury,12,6,6
Dagon,dentarg,576,warrior,fury,12,6,6
Rylbrah,blackmoore,576,warrior,fury,12,6,6
Mâggus,antonidas,576,warrior,fury,12,6,6
Lüund,ravencrest,576,warrior,fury,12,6,6
Nabb,outland,576,warrior,fury,12,6,6
Гигасмэш,gordunni,576,warrior,fury,12,6,6
Änvil,tarren-mill,576,warrior,fury,12,6,6
Саркон,ashenvale,576,warrior,fury,12,6,6
Sêrên,dun-modr,576,warrior,fury,12,6,6
Dhloos,kazzak,576,warrior,fury,12,6,6
Yenkonov,blackmoore,576,warrior,fury,12,6,6
Rinowar,archimonde,576,warrior,fury,12,6,6
Виртилий,soulflayer,576,warrior,fury,12,6,6
Shownomercy,blackrock,576,warrior,fury,12,6,6
Thegullet,draenor,576,warrior,fury,12,6,6
Роули,blackscar,576,warrior,fury,12,6,6
Ränchiëk,ravencrest,576,warrior,fury,12,6,6
Dominikhasek,stormscale,576,warrior,fury,12,6,6
Filoliha,silvermoon,576,warrior,fury,12,6,6
Balthew,defias-brotherhood,576,warrior,fury,12,6,6
Luchanka,the-maelstrom,576,warrior,fury,12,6,6
Омертин,howling-fjord,576,warrior,fury,12,6,6
Sovereign,kelthuzad,576,warrior,fury,12,6,6
Фктпх,blackscar,576,warrior,fury,12,6,6
Engalxsol,tarren-mill,576,warrior,fury,12,6,6
Stanfury,sylvanas,576,warrior,fury,12,6,6
Malyôrs,archimonde,576,warrior,fury,12,6,6
Aurélus,rexxar,576,warrior,fury,12,6,6
Gewaltbereit,malygos,576,warrior,fury,12,6,6
Onkra,malganis,576,warrior,fury,12,6,6
Tobythewarr,stormscale,576,warrior,fury,12,6,6
Nøcturnaqq,silvermoon,576,warrior,fury,12,6,6
Xiom,blackrock,576,warrior,fury,12,6,6
Kriegsfürsti,antonidas,576,warrior,fury,15,7,8
Ðjlækker,silvermoon,576,warrior,fury,18,6,12
Эксихард,gordunni,576,warrior,fury,18,6,12
Deswarr,tarren-mill,576,warrior,fury,18,6,12
Hulkzmash,tarren-mill,576,warrior,fury,18,6,12
Illmìndofboo,twisting-nether,576,warrior,fury,18,6,12
Bobolalegend,dalaran,576,warrior,fury,18,6,12
Guerriax,les-sentinelles,576,warrior,fury,18,6,12
Сталиран,gordunni,576,warrior,fury,18,6,12
Gladiatoor,terenas,576,warrior,fury,18,6,12
Velinde,outland,576,warrior,fury,18,6,12
Prettyangel,aegwynn,576,warrior,fury,18,6,12
Blæsild,ravencrest,576,warrior,fury,18,6,12
Stévé,kazzak,576,warrior,fury,24,6,18
Slyra,grim-batol,575,warrior,fury,12,6,6
Zulien,sanguino,575,warrior,fury,12,6,6
Моргаур,howling-fjord,575,warrior,fury,12,6,6
Nihroxis,blackrock,575,warrior,fury,12,6,6
Skribe,blackmoore,575,warrior,fury,12,6,6
Zaurzyfang,burning-legion,575,warrior,fury,12,6,6
Dariius,dun-modr,575,warrior,fury,12,6,6
Dübèl,blackrock,575,warrior,fury,12,6,6
Richymorty,los-errantes,575,warrior,fury,12,6,6
Esegryel,argent-dawn,575,warrior,fury,12,6,6
Roykór,auchindoun,575,warrior,fury,12,6,6
Jâmâli,malganis,575,warrior,fury,12,6,6
Durrüti,sanguino,575,warrior,fury,12,6,6
Slappie,kiljaeden,575,warrior,fury,12,6,6
Berzzerker,tarren-mill,575,warrior,fury,12,6,6
Ffrancis,eldrethalas,575,warrior,fury,12,6,6
Marjorieann,drakthul,575,warrior,fury,12,6,6
Granni,archimonde,575,warrior,fury,12,6,6
Xenesthis,dun-morogh,575,warrior,fury,12,6,6
Vmnbgh,aszune,575,warrior,fury,12,6,6
Warrz,turalyon,575,warrior,fury,12,6,6
Kogän,ragnaros,575,warrior,fury,12,6,6
Leorx,draenor,575,warrior,fury,12,6,6
Eiche,kazzak,575,warrior,fury,18,6,12
Nidwar,quelthalas,575,warrior,fury,18,6,12
Tîrael,antonidas,575,warrior,fury,18,6,12
Rotgesicht,blackrock,575,warrior,fury,18,6,12
Saevitius,aegwynn,575,warrior,fury,18,6,12
Maelvos,ravencrest,575,warrior,fury,18,6,12
Akäme,ysondre,575,warrior,fury,18,6,12
Argomor,stormscale,575,warrior,fury,18,6,12
Opwarrko,drakthul,575,warrior,fury,18,6,12
Khazoroth,blackmoore,575,warrior,fury,18,6,12
Xuyaw,kazzak,575,warrior,fury,18,6,12
Tyranitar,pozzo-delleternità,575,warrior,fury,18,6,12
Kiryn,draenor,575,warrior,fury,18,6,12
Niukí,blackmoore,575,warrior,fury,20,6,14
Exødiä,hyjal,574,warrior,fury,12,6,6
Вкусныисыр,soulflayer,574,warrior,fury,12,6,6
Bruko,silvermoon,574,warrior,fury,12,6,6
Denisamanea,chamber-of-aspects,574,warrior,fury,18,6,12
Xeonair,kazzak,574,warrior,fury,24,7,17
Admiràl,azuremyst,573,warrior,fury,12,6,6
Gomblin,blackmoore,573,warrior,fury,12,6,6
Booya,laughing-skull,573,warrior,fury,24,6,18
Scrin,ravenholdt,573,warrior,fury,24,6,18
Джомалкович,deathweaver,572,warrior,fury,12,6,6
Deushill,sylvanas,570,warrior,fury,12,6,6
Ragghatt,draenor,570,warrior,fury,18,6,12
Xaguu,magtheridon,570,warrior,fury,18,6,12
Bhzerrkk,nerathor,564,warrior,fury,24,6,18
Trickzît,silvermoon,559,warrior,fury,11,6,5
Loty,drakthul,559,warrior,fury,17,6,11
Røidrage,stormscale,559,warrior,fury,20,7,13
Wrcia,ragnaros,558,warrior,fury,10,7,3
Mokwo,chogall,543,warrior,fury,14,7,7
Долирия,gordunni,543,warrior,fury,14,7,7
Refl,kazzak,543,warrior,fury,17,6,11
Eljakko,sanguino,542,warrior,fury,14,7,7
Жлобьен,howling-fjord,542,warrior,fury,17,6,11
Piinte,naxxramas,536,warrior,fury,14,7,7
Мегамегаогр,howling-fjord,527,warrior,fury,11,6,5
Happywarrior,silvermoon,527,warrior,fury,11,6,5
Фишар,soulflayer,527,warrior,fury,11,6,5
Skeptikal,tarren-mill,527,warrior,fury,11,6,5
Carton,eredar,527,warrior,fury,11,6,5
Narkololzz,marécage-de-zangar,527,warrior,fury,15,6,9
ßílly,defias-brotherhood,526,warrior,fury,11,6,5
Skillissues,argent-dawn,522,warrior,fury,17,9,8
Retmain,draenor,522,warrior,fury,20,8,12
Kolxoz,doomhammer,521,warrior,fury,21,7,14
Gigadot,arathor,512,warrior,fury,10,6,4
Oluwafunmila,tarren-mill,512,warrior,fury,10,6,4
Shadowwarrio,burning-legion,511,warrior,fury,14,6,8
Крагерр,gordunni,511,warrior,fury,14,6,8
Khartoz,kult-der-verdammten,510,warrior,fury,14,6,8
Dreyker,sanguino,510,warrior,fury,14,6,8
Blutwar,kazzak,499,warrior,fury,25,11,14
Melogranod,nemesis,480,warrior,fury,6,5,1
Дайбек,howling-fjord,480,warrior,fury,6,5,1
Кровьюжадный,fordragon,480,warrior,fury,6,5,1
Ousgrytamer,archimonde,480,warrior,fury,6,5,1
Depopulator,blackmoore,480,warrior,fury,6,5,1
Nîmera,nemesis,480,warrior,fury,6,5,1
Gguts,archimonde,480,warrior,fury,6,5,1
Easypoîntsx,tarren-mill,480,warrior,fury,6,5,1
Bulldòzèr,kazzak,480,warrior,fury,6,5,1
Вульфычч,gordunni,480,warrior,fury,6,5,1
Juoppó,tarren-mill,480,warrior,fury,6,5,1
Juicycrits,ragnaros,480,warrior,fury,6,5,1
Ragoar,blackmoore,480,warrior,fury,6,5,1
Frandor,dalaran,480,warrior,fury,6,5,1
Wítts,ravencrest,480,warrior,fury,6,5,1
Ishbosheth,stormscale,480,warrior,fury,6,5,1
Bârney,ravencrest,480,warrior,fury,6,5,1
Heclatos,hyjal,480,warrior,fury,6,5,1
Arthyx,alexstrasza,480,warrior,fury,6,5,1
Ганахан,soulflayer,480,warrior,fury,6,5,1
Miniwitts,ravencrest,480,warrior,fury,6,5,1
Huxies,draenor,480,warrior,fury,6,5,1
Drîftkîñg,outland,480,warrior,fury,6,5,1
Coko,kirin-tor,480,warrior,fury,6,5,1
Obîwan,dalaran,480,warrior,fury,6,5,1
Kyruk,blackhand,480,warrior,fury,6,5,1
Sumecw,aegwynn,480,warrior,fury,6,5,1
Gigaa,outland,480,warrior,fury,6,5,1
Octtwar,twisting-nether,480,warrior,fury,6,5,1
Civok,kult-der-verdammten,480,warrior,fury,6,5,1
Fáro,ravencrest,480,warrior,fury,6,5,1
Palianytsia,ravencrest,480,warrior,fury,6,5,1
Pihvikostaja,stormreaver,480,warrior,fury,8,5,3
Моядаубить,howling-fjord,480,warrior,fury,10,6,4
Dregath,uldum,480,warrior,fury,12,5,7
Soullmike,drakthul,480,warrior,fury,12,5,7
Stkacha,sanguino,480,warrior,fury,12,5,7
Летакс,fordragon,480,warrior,fury,12,5,7
Daudal,frostwolf,480,warrior,fury,12,5,7
Arthayl,eredar,480,warrior,fury,12,5,7
Ulthrak,archimonde,480,warrior,fury,12,5,7
Æsirr,kazzak,480,warrior,fury,12,5,7
Falnah,sargeras,480,warrior,fury,12,5,7
Кэфтэмэ,soulflayer,480,warrior,fury,12,5,7
Kval,kazzak,480,warrior,fury,12,5,7
Трис,fordragon,480,warrior,fury,12,5,7
Petrixens,drakthul,480,warrior,fury,12,5,7
Kâllay,blackrock,480,warrior,fury,12,5,7
Bîmbämboom,blackmoore,480,warrior,fury,12,5,7
Боевыещёчки,eversong,480,warrior,fury,12,5,7
Riac,lothar,480,warrior,fury,12,5,7
Bíanco,blackrock,480,warrior,fury,12,5,7
Priceswex,ravencrest,480,warrior,fury,12,5,7
Jailegear,archimonde,480,warrior,fury,12,5,7
Darthmalgus,stormscale,480,warrior,fury,12,5,7
Daeriuss,silvermoon,480,warrior,fury,12,5,7
Ахиллслэм,howling-fjord,480,warrior,fury,12,5,7
Rohc,kazzak,480,warrior,fury,12,5,7
Lánse,ravencrest,480,warrior,fury,12,5,7
Idiotabroad,silvermoon,480,warrior,fury,12,5,7
Beznacaj,outland,480,warrior,fury,12,5,7
Skatergirl,stormscale,480,warrior,fury,12,5,7
Имбасенпай,howling-fjord,480,warrior,fury,12,5,7
Zeez,magtheridon,480,warrior,fury,12,5,7
Donvasto,sylvanas,480,warrior,fury,12,5,7
Warrioriox,sylvanas,480,warrior,fury,12,5,7
Incharge,argent-dawn,480,warrior,fury,12,5,7
Носфератузод,booty-bay,480,warrior,fury,12,5,7
Xatit,ravencrest,480,warrior,fury,12,5,7
Schwän,twisting-nether,480,warrior,fury,12,5,7
Iloveit,draenor,480,warrior,fury,12,5,7
Astrid,rajaxx,480,warrior,fury,12,5,7
Jugg,emerald-dream,480,warrior,fury,12,5,7
Mkekw,draenor,480,warrior,fury,12,5,7
Baleroni,burning-legion,480,warrior,fury,12,5,7
Like,blackrock,480,warrior,fury,12,5,7
Тысячидуш,gordunni,480,warrior,fury,12,5,7
Prúne,hyjal,480,warrior,fury,12,5,7
Zillrog,kazzak,480,warrior,fury,12,5,7
Friendlytwo,quelthalas,480,warrior,fury,12,5,7
Ruixxted,stormreaver,480,warrior,fury,12,5,7
Vortok,thrall,480,warrior,fury,12,5,7
Punahabe,draenor,480,warrior,fury,12,5,7
Fury,shattered-halls,480,warrior,fury,12,5,7
Ronaldrage,stormscale,480,warrior,fury,12,5,7
Xirár,sylvanas,480,warrior,fury,12,5,7
Kaîsaschnitt,malganis,480,warrior,fury,12,5,7
Jamyty,burning-legion,480,warrior,fury,12,5,7
Durahán,argent-dawn,480,warrior,fury,12,5,7
Лысыч,gordunni,480,warrior,fury,12,5,7
Damáge,doomhammer,480,warrior,fury,12,5,7
Tanaja,stormscale,480,warrior,fury,12,5,7
Йошихироо,howling-fjord,480,warrior,fury,12,5,7
Rageaholic,blackmoore,480,warrior,fury,12,5,7
Жарочныйшкаф,grom,480,warrior,fury,12,5,7
Orcmanyes,tarren-mill,480,warrior,fury,12,5,7
Lethalsnack,ragnaros,480,warrior,fury,12,5,7
Dauderup,aerie-peak,480,warrior,fury,12,5,7
Obersten,stormscale,480,warrior,fury,12,5,7
Jiziee,varimathras,480,warrior,fury,12,5,7
Bidur,twisting-nether,480,warrior,fury,12,5,7
Ursakhan,sylvanas,480,warrior,fury,15,6,9
Mouldyclunge,argent-dawn,480,warrior,fury,17,5,12
Bindera,silvermoon,480,warrior,fury,18,5,13
Nightmareb,magtheridon,480,warrior,fury,18,5,13
Warjuice,draenor,480,warrior,fury,18,5,13
Sambucá,blackmoore,480,warrior,fury,18,5,13
Delonathor,drakthul,480,warrior,fury,18,5,13
Asuross,dalaran,480,warrior,fury,18,5,13
Fluffeh,argent-dawn,480,warrior,fury,18,5,13
Ytrox,twisting-nether,480,warrior,fury,18,5,13
Jonalina,gilneas,480,warrior,fury,18,5,13
Römådûr,drakthul,480,warrior,fury,23,5,18
Haregos,gorgonnash,479,warrior,fury,6,5,1
Porrter,silvermoon,479,warrior,fury,6,5,1
Hynekiller,silvermoon,479,warrior,fury,12,5,7
Exaldár,veknilash,479,warrior,fury,12,5,7
Cosmoses,mazrigos,479,warrior,fury,12,5,7
Ironsteve,blackmoore,479,warrior,fury,12,5,7
Goshnac,blackmoore,479,warrior,fury,12,5,7
Wärlight,nemesis,479,warrior,fury,12,5,7
Чорныгвард,gordunni,479,warrior,fury,12,5,7
Maidenless,quelthalas,479,warrior,fury,12,5,7
Адвакаат,soulflayer,479,warrior,fury,12,5,7
Sevorok,blackrock,479,warrior,fury,12,5,7
Brutalz,kazzak,479,warrior,fury,12,5,7
Granrubin,dun-modr,479,warrior,fury,12,5,7
Azrail,xavius,479,warrior,fury,12,5,7
Pipsysimp,ragnaros,479,warrior,fury,12,5,7
Luciferkhan,twisting-nether,479,warrior,fury,12,5,7
Ärama,sanguino,479,warrior,fury,14,5,9
Jeembo,blackmoore,479,warrior,fury,18,5,13
Zexsors,kazzak,479,warrior,fury,18,5,13
Pumáni,silvermoon,479,warrior,fury,18,5,13
Rubyodin,tarren-mill,479,warrior,fury,18,5,13
Ельмара,gordunni,479,warrior,fury,18,5,13
Noizekick,ragnaros,479,warrior,fury,23,5,18
Vaeanash,ragnaros,479,warrior,fury,24,5,19
Caiimewiliam,ravencrest,478,warrior,fury,18,5,13
Dorwarhoof,ravencrest,478,warrior,fury,18,5,13
Harny,silvermoon,477,warrior,fury,10,6,4
Devrez,draenor,477,warrior,fury,12,5,7
Grystal,blackrock,477,warrior,fury,24,5,19
Roostai,shattered-hand,476,warrior,fury,12,5,7
Omosha,burning-legion,476,warrior,fury,12,5,7
Soulreaver,twisting-nether,467,warrior,fury,18,5,13
Shorrag,outland,463,warrior,fury,11,5,6
Ascendeadw,kazzak,447,warrior,fury,11,5,6
Dvärgrobot,draenor,447,warrior,fury,11,5,6
Infinitehair,ravencrest,447,warrior,fury,17,5,12
Cidh,sinstralis,446,warrior,fury,8,6,2
Autumnfálls,kazzak,446,warrior,fury,10,6,4
Eriqua,archimonde,431,warrior,fury,11,5,6
Chonku,draenor,431,warrior,fury,11,5,6
Talathas,archimonde,431,warrior,fury,11,5,6
Ievilstylez,malygos,430,warrior,fury,9,5,4
Valrathion,ravencrest,426,warrior,fury,17,8,9
Yugoslav,argent-dawn,426,warrior,fury,16,6,10
Roimyv,archimonde,426,warrior,fury,16,6,10
Confliction,outland,424,warrior,fury,23,6,17
Olagkhan,minahonda,422,warrior,fury,15,6,9
Zeryyo,blackrock,416,warrior,fury,10,5,5
Remen,archimonde,416,warrior,fury,10,5,5
Zecelei,tarren-mill,416,warrior,fury,16,5,11
Футбольчик,thermaplugg,415,warrior,fury,14,5,9
Ronda,nemesis,414,warrior,fury,8,5,3
Famous,argent-dawn,400,warrior,fury,7,5,2
Illyrish,blackmoore,393,warrior,fury,15,6,9
Truepassion,outland,384,warrior,fury,6,4,2
Bersurker,draenor,384,warrior,fury,6,4,2
Highdive,outland,384,warrior,fury,6,4,2
Korghar,xavius,384,warrior,fury,6,4,2
Enraged,tarren-mill,384,warrior,fury,6,4,2
Chipstjuven,tarren-mill,384,warrior,fury,6,4,2
Svinarghulk,twisting-nether,384,warrior,fury,6,4,2
Гневныйвиги,howling-fjord,384,warrior,fury,6,4,2
Razzani,nathrezim,384,warrior,fury,6,4,2
Nutstomper,twisting-nether,384,warrior,fury,6,4,2
Khalifa,stormscale,384,warrior,fury,6,4,2
Кайзерчиф,soulflayer,384,warrior,fury,6,4,2
Calopsith,ysondre,384,warrior,fury,6,4,2
Gurrtug,argent-dawn,384,warrior,fury,6,4,2
Айфилшок,gordunni,384,warrior,fury,6,4,2
Suzzon,hyjal,384,warrior,fury,6,4,2
Баам,fordragon,384,warrior,fury,6,4,2
ßèrserk,hyjal,384,warrior,fury,6,4,2
Exorcisten,silvermoon,384,warrior,fury,6,4,2
Смертокров,greymane,384,warrior,fury,6,4,2
Stickifrån,darkspear,384,warrior,fury,6,4,2
Extasceh,turalyon,384,warrior,fury,6,4,2
Rageweight,ragnaros,384,warrior,fury,6,4,2
Zaerna,draenor,384,warrior,fury,6,4,2
Lôcutus,thrall,384,warrior,fury,6,4,2
Arkcules,ghostlands,384,warrior,fury,6,4,2
Madvlad,twisting-nether,384,warrior,fury,6,4,2
Zhalm,stormscale,384,warrior,fury,6,4,2
Cheesehelmet,stormscale,384,warrior,fury,6,4,2
Kantarion,stormscale,384,warrior,fury,6,4,2
Warbigboss,draenor,384,warrior,fury,6,4,2
Vullgrîm,blackmoore,384,warrior,fury,6,4,2
Maxrior,runetotem,384,warrior,fury,6,4,2
Pierøne,nemesis,384,warrior,fury,6,4,2
Roadsick,outland,384,warrior,fury,6,4,2
Executte,zuljin,384,warrior,fury,6,4,2
Dominow,ysondre,384,warrior,fury,6,4,2
Snuusu,blackmoore,384,warrior,fury,6,4,2
Raikes,argent-dawn,384,warrior,fury,6,4,2
Grumgor,alonsus,384,warrior,fury,6,4,2
Dollystyle,kazzak,384,warrior,fury,6,4,2
Strähne,malganis,384,warrior,fury,6,4,2
Nobelisarius,norgannon,384,warrior,fury,6,4,2
Vixian,ragnaros,384,warrior,fury,6,4,2
Hugobugo,anachronos,384,warrior,fury,6,4,2
Wetrx,stormscale,384,warrior,fury,6,4,2
Bearimwar,ravencrest,384,warrior,fury,6,4,2
Zkou,wrathbringer,384,warrior,fury,6,4,2
Venomflex,sanguino,384,warrior,fury,6,4,2
Hofftor,eredar,384,warrior,fury,6,4,2
Antícide,blackrock,384,warrior,fury,6,4,2
Recklés,frostmourne,384,warrior,fury,6,4,2
Youngshorus,blackmoore,384,warrior,fury,6,4,2
Purporcfr,archimonde,384,warrior,fury,6,4,2
Dmgsponge,stormscale,384,warrior,fury,6,4,2
Jínfu,burning-legion,384,warrior,fury,6,4,2
Biboutons,sargeras,384,warrior,fury,6,4,2
Mornog,blackhand,384,warrior,fury,6,4,2
Shooky,blackrock,384,warrior,fury,6,4,2
Woltzeig,dentarg,384,warrior,fury,6,4,2
Чосо,razuvious,384,warrior,fury,6,4,2
Infernall,burning-legion,384,warrior,fury,6,4,2
Moowar,defias-brotherhood,384,warrior,fury,6,4,2
Bigschnäbi,blackhand,384,warrior,fury,6,4,2
Chickatilo,ravencrest,384,warrior,fury,6,4,2
Plebx,emeriss,384,warrior,fury,6,4,2
Busðriver,tarren-mill,384,warrior,fury,6,4,2
Бейлеор,gordunni,384,warrior,fury,6,4,2
Snirs,echsenkessel,384,warrior,fury,6,4,2
Mórdér,blackmoore,384,warrior,fury,6,4,2
Slayermaxx,kazzak,384,warrior,fury,6,4,2
Данзетар,howling-fjord,384,warrior,fury,6,4,2
Goragash,eredar,384,warrior,fury,6,4,2
Holzi,frostmourne,384,warrior,fury,6,4,2
Впижаме,gordunni,384,warrior,fury,6,4,2
Shuriká,blackmoore,384,warrior,fury,6,4,2
Gandosh,blackmoore,384,warrior,fury,6,4,2
Klonyarika,ravencrest,384,warrior,fury,6,4,2
Anzzwar,silvermoon,384,warrior,fury,6,4,2
Xdpromtius,dun-modr,384,warrior,fury,6,4,2
Johnblejder,burning-legion,384,warrior,fury,6,4,2
Ändrow,dalaran,384,warrior,fury,6,4,2
Gotnuub,tarren-mill,384,warrior,fury,6,4,2
Avelyr,pozzo-delleternità,384,warrior,fury,6,4,2
Daldiee,ravencrest,384,warrior,fury,6,4,2
Feelmyfúry,ravencrest,384,warrior,fury,6,4,2
Myshu,ravencrest,384,warrior,fury,6,4,2
Porkzzilão,aggra-português,384,warrior,fury,6,4,2
Goroth,vashj,384,warrior,fury,7,4,3
Вартон,grom,384,warrior,fury,11,6,5
Kekiko,twisting-nether,384,warrior,fury,10,5,5
Sanhaevel,ravencrest,384,warrior,fury,10,4,6
Lyandraa,outland,384,warrior,fury,12,4,8
Барнетт,gordunni,384,warrior,fury,12,4,8
Причинный,booty-bay,384,warrior,fury,12,4,8
Ganzaésábi,aggra-português,384,warrior,fury,12,4,8
Råkeff,tarren-mill,384,warrior,fury,12,4,8
Natriumwar,magtheridon,384,warrior,fury,12,4,8
Doomz,die-aldor,384,warrior,fury,12,4,8
Athérøs,outland,384,warrior,fury,12,4,8
Колобочек,eversong,384,warrior,fury,12,4,8
Skullcrûsher,archimonde,384,warrior,fury,12,4,8
Tysonfurry,defias-brotherhood,384,warrior,fury,12,4,8
Vearpayne,silvermoon,384,warrior,fury,12,4,8
Bllué,ravencrest,384,warrior,fury,12,4,8
Testonator,outland,384,warrior,fury,12,4,8
Ruz,defias-brotherhood,384,warrior,fury,12,4,8
Aprilis,thrall,384,warrior,fury,12,4,8
Hellevorn,hyjal,384,warrior,fury,12,4,8
Hackzoro,grim-batol,384,warrior,fury,12,4,8
Zangetsú,stormscale,384,warrior,fury,12,4,8
Stillpetao,dun-modr,384,warrior,fury,12,4,8
Grisettê,archimonde,384,warrior,fury,12,4,8
Деспазитыч,fordragon,384,warrior,fury,12,4,8
Überhase,taerar,384,warrior,fury,12,4,8
Ordínaryname,blackrock,384,warrior,fury,12,4,8
Unstorm,drakthul,384,warrior,fury,12,4,8
Sabak,archimonde,384,warrior,fury,12,4,8
Stamz,drakthul,384,warrior,fury,12,4,8
Daxhter,sanguino,384,warrior,fury,12,4,8
Bannedbybliz,garrosh,384,warrior,fury,12,4,8
Aynerin,silvermoon,384,warrior,fury,12,4,8
Xxoorrwarr,tarren-mill,384,warrior,fury,12,4,8
Katmos,baelgun,384,warrior,fury,12,4,8
Warfam,twisting-nether,384,warrior,fury,12,4,8
Shaxov,draenor,384,warrior,fury,12,4,8
Flundexý,todeswache,384,warrior,fury,12,4,8
Xial,ravencrest,384,warrior,fury,12,4,8
Blackhêart,shadowsong,384,warrior,fury,12,4,8
Zorath,sanguino,384,warrior,fury,12,4,8
Jaru,alleria,384,warrior,fury,12,4,8
Киссмиплис,gordunni,384,warrior,fury,12,4,8
Fistawarrior,nemesis,384,warrior,fury,12,4,8
Tanalias,outland,384,warrior,fury,12,4,8
Yumahee,kult-der-verdammten,384,warrior,fury,12,4,8
Bastrick,argent-dawn,384,warrior,fury,12,4,8
Vesterby,stormscale,384,warrior,fury,12,4,8
Läskipää,argent-dawn,384,warrior,fury,12,4,8
Nexyycleave,kazzak,384,warrior,fury,12,4,8
Sefty,tarren-mill,384,warrior,fury,12,4,8
Pattrock,blackmoore,384,warrior,fury,12,4,8
Sangremort,khaz-modan,384,warrior,fury,12,4,8
Teronth,burning-legion,384,warrior,fury,12,4,8
Guspy,sanguino,384,warrior,fury,12,4,8
Varkoz,sylvanas,384,warrior,fury,12,4,8
Sahl,sylvanas,384,warrior,fury,12,4,8
Bulletpants,argent-dawn,384,warrior,fury,12,4,8
Аркашевич,gordunni,384,warrior,fury,12,4,8
Camaviinga,kazzak,384,warrior,fury,12,4,8
Акнаранд,soulflayer,384,warrior,fury,12,4,8
Neekero,burning-legion,384,warrior,fury,12,4,8
Perfectblood,kazzak,384,warrior,fury,12,4,8
Utharis,stormscale,384,warrior,fury,12,4,8
Rawne,kirin-tor,384,warrior,fury,12,4,8
Sininemunn,alakir,384,warrior,fury,13,4,9
Garradoom,stormscale,384,warrior,fury,17,5,12
Séarix,blackrock,384,warrior,fury,18,4,14
Cranas,medivh,384,warrior,fury,18,4,14
Voa,stormscale,383,warrior,fury,6,4,2
Хенминия,blackscar,383,warrior,fury,6,4,2
Bulbumbo,twisting-nether,383,warrior,fury,6,4,2
Siltiel,marécage-de-zangar,383,warrior,fury,6,4,2
Dersaft,blackmoore,383,warrior,fury,9,5,4
Jøsí,dalaran,383,warrior,fury,9,4,5
Jún,dun-modr,383,warrior,fury,12,4,8
Basingaa,pozzo-delleternità,383,warrior,fury,12,4,8
Grimmbearock,amanthul,383,warrior,fury,12,4,8
Haryssa,blackhand,383,warrior,fury,12,4,8
Xhasan,sylvanas,383,warrior,fury,12,4,8
Ruuddy,draenor,382,warrior,fury,12,4,8
Biigjiim,doomhammer,381,warrior,fury,12,4,8
Colliderbody,dun-modr,367,warrior,fury,9,5,4
Scràvity,blackhand,367,warrior,fury,11,4,7
Proeliator,argent-dawn,367,warrior,fury,13,4,9
Kirzan,silvermoon,367,warrior,fury,17,4,13
Ооч,gordunni,361,warrior,fury,17,4,13
Slaba,stormscale,351,warrior,fury,11,4,7
Toxîn,dalaran,351,warrior,fury,11,4,7
Hembränt,hellfire,351,warrior,fury,17,4,13
Bossít,doomhammer,336,warrior,fury,9,4,5
Kuró,archimonde,335,warrior,fury,8,5,3
Bronzefuryx,ravencrest,335,warrior,fury,11,4,7
Blackseven,ravencrest,330,warrior,fury,9,6,3
Sërgi,minahonda,320,warrior,fury,10,4,6
Fleshwerk,silvermoon,320,warrior,fury,10,4,6
Zazate,archimonde,319,warrior,fury,5,4,1
Medioçre,ravencrest,319,warrior,fury,5,4,1
Goinhamx,blackhand,319,warrior,fury,5,4,1
Хоркан,blackscar,319,warrior,fury,8,4,4
Vlader,dun-modr,319,warrior,fury,8,4,4
Phòbos,stormrage,319,warrior,fury,11,4,7
Anaba,voljin,318,warrior,fury,10,4,6
Groullomus,archimonde,318,warrior,fury,10,4,6
Остинс,soulflayer,303,warrior,fury,13,4,9
Wunderwaffle,xavius,288,warrior,fury,6,3,3
Kházad,proudmoore,288,warrior,fury,6,3,3
Claif,sanguino,288,warrior,fury,6,3,3
Mídoriya,argent-dawn,288,warrior,fury,6,3,3
Xeltas,burning-legion,288,warrior,fury,6,3,3
Hílfiger,kazzak,288,warrior,fury,6,3,3
Tidùs,nethersturm,288,warrior,fury,6,3,3
Xsann,argent-dawn,288,warrior,fury,6,3,3
Previse,argent-dawn,288,warrior,fury,6,3,3
Snakééyés,kazzak,288,warrior,fury,6,3,3
Orcassmus,blackrock,288,warrior,fury,6,3,3
Kleptomane,blackrock,288,warrior,fury,6,3,3
Merked,kazzak,288,warrior,fury,6,3,3
Brel,suramar,288,warrior,fury,6,3,3
Serakhan,argent-dawn,288,warrior,fury,6,3,3
Ivailowar,ravencrest,288,warrior,fury,6,3,3
Deadlift,thunderhorn,288,warrior,fury,6,3,3
Manký,kazzak,288,warrior,fury,6,3,3
Pulsefuzz,burning-legion,288,warrior,fury,6,3,3
Bigbmh,tarren-mill,288,warrior,fury,6,3,3
Mumbojumbo,uldum,288,warrior,fury,6,3,3
Tótenkopf,ravencrest,288,warrior,fury,6,3,3
Ironlol,ravencrest,288,warrior,fury,6,3,3
Pwndrizle,blackmoore,288,warrior,fury,6,3,3
Rodgerage,tarren-mill,288,warrior,fury,6,3,3
Jaffacakes,kazzak,288,warrior,fury,6,3,3
Lektor,eredar,288,warrior,fury,6,3,3
Sentrocks,sanguino,288,warrior,fury,6,3,3
Gnarrwarr,eredar,288,warrior,fury,6,3,3
Ðennis,argent-dawn,288,warrior,fury,6,3,3
Cryze,ravencrest,288,warrior,fury,6,3,3
Smâllpackage,silvermoon,288,warrior,fury,6,3,3
Ðæðlý,ravencrest,288,warrior,fury,6,3,3
Poolboyx,tarren-mill,288,warrior,fury,6,3,3
Lythaya,eredar,288,warrior,fury,6,3,3
Frankytank,antonidas,288,warrior,fury,6,3,3
Cleavyera,tarren-mill,288,warrior,fury,6,3,3
Nightmareowl,tarren-mill,288,warrior,fury,6,3,3
Múndus,outland,288,warrior,fury,6,3,3
Androhan,silvermoon,288,warrior,fury,6,3,3
Hayahol,kazzak,288,warrior,fury,6,3,3
Rägnât,dun-modr,288,warrior,fury,6,3,3
Montralk,antonidas,288,warrior,fury,6,3,3
Dekian,dun-modr,288,warrior,fury,6,3,3
Druubak,aggra-português,288,warrior,fury,6,3,3
Zapaz,defias-brotherhood,288,warrior,fury,6,3,3
Imabeatyoass,kazzak,288,warrior,fury,6,3,3
Venavar,kazzak,288,warrior,fury,6,3,3
Laude,ragnaros,288,warrior,fury,6,3,3
Grimaced,tarren-mill,288,warrior,fury,6,3,3
Phalek,ravencrest,288,warrior,fury,6,3,3
Syel,sinstralis,288,warrior,fury,6,3,3
Axxtm,ravencrest,288,warrior,fury,6,3,3
Reckless,saurfang,288,warrior,fury,6,3,3
Corychase,ravencrest,288,warrior,fury,6,3,3
Ragébar,tarren-mill,288,warrior,fury,6,3,3
Ýuritarded,silvermoon,288,warrior,fury,6,3,3
Uncledazzo,quelthalas,288,warrior,fury,6,3,3
Эллегон,fordragon,288,warrior,fury,6,3,3
Slg,tarren-mill,288,warrior,fury,6,3,3
Bunsen,magtheridon,288,warrior,fury,6,3,3
Tequiero,zuljin,288,warrior,fury,6,3,3
Dámpening,ravencrest,288,warrior,fury,6,3,3
Bigdbigarms,tarren-mill,288,warrior,fury,6,3,3
Oombac,lordaeron,288,warrior,fury,6,3,3
Carizona,twisting-nether,288,warrior,fury,6,3,3
Aîdogar,ysondre,288,warrior,fury,6,3,3
Jamiex,marécage-de-zangar,288,warrior,fury,6,3,3
Hellion,uldum,288,warrior,fury,6,3,3
Brandøn,colinas-pardas,288,warrior,fury,6,3,3
Belliny,draenor,288,warrior,fury,6,3,3
Støick,lightbringer,288,warrior,fury,6,3,3
Wëx,tarren-mill,288,warrior,fury,6,3,3
Wtfx,draenor,288,warrior,fury,6,3,3
Rakuna,tarren-mill,288,warrior,fury,6,3,3
Boompowsmash,emerald-dream,288,warrior,fury,6,3,3
Ntzy,twisting-nether,288,warrior,fury,6,3,3
Mòrdréd,kazzak,288,warrior,fury,6,3,3
Morthrang,defias-brotherhood,288,warrior,fury,6,3,3
Stormfàng,ragnaros,288,warrior,fury,6,3,3
Äkzequte,blackhand,288,warrior,fury,6,3,3
Várkáld,nordrassil,288,warrior,fury,6,3,3
Lundehund,dalaran,288,warrior,fury,6,3,3
Trìnítÿ,anubarak,288,warrior,fury,6,3,3
Tojaraa,kazzak,288,warrior,fury,6,3,3
Bernieboi,tarren-mill,288,warrior,fury,6,3,3
Zarrgash,blackhand,288,warrior,fury,6,3,3
Argadea,archimonde,288,warrior,fury,6,3,3
Karguk,blackhand,288,warrior,fury,6,3,3
Sucyenbrie,archimonde,288,warrior,fury,6,3,3
Greenblób,kazzak,288,warrior,fury,6,3,3
Wingüi,dun-modr,288,warrior,fury,6,3,3
Sellblade,blackhand,288,warrior,fury,6,3,3
Påpynou,garona,288,warrior,fury,6,3,3
Aestl,blackhand,288,warrior,fury,6,3,3
Shaanks,archimonde,288,warrior,fury,6,3,3
Arachnoyd,drakthul,288,warrior,fury,6,3,3
Döömed,drakthul,288,warrior,fury,6,3,3
Uwuaraqtlol,stormscale,288,warrior,fury,6,3,3
Didgedelik,archimonde,288,warrior,fury,6,3,3
Prettygucci,stormscale,288,warrior,fury,6,3,3
Azotz,archimonde,288,warrior,fury,6,3,3
Eatall,outland,288,warrior,fury,6,3,3
Zilg,twisting-nether,288,warrior,fury,6,3,3
Lilenrage,stormscale,288,warrior,fury,6,3,3
Barrocket,aegwynn,288,warrior,fury,6,3,3
Blackwólf,bloodhoof,288,warrior,fury,6,3,3
Galanax,silvermoon,288,warrior,fury,6,3,3
Komissarecks,aegwynn,288,warrior,fury,6,3,3
Parachoque,ragnaros,288,warrior,fury,6,3,3
Zørglar,hyjal,288,warrior,fury,6,3,3
Auggies,outland,288,warrior,fury,6,3,3
Доргас,howling-fjord,288,warrior,fury,6,3,3
Nârmøra,thrall,288,warrior,fury,6,3,3
Keffboi,draenor,288,warrior,fury,6,3,3
Finnyboi,ragnaros,288,warrior,fury,6,3,3
Keluke,thrall,288,warrior,fury,6,3,3
Ziglekk,thrall,288,warrior,fury,6,3,3
Lovemilkers,stormscale,288,warrior,fury,6,3,3
Optiwarrior,turalyon,288,warrior,fury,6,3,3
Mfdoöm,draenor,288,warrior,fury,6,3,3
Febreez,die-aldor,288,warrior,fury,6,3,3
Grinrok,thrall,288,warrior,fury,6,3,3
Drvx,twisting-nether,288,warrior,fury,6,3,3
Belfodil,outland,288,warrior,fury,6,3,3
Sulemanslay,silvermoon,288,warrior,fury,6,3,3
Kopfnusskali,thrall,288,warrior,fury,6,3,3
Berserkarche,twisting-nether,288,warrior,fury,6,3,3
Dísplacement,draenor,288,warrior,fury,6,3,3
Whàtsup,stormscale,288,warrior,fury,6,3,3
Shelied,twisting-nether,288,warrior,fury,6,3,3
Rakewar,draenor,288,warrior,fury,6,3,3
Qkazoo,nathrezim,288,warrior,fury,6,3,3
Sathom,hyjal,288,warrior,fury,6,3,3
Drfeelgud,twisting-nether,288,warrior,fury,6,3,3
Desprado,outland,288,warrior,fury,6,3,3
Lozzakum,draenor,288,warrior,fury,6,3,3
Helallokma,silvermoon,288,warrior,fury,6,3,3
Uthric,azuremyst,288,warrior,fury,6,3,3
Kohhør,archimonde,288,warrior,fury,6,3,3
Alccont,stormscale,288,warrior,fury,6,3,3
Yøussifer,silvermoon,288,warrior,fury,6,3,3
Xerone,doomhammer,288,warrior,fury,6,3,3
Tabboonishka,draenor,288,warrior,fury,6,3,3
Peon,eredar,288,warrior,fury,6,3,3
Wárríor,ragnaros,288,warrior,fury,6,3,3
Lebronjones,sylvanas,288,warrior,fury,6,3,3
Егермейстр,borean-tundra,288,warrior,fury,6,3,3
Зандур,eversong,288,warrior,fury,6,3,3
Барашкубийца,borean-tundra,288,warrior,fury,6,3,3
Мегавар,eversong,288,warrior,fury,6,3,3
Ijzerekast,sylvanas,288,warrior,fury,6,3,3
Бигбэйбитейп,greymane,288,warrior,fury,6,3,3
Sóúl,nagrand,288,warrior,fury,6,3,3
Elyozz,silvermoon,288,warrior,fury,6,3,3
Drakhel,the-maelstrom,288,warrior,fury,6,3,3
Subtobualock,sylvanas,288,warrior,fury,6,3,3
Брэмбур,goldrinn,288,warrior,fury,6,3,3
Elffarian,the-maelstrom,288,warrior,fury,6,3,3
Снакихснаки,gordunni,288,warrior,fury,6,3,3
Snuzil,the-maelstrom,288,warrior,fury,6,3,3
Nifrediel,trollbane,288,warrior,fury,6,3,3
Ødräcîë,silvermoon,288,warrior,fury,6,3,3
Stopdaddy,sylvanas,288,warrior,fury,6,3,3
Vernoz,sylvanas,288,warrior,fury,6,3,3
Nirut,blackrock,288,warrior,fury,9,4,5
Elvedin,antonidas,288,warrior,fury,9,4,5
Mullen,thunderhorn,288,warrior,fury,8,3,5
Zaxoli,turalyon,288,warrior,fury,8,3,5
Ghanam,hyjal,288,warrior,fury,8,3,5
Iluwar,ragnaros,288,warrior,fury,8,3,5
Grimbërgën,hyjal,288,warrior,fury,9,3,6
Barbbarus,silvermoon,288,warrior,fury,12,3,9
Джондо,gordunni,288,warrior,fury,12,3,9
Récksy,tarren-mill,288,warrior,fury,12,3,9
Naspy,stormscale,288,warrior,fury,12,3,9
Titanstriker,silvermoon,288,warrior,fury,12,3,9
Сетт,howling-fjord,288,warrior,fury,12,3,9
Гхазгхкалл,howling-fjord,288,warrior,fury,12,3,9
Daye,zuluhed,288,warrior,fury,12,3,9
Ôrcboi,tarren-mill,288,warrior,fury,12,3,9
Efive,stormscale,288,warrior,fury,12,3,9
Phovoss,stormscale,288,warrior,fury,12,3,9
Ireincarnate,argent-dawn,288,warrior,fury,12,3,9
Conânan,blackrock,288,warrior,fury,12,3,9
Draggs,kazzak,288,warrior,fury,12,3,9
Bruks,antonidas,288,warrior,fury,12,3,9
Valldi,argent-dawn,288,warrior,fury,12,3,9
Grommer,dentarg,288,warrior,fury,12,3,9
Skykrow,ysondre,288,warrior,fury,12,3,9
Zwheind,silvermoon,288,warrior,fury,12,3,9
Тселур,fordragon,288,warrior,fury,12,3,9
Ònîsînîshêrû,kazzak,288,warrior,fury,12,3,9
Drøgma,tyrande,288,warrior,fury,12,3,9
Sudosolo,burning-blade,288,warrior,fury,12,3,9
Shreedshot,blackmoore,288,warrior,fury,12,3,9
Оболис,galakrond,288,warrior,fury,12,3,9
Gorkill,bladefist,288,warrior,fury,12,3,9
Киллдекс,gordunni,288,warrior,fury,12,3,9
Aphae,defias-brotherhood,288,warrior,fury,12,3,9
Hördê,zuljin,288,warrior,fury,12,3,9
Høxy,outland,288,warrior,fury,12,3,9
Pekknekck,outland,288,warrior,fury,12,3,9
Хоусен,gordunni,288,warrior,fury,12,3,9
Linkx,lightnings-blade,288,warrior,fury,12,3,9
Ronflatter,blackrock,288,warrior,fury,12,3,9
Goodoldtrial,outland,288,warrior,fury,12,3,9
Layä,krasus,288,warrior,fury,12,3,9
Wildò,frostwhisper,288,warrior,fury,12,3,9
Sisuthros,draenor,288,warrior,fury,12,3,9
Dragonvall,draenor,288,warrior,fury,12,3,9
Воинглад,gordunni,288,warrior,fury,12,3,9
Анимэ,blackscar,288,warrior,fury,12,3,9
Zyn,outland,288,warrior,fury,12,3,9
Nedart,grim-batol,288,warrior,fury,12,3,9
Kyösti,defias-brotherhood,288,warrior,fury,12,3,9
Uzuií,blackmoore,288,warrior,fury,12,3,9
Hamgobbler,shattered-hand,288,warrior,fury,12,3,9
Arenameister,blackmoore,288,warrior,fury,12,3,9
Pamila,outland,288,warrior,fury,12,3,9
Fitï,cthun,287,warrior,fury,6,3,3
Shïn,kaelthas,287,warrior,fury,6,3,3
Atelier,magtheridon,287,warrior,fury,6,3,3
Arnnau,dun-modr,287,warrior,fury,6,3,3
Garuul,magtheridon,287,warrior,fury,6,3,3
Xragnar,sylvanas,287,warrior,fury,6,3,3
Varineya,blackmoore,287,warrior,fury,6,3,3
Gartenzwerge,kelthuzad,287,warrior,fury,6,3,3
Luw,twisting-nether,287,warrior,fury,12,3,9
Sjuan,silvermoon,287,warrior,fury,12,3,9
Katmai,nemesis,287,warrior,fury,18,3,15
Weqeqf,kazzak,286,warrior,fury,6,3,3
Agunnai,karazhan,286,warrior,fury,6,3,3
Raffael,pozzo-delleternità,286,warrior,fury,12,3,9
Tchøkz,hyjal,271,warrior,fury,11,3,8
Nidhoggr,frostwhisper,271,warrior,fury,11,3,8
Aegís,drakthul,256,warrior,fury,10,3,7
Клифф,gordunni,255,warrior,fury,11,3,8
Kilsorrow,silvermoon,240,warrior,fury,9,4,5
Lutherion,drakthul,239,warrior,fury,5,3,2
Neozz,ravencrest,239,warrior,fury,5,3,2
Todesgewalt,kazzak,239,warrior,fury,5,3,2
Execute,sanguino,239,warrior,fury,5,3,2
Draur,archimonde,239,warrior,fury,5,3,2
Daýz,draenor,234,warrior,fury,7,4,3
Zeldaixi,twisting-nether,234,warrior,fury,10,5,5
Perkutor,rashgarroth,234,warrior,fury,11,5,6
Xqt,laughing-skull,234,warrior,fury,9,4,5
Leapling,blackmoore,223,warrior,fury,6,4,2
Gargarensis,khadgar,223,warrior,fury,8,3,5
Iarsonn,drakthul,223,warrior,fury,8,3,5
Флокт,howling-fjord,208,warrior,fury,7,3,4
Цезарь,greymane,192,warrior,fury,4,3,1
Блудхаст,gordunni,192,warrior,fury,4,3,1
Имбанутыйвар,soulflayer,192,warrior,fury,4,3,1
Mudryk,burning-blade,192,warrior,fury,4,3,1
Балласёж,gordunni,192,warrior,fury,9,3,6
Themachine,burning-blade,192,warrior,fury,9,3,6
Кунгфурик,soulflayer,192,warrior,fury,6,2,4
Teñseî,archimonde,192,warrior,fury,6,2,4
Onykat,aegwynn,192,warrior,fury,6,2,4
Nallen,the-venture-co,192,warrior,fury,6,2,4
Optitt,dethecus,192,warrior,fury,6,2,4
Piixxz,hyjal,192,warrior,fury,6,2,4
Кентафурик,soulflayer,192,warrior,fury,6,2,4
Rézinplin,archimonde,192,warrior,fury,6,2,4
Боадрог,soulflayer,192,warrior,fury,6,2,4
Spaceløl,archimonde,192,warrior,fury,6,2,4
Glàek,archimonde,192,warrior,fury,6,2,4
Redow,stormreaver,192,warrior,fury,6,2,4
Oueban,doomhammer,192,warrior,fury,6,2,4
Martins,doomhammer,192,warrior,fury,6,2,4
Wïnqlùlz,archimonde,192,warrior,fury,6,2,4
Брамон,gordunni,192,warrior,fury,6,2,4
Lengthymort,tarren-mill,192,warrior,fury,6,2,4
Ellchefe,aggra-português,192,warrior,fury,6,2,4
Walkers,frostmane,192,warrior,fury,6,2,4
Lørð,frostmane,192,warrior,fury,6,2,4
Enface,ragnaros,192,warrior,fury,6,2,4
Demonraze,hyjal,192,warrior,fury,6,2,4
Hgfe,doomhammer,192,warrior,fury,6,2,4
Draskoé,hyjal,192,warrior,fury,6,2,4
Oxxi,outland,192,warrior,fury,6,2,4
Квистин,soulflayer,192,warrior,fury,6,2,4
Malalulu,burning-legion,192,warrior,fury,6,2,4
Ультрамариня,howling-fjord,192,warrior,fury,6,2,4
Zalazain,burning-legion,192,warrior,fury,6,2,4
Descending,xavius,192,warrior,fury,6,2,4
Андрюхабш,soulflayer,192,warrior,fury,6,2,4
Rampage,ghostlands,192,warrior,fury,6,2,4
Evilweraz,turalyon,192,warrior,fury,6,2,4
Pantsonfire,blackmoore,192,warrior,fury,6,2,4
Alxqt,outland,192,warrior,fury,6,2,4
Xilquib,darksorrow,192,warrior,fury,6,2,4
Dabsimot,outland,192,warrior,fury,6,2,4
Тарттарион,gordunni,192,warrior,fury,6,2,4
Elendurel,outland,192,warrior,fury,6,2,4
Mîcî,tarren-mill,192,warrior,fury,6,2,4
Тевивар,gordunni,192,warrior,fury,6,2,4
Андертейкерх,gordunni,192,warrior,fury,6,2,4
Гудмунт,borean-tundra,192,warrior,fury,6,2,4
Lianore,sanguino,192,warrior,fury,6,2,4
Regulators,outland,192,warrior,fury,6,2,4
Holdemhammer,sanguino,192,warrior,fury,6,2,4
Lrb,tarren-mill,192,warrior,fury,6,2,4
Migtythor,draenor,192,warrior,fury,6,2,4
Луновоин,gordunni,192,warrior,fury,6,2,4
Goretterog,ysondre,192,warrior,fury,6,2,4
Mòrzàr,outland,192,warrior,fury,6,2,4
Искристый,howling-fjord,192,warrior,fury,6,2,4
Kuran,outland,192,warrior,fury,6,2,4
Søwtime,sanguino,192,warrior,fury,6,2,4
Nokturnâl,silvermoon,192,warrior,fury,6,2,4
Lucíus,outland,192,warrior,fury,6,2,4
Rezn,kazzak,192,warrior,fury,6,2,4
Ezlive,blackrock,192,warrior,fury,6,2,4
Sertigan,dun-modr,192,warrior,fury,6,2,4
Carmën,dun-modr,192,warrior,fury,6,2,4
Секирис,soulflayer,192,warrior,fury,6,2,4
Бургерс,soulflayer,192,warrior,fury,6,2,4
Crystallake,blackrock,192,warrior,fury,6,2,4
Dieselafro,azjolnerub,192,warrior,fury,6,2,4
Vrokada,quelthalas,192,warrior,fury,6,2,4
Tedbuckland,blackrock,192,warrior,fury,6,2,4
Vaaýzx,blackrock,192,warrior,fury,6,2,4
Endermite,magtheridon,192,warrior,fury,6,2,4
Syen,ysondre,192,warrior,fury,6,2,4
Nedåh,blackrock,192,warrior,fury,6,2,4
Skrïllex,colinas-pardas,192,warrior,fury,6,2,4
Dárïus,kazzak,192,warrior,fury,6,2,4
Zéox,baelgun,192,warrior,fury,6,2,4
Atälànte,ysondre,192,warrior,fury,6,2,4
Calebrind,ysondre,192,warrior,fury,6,2,4
Stapta,kazzak,192,warrior,fury,6,2,4
Крематория,howling-fjord,192,warrior,fury,6,2,4
Maniaco,kazzak,192,warrior,fury,6,2,4
Армгрид,gordunni,192,warrior,fury,6,2,4
Whydeadbro,twisting-nether,192,warrior,fury,6,2,4
Seancollins,sunstrider,192,warrior,fury,6,2,4
Cebystance,kazzak,192,warrior,fury,6,2,4
Massivezug,kazzak,192,warrior,fury,6,2,4
Pizivisiems,chromaggus,192,warrior,fury,6,2,4
Queak,kazzak,192,warrior,fury,6,2,4
Crøwñd,twisting-nether,192,warrior,fury,6,2,4
Skullxy,talnivarr,192,warrior,fury,6,2,4
Janîtschar,eredar,192,warrior,fury,6,2,4
Zaddi,blackrock,192,warrior,fury,6,2,4
Pacheco,eredar,192,warrior,fury,6,2,4
Gregórry,eredar,192,warrior,fury,6,2,4
Ragehead,twisting-nether,192,warrior,fury,6,2,4
Pemex,stormreaver,192,warrior,fury,6,2,4
Romxo,kazzak,192,warrior,fury,6,2,4
Stormravager,balnazzar,192,warrior,fury,6,2,4
Wlâdimir,eredar,192,warrior,fury,6,2,4
Ragelust,twisting-nether,192,warrior,fury,6,2,4
Raxur,kazzak,192,warrior,fury,6,2,4
Juzum,kazzak,192,warrior,fury,6,2,4
Segovaxx,twisting-nether,192,warrior,fury,6,2,4
Potatoslam,twisting-nether,192,warrior,fury,6,2,4
Akkí,twisting-nether,192,warrior,fury,6,2,4
Dandada,arathor,192,warrior,fury,6,2,4
Dariman,aegwynn,192,warrior,fury,6,2,4
Hradball,twilights-hammer,192,warrior,fury,6,2,4
Halberd,illidan,192,warrior,fury,6,2,4
Sïmstärxzy,hakkar,192,warrior,fury,6,2,4
Rututu,ragnaros,192,warrior,fury,6,2,4
Riöt,ysondre,192,warrior,fury,6,2,4
Zugzugcleave,blackrock,192,warrior,fury,6,2,4
Zirvey,tarren-mill,192,warrior,fury,6,2,4
Magyarsas,ragnaros,192,warrior,fury,6,2,4
Deadnamekill,ragnaros,192,warrior,fury,6,2,4
Kmag,ravencrest,192,warrior,fury,6,2,4
Tamadniakar,ragnaros,192,warrior,fury,6,2,4
Howdyfrau,eredar,192,warrior,fury,6,2,4
Bôrák,nathrezim,192,warrior,fury,6,2,4
Armlock,ravencrest,192,warrior,fury,6,2,4
Whitescale,silvermoon,192,warrior,fury,6,2,4
Zad,das-konsortium,192,warrior,fury,6,2,4
Vikiox,das-konsortium,192,warrior,fury,6,2,4
Оверфлок,howling-fjord,192,warrior,fury,6,2,4
Каррагор,howling-fjord,192,warrior,fury,6,2,4
Watsabe,kazzak,192,warrior,fury,6,2,4
Brook,frostwolf,192,warrior,fury,6,2,4
Disith,dunemaul,192,warrior,fury,6,2,4
Krandok,antonidas,192,warrior,fury,6,2,4
Aleis,stormscale,192,warrior,fury,6,2,4
Ráksha,antonidas,192,warrior,fury,6,2,4
Даммодар,howling-fjord,192,warrior,fury,6,2,4
Manwéx,silvermoon,192,warrior,fury,6,2,4
Свинореззка,howling-fjord,192,warrior,fury,6,2,4
Wembley,proudmoore,192,warrior,fury,6,2,4
Falconer,ravencrest,192,warrior,fury,6,2,4
Faugh,tarren-mill,192,warrior,fury,6,2,4
Papamatson,silvermoon,192,warrior,fury,6,2,4
Crocbait,ravencrest,192,warrior,fury,6,2,4
Nabucadnozor,illidan,192,warrior,fury,6,2,4
Ragejuice,silvermoon,192,warrior,fury,6,2,4
Sputnikwarr,tarren-mill,192,warrior,fury,6,2,4
Slamona,ravencrest,192,warrior,fury,6,2,4
Karkun,gilneas,192,warrior,fury,6,2,4
Caitlyn,argent-dawn,192,warrior,fury,6,2,4
Ærion,die-aldor,192,warrior,fury,6,2,4
Zoulaani,argent-dawn,192,warrior,fury,6,2,4
Infernant,tarren-mill,192,warrior,fury,6,2,4
Jriddyzug,ravencrest,192,warrior,fury,6,2,4
Evillight,silvermoon,192,warrior,fury,6,2,4
Jaykr,stormscale,192,warrior,fury,6,2,4
Taÿ,stormscale,192,warrior,fury,6,2,4
Chrymiiee,blutkessel,192,warrior,fury,6,2,4
Orcrago,thrall,192,warrior,fury,6,2,4
Rayyes,stormscale,192,warrior,fury,6,2,4
Extazsion,stormscale,192,warrior,fury,6,2,4
Gucciflipflo,sylvanas,192,warrior,fury,6,2,4
Versionx,stormscale,192,warrior,fury,6,2,4
Velgur,ravencrest,192,warrior,fury,6,2,4
Fookyoup,stormscale,192,warrior,fury,6,2,4
Buntstift,thrall,192,warrior,fury,6,2,4
Ezlx,stormscale,192,warrior,fury,6,2,4
Kímbo,tarren-mill,192,warrior,fury,6,2,4
Arozin,thrall,192,warrior,fury,6,2,4
Jambaz,ravencrest,192,warrior,fury,6,2,4
Ijzereter,argent-dawn,192,warrior,fury,6,2,4
Azzaêl,blackhand,192,warrior,fury,6,2,4
Xvlanter,silvermoon,192,warrior,fury,6,2,4
Leviatrius,blackhand,192,warrior,fury,6,2,4
Thorzaram,argent-dawn,192,warrior,fury,6,2,4
Otp,ravencrest,192,warrior,fury,6,2,4
Kennzz,ravencrest,192,warrior,fury,6,2,4
Sgàthach,silvermoon,192,warrior,fury,6,2,4
Fuwy,argent-dawn,192,warrior,fury,6,2,4
Romhilde,ravencrest,192,warrior,fury,6,2,4
Shíranuí,blackhand,192,warrior,fury,10,3,7
Karmok,hyjal,192,warrior,fury,7,2,5
Schneklinge,blutkessel,192,warrior,fury,8,2,6
Buakaw,dalaran,192,warrior,fury,9,2,7
Ikaroshi,silvermoon,192,warrior,fury,9,2,7
Армата,gordunni,192,warrior,fury,10,2,8
Thordis,sylvanas,192,warrior,fury,11,2,9
Earny,outland,192,warrior,fury,12,2,10
Xlora,argent-dawn,192,warrior,fury,12,2,10
Minotaureeni,silvermoon,192,warrior,fury,12,2,10
Трапсир,gordunni,192,warrior,fury,12,2,10
Angrethar,tarren-mill,192,warrior,fury,12,2,10
Frowenn,ravencrest,192,warrior,fury,12,2,10
Зоранит,howling-fjord,192,warrior,fury,12,2,10
Altroox,malorne,192,warrior,fury,12,2,10
Зигигодх,gordunni,192,warrior,fury,12,2,10
Rageside,draenor,192,warrior,fury,12,2,10
Smasherx,draenor,192,warrior,fury,12,2,10
Сажень,blackscar,192,warrior,fury,12,2,10
Joblôb,guldan,192,warrior,fury,12,2,10
Selethedrae,antonidas,192,warrior,fury,12,2,10
Bätscher,nefarian,192,warrior,fury,12,2,10
Gottfrie,argent-dawn,192,warrior,fury,12,2,10
Davetsiz,burning-legion,192,warrior,fury,12,2,10
Korova,blackrock,192,warrior,fury,12,2,10
Sycon,chamber-of-aspects,192,warrior,fury,12,2,10
Bämoida,eredar,192,warrior,fury,12,2,10
Andrjuscha,blackrock,192,warrior,fury,12,2,10
Kixx,twisting-nether,192,warrior,fury,12,2,10
Everest,aegwynn,192,warrior,fury,12,2,10
Killingstórm,kazzak,192,warrior,fury,12,2,10
Urruk,archimonde,192,warrior,fury,12,2,10
Rampage,azuremyst,192,warrior,fury,12,2,10
Boofhoof,nordrassil,192,warrior,fury,12,2,10
Bullie,magtheridon,192,warrior,fury,12,2,10
Keldeo,hyjal,191,warrior,fury,6,2,4
Dorinaz,die-aldor,191,warrior,fury,6,2,4
Sakaî,temple-noir,191,warrior,fury,6,2,4
Alvis,nathrezim,191,warrior,fury,6,2,4
Tömahawk,defias-brotherhood,191,warrior,fury,6,2,4
Bøyka,sinstralis,175,warrior,fury,11,2,9
Кереешка,howling-fjord,175,warrior,fury,11,2,9
Limejuicer,argent-dawn,169,warrior,fury,12,5,7
Møtomoto,defias-brotherhood,159,warrior,fury,5,2,3
Marranu,cthun,159,warrior,fury,5,2,3
Volkanowski,archimonde,159,warrior,fury,5,2,3
Dampbob,draenor,159,warrior,fury,5,2,3
Brülldozer,kargath,159,warrior,fury,5,2,3
Бэнкинс,blackscar,159,warrior,fury,8,3,5
Cbahorde,outland,138,warrior,fury,8,3,5
Servion,ravencrest,138,warrior,fury,8,3,5
Ieatprotein,kazzak,138,warrior,fury,13,4,9
Geicoo,dalaran,138,warrior,fury,16,4,12
Vlaax,ravencrest,138,warrior,fury,14,3,11
Maldanor,confrérie-du-thorium,128,warrior,fury,4,2,2
Æxcoast,ravencrest,128,warrior,fury,4,2,2
Gorchak,blackmoore,96,warrior,fury,3,2,1
Ög,archimonde,96,warrior,fury,3,2,1
Krunchä,ragnaros,96,warrior,fury,3,2,1
Варнак,soulflayer,96,warrior,fury,3,2,1
Beeper,tarren-mill,96,warrior,fury,8,2,6
Nýbz,sylvanas,96,warrior,fury,6,1,5
Salom,illidan,96,warrior,fury,6,1,5
Mexî,tarren-mill,96,warrior,fury,6,1,5
Bjornalf,silvermoon,96,warrior,fury,6,1,5
Opatos,tarren-mill,96,warrior,fury,6,1,5
Денеур,gordunni,96,warrior,fury,6,1,5
Nînes,tarren-mill,96,warrior,fury,6,1,5
Bossekpani,stormscale,96,warrior,fury,6,1,5
Fønex,sylvanas,96,warrior,fury,6,1,5
Онлихелл,howling-fjord,96,warrior,fury,6,1,5
Martoka,malganis,96,warrior,fury,6,1,5
Дуухаст,gordunni,96,warrior,fury,6,1,5
Рагкар,gordunni,96,warrior,fury,6,1,5
Марльин,howling-fjord,96,warrior,fury,6,1,5
Rion,malganis,96,warrior,fury,6,1,5
Callipsa,argent-dawn,96,warrior,fury,6,1,5
Krevó,ragnaros,96,warrior,fury,6,1,5
Raixxon,ragnaros,96,warrior,fury,6,1,5
Lavati,malganis,96,warrior,fury,6,1,5
Proteingris,tarren-mill,96,warrior,fury,6,1,5
Gormac,ragnaros,96,warrior,fury,6,1,5
Swordluw,argent-dawn,96,warrior,fury,6,1,5
Тромгорд,howling-fjord,96,warrior,fury,6,1,5
Fitzgibbons,ravencrest,96,warrior,fury,6,1,5
Varruth,tarren-mill,96,warrior,fury,6,1,5
Raakalainen,vashj,96,warrior,fury,6,1,5
Dikkefeld,trollbane,96,warrior,fury,6,1,5
Batoh,twisting-nether,96,warrior,fury,6,1,5
Eyenur,drakthul,96,warrior,fury,6,1,5
Znorro,trollbane,96,warrior,fury,6,1,5
Notsyn,twisting-nether,96,warrior,fury,6,1,5
Tøytank,twisting-nether,96,warrior,fury,6,1,5
Aiarm,twisting-nether,96,warrior,fury,6,1,5
Tafler,twisting-nether,96,warrior,fury,6,1,5
Xenowarr,tarren-mill,96,warrior,fury,6,1,5
Гайрана,razuvious,96,warrior,fury,6,1,5
Рекруттер,galakrond,96,warrior,fury,6,1,5
Feltias,drakthul,96,warrior,fury,6,1,5
Rïven,los-errantes,96,warrior,fury,6,1,5
Спаццифика,soulflayer,96,warrior,fury,6,1,5
Jungar,magtheridon,96,warrior,fury,6,1,5
Parabellum,dun-modr,96,warrior,fury,6,1,5
Gotar,ravencrest,96,warrior,fury,6,1,5
Ghøst,frostwolf,96,warrior,fury,6,1,5
Chadtherad,draenor,96,warrior,fury,6,1,5
Dosenorc,frostwolf,96,warrior,fury,6,1,5
Флагмэн,gordunni,96,warrior,fury,6,1,5
Hammerfall,uldum,96,warrior,fury,6,1,5
Анстасмэш,soulflayer,96,warrior,fury,6,1,5
Армапипец,soulflayer,96,warrior,fury,6,1,5
Nellytkø,eredar,96,warrior,fury,6,1,5
Sahaminho,draenor,96,warrior,fury,6,1,5
Bladewound,draenor,96,warrior,fury,6,1,5
Classi,tarren-mill,96,warrior,fury,6,1,5
Тоштайн,gordunni,96,warrior,fury,6,1,5
Savedsky,zuljin,96,warrior,fury,6,1,5
Wiliamwalace,zuljin,96,warrior,fury,6,1,5
Kaij,draenor,96,warrior,fury,6,1,5
Béttemy,shattered-hand,96,warrior,fury,6,1,5
Coldstory,draenor,96,warrior,fury,6,1,5
Gokoff,ragnaros,96,warrior,fury,6,1,5
Furyfame,darksorrow,96,warrior,fury,6,1,5
Nismoon,culte-de-la-rive-noire,96,warrior,fury,6,1,5
Stratic,blackmoore,96,warrior,fury,6,1,5
Bàal,kirin-tor,96,warrior,fury,6,1,5
Hdarriia,ysondre,96,warrior,fury,6,1,5
Sigewulf,outland,96,warrior,fury,6,1,5
Slante,darksorrow,96,warrior,fury,6,1,5
Jessepinkman,kirin-tor,96,warrior,fury,6,1,5
Orchilles,alakir,96,warrior,fury,6,1,5
Foxaz,burning-legion,96,warrior,fury,6,1,5
Diliul,doomhammer,96,warrior,fury,6,1,5
Bossness,turalyon,96,warrior,fury,6,1,5
Cárlsberg,pozzo-delleternità,96,warrior,fury,6,1,5
Håren,frostmane,96,warrior,fury,6,1,5
Вефелька,gordunni,96,warrior,fury,6,1,5
Zoldado,silvermoon,96,warrior,fury,6,1,5
Matchoo,archimonde,96,warrior,fury,6,1,5
Kalithon,der-rat-von-dalaran,96,warrior,fury,6,1,5
Видманта,gordunni,96,warrior,fury,6,1,5
Grozgeg,garona,96,warrior,fury,6,1,5
Mot,terenas,96,warrior,fury,6,1,5
Dp,area-52,96,warrior,fury,6,1,5
Bokth,archimonde,96,warrior,fury,6,1,5
Karakaartall,silvermoon,96,warrior,fury,6,1,5
Malebolia,mugthol,96,warrior,fury,6,1,5
Monkeyfury,archimonde,96,warrior,fury,6,1,5
Arowbaze,archimonde,96,warrior,fury,6,1,5
Hordox,archimonde,96,warrior,fury,6,1,5
Spacemachine,kazzak,96,warrior,fury,6,1,5
Ðý,silvermoon,96,warrior,fury,6,1,5
Wscieklosc,silvermoon,96,warrior,fury,6,1,5
Mazelion,ambossar,96,warrior,fury,6,1,5
Twinblyat,defias-brotherhood,96,warrior,fury,6,1,5
Gellios,kazzak,96,warrior,fury,6,1,5
Demirkol,outland,96,warrior,fury,6,1,5
Aagony,hyjal,96,warrior,fury,6,1,5
Stromzy,silvermoon,96,warrior,fury,6,1,5
Karreg,hyjal,96,warrior,fury,6,1,5
Janobito,blackmoore,96,warrior,fury,6,1,5
Bladoran,hyjal,96,warrior,fury,6,1,5
Kysse,hyjal,96,warrior,fury,6,1,5
Warduvel,dragonblight,96,warrior,fury,6,1,5
Aeyron,blackmoore,96,warrior,fury,6,1,5
Misiaczek,the-maelstrom,96,warrior,fury,6,1,5
Gameera,aerie-peak,96,warrior,fury,6,1,5
Marícan,blackmoore,96,warrior,fury,6,1,5
Bababuii,blackmoore,96,warrior,fury,6,1,5
Krônôs,thrall,96,warrior,fury,6,1,5
Kronstris,veklor,96,warrior,fury,6,1,5
Syphica,silvermoon,96,warrior,fury,6,1,5
Джереми,deathweaver,96,warrior,fury,6,1,5
Magooth,kazzak,96,warrior,fury,6,1,5
Narkzsthki,kazzak,96,warrior,fury,6,1,5
Greekazi,kazzak,96,warrior,fury,6,1,5
Zhadsnark,blackrock,96,warrior,fury,6,1,5
Kerpi,silvermoon,96,warrior,fury,6,1,5
Модныйклык,eversong,96,warrior,fury,6,1,5
Кимлий,deathweaver,96,warrior,fury,6,1,5
Grimmrock,gorgonnash,96,warrior,fury,6,1,5
Wifioffline,silvermoon,96,warrior,fury,6,1,5
Mynameisjohn,kazzak,96,warrior,fury,6,1,5
Ayelsyssup,silvermoon,96,warrior,fury,6,1,5
Kjøttbiten,kazzak,96,warrior,fury,6,1,5
Noopany,kazzak,96,warrior,fury,6,1,5
Фиббоначи,deathguard,96,warrior,fury,6,1,5
Jdiggidy,ravencrest,96,warrior,fury,12,1,11
Tochka,kazzak,96,warrior,fury,12,1,11
Zarolk,rashgarroth,96,warrior,fury,12,1,11
Cäös,sanguino,96,warrior,fury,12,1,11
Анури,eversong,96,warrior,fury,12,1,11
Quandaledngl,silvermoon,96,warrior,fury,12,1,11
Kaodes,outland,96,warrior,fury,17,1,16
Bladewolf,khadgar,95,warrior,fury,12,1,11
Nutz,archimonde,89,warrior,fury,7,3,4
Skederon,chogall,79,warrior,fury,5,1,4
Sydre,nerathor,64,warrior,fury,4,1,3
Frézzér,blackrock,64,warrior,fury,4,1,3
Krachz,draenor,63,warrior,fury,2,2,0
Lægend,hyjal,63,warrior,fury,8,2,6
Kellja,aggramar,48,warrior,fury,3,1,2
Arsyn,darkmoon-faire,48,warrior,fury,3,1,2
Cowbatant,darkspear,48,warrior,fury,3,1,2
Elkatar,stormscale,46,warrior,fury,23,6,17
Hellzint,sanguino,42,warrior,fury,7,2,5
Skyvajt,drakthul,42,warrior,fury,8,2,6
Pappasmurfy,outland,42,warrior,fury,10,2,8
Josimar,kazzak,31,warrior,fury,2,1,1
Olriksen,dentarg,31,warrior,fury,2,1,1
Новард,eversong,31,warrior,fury,2,1,1
Vivrya,silvermoon,31,warrior,fury,2,1,1
Shinobú,blackrock,16,warrior,fury,1,1,0
Threa,drekthar,16,warrior,fury,7,1,6
Fatbud,tarren-mill,16,warrior,fury,7,1,6
Marcus,ravencrest,2254,warrior,arms,150,79,71
Therealman,kazzak,2224,warrior,arms,97,52,45
Réckx,twisting-nether,2217,warrior,arms,117,62,55
Dõxqt,kazzak,2204,warrior,arms,86,49,37
Joéfernandés,sylvanas,2201,warrior,arms,88,47,41
Scardrex,defias-brotherhood,2172,warrior,arms,94,49,45
Palianytsia,ravencrest,2170,warrior,arms,89,47,42
Sickjackenn,executus,2166,warrior,arms,111,58,53
Luphrek,ysondre,2158,warrior,arms,96,50,46
Oswáld,defias-brotherhood,2152,warrior,arms,74,55,19
Blizo,tarren-mill,2152,warrior,arms,85,48,37
Midgetdamis,blackhand,2147,warrior,arms,137,87,50
Anahkäs,archimonde,2144,warrior,arms,119,60,59
Whýsøsîleñt,ragnaros,2139,warrior,arms,94,58,36
Semmino,nemesis,2137,warrior,arms,84,46,38
Dunecrab,tarren-mill,2131,warrior,arms,197,108,89
Лёшавор,howling-fjord,2125,warrior,arms,126,65,61
Regnarok,sylvanas,2124,warrior,arms,268,147,121
Palmexwar,drakthul,2123,warrior,arms,198,106,92
Okcool,twisting-nether,2121,warrior,arms,144,78,66
Sickjackenx,executus,2121,warrior,arms,222,117,105
Joißoi,dalaran,2116,warrior,arms,238,126,112
Ðävïðßëckhäm,stormscale,2116,warrior,arms,80,41,39
Tpyñåöädxzd,the-maelstrom,2116,warrior,arms,88,45,43
Gabrijel,draenor,2116,warrior,arms,277,139,138
Tozzhug,ragnaros,2114,warrior,arms,135,76,59
Кокдиллак,soulflayer,2113,warrior,arms,160,82,78
Скварх,howling-fjord,2112,warrior,arms,120,74,46
Kartha,stormscale,2106,warrior,arms,90,50,40
Ulrid,draenor,2106,warrior,arms,198,104,94
Фрейз,deathweaver,2105,warrior,arms,78,49,29
Grkpwh,silvermoon,2105,warrior,arms,88,48,40
Yarilolx,outland,2103,warrior,arms,73,42,31
Immørtálx,tarren-mill,2102,warrior,arms,72,38,34
Стефанидзе,soulflayer,2101,warrior,arms,66,37,29
Sekwar,twisting-nether,2101,warrior,arms,77,38,39
Anahkas,archimonde,2097,warrior,arms,144,75,69
Blîxtgordon,tarren-mill,2094,warrior,arms,156,80,76
Sneakydrm,kazzak,2085,warrior,arms,88,48,40
Rhâpsodyw,ravencrest,2080,warrior,arms,300,165,135
Miniphrek,ravencrest,2080,warrior,arms,96,48,48
Stupidz,hyjal,2076,warrior,arms,84,42,42
Benzemá,sanguino,2075,warrior,arms,165,97,68
Broarexlion,ragnaros,2072,warrior,arms,91,43,48
Markers,twisting-nether,2068,warrior,arms,339,167,172
Ðênnis,ravencrest,2062,warrior,arms,54,31,23
Anakhas,archimonde,2057,warrior,arms,120,58,62
Соджиро,howling-fjord,2053,warrior,arms,114,54,60
Compétiteub,archimonde,2052,warrior,arms,137,71,66
Amokdamis,blackhand,2047,warrior,arms,104,49,55
Sharpen,chamber-of-aspects,2044,warrior,arms,122,60,62
Mastodøntes,hyjal,2042,warrior,arms,131,67,64
Варплеер,gordunni,2039,warrior,arms,66,32,34
Ässholedamis,blackhand,2038,warrior,arms,78,54,24
Connorzw,blackmoore,2029,warrior,arms,71,41,30
Рвбстох,blackscar,2028,warrior,arms,172,94,78
Zhrey,stormscale,2025,warrior,arms,206,101,105
Yorgal,arakarahm,2020,warrior,arms,185,89,96
Galeron,kazzak,2019,warrior,arms,114,55,59
Ðöç,argent-dawn,2018,warrior,arms,96,48,48
Seifcham,ragnaros,2017,warrior,arms,317,155,162
Jessicaday,archimonde,2013,warrior,arms,72,37,35
Nikkí,naxxramas,2013,warrior,arms,102,51,51
Irherklek,stormscale,2011,warrior,arms,59,35,24
Purporcfr,archimonde,2011,warrior,arms,148,80,68
Marex,grim-batol,2008,warrior,arms,78,40,38
Kûrûmî,blackmoore,2007,warrior,arms,167,100,67
Ironmásk,tarren-mill,2006,warrior,arms,54,32,22
Seifchamqt,ragnaros,2005,warrior,arms,223,122,101
Quotx,stormscale,2001,warrior,arms,129,61,68
Manaskhan,tarren-mill,2000,warrior,arms,213,111,102
Qtcockxx,stormscale,2000,warrior,arms,132,67,65
Yarilol,aegwynn,1999,warrior,arms,36,21,15
Trâshwarriør,blackhand,1998,warrior,arms,62,27,35
Konebankærn,ravencrest,1997,warrior,arms,108,54,54
Pentagramlol,twisting-nether,1996,warrior,arms,91,49,42
Joeférnandes,ragnaros,1996,warrior,arms,77,38,39
Zhoti,outland,1995,warrior,arms,82,43,39
Wràthfúl,kazzak,1995,warrior,arms,143,74,69
Pürporc,archimonde,1994,warrior,arms,100,53,47
Олдборовс,soulflayer,1993,warrior,arms,92,51,41
Mitu,sanguino,1990,warrior,arms,257,130,127
Merked,kazzak,1989,warrior,arms,102,49,53
Thomasman,nerathor,1989,warrior,arms,138,64,74
Оркабал,howling-fjord,1988,warrior,arms,195,101,94
Arsinal,blackhand,1987,warrior,arms,85,46,39
Lostday,blackrock,1987,warrior,arms,254,131,123
Mercey,stormscale,1987,warrior,arms,65,31,34
Elbutanero,tarren-mill,1982,warrior,arms,84,48,36
Jeriko,archimonde,1982,warrior,arms,59,30,29
Elwarroo,dun-modr,1981,warrior,arms,394,203,191
Disarmed,auchindoun,1979,warrior,arms,108,58,50
Scherø,aegwynn,1977,warrior,arms,76,45,31
Pürporcc,archimonde,1976,warrior,arms,222,115,107
Asquare,stormscale,1973,warrior,arms,76,40,36
Zak,stormscale,1968,warrior,arms,136,63,73
Мокдэмвп,soulflayer,1966,warrior,arms,60,32,28
Варзила,blackscar,1966,warrior,arms,86,44,42
Myonmyonmyon,blackmoore,1965,warrior,arms,98,56,42
Dominikhasek,stormscale,1963,warrior,arms,94,56,38
Assgar,silvermoon,1962,warrior,arms,83,46,37
Theryk,sanguino,1962,warrior,arms,201,97,104
Shortcvnt,ravencrest,1960,warrior,arms,72,37,35
Ðennis,argent-dawn,1959,warrior,arms,96,60,36
Apacolata,outland,1959,warrior,arms,63,34,29
Rînus,aegwynn,1957,warrior,arms,66,33,33
Cerry,ravencrest,1954,warrior,arms,165,82,83
Kaieh,argent-dawn,1953,warrior,arms,60,39,21
Аэска,deathweaver,1950,warrior,arms,78,38,40
Dantius,nemesis,1950,warrior,arms,102,49,53
Purpórc,archimonde,1947,warrior,arms,65,35,30
Javakt,stormscale,1947,warrior,arms,389,193,196
Брамон,gordunni,1946,warrior,arms,46,30,16
Mômsboy,tarren-mill,1946,warrior,arms,76,39,37
Schwän,twisting-nether,1943,warrior,arms,60,32,28
Reysleys,mazrigos,1943,warrior,arms,151,76,75
Wingüi,dun-modr,1942,warrior,arms,156,74,82
Skyowner,twisting-nether,1940,warrior,arms,57,33,24
Regnarøk,sylvanas,1937,warrior,arms,89,55,34
Lexiliuz,twisting-nether,1937,warrior,arms,72,44,28
Dragondeznut,ravencrest,1935,warrior,arms,78,38,40
Midnightrain,archimonde,1934,warrior,arms,66,35,31
Джерамин,blackscar,1934,warrior,arms,77,35,42
Messermozart,blackmoore,1933,warrior,arms,90,44,46
Kwasimodo,blackmoore,1933,warrior,arms,70,30,40
Downpipe,twisting-nether,1932,warrior,arms,215,113,102
Nazrihk,ravencrest,1931,warrior,arms,151,77,74
Velcorn,ravencrest,1931,warrior,arms,54,26,28
Pawnerlol,mannoroth,1931,warrior,arms,120,57,63
Infernion,jaedenar,1930,warrior,arms,48,30,18
Belver,argent-dawn,1929,warrior,arms,38,22,16
Бэнчпресс,soulflayer,1929,warrior,arms,66,33,33
Xurainzone,eredar,1927,warrior,arms,83,43,40
Cleix,frostwolf,1927,warrior,arms,103,50,53
Drclapit,blackrock,1927,warrior,arms,66,30,36
Wake,eredar,1925,warrior,arms,66,38,28
Вэшикх,soulflayer,1924,warrior,arms,155,79,76
Colard,ravencrest,1924,warrior,arms,60,28,32
Kapuchino,twisting-nether,1921,warrior,arms,48,27,21
Zodiac,aggra-português,1919,warrior,arms,66,35,31
Wasro,norgannon,1919,warrior,arms,178,92,86
Lilsweép,draenor,1917,warrior,arms,66,36,30
Zugzugcleave,blackrock,1916,warrior,arms,87,48,39
Jenkinzz,stormscale,1916,warrior,arms,294,155,139
Dabr,stormscale,1916,warrior,arms,61,32,29
Blademir,blackrock,1912,warrior,arms,71,47,24
Doomqt,terokkar,1912,warrior,arms,53,29,24
Bravopla,silvermoon,1912,warrior,arms,108,55,53
Belattor,silvermoon,1912,warrior,arms,66,31,35
Timpey,kazzak,1911,warrior,arms,54,30,24
Комочекгнева,howling-fjord,1909,warrior,arms,235,118,117
Mckinseybcg,outland,1906,warrior,arms,209,119,90
Куртфорренс,gordunni,1905,warrior,arms,241,116,125
Tonyyuu,aegwynn,1904,warrior,arms,125,63,62
Nstx,dun-modr,1902,warrior,arms,60,32,28
Ущипнузатитю,deathguard,1900,warrior,arms,126,63,63
Длоордпро,soulflayer,1900,warrior,arms,65,29,36
Кокделивери,howling-fjord,1898,warrior,arms,24,20,4
Atrôcithy,silvermoon,1898,warrior,arms,60,31,29
Gewyon,ragnaros,1897,warrior,arms,102,49,53
Chucho,argent-dawn,1896,warrior,arms,78,42,36
Çatàclysmíc,kazzak,1896,warrior,arms,138,69,69
Фокатоп,blackscar,1895,warrior,arms,54,28,26
Julololo,archimonde,1893,warrior,arms,72,40,32
Zåk,stormscale,1892,warrior,arms,42,20,22
Рукзуф,razuvious,1890,warrior,arms,29,21,8
Toscothegoat,ravencrest,1889,warrior,arms,54,36,18
Courageous,ravencrest,1889,warrior,arms,66,39,27
Буккакеньер,gordunni,1889,warrior,arms,76,40,36
Døkidøki,silvermoon,1889,warrior,arms,515,262,253
Saurens,twisting-nether,1889,warrior,arms,144,68,76
Æriø,dalaran,1888,warrior,arms,54,30,24
Tsuperman,tarren-mill,1888,warrior,arms,72,37,35
Notthateasy,blackrock,1887,warrior,arms,42,24,18
Howdoulose,dun-modr,1886,warrior,arms,60,39,21
Лилиофаныч,soulflayer,1886,warrior,arms,71,38,33
Xørkull,zuljin,1884,warrior,arms,104,64,40
Klonyarikjr,ravencrest,1884,warrior,arms,36,22,14
Thenx,tarren-mill,1884,warrior,arms,257,125,132
Nipes,nozdormu,1883,warrior,arms,217,108,109
Куесэс,howling-fjord,1880,warrior,arms,36,20,16
Gnømércy,stormscale,1878,warrior,arms,42,22,20
Andzone,alakir,1878,warrior,arms,54,28,26
Gulläx,burning-legion,1878,warrior,arms,42,20,22
Klonyarik,ravencrest,1877,warrior,arms,42,22,20
Флагмэн,gordunni,1876,warrior,arms,89,50,39
Everdipper,outland,1876,warrior,arms,97,48,49
Trapoulas,kazzak,1876,warrior,arms,166,79,87
Cathériné,drakthul,1875,warrior,arms,48,27,21
Alegral,ravencrest,1875,warrior,arms,325,158,167
Allthèwayup,kazzak,1875,warrior,arms,69,32,37
Фрейз,blackscar,1874,warrior,arms,70,34,36
Pantsupic,archimonde,1874,warrior,arms,66,24,42
Craanked,aegwynn,1873,warrior,arms,88,44,44
Urmack,ravencrest,1872,warrior,arms,54,41,13
Valoo,malganis,1871,warrior,arms,223,113,110
Aixer,archimonde,1871,warrior,arms,73,35,38
Шурпач,deathguard,1870,warrior,arms,102,54,48
Liptonxecute,blackhand,1870,warrior,arms,118,61,57
Pända,archimonde,1868,warrior,arms,125,54,71
Gguts,archimonde,1867,warrior,arms,97,53,44
Troma,archimonde,1867,warrior,arms,95,44,51
Пробуюстерву,soulflayer,1866,warrior,arms,84,40,44
Kamked,burning-legion,1864,warrior,arms,167,81,86
Magnî,auchindoun,1863,warrior,arms,97,53,44
Сетт,howling-fjord,1863,warrior,arms,86,42,44
Xåb,dun-morogh,1863,warrior,arms,84,37,47
Екзобайт,gordunni,1862,warrior,arms,101,55,46
Kurbá,stormscale,1858,warrior,arms,54,30,24
Hashladun,draenor,1857,warrior,arms,36,23,13
Feckdech,blackrock,1857,warrior,arms,53,32,21
Grimogør,stormscale,1857,warrior,arms,48,27,21
Shooky,blackrock,1857,warrior,arms,67,34,33
Pivcuga,kazzak,1857,warrior,arms,313,158,155
Pházéd,kazzak,1856,warrior,arms,58,33,25
Ønogal,archimonde,1856,warrior,arms,120,56,64
Kiyomaro,stormscale,1855,warrior,arms,84,46,38
Karny,ravencrest,1855,warrior,arms,204,104,100
Vallenwar,twisting-nether,1854,warrior,arms,63,42,21
Mirageous,tarren-mill,1854,warrior,arms,83,46,37
Matrixer,aegwynn,1853,warrior,arms,47,28,19
Ланро,gordunni,1853,warrior,arms,65,33,32
Jammy,dentarg,1853,warrior,arms,84,41,43
Àlexander,ravencrest,1852,warrior,arms,35,20,15
Aeyon,burning-blade,1852,warrior,arms,51,29,22
Rec,thrall,1851,warrior,arms,42,23,19
Reacôn,twisting-nether,1851,warrior,arms,52,28,24
Balthew,defias-brotherhood,1851,warrior,arms,48,24,24
Yseras,aegwynn,1851,warrior,arms,89,39,50
Leeches,aggramar,1850,warrior,arms,66,35,31
Акнаранд,soulflayer,1850,warrior,arms,48,25,23
Mtc,blackrock,1850,warrior,arms,110,55,55
Skorm,mugthol,1849,warrior,arms,36,27,9
Reckqtw,eredar,1849,warrior,arms,92,50,42
Schaufelørc,blackrock,1849,warrior,arms,120,60,60
Mtctwo,blackrock,1849,warrior,arms,108,52,56
Slowann,argent-dawn,1848,warrior,arms,208,111,97
Krônm,dun-modr,1847,warrior,arms,78,33,45
Izurritea,tarren-mill,1846,warrior,arms,102,49,53
Dortenz,ragnaros,1846,warrior,arms,72,31,41
Chippéd,draenor,1845,warrior,arms,46,28,18
Goatie,frostwhisper,1844,warrior,arms,42,30,12
Gaav,burning-legion,1844,warrior,arms,381,182,199
Civok,kult-der-verdammten,1844,warrior,arms,66,31,35
Downpippuri,silvermoon,1843,warrior,arms,293,161,132
Malebolia,mugthol,1843,warrior,arms,487,253,234
Europ,silvermoon,1843,warrior,arms,270,131,139
Фокатопх,blackscar,1843,warrior,arms,66,30,36
Zirêael,kazzak,1843,warrior,arms,96,43,53
Rbbx,tarren-mill,1842,warrior,arms,68,33,35
Orthoss,archimonde,1842,warrior,arms,196,94,102
Zéox,baelgun,1840,warrior,arms,53,30,23
Lrb,tarren-mill,1840,warrior,arms,258,138,120
Jriddyzug,ravencrest,1840,warrior,arms,62,33,29
Wuifly,dun-modr,1840,warrior,arms,279,140,139
Môtu,aegwynn,1839,warrior,arms,60,29,31
Enøt,kazzak,1839,warrior,arms,53,25,28
Sagethi,blackrock,1839,warrior,arms,89,41,48
Avgålöfvén,stormscale,1838,warrior,arms,27,21,6
Мираккл,borean-tundra,1838,warrior,arms,36,21,15
Орданис,deathguard,1838,warrior,arms,66,33,33
Vory,ravencrest,1837,warrior,arms,108,61,47
Eidzo,tarren-mill,1837,warrior,arms,90,48,42
Артагор,blackscar,1836,warrior,arms,53,33,20
Zäløøpå,kazzak,1836,warrior,arms,43,25,18
Vvulf,eredar,1836,warrior,arms,71,31,40
Bøklig,stormscale,1835,warrior,arms,164,90,74
Kanté,burning-blade,1834,warrior,arms,41,24,17
Greenblób,kazzak,1834,warrior,arms,72,31,41
Juggernãut,ravencrest,1833,warrior,arms,159,86,73
Salpaaja,frostwhisper,1833,warrior,arms,66,28,38
Fràgile,ravencrest,1832,warrior,arms,119,65,54
Goldrage,archimonde,1832,warrior,arms,76,41,35
Хэйре,howling-fjord,1832,warrior,arms,238,122,116
Karpzug,stormscale,1832,warrior,arms,45,22,23
Blåvingad,kazzak,1831,warrior,arms,56,34,22
Боссберс,soulflayer,1831,warrior,arms,89,44,45
Rhagnok,archimonde,1831,warrior,arms,180,87,93
Watrux,outland,1831,warrior,arms,66,31,35
Jasi,kazzak,1830,warrior,arms,72,44,28
Воинлета,howling-fjord,1830,warrior,arms,101,60,41
Matti,magtheridon,1830,warrior,arms,53,29,24
Qapper,kazzak,1830,warrior,arms,57,28,29
Shchoor,ravencrest,1830,warrior,arms,48,23,25
Khÿze,ysondre,1829,warrior,arms,58,39,19
Mirpz,doomhammer,1829,warrior,arms,48,31,17
Klearr,silvermoon,1829,warrior,arms,91,56,35
Njn,argent-dawn,1829,warrior,arms,48,23,25
Goorila,kazzak,1829,warrior,arms,54,25,29
Демиорт,howling-fjord,1828,warrior,arms,255,144,111
Balenciarmor,silvermoon,1828,warrior,arms,54,26,28
Kragrâu,kazzak,1828,warrior,arms,83,39,44
Nightmareowl,tarren-mill,1827,warrior,arms,136,76,60
Blazefüry,ravencrest,1827,warrior,arms,61,33,28
Xiro,hellscream,1826,warrior,arms,81,50,31
Bladrun,frostmane,1826,warrior,arms,120,67,53
Skumslag,blackmoore,1826,warrior,arms,137,71,66
Ragestarved,ragnaros,1826,warrior,arms,137,64,73
Starscourge,tarren-mill,1825,warrior,arms,114,85,29
Pyrit,blackhand,1825,warrior,arms,30,21,9
Ярыйваряг,soulflayer,1825,warrior,arms,48,30,18
Ändrow,dalaran,1825,warrior,arms,114,64,50
Nayro,mugthol,1825,warrior,arms,65,33,32
Nurekin,argent-dawn,1825,warrior,arms,66,32,34
Magmos,terenas,1825,warrior,arms,66,30,36
Köftemecx,blackrock,1824,warrior,arms,70,42,28
Rivah,tarren-mill,1824,warrior,arms,63,34,29
Xurainlol,eredar,1824,warrior,arms,58,29,29
Ðezia,tarren-mill,1823,warrior,arms,168,94,74
Naskwar,archimonde,1823,warrior,arms,60,31,29
Ozrenac,kazzak,1823,warrior,arms,213,109,104
Дуухаст,gordunni,1823,warrior,arms,62,29,33
Ðior,bronze-dragonflight,1822,warrior,arms,53,29,24
Augustus,runetotem,1822,warrior,arms,345,183,162
Planina,ravencrest,1822,warrior,arms,231,121,110
Дроктул,howling-fjord,1822,warrior,arms,675,344,331
Crîxús,silvermoon,1822,warrior,arms,60,25,35
Badgenius,nemesis,1821,warrior,arms,42,26,16
Asçrðth,kazzak,1821,warrior,arms,54,26,28
Corvy,ravencrest,1821,warrior,arms,54,25,29
Rngmonster,kazzak,1820,warrior,arms,100,68,32
Uzamaki,bronzebeard,1820,warrior,arms,48,32,16
Knutrex,tarren-mill,1820,warrior,arms,61,35,26
Xxeqtr,kazzak,1820,warrior,arms,166,80,86
Лимпс,gordunni,1819,warrior,arms,30,19,11
Shînta,hyjal,1819,warrior,arms,35,22,13
Vandarms,archimonde,1819,warrior,arms,59,35,24
Flinta,blackmoore,1819,warrior,arms,90,51,39
Maarshl,ysondre,1819,warrior,arms,225,121,104
Pazùzu,twisting-nether,1819,warrior,arms,114,54,60
Dwarfdruine,dun-modr,1818,warrior,arms,85,49,36
Guter,kazzak,1818,warrior,arms,216,110,106
Hunkz,sylvanas,1818,warrior,arms,65,32,33
Nakedwarrior,silvermoon,1818,warrior,arms,66,30,36
Basemode,twisting-nether,1817,warrior,arms,116,65,51
Thebigshow,the-maelstrom,1817,warrior,arms,196,97,99
Daredevìl,eredar,1817,warrior,arms,187,91,96
Nímera,nemesis,1817,warrior,arms,77,37,40
Purporcc,archimonde,1817,warrior,arms,111,50,61
Randomdmg,stormscale,1816,warrior,arms,42,28,14
Liferuiner,rexxar,1816,warrior,arms,133,73,60
Drxeqtit,blackrock,1816,warrior,arms,59,32,27
Eysnwar,blackrock,1815,warrior,arms,30,22,8
Enragemfck,outland,1815,warrior,arms,36,22,14
Erikeverhard,nathrezim,1815,warrior,arms,80,41,39
Dnoire,ravencrest,1815,warrior,arms,60,28,32
Nelthôr,alleria,1814,warrior,arms,156,94,62
Ranoth,hellfire,1814,warrior,arms,54,30,24
Maxwall,twisting-nether,1814,warrior,arms,59,32,27
Чюнилингус,soulflayer,1814,warrior,arms,146,77,69
Naskez,kazzak,1814,warrior,arms,81,41,40
Capitalista,das-konsortium,1814,warrior,arms,89,45,44
Warriorri,haomarush,1814,warrior,arms,42,20,22
Pathocend,kazzak,1814,warrior,arms,106,50,56
Juank,minahonda,1814,warrior,arms,48,21,27
Арма,howling-fjord,1813,warrior,arms,54,39,15
Vic,tarren-mill,1813,warrior,arms,47,20,27
Zcell,kazzak,1812,warrior,arms,36,23,13
Kelhim,blackrock,1812,warrior,arms,138,75,63
Gucciwarrior,blackhand,1812,warrior,arms,90,41,49
Axinit,blackrock,1811,warrior,arms,42,23,19
Thafold,eredar,1811,warrior,arms,107,58,49
Myth,stormscale,1811,warrior,arms,96,52,44
Idiotplay,drekthar,1811,warrior,arms,42,19,23
Raaoo,blackmoore,1810,warrior,arms,57,33,24
Chaosedge,terokkar,1810,warrior,arms,251,137,114
Jesperharle,ravencrest,1810,warrior,arms,41,22,19
Oktharu,silvermoon,1810,warrior,arms,71,37,34
Ðiscordia,blackhand,1810,warrior,arms,84,43,41
Кимлий,deathweaver,1810,warrior,arms,264,125,139
Jokkul,tarren-mill,1810,warrior,arms,46,21,25
Bîmbämboom,blackmoore,1809,warrior,arms,148,94,54
Nikoma,silvermoon,1809,warrior,arms,54,29,25
Старварлорд,soulflayer,1809,warrior,arms,107,55,52
Klnrk,ravencrest,1808,warrior,arms,48,25,23
Anthalar,argent-dawn,1808,warrior,arms,179,92,87
Takeashower,hyjal,1808,warrior,arms,56,28,28
Демолишеер,howling-fjord,1808,warrior,arms,89,42,47
Drilley,blackmoore,1807,warrior,arms,50,34,16
Мелькорт,gordunni,1807,warrior,arms,60,34,26
Zeddone,drakthul,1807,warrior,arms,90,46,44
Bloodhorn,blackhand,1807,warrior,arms,107,54,53
Daigoro,ravencrest,1807,warrior,arms,358,180,178
Nìmera,nemesis,1806,warrior,arms,36,26,10
Yelanx,twisting-nether,1806,warrior,arms,48,34,14
Гатсберсерк,gordunni,1806,warrior,arms,167,91,76
Vathaleron,alakir,1806,warrior,arms,116,63,53
Wayneson,tarren-mill,1806,warrior,arms,108,58,50
Книфэк,howling-fjord,1806,warrior,arms,76,40,36
Wargoth,draenor,1806,warrior,arms,123,63,60
Blademir,aegwynn,1806,warrior,arms,82,37,45
Càvalry,nemesis,1806,warrior,arms,60,27,33
Prymebeevz,blackmoore,1805,warrior,arms,102,59,43
Wetrx,stormscale,1805,warrior,arms,42,24,18
Huyer,stormscale,1805,warrior,arms,54,30,24
Cerßere,archimonde,1805,warrior,arms,128,66,62
Nolóve,archimonde,1805,warrior,arms,198,101,97
Zhangbeihai,ravencrest,1805,warrior,arms,402,203,199
Оксенфурт,soulflayer,1804,warrior,arms,169,85,84
Hanìbal,ravencrest,1803,warrior,arms,60,32,28
Bløødyshøcks,aggra-português,1803,warrior,arms,319,166,153
Vaaýzx,blackrock,1803,warrior,arms,96,48,48
Sonnethrash,tarren-mill,1803,warrior,arms,91,43,48
Ghakra,kazzak,1802,warrior,arms,36,25,11
Westwyde,hyjal,1802,warrior,arms,48,30,18
Thyréc,blackmoore,1802,warrior,arms,60,34,26
Воованыч,gordunni,1802,warrior,arms,72,38,34
Pummelthru,burning-legion,1802,warrior,arms,98,47,51
Yandan,ysondre,1801,warrior,arms,157,83,74
Креспекс,soulflayer,1801,warrior,arms,193,91,102
Tyrasîà,hyjal,1801,warrior,arms,120,54,66
Steroidkidx,stormscale,1801,warrior,arms,54,24,30
Wrecktal,eredar,1800,warrior,arms,81,48,33
Phalek,argent-dawn,1800,warrior,arms,48,28,20
Getsmokedjr,ravencrest,1800,warrior,arms,68,37,31
Варбоссец,soulflayer,1800,warrior,arms,77,40,37
Dairøx,blackrock,1800,warrior,arms,60,31,29
Брокскрим,soulflayer,1800,warrior,arms,144,70,74
Shilix,twisting-nether,1799,warrior,arms,141,65,76
Prøject,archimonde,1798,warrior,arms,66,34,32
Элетий,soulflayer,1798,warrior,arms,108,50,58
Louana,outland,1797,warrior,arms,78,46,32
Saidi,outland,1797,warrior,arms,499,244,255
Lyriae,argent-dawn,1796,warrior,arms,72,43,29
Ursakhan,sylvanas,1796,warrior,arms,81,39,42
Злопиканка,gordunni,1794,warrior,arms,58,29,29
Mintys,sylvanas,1793,warrior,arms,122,66,56
Dõxlol,kazzak,1793,warrior,arms,42,21,21
Hitt,ysondre,1793,warrior,arms,150,71,79
Beevzyn,blackmoore,1791,warrior,arms,36,25,11
Аоетакси,soulflayer,1791,warrior,arms,116,63,53
Nukerz,kirin-tor,1791,warrior,arms,96,48,48
Drahkor,baelgun,1790,warrior,arms,72,44,28
Bigdstance,outland,1790,warrior,arms,227,118,109
Изикол,blackscar,1790,warrior,arms,47,22,25
Kënnyföx,ysondre,1789,warrior,arms,36,19,17
Илди,soulflayer,1789,warrior,arms,88,40,48
Recklesnes,kazzak,1789,warrior,arms,60,26,34
Nedåh,blackrock,1788,warrior,arms,158,77,81
Renwíck,burning-legion,1787,warrior,arms,78,41,37
Keññyfðx,ysondre,1786,warrior,arms,48,28,20
Nihe,stormreaver,1786,warrior,arms,84,37,47
Azotz,archimonde,1786,warrior,arms,60,26,34
Zheaks,kazzak,1785,warrior,arms,95,45,50
Сладкаяхурма,howling-fjord,1784,warrior,arms,54,22,32
Древилгод,gordunni,1783,warrior,arms,57,31,26
Natis,drakthul,1783,warrior,arms,179,87,92
Kennyföx,ysondre,1782,warrior,arms,38,24,14
Eren,todeswache,1782,warrior,arms,114,67,47
Pyrul,antonidas,1782,warrior,arms,143,72,71
Selenez,outland,1782,warrior,arms,97,45,52
Cukrownik,defias-brotherhood,1781,warrior,arms,106,56,50
Эпитафорх,blackscar,1780,warrior,arms,64,40,24
Dragnil,twisting-nether,1779,warrior,arms,60,29,31
Хиро,deathweaver,1779,warrior,arms,118,57,61
Стилерин,gordunni,1779,warrior,arms,93,39,54
Avalin,outland,1778,warrior,arms,48,31,17
Venres,blackhand,1777,warrior,arms,88,47,41
Xvlanter,silvermoon,1777,warrior,arms,151,74,77
Nitheriá,draenor,1776,warrior,arms,448,226,222
Боссберс,howling-fjord,1776,warrior,arms,84,41,43
Малаятварь,gordunni,1774,warrior,arms,58,32,26
Bujax,onyxia,1774,warrior,arms,67,32,35
Røidrage,stormscale,1774,warrior,arms,114,54,60
Màb,antonidas,1773,warrior,arms,108,62,46
Shaked,dun-modr,1772,warrior,arms,119,55,64
Oldcockball,argent-dawn,1771,warrior,arms,207,109,98
Zoefernandes,kazzak,1771,warrior,arms,96,46,50
Niiol,burning-blade,1770,warrior,arms,71,37,34
Brogre,stormrage,1770,warrior,arms,107,53,54
Крипочёк,gordunni,1770,warrior,arms,72,34,38
Otp,ravencrest,1768,warrior,arms,131,61,70
Reapersrage,twisting-nether,1767,warrior,arms,81,44,37
Swaf,ravencrest,1767,warrior,arms,60,30,30
Komissarecks,aegwynn,1767,warrior,arms,63,31,32
Meistersykes,silvermoon,1767,warrior,arms,94,45,49
Yosiwa,draenor,1766,warrior,arms,108,60,48
Blackbiird,blackmoore,1766,warrior,arms,77,42,35
Вуриор,howling-fjord,1766,warrior,arms,231,120,111
Lockmagewar,burning-legion,1766,warrior,arms,108,56,52
Mystylez,silvermoon,1766,warrior,arms,78,34,44
Dannyp,twisting-nether,1765,warrior,arms,42,20,22
Ехрерау,gordunni,1765,warrior,arms,66,27,39
Wørldrûiner,kazzak,1764,warrior,arms,41,31,10
Hatenest,argent-dawn,1764,warrior,arms,100,62,38
Bigdamtosco,ravencrest,1764,warrior,arms,36,20,16
Darshan,grim-batol,1764,warrior,arms,123,59,64
Ayraw,eredar,1763,warrior,arms,60,32,28
Krigipigi,antonidas,1763,warrior,arms,126,61,65
Shookyx,ravencrest,1761,warrior,arms,60,32,28
Бургерс,soulflayer,1761,warrior,arms,202,104,98
Имеравета,gordunni,1761,warrior,arms,180,84,96
Экзекьютлол,soulflayer,1760,warrior,arms,65,32,33
Bigboomer,frostmane,1759,warrior,arms,210,96,114
Gonutz,sylvanas,1757,warrior,arms,66,39,27
Trashman,bronzebeard,1757,warrior,arms,210,111,99
Pj,sanguino,1757,warrior,arms,164,78,86
Flaãy,ravencrest,1756,warrior,arms,142,79,63
Fruiittyy,ravencrest,1756,warrior,arms,149,76,73
Grimlok,sylvanas,1756,warrior,arms,117,53,64
Лилиофанныч,soulflayer,1755,warrior,arms,108,49,59
Deymio,defias-brotherhood,1755,warrior,arms,66,28,38
Cisataker,hyjal,1754,warrior,arms,54,34,20
Khalimov,tarren-mill,1754,warrior,arms,108,54,54
Böggzbunny,tarren-mill,1754,warrior,arms,72,35,37
Azudaddy,blackmoore,1753,warrior,arms,77,41,36
Warounet,hyjal,1753,warrior,arms,54,26,28
Artøria,archimonde,1752,warrior,arms,102,55,47
Cleaver,tarren-mill,1752,warrior,arms,54,29,25
Hasbullá,kazzak,1752,warrior,arms,418,210,208
Хенеар,howling-fjord,1752,warrior,arms,122,61,61
Broumír,antonidas,1752,warrior,arms,78,38,40
Хеула,gordunni,1752,warrior,arms,90,41,49
Trôth,kazzak,1750,warrior,arms,36,23,13
Dataçasé,silvermoon,1750,warrior,arms,71,38,33
Damagz,tarren-mill,1750,warrior,arms,131,64,67
Даскул,gordunni,1749,warrior,arms,72,31,41
Wasdwarr,aegwynn,1748,warrior,arms,195,107,88
Oldchap,nordrassil,1746,warrior,arms,60,34,26
Cyanerd,bronzebeard,1745,warrior,arms,60,30,30
Skywritter,archimonde,1744,warrior,arms,36,25,11
Атаир,deathweaver,1744,warrior,arms,115,63,52
Drittsekken,sylvanas,1744,warrior,arms,135,73,62
Экспла,ashenvale,1744,warrior,arms,60,32,28
Extazsion,stormscale,1744,warrior,arms,57,30,27
Ástriax,ravencrest,1744,warrior,arms,165,78,87
Läerezh,ysondre,1744,warrior,arms,72,34,38
Savesta,dalaran,1743,warrior,arms,233,113,120
Rexonawarr,kazzak,1741,warrior,arms,36,19,17
Rageco,ravencrest,1740,warrior,arms,60,37,23
Ufu,outland,1740,warrior,arms,41,23,18
Whýsøsîlêñt,ragnaros,1739,warrior,arms,42,22,20
Mojotsche,taerar,1738,warrior,arms,64,36,28
Hulkensmash,kazzak,1738,warrior,arms,175,87,88
Cesr,bloodhoof,1738,warrior,arms,106,47,59
Абырабыр,howling-fjord,1737,warrior,arms,48,28,20
Зотлолпромвп,booty-bay,1737,warrior,arms,212,101,111
Троммтар,howling-fjord,1737,warrior,arms,216,101,115
Veav,norgannon,1737,warrior,arms,96,42,54
Фктпх,blackscar,1736,warrior,arms,60,35,25
Hellguard,archimonde,1736,warrior,arms,107,54,53
Rootmagnet,twisting-nether,1734,warrior,arms,77,47,30
Rilor,burning-legion,1734,warrior,arms,147,70,77
Howdoyouløse,stormscale,1734,warrior,arms,54,22,32
Chaddimus,draenor,1733,warrior,arms,75,39,36
Aerês,tarren-mill,1733,warrior,arms,348,171,177
Cherserker,ragnaros,1732,warrior,arms,119,63,56
Bôlufonâ,dun-modr,1732,warrior,arms,292,147,145
Zheq,ragnaros,1732,warrior,arms,68,33,35
Бейесличё,deathguard,1731,warrior,arms,137,61,76
Heltslut,tarren-mill,1730,warrior,arms,143,73,70
Маклецкий,gordunni,1730,warrior,arms,150,68,82
Kotechnik,ysondre,1729,warrior,arms,54,32,22
Jake,rajaxx,1729,warrior,arms,60,30,30
Brutilda,antonidas,1729,warrior,arms,95,43,52
Jínro,draenor,1729,warrior,arms,76,34,42
Dríx,hyjal,1728,warrior,arms,162,84,78
Gigadot,arathor,1728,warrior,arms,294,149,145
Kalacher,draenor,1728,warrior,arms,170,83,87
Вокилог,soulflayer,1726,warrior,arms,955,475,480
Fruitdealer,shattrath,1726,warrior,arms,118,58,60
Oluwafunmila,tarren-mill,1726,warrior,arms,68,33,35
Zexa,tarren-mill,1725,warrior,arms,48,23,25
Srambo,ragnaros,1724,warrior,arms,42,27,15
Creativenot,outland,1724,warrior,arms,62,32,30
Imondiet,ragnaros,1723,warrior,arms,36,21,15
Crawly,aegwynn,1723,warrior,arms,189,97,92
Maisner,stormscale,1723,warrior,arms,74,36,38
Ítikovan,aegwynn,1721,warrior,arms,236,116,120
Wisemanx,draenor,1720,warrior,arms,78,45,33
Giannizugzug,nemesis,1719,warrior,arms,470,240,230
Данзетар,howling-fjord,1719,warrior,arms,71,30,41
Роули,blackscar,1718,warrior,arms,105,57,48
Chargeyou,ragnaros,1718,warrior,arms,84,44,40
Thundranium,kazzak,1718,warrior,arms,55,28,27
Mortalfist,stormscale,1718,warrior,arms,67,33,34
Urasli,doomhammer,1717,warrior,arms,42,24,18
Vôx,sylvanas,1717,warrior,arms,362,178,184
Кисямур,soulflayer,1717,warrior,arms,66,28,38
Bladoran,hyjal,1716,warrior,arms,78,44,34
Nârmøra,thrall,1716,warrior,arms,66,35,31
Барсток,soulflayer,1716,warrior,arms,107,53,54
Emix,arygos,1715,warrior,arms,158,77,81
Hulksmsh,hyjal,1715,warrior,arms,149,63,86
Néxtlølz,twisting-nether,1714,warrior,arms,111,59,52
Виттурус,howling-fjord,1714,warrior,arms,48,25,23
Apacho,outland,1714,warrior,arms,42,21,21
Bordi,nemesis,1713,warrior,arms,259,122,137
Chádtóurps,drakthul,1713,warrior,arms,47,22,25
Rektdrum,ravencrest,1713,warrior,arms,68,31,37
Arnoldr,ysondre,1712,warrior,arms,69,39,30
Cazaril,kazzak,1712,warrior,arms,166,84,82
Jengaa,draenor,1712,warrior,arms,186,93,93
Бисовыйармен,soulflayer,1711,warrior,arms,53,28,25
Johnmeadows,ravencrest,1711,warrior,arms,60,31,29
Balltas,drakthul,1711,warrior,arms,228,114,114
Frozenliøn,twisting-nether,1711,warrior,arms,60,28,32
Tranqtum,ravencrest,1711,warrior,arms,55,25,30
Dógmòdex,stormscale,1710,warrior,arms,48,30,18
Жестокус,gordunni,1710,warrior,arms,102,55,47
Мадс,howling-fjord,1708,warrior,arms,24,18,6
Pourfendre,archimonde,1708,warrior,arms,60,35,25
Xendyo,frostmourne,1707,warrior,arms,232,113,119
Avalinqt,blackrock,1706,warrior,arms,44,32,12
Noxeeql,tarren-mill,1706,warrior,arms,173,97,76
Армсег,soulflayer,1706,warrior,arms,106,57,49
Toroespaña,draenor,1706,warrior,arms,378,193,185
Meovv,saurfang,1706,warrior,arms,102,44,58
Brunodressed,aegwynn,1705,warrior,arms,150,75,75
Rumer,tarren-mill,1704,warrior,arms,111,55,56
Ezøn,aegwynn,1703,warrior,arms,95,46,49
Jackyred,silvermoon,1703,warrior,arms,101,42,59
Mîleycyrûs,stormscale,1702,warrior,arms,30,19,11
Витодпс,howling-fjord,1702,warrior,arms,113,54,59
Yaune,ravencrest,1702,warrior,arms,90,43,47
Марльин,howling-fjord,1702,warrior,arms,101,44,57
Autumnfálls,kazzak,1701,warrior,arms,59,31,28
Garkathar,draenor,1701,warrior,arms,60,31,29
Khemen,kazzak,1700,warrior,arms,149,83,66
Bêllator,stormscale,1700,warrior,arms,64,34,30
Klonyarika,ravencrest,1699,warrior,arms,36,20,16
Endagon,ravencrest,1699,warrior,arms,197,90,107
Falconer,ravencrest,1699,warrior,arms,132,57,75
Maikouyes,archimonde,1698,warrior,arms,266,136,130
Karkatoes,twisting-nether,1698,warrior,arms,68,34,34
Warrez,azuremyst,1697,warrior,arms,48,30,18
Chadsmorc,twisting-nether,1697,warrior,arms,336,175,161
Heclatos,hyjal,1697,warrior,arms,36,18,18
Кофесмолоком,ashenvale,1697,warrior,arms,231,109,122
Nazgrosh,burning-legion,1697,warrior,arms,229,107,122
Naronnas,drakthul,1696,warrior,arms,206,101,105
Yellowjuice,stormscale,1695,warrior,arms,156,89,67
Themeec,silvermoon,1695,warrior,arms,60,29,31
Naum,draenor,1694,warrior,arms,24,18,6
Shadokaa,stormscale,1694,warrior,arms,94,56,38
Greenpanzer,archimonde,1694,warrior,arms,164,90,74
Килафх,blackscar,1694,warrior,arms,294,149,145
Capigo,tarren-mill,1693,warrior,arms,54,32,22
Caltan,wildhammer,1693,warrior,arms,98,55,43
Togas,silvermoon,1693,warrior,arms,437,230,207
Donquiexote,ravencrest,1692,warrior,arms,90,49,41
Imglad,ragnaros,1692,warrior,arms,81,44,37
Woobaby,outland,1692,warrior,arms,138,73,65
Banîsher,drakthul,1692,warrior,arms,235,110,125
Брок,soulflayer,1692,warrior,arms,96,39,57
Escapematrix,kazzak,1691,warrior,arms,131,62,69
Эсфор,howling-fjord,1690,warrior,arms,36,21,15
Тролльвоен,gordunni,1690,warrior,arms,93,54,39
Fattysw,argent-dawn,1690,warrior,arms,73,37,36
Дуглимон,gordunni,1690,warrior,arms,83,42,41
Cassândrä,dalaran,1690,warrior,arms,115,53,62
Vayné,ravencrest,1690,warrior,arms,78,35,43
Naait,draenor,1688,warrior,arms,69,39,30
Orn,tarren-mill,1688,warrior,arms,60,29,31
Babovic,aegwynn,1687,warrior,arms,77,48,29
Kèrrysmâsh,blackrock,1687,warrior,arms,126,75,51
Мопк,howling-fjord,1687,warrior,arms,96,50,46
Asenine,sylvanas,1687,warrior,arms,582,288,294
Рэмпи,soulflayer,1687,warrior,arms,81,37,44
Clashblood,outland,1687,warrior,arms,62,28,34
Hangart,argent-dawn,1687,warrior,arms,48,20,28
Æç,argent-dawn,1686,warrior,arms,72,35,37
Rawenz,drakthul,1686,warrior,arms,89,43,46
Scormash,burning-legion,1686,warrior,arms,67,31,36
Kayhw,stormscale,1686,warrior,arms,72,27,45
Omcat,dun-modr,1686,warrior,arms,57,20,37
Суицидгодх,howling-fjord,1685,warrior,arms,131,73,58
Makgorei,outland,1684,warrior,arms,129,64,65
Тьмасвятая,gordunni,1684,warrior,arms,54,24,30
Quetrax,chogall,1684,warrior,arms,66,24,42
Luntee,ragnaros,1683,warrior,arms,56,32,24
Азктор,soulflayer,1683,warrior,arms,34,19,15
Jackzx,twisting-nether,1683,warrior,arms,48,26,22
Thrux,dalaran,1683,warrior,arms,182,93,89
Гримг,lich-king,1682,warrior,arms,111,58,53
Nèssa,outland,1682,warrior,arms,87,42,45
Грамикк,howling-fjord,1681,warrior,arms,30,19,11
Skillissues,argent-dawn,1681,warrior,arms,72,39,33
Stepmomgodx,kazzak,1681,warrior,arms,49,24,25
Biscuitoliva,hyjal,1681,warrior,arms,49,23,26
Kronmw,dun-modr,1680,warrior,arms,54,20,34
Криккс,greymane,1679,warrior,arms,174,86,88
Loty,drakthul,1679,warrior,arms,368,173,195
Sjozug,tarren-mill,1679,warrior,arms,54,21,33
Ридиусх,gordunni,1678,warrior,arms,43,24,19
Kamatâ,kazzak,1678,warrior,arms,104,50,54
Хеликат,soulflayer,1678,warrior,arms,102,48,54
Palmsweaty,stormrage,1678,warrior,arms,114,51,63
Nyxz,blackhand,1677,warrior,arms,119,62,57
Zaedt,tarren-mill,1677,warrior,arms,53,25,28
Lirscuits,silvermoon,1676,warrior,arms,70,37,33
Neoballac,uldum,1676,warrior,arms,164,83,81
Reccey,blackrock,1676,warrior,arms,158,77,81
Сажень,blackscar,1676,warrior,arms,134,64,70
Alpairx,aegwynn,1676,warrior,arms,56,23,33
Nameless,ysondre,1675,warrior,arms,83,49,34
Шагах,soulflayer,1675,warrior,arms,256,128,128
Fulgrimu,archimonde,1675,warrior,arms,111,53,58
Ðowman,blackrock,1675,warrior,arms,80,38,42
Raikaz,ravencrest,1675,warrior,arms,102,46,56
Бигдэм,howling-fjord,1674,warrior,arms,36,20,16
Mazutov,outland,1673,warrior,arms,54,34,20
Asasius,ravencrest,1673,warrior,arms,42,23,19
Gotar,ravencrest,1673,warrior,arms,255,139,116
Duckyone,zenedar,1673,warrior,arms,42,21,21
Лисерк,howling-fjord,1673,warrior,arms,96,47,49
Catrine,drakthul,1673,warrior,arms,81,33,48
Bonza,blackrock,1672,warrior,arms,102,49,53
Skylåw,archimonde,1672,warrior,arms,178,84,94
Дарамартире,blackscar,1671,warrior,arms,76,42,34
Vorri,ravencrest,1671,warrior,arms,54,27,27
Chíppéd,draenor,1671,warrior,arms,54,26,28
Gatts,krasus,1671,warrior,arms,282,134,148
Kamïlio,stormscale,1671,warrior,arms,66,30,36
Fantasý,burning-legion,1671,warrior,arms,137,59,78
Nîmera,nemesis,1670,warrior,arms,24,19,5
Фалькр,soulflayer,1670,warrior,arms,48,26,22
Aemox,silvermoon,1670,warrior,arms,154,81,73
Estarotte,ravencrest,1670,warrior,arms,73,36,37
Chromoly,aegwynn,1670,warrior,arms,90,43,47
Krionos,ravencrest,1670,warrior,arms,120,57,63
Extreemee,drakthul,1669,warrior,arms,54,28,26
Manoito,argent-dawn,1669,warrior,arms,102,50,52
Skädy,dun-modr,1669,warrior,arms,108,51,57
Riyan,lothar,1668,warrior,arms,48,28,20
Ragëë,tarren-mill,1668,warrior,arms,90,51,39
Bumoletroll,draenor,1668,warrior,arms,45,24,21
Shhimbanned,doomhammer,1668,warrior,arms,85,43,42
Kymz,hyjal,1668,warrior,arms,66,33,33
Nonow,silvermoon,1668,warrior,arms,316,155,161
Wlãð,archimonde,1668,warrior,arms,66,32,34
Braveorc,kazzak,1667,warrior,arms,66,37,29
Ranmaru,kazzak,1667,warrior,arms,115,57,58
Бигдэмс,soulflayer,1667,warrior,arms,54,22,32
Dasyana,drakthul,1666,warrior,arms,137,71,66
Karuck,tarren-mill,1666,warrior,arms,106,54,52
Istyos,hyjal,1666,warrior,arms,137,62,75
Уэсгар,blackscar,1666,warrior,arms,54,19,35
Lepka,drakthul,1665,warrior,arms,147,81,66
Puremëtal,silvermoon,1665,warrior,arms,117,58,59
Геркавоин,eversong,1665,warrior,arms,96,45,51
Wismerx,kazzak,1665,warrior,arms,54,23,31
Ødräcîë,silvermoon,1664,warrior,arms,168,92,76
Acaleus,the-maelstrom,1664,warrior,arms,258,128,130
Дайбайхенд,howling-fjord,1664,warrior,arms,120,59,61
Summerkarma,wildhammer,1664,warrior,arms,263,127,136
Gailko,sanguino,1664,warrior,arms,50,24,26
Zufzuf,twisting-nether,1663,warrior,arms,66,38,28
Learningwarr,eredar,1663,warrior,arms,50,26,24
Bruxus,blackhand,1663,warrior,arms,268,138,130
Rîdler,ravencrest,1663,warrior,arms,389,199,190
Skokuxx,silvermoon,1663,warrior,arms,197,99,98
Fosler,frostmane,1663,warrior,arms,78,35,43
Oplarxigos,kazzak,1663,warrior,arms,84,35,49
Moosewood,draenor,1661,warrior,arms,130,64,66
Arms,earthen-ring,1661,warrior,arms,86,41,45
Spártacus,kazzak,1661,warrior,arms,147,68,79
Tiwâz,eredar,1660,warrior,arms,175,95,80
Chainsáw,stormscale,1660,warrior,arms,202,102,100
Toptier,drakthul,1659,warrior,arms,34,23,11
Громпузан,galakrond,1659,warrior,arms,133,68,65
Олдизаер,soulflayer,1659,warrior,arms,78,39,39
Zombossio,tarren-mill,1659,warrior,arms,175,85,90
Telrion,silvermoon,1658,warrior,arms,42,19,23
Btr,archimonde,1658,warrior,arms,54,23,31
Maresur,burning-legion,1658,warrior,arms,46,18,28
Rolo,antonidas,1657,warrior,arms,85,42,43
Кибервайфу,howling-fjord,1656,warrior,arms,36,22,14
Crandalius,kazzak,1656,warrior,arms,87,51,36
Bloodrain,twilights-hammer,1656,warrior,arms,164,88,76
Lanstus,silvermoon,1656,warrior,arms,120,60,60
Ijzerekast,sylvanas,1656,warrior,arms,103,48,55
Hirurg,thrall,1656,warrior,arms,77,34,43
Rhinobob,kazzak,1656,warrior,arms,56,24,32
Eradya,ravencrest,1655,warrior,arms,82,41,41
Brizeis,malganis,1655,warrior,arms,175,87,88
Leroyluca,gilneas,1655,warrior,arms,66,32,34
Jumpilawl,khaz-modan,1655,warrior,arms,256,124,132
Terrificone,drakthul,1653,warrior,arms,136,76,60
Glavý,burning-legion,1653,warrior,arms,46,25,21
Mertik,twisting-nether,1653,warrior,arms,60,32,28
Латексник,booty-bay,1653,warrior,arms,149,77,72
Freelongx,stormscale,1653,warrior,arms,48,20,28
Lusan,sylvanas,1652,warrior,arms,60,31,29
Gigasmash,pozzo-delleternità,1652,warrior,arms,404,202,202
Zijsû,chogall,1652,warrior,arms,91,39,52
Furukawa,ravencrest,1651,warrior,arms,87,45,42
Lazytowl,outland,1651,warrior,arms,177,90,87
Hli,tarren-mill,1650,warrior,arms,42,24,18
Avelyr,pozzo-delleternità,1650,warrior,arms,48,26,22
Богадорога,howling-fjord,1650,warrior,arms,72,37,35
Айфилшок,gordunni,1650,warrior,arms,96,48,48
Belmont,doomhammer,1650,warrior,arms,66,33,33
Pangowar,elune,1650,warrior,arms,99,49,50
Jeronimoe,blackmoore,1649,warrior,arms,49,34,15
Заликмортал,soulflayer,1649,warrior,arms,216,110,106
Mozeratz,magtheridon,1649,warrior,arms,46,22,24
Drâpârn,sylvanas,1648,warrior,arms,42,24,18
Quadfather,kazzak,1648,warrior,arms,42,22,20
Wardruine,dun-modr,1648,warrior,arms,191,92,99
Reider,twisting-nether,1648,warrior,arms,260,123,137
Whatabeast,blackmoore,1647,warrior,arms,37,20,17
Asç,kazzak,1647,warrior,arms,42,21,21
Boldinq,ravencrest,1647,warrior,arms,147,70,77
Raidek,dragonmaw,1646,warrior,arms,132,68,64
Loosecanon,ravencrest,1646,warrior,arms,53,26,27
Termonsa,stormscale,1645,warrior,arms,67,38,29
Preliator,outland,1644,warrior,arms,42,24,18
Zhadsnark,blackrock,1644,warrior,arms,150,79,71
Lîlsaint,dun-morogh,1644,warrior,arms,60,30,30
Taoke,ravencrest,1644,warrior,arms,90,39,51
Morbaac,archimonde,1644,warrior,arms,54,22,32
Doksziqqt,ragnaros,1642,warrior,arms,36,22,14
Rankone,bladefist,1642,warrior,arms,47,24,23
Hornkesh,draenor,1642,warrior,arms,48,24,24
Бодибилдерыч,gordunni,1642,warrior,arms,149,74,75
Smkms,kazzak,1642,warrior,arms,101,49,52
Bhallts,tarren-mill,1642,warrior,arms,98,44,54
Ckz,ysondre,1641,warrior,arms,36,26,10
Cyruk,blackmoore,1641,warrior,arms,289,145,144
Hamez,thunderhorn,1641,warrior,arms,76,38,38
Nardoch,archimonde,1641,warrior,arms,234,116,118
Remen,archimonde,1641,warrior,arms,84,37,47
Diamonddogs,draenor,1640,warrior,arms,52,32,20
Андреевич,blackscar,1640,warrior,arms,270,138,132
Nassir,stormscale,1640,warrior,arms,138,64,74
Broarextiger,ragnaros,1639,warrior,arms,33,18,15
Fatmikez,aggra-português,1639,warrior,arms,142,77,65
Ahzrok,draenor,1639,warrior,arms,238,128,110
Фенилэфрин,gordunni,1639,warrior,arms,140,71,69
Wítts,ravencrest,1638,warrior,arms,36,22,14
Samîr,arthas,1638,warrior,arms,36,21,15
Paralantius,kazzak,1638,warrior,arms,48,27,21
Беренса,howling-fjord,1638,warrior,arms,219,114,105
Jambaz,ravencrest,1638,warrior,arms,53,27,26
Sefty,tarren-mill,1638,warrior,arms,46,18,28
Луновоин,gordunni,1637,warrior,arms,84,51,33
Eduartho,dun-modr,1637,warrior,arms,51,29,22
Bastrick,argent-dawn,1637,warrior,arms,146,77,69
Pachipachi,blackmoore,1637,warrior,arms,44,23,21
Nyamnyamnyam,blackmoore,1637,warrior,arms,46,21,25
Keluke,thrall,1637,warrior,arms,63,27,36
Fookyoup,stormscale,1637,warrior,arms,51,21,30
Pinkblast,sylvanas,1637,warrior,arms,78,30,48
Lizzybigtits,kazzak,1636,warrior,arms,60,40,20
Lücifer,dun-modr,1636,warrior,arms,177,102,75
Blackfrosty,stormscale,1636,warrior,arms,78,43,35
Хедтакер,gordunni,1636,warrior,arms,69,37,32
Hatestørm,kazzak,1636,warrior,arms,42,22,20
Psychlolz,burning-legion,1636,warrior,arms,60,30,30
Thanâtøs,kazzak,1636,warrior,arms,36,18,18
Garthock,stormscale,1636,warrior,arms,42,20,22
Josem,sanguino,1636,warrior,arms,45,20,25
Erickson,tarren-mill,1636,warrior,arms,42,18,24
Haanok,ravencrest,1635,warrior,arms,77,45,32
Sydian,burning-legion,1635,warrior,arms,36,21,15
Tgabor,ragnaros,1635,warrior,arms,95,51,44
Ryofu,stormscale,1635,warrior,arms,42,22,20
Krew,drakthul,1635,warrior,arms,96,48,48
Белхэнд,soulflayer,1635,warrior,arms,315,154,161
Off,archimonde,1634,warrior,arms,30,18,12
Knubbz,ravencrest,1634,warrior,arms,114,59,55
Curelia,malganis,1634,warrior,arms,36,18,18
Kawaro,rajaxx,1634,warrior,arms,72,35,37
Dedewawa,ysondre,1634,warrior,arms,42,20,22
Doloresvp,zuljin,1634,warrior,arms,156,74,82
Klynd,nemesis,1634,warrior,arms,246,114,132
Devidz,outland,1634,warrior,arms,95,43,52
Geforce,hellscream,1633,warrior,arms,587,298,289
Eggsecutor,stormscale,1633,warrior,arms,164,83,81
Nazhar,kult-der-verdammten,1633,warrior,arms,54,27,27
Lyroe,blackrock,1633,warrior,arms,42,21,21
Randrion,blackrock,1633,warrior,arms,47,23,24
Asuramaru,aegwynn,1632,warrior,arms,176,96,80
Арсон,soulflayer,1632,warrior,arms,36,19,17
Atlizz,twisting-nether,1632,warrior,arms,90,47,43
Agoobagoo,alakir,1632,warrior,arms,47,23,24
Кхаррнн,gordunni,1632,warrior,arms,185,89,96
Liked,tarren-mill,1632,warrior,arms,54,24,30
Bronn,defias-brotherhood,1631,warrior,arms,97,53,44
Ebonheart,argent-dawn,1631,warrior,arms,139,68,71
Bamme,archimonde,1631,warrior,arms,59,28,31
Zaurzyfang,burning-legion,1630,warrior,arms,94,52,42
Испепелитель,howling-fjord,1630,warrior,arms,126,66,60
Çon,ravencrest,1630,warrior,arms,121,63,58
Nalx,tarren-mill,1630,warrior,arms,147,76,71
Aranill,tarren-mill,1630,warrior,arms,117,60,57
Maxxiwumms,amanthul,1630,warrior,arms,84,39,45
Arachnoyd,drakthul,1629,warrior,arms,36,21,15
Aestheticon,burning-blade,1629,warrior,arms,36,21,15
Høtsky,twisting-nether,1629,warrior,arms,72,38,34
Zugstorm,outland,1629,warrior,arms,100,50,50
Lewh,blackmoore,1629,warrior,arms,139,69,70
Unbrauchbar,silvermoon,1628,warrior,arms,182,99,83
Laavapoeg,outland,1628,warrior,arms,105,56,49
Darksídex,silvermoon,1628,warrior,arms,339,176,163
Watashilfy,ravencrest,1628,warrior,arms,78,39,39
Inhaler,ravencrest,1628,warrior,arms,74,37,37
Bluxy,outland,1628,warrior,arms,54,21,33
Winabella,tarren-mill,1627,warrior,arms,36,20,16
Iameconomist,twisting-nether,1627,warrior,arms,36,17,19
Hellkau,blackmoore,1627,warrior,arms,57,26,31
Klinga,bladefist,1626,warrior,arms,42,24,18
Xzm,stormscale,1626,warrior,arms,33,18,15
Incendix,stormscale,1626,warrior,arms,184,96,88
Omgez,grim-batol,1626,warrior,arms,48,20,28
Temashi,kazzak,1625,warrior,arms,113,64,49
Mellîødas,blackmoore,1625,warrior,arms,92,49,43
Седлайккеану,howling-fjord,1625,warrior,arms,195,99,96
Hollydeffs,blackmoore,1625,warrior,arms,114,56,58
Zouo,blackhand,1625,warrior,arms,47,23,24
Asipositas,eredar,1625,warrior,arms,42,19,23
Golmmash,draenor,1625,warrior,arms,122,55,67
Stanislav,tarren-mill,1624,warrior,arms,38,24,14
Arsinal,destromath,1624,warrior,arms,30,17,13
Sørêy,aegwynn,1624,warrior,arms,84,41,43
Kfc,chamber-of-aspects,1623,warrior,arms,70,37,33
Розети,gordunni,1623,warrior,arms,57,30,27
Богатыйпапа,howling-fjord,1623,warrior,arms,191,98,93
Rhaegon,laughing-skull,1623,warrior,arms,48,24,24
Justyòqt,archimonde,1623,warrior,arms,84,40,44
Bhallts,twisting-nether,1623,warrior,arms,100,45,55
Leethal,outland,1623,warrior,arms,119,48,71
Facestomper,onyxia,1622,warrior,arms,145,77,68
Sorkk,kazzak,1622,warrior,arms,98,50,48
Serastul,rajaxx,1622,warrior,arms,116,59,57
Kennzz,ravencrest,1622,warrior,arms,66,33,33
Фурианка,galakrond,1622,warrior,arms,63,31,32
Spartaz,eredar,1622,warrior,arms,66,30,36
Ludiboro,kazzak,1622,warrior,arms,60,22,38
Diz,terokkar,1621,warrior,arms,139,82,57
Solaje,dun-modr,1621,warrior,arms,39,22,17
Kût,les-sentinelles,1621,warrior,arms,41,22,19
Арткес,gordunni,1621,warrior,arms,254,133,121
Mocomomo,argent-dawn,1621,warrior,arms,48,25,23
Liper,silvermoon,1621,warrior,arms,235,122,113
Kamilfury,burning-legion,1621,warrior,arms,148,71,77
Vizn,emerald-dream,1621,warrior,arms,100,43,57
Autístickid,aegwynn,1620,warrior,arms,30,23,7
Pishpy,sylvanas,1620,warrior,arms,50,27,23
Prestà,archimonde,1620,warrior,arms,93,49,44
Gargaflike,aggra-português,1620,warrior,arms,84,37,47
Øfdream,tarren-mill,1619,warrior,arms,47,27,20
Vayndral,kazzak,1619,warrior,arms,126,67,59
Saetásh,argent-dawn,1619,warrior,arms,185,87,98
Sickslamzyø,ravencrest,1619,warrior,arms,42,17,25
Schmelzlord,thrall,1619,warrior,arms,45,18,27
Mxrdvr,kazzak,1618,warrior,arms,54,35,19
Tabboonishka,draenor,1618,warrior,arms,48,28,20
Axero,drakthul,1618,warrior,arms,88,44,44
Wigsplitterx,twisting-nether,1618,warrior,arms,467,229,238
Хирошка,gordunni,1618,warrior,arms,138,66,72
Глейс,gordunni,1618,warrior,arms,54,23,31
Cptnzugzug,blackmoore,1617,warrior,arms,41,23,18
Surthur,magtheridon,1617,warrior,arms,82,42,40
Ermòr,ravencrest,1617,warrior,arms,81,40,41
Фуджитаку,gordunni,1617,warrior,arms,60,19,41
Чухануспрайм,howling-fjord,1616,warrior,arms,52,25,27
Shavoi,die-aldor,1616,warrior,arms,47,21,26
Borthuk,tarren-mill,1616,warrior,arms,119,51,68
Khireebonk,hyjal,1615,warrior,arms,36,24,12
Räzorleaf,kul-tiras,1615,warrior,arms,126,69,57
Gerrmund,silvermoon,1615,warrior,arms,81,44,37
Рекиро,blackscar,1615,warrior,arms,40,21,19
Riptack,anetheron,1615,warrior,arms,379,197,182
Gladius,ysera,1615,warrior,arms,86,43,43
Voxz,stormscale,1615,warrior,arms,318,154,164
Вандэрбой,howling-fjord,1615,warrior,arms,288,133,155
Otzi,sargeras,1615,warrior,arms,135,62,73
Оманко,howling-fjord,1614,warrior,arms,60,29,31
Chàrgex,blackrock,1614,warrior,arms,64,30,34
Untiltèd,ravencrest,1613,warrior,arms,89,60,29
Фелпир,soulflayer,1613,warrior,arms,197,104,93
Cirenax,draenor,1613,warrior,arms,60,31,29
Jakim,tarren-mill,1613,warrior,arms,190,95,95
Гуорг,howling-fjord,1613,warrior,arms,326,161,165
Blayr,tarren-mill,1613,warrior,arms,163,78,85
Tinkaton,sylvanas,1613,warrior,arms,54,23,31
Maldark,scarshield-legion,1612,warrior,arms,212,100,112
Чевчелиос,deathweaver,1612,warrior,arms,53,25,28
Ахиллслэм,howling-fjord,1612,warrior,arms,174,76,98
Senzroy,bloodfeather,1611,warrior,arms,44,24,20
Ïnahö,hyjal,1611,warrior,arms,36,19,17
Bélløne,dalaran,1611,warrior,arms,138,66,72
Diô,stormscale,1611,warrior,arms,47,21,26
Mumon,burning-legion,1611,warrior,arms,59,24,35
Smoothbrian,ravencrest,1610,warrior,arms,137,70,67
Dafrang,kazzak,1610,warrior,arms,184,94,90
Куэсес,howling-fjord,1610,warrior,arms,39,19,20
Донтрелиз,howling-fjord,1610,warrior,arms,123,59,64
Enzja,nazjatar,1610,warrior,arms,66,31,35
Strife,ravencrest,1609,warrior,arms,81,51,30
Убитаякорова,soulflayer,1609,warrior,arms,72,38,34
Ивантуз,gordunni,1609,warrior,arms,54,27,27
Biggerer,blackrock,1609,warrior,arms,120,57,63
Pryzinstyle,aegwynn,1609,warrior,arms,36,17,19
Yakhshar,silvermoon,1609,warrior,arms,54,24,30
Mävïs,ravencrest,1608,warrior,arms,84,46,38
Skgrimson,stormscale,1608,warrior,arms,113,60,53
Штурмгешутц,deathweaver,1608,warrior,arms,204,105,99
Crissx,silvermoon,1608,warrior,arms,444,228,216
Guts,frostwhisper,1608,warrior,arms,173,83,90
Caméltoe,frostwolf,1608,warrior,arms,149,70,79
Fromagekipue,argent-dawn,1607,warrior,arms,88,47,41
Bellerophon,eredar,1607,warrior,arms,62,31,31
Pulx,dun-modr,1607,warrior,arms,54,20,34
Хэллоуиныч,soulflayer,1606,warrior,arms,30,17,13
Bj,blackrock,1606,warrior,arms,123,65,58
Pikkemaát,stormscale,1606,warrior,arms,101,53,48
Oppressíon,silvermoon,1606,warrior,arms,46,22,24
Takatoa,argent-dawn,1606,warrior,arms,54,23,31
Rágnør,blackrock,1606,warrior,arms,66,26,40
Zelwar,drakthul,1605,warrior,arms,37,23,14
Trajkovic,ravencrest,1605,warrior,arms,292,160,132
Taÿ,stormscale,1605,warrior,arms,36,19,17
Jeax,rexxar,1605,warrior,arms,46,20,26
Albwarr,kazzak,1605,warrior,arms,42,18,24
Faimy,tarren-mill,1604,warrior,arms,36,21,15
Ronoh,kazzak,1604,warrior,arms,42,23,19
Poyraz,blackrock,1604,warrior,arms,78,41,37
Gooner,argent-dawn,1604,warrior,arms,94,49,45
Armsbull,twisting-nether,1604,warrior,arms,126,65,61
Knî,archimonde,1604,warrior,arms,51,20,31
Bloodx,archimonde,1603,warrior,arms,36,20,16
Gipsyjoe,ragnaros,1603,warrior,arms,100,51,49
Battlemaster,die-aldor,1603,warrior,arms,98,49,49
Tweran,drakthul,1603,warrior,arms,66,33,33
Buckiesøde,twisting-nether,1603,warrior,arms,36,17,19
Tenvee,outland,1603,warrior,arms,48,22,26
Paranoiás,ragnaros,1603,warrior,arms,110,47,63
Eskiler,burning-legion,1603,warrior,arms,54,23,31
Zkou,wrathbringer,1603,warrior,arms,60,22,38
Ironbutter,ravencrest,1602,warrior,arms,122,71,51
Warmis,argent-dawn,1602,warrior,arms,72,39,33
Eselhirte,blackmoore,1602,warrior,arms,85,46,39
Grimarg,drakthul,1602,warrior,arms,102,54,48
Голдибитч,gordunni,1602,warrior,arms,138,72,66
Eohere,der-rat-von-dalaran,1602,warrior,arms,117,61,56
Астерио,blackscar,1601,warrior,arms,120,63,57
Miz,dun-modr,1601,warrior,arms,63,32,31
Reapo,blackhand,1601,warrior,arms,207,101,106
Dragoons,tyrande,1601,warrior,arms,128,62,66
Héda,tarren-mill,1601,warrior,arms,108,52,56
Kupr,outland,1601,warrior,arms,46,21,25
Crystallake,blackrock,1601,warrior,arms,114,52,62
Sunney,tarren-mill,1600,warrior,arms,35,21,14
Ммайдаен,goldrinn,1600,warrior,arms,148,77,71
Béastmødexz,eredar,1600,warrior,arms,59,26,33
Bucketheadde,thrall,1600,warrior,arms,59,26,33
Sumprunkare,stormscale,1599,warrior,arms,52,29,23
Mugteef,der-rat-von-dalaran,1599,warrior,arms,41,22,19
Вамвоосна,gordunni,1599,warrior,arms,50,22,28
Furanos,blackrock,1597,warrior,arms,71,36,35
Вагранна,soulflayer,1597,warrior,arms,54,26,28
Морнстар,gordunni,1597,warrior,arms,115,55,60
Bloodbrother,blackmoore,1596,warrior,arms,152,81,71
Grimzot,ragnaros,1596,warrior,arms,96,51,45
Кладбошаа,gordunni,1596,warrior,arms,138,70,68
Gorelaw,turalyon,1596,warrior,arms,36,18,18
Омепразол,gordunni,1596,warrior,arms,289,143,146
Poolboyx,tarren-mill,1596,warrior,arms,165,80,85
Arandyr,archimonde,1596,warrior,arms,72,30,42
Hamilton,bronzebeard,1595,warrior,arms,51,30,21
Elder,darkmoon-faire,1595,warrior,arms,203,102,101
Kobeni,ysondre,1595,warrior,arms,85,40,45
Kwaiha,kazzak,1595,warrior,arms,91,42,49
Бурчун,deathguard,1594,warrior,arms,54,34,20
Fáro,ravencrest,1594,warrior,arms,70,34,36
Xiiver,burning-legion,1593,warrior,arms,143,76,67
Bstgame,frostmane,1593,warrior,arms,54,23,31
Secondwarri,frostwolf,1592,warrior,arms,92,49,43
Trâshcârlitâ,eredar,1592,warrior,arms,54,19,35
Hashashyn,stormscale,1591,warrior,arms,71,37,34
Туранк,howling-fjord,1591,warrior,arms,298,148,150
Najjs,eredar,1591,warrior,arms,51,25,26
Neoballâc,uldum,1590,warrior,arms,42,24,18
Ruinatiøn,stormscale,1589,warrior,arms,48,30,18
Порицающий,soulflayer,1589,warrior,arms,76,39,37
Sepuko,stormscale,1589,warrior,arms,144,71,73
Thundersword,sylvanas,1589,warrior,arms,84,30,54
Kultywator,silvermoon,1588,warrior,arms,30,21,9
Spijkerbroek,alakir,1588,warrior,arms,779,395,384
Huscar,thrall,1588,warrior,arms,77,38,39
Olfik,drakthul,1588,warrior,arms,52,20,32
Spridan,ravencrest,1588,warrior,arms,54,20,34
Celphboss,tarren-mill,1587,warrior,arms,111,61,50
Kazzuk,dentarg,1587,warrior,arms,81,41,40
Dreadbanga,blackmoore,1587,warrior,arms,103,49,54
Deathwingx,azuremyst,1587,warrior,arms,159,75,84
Corlo,uldaman,1587,warrior,arms,98,44,54
Jaythegodx,blackrock,1587,warrior,arms,169,75,94
Drachnór,kazzak,1586,warrior,arms,57,34,23
Aeldran,argent-dawn,1586,warrior,arms,54,28,26
Bronix,blackrock,1586,warrior,arms,130,64,66
Дугмар,gordunni,1586,warrior,arms,271,131,140
Astidon,ravencrest,1586,warrior,arms,69,33,36
Khylza,archimonde,1586,warrior,arms,42,20,22
Nozuki,archimonde,1585,warrior,arms,475,234,241
Karreg,hyjal,1585,warrior,arms,253,122,131
Ogurok,frostwolf,1585,warrior,arms,129,58,71
Sobii,ravencrest,1584,warrior,arms,83,44,39
Germantank,ravencrest,1584,warrior,arms,36,19,17
Bufdefstance,kazzak,1584,warrior,arms,86,43,43
Belfodil,outland,1584,warrior,arms,52,26,26
Джамалли,howling-fjord,1584,warrior,arms,60,26,34
Рандомвар,howling-fjord,1583,warrior,arms,30,17,13
Mortaal,frostmane,1583,warrior,arms,127,69,58
Pumpadzhîja,stormscale,1583,warrior,arms,52,28,24
Bérsérk,blackmoore,1583,warrior,arms,46,24,22
Напутанность,soulflayer,1583,warrior,arms,459,237,222
Мастерион,soulflayer,1583,warrior,arms,216,108,108
Shiqo,ravencrest,1583,warrior,arms,135,63,72
Молчаньеума,howling-fjord,1583,warrior,arms,96,41,55
Naturesfault,ravencrest,1582,warrior,arms,32,19,13
Únkqt,dalaran,1582,warrior,arms,75,40,35
Notinfa,draenor,1582,warrior,arms,239,126,113
Rageover,outland,1582,warrior,arms,40,21,19
Fragmeista,ragnaros,1582,warrior,arms,36,17,19
Achîlles,twisting-nether,1581,warrior,arms,36,20,16
Rødprincê,ravencrest,1581,warrior,arms,69,38,31
Grandslám,blackrock,1581,warrior,arms,41,20,21
Geroldius,silvermoon,1581,warrior,arms,60,26,34
Форгерон,howling-fjord,1581,warrior,arms,71,30,41
Talión,ravencrest,1580,warrior,arms,42,28,14
Yeezy,les-sentinelles,1580,warrior,arms,50,26,24
Knoutt,burning-legion,1580,warrior,arms,42,20,22
Orgi,drakthul,1580,warrior,arms,42,17,25
Каосвар,howling-fjord,1579,warrior,arms,30,19,11
Wtchmyblade,blackmoore,1579,warrior,arms,124,71,53
Shirurî,blackrock,1577,warrior,arms,80,46,34
Okoru,stormscale,1577,warrior,arms,154,79,75
Brewgut,argent-dawn,1577,warrior,arms,83,40,43
Badroch,kazzak,1577,warrior,arms,94,41,53
Snðw,outland,1577,warrior,arms,103,40,63
Sýkz,exodar,1577,warrior,arms,53,19,34
Duncán,auchindoun,1576,warrior,arms,71,38,33
Vullgrîm,blackmoore,1576,warrior,arms,102,51,51
Taistelumage,stormreaver,1576,warrior,arms,35,17,18
Argean,argent-dawn,1576,warrior,arms,78,34,44
Lpa,stormscale,1575,warrior,arms,80,42,38
Crangle,draenor,1575,warrior,arms,126,65,61
Eyeslicer,quelthalas,1575,warrior,arms,54,27,27
Robou,hyjal,1575,warrior,arms,382,180,202
Oxay,alakir,1575,warrior,arms,70,30,40
Nakro,hyjal,1574,warrior,arms,48,29,19
Malgár,argent-dawn,1574,warrior,arms,82,42,40
Glendower,draenor,1574,warrior,arms,109,51,58
Erotixboi,blackrock,1573,warrior,arms,48,29,19
Sebeastian,ravencrest,1573,warrior,arms,126,67,59
Rabaozi,blackhand,1573,warrior,arms,167,84,83
Хоркан,blackscar,1573,warrior,arms,72,35,37
Linkx,lightnings-blade,1573,warrior,arms,66,30,36
Teliese,argent-dawn,1573,warrior,arms,50,20,30
Drengr,blackhand,1572,warrior,arms,30,17,13
Quáker,stormscale,1572,warrior,arms,86,48,38
Оргрриммар,soulflayer,1572,warrior,arms,501,250,251
Khanox,twisting-nether,1572,warrior,arms,166,82,84
Сариату,soulflayer,1572,warrior,arms,36,17,19
Velgrim,ravencrest,1572,warrior,arms,87,37,50
Arashicage,emeriss,1571,warrior,arms,183,102,81
Bôris,argent-dawn,1571,warrior,arms,94,51,43
Mypzo,kazzak,1571,warrior,arms,156,76,80
Trust,darksorrow,1570,warrior,arms,119,61,58
Monbun,silvermoon,1570,warrior,arms,101,51,50
Arcreign,kazzak,1570,warrior,arms,216,107,109
Hefthyn,sanguino,1569,warrior,arms,72,41,31
Breaken,silvermoon,1569,warrior,arms,60,32,28
Спуллае,soulflayer,1569,warrior,arms,48,25,23
Robitusin,ragnaros,1569,warrior,arms,151,72,79
Melogranod,nemesis,1569,warrior,arms,42,20,22
Zarad,stormreaver,1568,warrior,arms,90,50,40
Vampviv,tarren-mill,1568,warrior,arms,36,19,17
Yoñtuk,twisting-nether,1568,warrior,arms,36,19,17
Dzvenyhora,darkspear,1568,warrior,arms,138,70,68
Miodrag,kazzak,1568,warrior,arms,71,35,36
Lakes,eredar,1568,warrior,arms,50,18,32
Rswar,archimonde,1567,warrior,arms,36,21,15
Ganzaésábi,aggra-português,1567,warrior,arms,108,57,51
Слуфен,galakrond,1566,warrior,arms,78,44,34
Gely,silvermoon,1566,warrior,arms,119,59,60
Rageful,saurfang,1566,warrior,arms,66,32,34
Chestbru,blackrock,1566,warrior,arms,164,72,92
Дейдулус,soulflayer,1566,warrior,arms,78,33,45
Miniwitts,ravencrest,1565,warrior,arms,30,20,10
Orcassmus,blackrock,1565,warrior,arms,66,36,30
Тритиан,soulflayer,1565,warrior,arms,171,87,84
Rakuna,tarren-mill,1565,warrior,arms,138,68,70
Lilgozga,stormscale,1565,warrior,arms,113,47,66
Stormfist,tarren-mill,1564,warrior,arms,96,54,42
Едигейй,gordunni,1564,warrior,arms,58,32,26
Skrawarr,das-syndikat,1564,warrior,arms,174,88,86
Perinel,draenor,1564,warrior,arms,210,104,106
Ajax,defias-brotherhood,1564,warrior,arms,101,49,52
Methodxd,outland,1564,warrior,arms,84,40,44
Jastreb,blackrock,1564,warrior,arms,132,60,72
Sankuto,kazzak,1563,warrior,arms,83,50,33
Cavo,drakthul,1563,warrior,arms,42,18,24
Lilshockwave,argent-dawn,1561,warrior,arms,54,31,23
Krîspie,archimonde,1561,warrior,arms,131,68,63
Футжисубо,razuvious,1561,warrior,arms,47,24,23
Gozga,twisting-nether,1561,warrior,arms,202,103,99
Rongh,saurfang,1561,warrior,arms,36,17,19
Daýz,draenor,1561,warrior,arms,48,18,30
Shoesmith,outland,1560,warrior,arms,388,191,197
Abrash,ysondre,1560,warrior,arms,154,75,79
Протектор,soulflayer,1560,warrior,arms,60,29,31
Stancenation,draenor,1560,warrior,arms,105,50,55
Сёнпай,soulflayer,1559,warrior,arms,35,21,14
Delonathor,drakthul,1559,warrior,arms,50,29,21
Alyx,mugthol,1559,warrior,arms,116,62,54
Хэлслэйтэр,gordunni,1559,warrior,arms,130,65,65
Xennor,argent-dawn,1558,warrior,arms,118,61,57
Huullkk,nazjatar,1558,warrior,arms,149,73,76
Nerfmyrage,hyjal,1558,warrior,arms,136,64,72
Mikehawk,les-clairvoyants,1558,warrior,arms,53,20,33
Беспонятия,blackscar,1557,warrior,arms,82,45,37
Ayasana,argent-dawn,1557,warrior,arms,48,26,22
Zíreael,ravencrest,1557,warrior,arms,95,49,46
Тише,deathweaver,1557,warrior,arms,60,29,31
Daminia,aegwynn,1556,warrior,arms,60,38,22
Wyes,kazzak,1556,warrior,arms,227,118,109
Manokikiros,sylvanas,1556,warrior,arms,36,18,18
Hasmocaru,silvermoon,1556,warrior,arms,84,40,44
Saofang,twisting-nether,1555,warrior,arms,66,33,33
Yeahq,kazzak,1555,warrior,arms,266,130,136
Elprotes,sanguino,1554,warrior,arms,204,110,94
Hivuka,blackhand,1554,warrior,arms,42,22,20
Evrybodydown,draenor,1554,warrior,arms,296,150,146
Wazraf,khaz-modan,1554,warrior,arms,198,100,98
Reìvah,silvermoon,1554,warrior,arms,147,70,77
Rendz,ravencrest,1553,warrior,arms,30,19,11
Mélindà,silvermoon,1553,warrior,arms,63,38,25
Ariéz,tarren-mill,1553,warrior,arms,116,62,54
Dagreenjo,tarren-mill,1553,warrior,arms,60,32,28
Kantarion,stormscale,1553,warrior,arms,108,55,53
Сабствер,howling-fjord,1553,warrior,arms,125,56,69
Bllué,ravencrest,1553,warrior,arms,42,17,25
Fokra,draenor,1552,warrior,arms,86,53,33
Mashooxd,archimonde,1552,warrior,arms,42,23,19
Waf,hakkar,1552,warrior,arms,195,105,90
Shownomercy,blackrock,1552,warrior,arms,72,36,36
Xanco,ravencrest,1552,warrior,arms,110,54,56
Шеломвар,gordunni,1552,warrior,arms,256,123,133
Tezzter,malganis,1552,warrior,arms,87,40,47
ßloodz,hyjal,1552,warrior,arms,144,66,78
Horsewarrior,stormscale,1552,warrior,arms,83,35,48
Брэмбур,goldrinn,1551,warrior,arms,185,95,90
Lothbrok,haomarush,1551,warrior,arms,95,44,51
Shirøx,blackrock,1550,warrior,arms,78,42,36
Philatou,antonidas,1549,warrior,arms,53,29,24
Ratko,blackmoore,1549,warrior,arms,74,40,34
Genjutsubeat,blackmoore,1548,warrior,arms,54,31,23
Divyx,tarren-mill,1548,warrior,arms,139,72,67
Scarloc,archimonde,1548,warrior,arms,134,68,66
Martins,doomhammer,1548,warrior,arms,302,151,151
Raizy,frostwolf,1547,warrior,arms,350,185,165
Kaîsaschnitt,malganis,1547,warrior,arms,167,88,79
Arowbaze,archimonde,1547,warrior,arms,66,28,38
Hortswarr,drakthul,1546,warrior,arms,49,29,20
Donfidel,tarren-mill,1546,warrior,arms,30,17,13
Threnewar,kazzak,1546,warrior,arms,60,31,29
Tamesulo,silvermoon,1546,warrior,arms,101,52,49
Zëhef,hyjal,1546,warrior,arms,138,71,67
Bluto,dunemaul,1546,warrior,arms,447,228,219
Chrekk,khaz-modan,1546,warrior,arms,157,80,77
Shagara,defias-brotherhood,1546,warrior,arms,92,45,47
Trenôdeca,stormscale,1546,warrior,arms,48,23,25
Alexandrrior,rexxar,1546,warrior,arms,114,53,61
Rightversion,sylvanas,1546,warrior,arms,66,30,36
Khilax,ragnaros,1545,warrior,arms,228,127,101
Yatõ,blackmoore,1545,warrior,arms,83,41,42
Cäös,sanguino,1545,warrior,arms,122,59,63
Nàsher,frostwolf,1545,warrior,arms,133,64,69
Batïk,blackmoore,1545,warrior,arms,131,59,72
Roniw,sylvanas,1544,warrior,arms,102,54,48
Massiveape,argent-dawn,1544,warrior,arms,69,35,34
Grumpy,lightbringer,1544,warrior,arms,136,67,69
Kekrah,burning-legion,1544,warrior,arms,65,27,38
Lubcifer,emeriss,1543,warrior,arms,30,17,13
Lyes,uldaman,1543,warrior,arms,444,222,222
Panggy,ragnaros,1543,warrior,arms,100,50,50
Rottenfall,azjolnerub,1542,warrior,arms,135,81,54
Ignyz,stormscale,1542,warrior,arms,86,42,44
Grimoire,drakthul,1541,warrior,arms,80,44,36
Ricovega,kazzak,1541,warrior,arms,64,34,30
Мускулатор,soulflayer,1541,warrior,arms,159,82,77
Liqpref,draenor,1541,warrior,arms,63,32,31
Wrynir,archimonde,1541,warrior,arms,78,38,40
Hellespont,hellscream,1541,warrior,arms,191,85,106
Rogersrage,ragnaros,1540,warrior,arms,195,102,93
Màkáveli,stormscale,1540,warrior,arms,113,56,57
Bladesmiths,argent-dawn,1540,warrior,arms,66,32,34
Jeonsoyeon,argent-dawn,1540,warrior,arms,36,17,19
Mazaharine,archimonde,1540,warrior,arms,72,33,39
Бизэмэйкер,gordunni,1540,warrior,arms,42,19,23
Deadlyanger,kazzak,1538,warrior,arms,108,56,52
Бубаигавар,gordunni,1538,warrior,arms,72,36,36
ßamßam,draenor,1538,warrior,arms,58,29,29
Shwreck,kazzak,1538,warrior,arms,138,68,70
Ym,twisting-nether,1538,warrior,arms,78,38,40
Alexamazing,lordaeron,1538,warrior,arms,79,37,42
Marablind,drakthul,1538,warrior,arms,42,17,25
Zhulgar,azjolnerub,1537,warrior,arms,60,32,28
Имяужезанято,gordunni,1537,warrior,arms,35,18,17
Мираксус,soulflayer,1537,warrior,arms,103,50,53
Земибор,soulflayer,1537,warrior,arms,96,38,58
Euforija,kazzak,1536,warrior,arms,160,85,75
Grántor,eredar,1536,warrior,arms,78,41,37
Renbaka,marécage-de-zangar,1536,warrior,arms,48,25,23
Агрегат,goldrinn,1536,warrior,arms,138,66,72
Vlorgboi,drakthul,1536,warrior,arms,66,28,38
Axetomouth,blackrock,1535,warrior,arms,72,38,34
Nurfbolt,kazzak,1535,warrior,arms,65,33,32
Stepa,sylvanas,1535,warrior,arms,86,43,43
Whiteowlx,argent-dawn,1535,warrior,arms,72,36,36
Ckx,kazzak,1534,warrior,arms,44,28,16
Почтитайсон,howling-fjord,1534,warrior,arms,50,27,23
Akenrun,eredar,1534,warrior,arms,102,52,50
Артен,ashenvale,1534,warrior,arms,40,20,20
Madkill,twisting-nether,1533,warrior,arms,105,55,50
Aizy,blackhand,1533,warrior,arms,54,28,26
Архиватор,gordunni,1533,warrior,arms,175,89,86
Nelios,sylvanas,1533,warrior,arms,137,61,76
Айсиёу,howling-fjord,1533,warrior,arms,74,32,42
Tyrasia,hyjal,1532,warrior,arms,30,16,14
Èzekiel,dalaran,1532,warrior,arms,209,107,102
Gravityfalls,blackmoore,1532,warrior,arms,298,150,148
Skorz,kazzak,1532,warrior,arms,117,57,60
Badwarr,blackhand,1532,warrior,arms,72,35,37
Mesmash,uldum,1532,warrior,arms,54,26,28
Cleopatra,frostwhisper,1531,warrior,arms,42,24,18
Rexagon,blackrock,1531,warrior,arms,60,32,28
Battleox,stormscale,1531,warrior,arms,33,17,16
Lahzar,krasus,1531,warrior,arms,138,64,74
Swayzze,frostwolf,1531,warrior,arms,60,25,35
Mbappé,dragonblight,1530,warrior,arms,18,16,2
Jagannath,stormscale,1530,warrior,arms,44,22,22
Анакронокс,howling-fjord,1530,warrior,arms,56,27,29
Zeepp,ravencrest,1530,warrior,arms,160,75,85
Giganza,outland,1530,warrior,arms,90,40,50
Êphêý,kazzak,1530,warrior,arms,36,16,20
Brigitá,argent-dawn,1530,warrior,arms,42,16,26
Ваншотч,blackscar,1530,warrior,arms,42,16,26
Laceysmash,anubarak,1529,warrior,arms,42,21,21
Foxxzorr,aszune,1529,warrior,arms,78,38,40
Proxxyyqt,blackrock,1529,warrior,arms,68,30,38
Teg,ravencrest,1528,warrior,arms,120,61,59
Séphi,archimonde,1527,warrior,arms,96,47,49
Beanzz,blackmoore,1527,warrior,arms,41,19,22
Kookwr,aggra-português,1527,warrior,arms,128,57,71
Heubba,hyjal,1527,warrior,arms,48,18,30
Ялаз,gordunni,1526,warrior,arms,201,101,100
Kyrú,silvermoon,1526,warrior,arms,138,67,71
Arouga,blackrock,1526,warrior,arms,45,19,26
Зэйсс,gordunni,1525,warrior,arms,42,25,17
Mòrdréd,kazzak,1525,warrior,arms,117,62,55
Kàinen,nemesis,1525,warrior,arms,108,57,51
Whoosah,ragnaros,1525,warrior,arms,123,60,63
Pumpadzhija,outland,1525,warrior,arms,36,17,19
Zergalot,stormscale,1525,warrior,arms,82,37,45
Adzandel,silvermoon,1525,warrior,arms,138,62,76
Darkironwolf,silvermoon,1524,warrior,arms,24,16,8
Hellzint,sanguino,1524,warrior,arms,523,260,263
Jonukas,argent-dawn,1524,warrior,arms,64,29,35
Pra,antonidas,1523,warrior,arms,84,49,35
Nukebomb,dun-modr,1523,warrior,arms,89,45,44
Vratranzhul,kirin-tor,1523,warrior,arms,349,172,177
Odenscolddry,kazzak,1523,warrior,arms,209,99,110
Tentontruck,ragnaros,1523,warrior,arms,95,40,55
Naizu,zuljin,1523,warrior,arms,78,30,48
Ricssonz,burning-legion,1522,warrior,arms,120,62,58
Xecutie,antonidas,1522,warrior,arms,189,96,93
Shrekwarr,kazzak,1522,warrior,arms,137,67,70
Norwegian,silvermoon,1522,warrior,arms,92,44,48
Маньякубица,howling-fjord,1522,warrior,arms,36,17,19
Shadezzqt,blackmoore,1522,warrior,arms,36,16,20
Meldy,dun-morogh,1522,warrior,arms,56,22,34
Kestialezin,archimonde,1521,warrior,arms,112,67,45
Stormcoil,stormscale,1521,warrior,arms,47,24,23
Icekissx,hyjal,1521,warrior,arms,147,75,72
Каутто,howling-fjord,1521,warrior,arms,66,30,36
Piksitron,silvermoon,1520,warrior,arms,264,149,115
Ingensan,lightbringer,1520,warrior,arms,123,67,56
Devilpanic,outland,1520,warrior,arms,30,16,14
Заверчу,soulflayer,1520,warrior,arms,227,118,109
Сика,blackscar,1520,warrior,arms,114,55,59
Demonstðrm,silvermoon,1520,warrior,arms,46,21,25
Gervvand,burning-legion,1519,warrior,arms,48,26,22
Мэйрил,lich-king,1519,warrior,arms,190,99,91
Hazzael,ravencrest,1519,warrior,arms,126,63,63
Deadlycalm,blackrock,1519,warrior,arms,229,114,115
Ослаард,gordunni,1519,warrior,arms,54,26,28
Nashgrim,blackrock,1519,warrior,arms,60,26,34
Eyesonly,blackmoore,1518,warrior,arms,100,58,42
Yukizz,ravencrest,1518,warrior,arms,30,16,14
Gaisorg,die-aldor,1518,warrior,arms,60,31,29
Darkwhisper,destromath,1518,warrior,arms,84,43,41
Bigbanz,outland,1518,warrior,arms,161,75,86
Лотрранк,gordunni,1518,warrior,arms,114,50,64
Kielon,kazzak,1517,warrior,arms,24,16,8
Vurux,blackrock,1517,warrior,arms,50,27,23
Grroom,tarren-mill,1517,warrior,arms,82,41,41
Jøtawarrior,sanguino,1517,warrior,arms,91,44,47
Savedsky,zuljin,1517,warrior,arms,48,16,32
Blitz,archimonde,1516,warrior,arms,47,28,19
Warclodo,la-croisade-écarlate,1516,warrior,arms,36,18,18
Ashecröft,sylvanas,1516,warrior,arms,68,31,37
Trilon,blackrock,1516,warrior,arms,56,24,32
Оргнар,ashenvale,1515,warrior,arms,66,34,32
Рестат,soulflayer,1515,warrior,arms,405,201,204
Skeletor,draenor,1515,warrior,arms,61,30,31
Rayner,illidan,1515,warrior,arms,60,28,32
Madaxe,kazzak,1514,warrior,arms,95,59,36
Booj,silvermoon,1514,warrior,arms,200,105,95
Bullrug,blackrock,1514,warrior,arms,88,44,44
Maniackz,tarren-mill,1514,warrior,arms,42,21,21
Cryhoof,ragnaros,1514,warrior,arms,207,103,104
Treze,sanguino,1514,warrior,arms,200,96,104
Трешконтент,gordunni,1514,warrior,arms,138,66,72
Fraggiz,auchindoun,1513,warrior,arms,47,24,23
Oweiko,blackrock,1513,warrior,arms,96,48,48
Dvvdeek,burning-legion,1513,warrior,arms,48,17,31
Warmegedon,frostmane,1512,warrior,arms,24,16,8
Bävling,kazzak,1512,warrior,arms,61,33,28
Thaldrys,blackhand,1512,warrior,arms,167,81,86
Frcwar,kazzak,1512,warrior,arms,90,42,48
Firience,silvermoon,1512,warrior,arms,65,26,39
Шлифую,howling-fjord,1511,warrior,arms,79,45,34
Xorlog,thrall,1511,warrior,arms,59,33,26
Ødên,frostmane,1511,warrior,arms,30,16,14
Romanul,terokkar,1511,warrior,arms,182,91,91
Lachandrius,blackhand,1511,warrior,arms,141,70,71
Glakias,silvermoon,1510,warrior,arms,69,35,34
Ragnou,tarren-mill,1510,warrior,arms,100,48,52
Хамерртайм,goldrinn,1510,warrior,arms,48,20,28
Киссмиплис,gordunni,1509,warrior,arms,147,69,78
Cráft,silvermoon,1509,warrior,arms,124,57,67
Sanca,naxxramas,1509,warrior,arms,66,26,40
Ryuuzetsu,drakthul,1508,warrior,arms,24,16,8
Lågærtha,blackmoore,1508,warrior,arms,99,57,42
Dokô,twisting-nether,1508,warrior,arms,102,53,49
Swefy,sanguino,1508,warrior,arms,359,179,180
Èbert,silvermoon,1508,warrior,arms,48,23,25
Drahtalger,hyjal,1508,warrior,arms,54,25,29
Melliug,ysondre,1508,warrior,arms,48,20,28
Nøsyo,blackrock,1507,warrior,arms,30,18,12
Üs,ravencrest,1507,warrior,arms,69,37,32
Лувисфолл,soulflayer,1507,warrior,arms,30,16,14
Xgs,archimonde,1507,warrior,arms,344,173,171
Бокалпивка,soulflayer,1507,warrior,arms,62,31,31
Настрамо,gordunni,1507,warrior,arms,52,26,26
Arowpoint,doomhammer,1507,warrior,arms,53,25,28
Jashin,hellfire,1507,warrior,arms,90,39,51
Sonìe,kazzak,1506,warrior,arms,89,51,38
Wahin,uldum,1506,warrior,arms,30,16,14
Subwaygodx,frostwolf,1506,warrior,arms,61,25,36
Jamakun,magtheridon,1505,warrior,arms,54,29,25
Fiveboy,tarren-mill,1505,warrior,arms,66,33,33
Haraldjuhnke,frostwolf,1505,warrior,arms,76,35,41
Wargak,stormscale,1505,warrior,arms,42,18,24
Micromachine,argent-dawn,1505,warrior,arms,66,25,41
Думхаммер,howling-fjord,1504,warrior,arms,116,64,52
Pied,krasus,1504,warrior,arms,36,19,17
Тэйкмисофтли,blackscar,1504,warrior,arms,54,28,26
Волрок,howling-fjord,1504,warrior,arms,67,34,33
Pptickler,argent-dawn,1504,warrior,arms,83,41,42
Raakalainen,vashj,1504,warrior,arms,59,29,30
Knoxworth,kazzak,1504,warrior,arms,77,37,40
Grezlyk,drakthul,1504,warrior,arms,149,71,78
Ironsíde,alakir,1504,warrior,arms,63,28,35
Istenn,stormscale,1504,warrior,arms,72,27,45
Alokar,draenor,1503,warrior,arms,66,35,31
Cutting,burning-legion,1503,warrior,arms,141,74,67
Totenkrieger,draenor,1503,warrior,arms,60,29,31
Дагмар,howling-fjord,1503,warrior,arms,72,34,38
Currarms,aegwynn,1503,warrior,arms,73,29,44
Дезертиир,booty-bay,1503,warrior,arms,77,28,49
Nezruslone,dun-modr,1502,warrior,arms,58,42,16
Dødsdonny,draenor,1502,warrior,arms,162,89,73
Leroxius,ragnaros,1502,warrior,arms,222,116,106
Mordeukay,hyjal,1502,warrior,arms,90,44,46
Кизуми,gordunni,1502,warrior,arms,81,38,43
Rookian,blackrock,1502,warrior,arms,42,19,23
Ausrastus,blackhand,1501,warrior,arms,36,18,18
Slidmacka,twisting-nether,1501,warrior,arms,222,104,118
Брюслипве,gordunni,1501,warrior,arms,60,26,34
Suchasosuck,twisting-nether,1500,warrior,arms,334,176,158
Рыгулька,gordunni,1500,warrior,arms,198,96,102
Bursch,ravencrest,1500,warrior,arms,168,81,87
Arktharion,antonidas,1500,warrior,arms,96,46,50
Noitoved,outland,1500,warrior,arms,62,24,38
Таосен,galakrond,1500,warrior,arms,42,16,26
Greekazi,kazzak,1499,warrior,arms,87,47,40
Mentôr,sargeras,1499,warrior,arms,47,23,24
Arreat,chogall,1499,warrior,arms,194,94,100
Rohc,kazzak,1499,warrior,arms,124,60,64
Sasorí,blackrock,1499,warrior,arms,208,99,109
Swornsword,blackmoore,1499,warrior,arms,42,17,25
Shimslady,outland,1499,warrior,arms,48,17,31
Люцц,gordunni,1498,warrior,arms,357,174,183
Cabzout,archimonde,1498,warrior,arms,48,20,28
Crriminal,ravencrest,1498,warrior,arms,48,20,28
Notsyn,twisting-nether,1497,warrior,arms,60,38,22
Shedzo,tarren-mill,1497,warrior,arms,42,25,17
Valíon,outland,1497,warrior,arms,178,96,82
Dxc,blackhand,1497,warrior,arms,56,29,27
Astost,silvermoon,1497,warrior,arms,108,55,53
Chynora,blackmoore,1497,warrior,arms,84,40,44
Trohr,blackmoore,1497,warrior,arms,36,16,20
Pezuñaloca,shendralar,1496,warrior,arms,96,56,40
Киллдекс,gordunni,1496,warrior,arms,259,126,133
Shïn,kaelthas,1496,warrior,arms,84,38,46
Fiverare,stormscale,1495,warrior,arms,30,16,14
Ragingqawk,outland,1495,warrior,arms,34,18,16
Bobloblaww,doomhammer,1495,warrior,arms,102,53,49
Mouliard,archimonde,1495,warrior,arms,68,33,35
Umadyeh,stormscale,1494,warrior,arms,58,36,22
Morvar,sanguino,1494,warrior,arms,30,16,14
Cãngo,die-todeskrallen,1494,warrior,arms,180,94,86
Shadowbôxer,onyxia,1494,warrior,arms,74,38,36
Thiccbra,burning-legion,1494,warrior,arms,78,40,38
Whátsup,stormscale,1494,warrior,arms,48,24,24
Gìlgamesh,dun-modr,1494,warrior,arms,182,89,93
Kleidaria,stormscale,1494,warrior,arms,80,39,41
Donkeymeta,frostmane,1494,warrior,arms,102,47,55
Aurélus,rexxar,1493,warrior,arms,36,22,14
Hekkarí,auchindoun,1493,warrior,arms,28,16,12
Ardmoo,burning-legion,1493,warrior,arms,65,34,31
Эйримор,gordunni,1493,warrior,arms,36,18,18
Dárkhammer,tarren-mill,1493,warrior,arms,102,50,52
Prolyx,doomhammer,1492,warrior,arms,66,36,30
Ssnakeess,silvermoon,1492,warrior,arms,90,48,42
Boshim,ravencrest,1492,warrior,arms,60,32,28
Tinkley,quelthalas,1492,warrior,arms,51,27,24
Solezte,tarren-mill,1492,warrior,arms,114,59,55
Deswarr,tarren-mill,1492,warrior,arms,63,25,38
Tomsom,sanguino,1492,warrior,arms,41,16,25
Hùmøngöúslåm,ravencrest,1491,warrior,arms,42,25,17
Bonnaventure,hyjal,1491,warrior,arms,304,159,145
Nighat,sanguino,1491,warrior,arms,174,88,86
Nexpwns,blackhand,1491,warrior,arms,225,113,112
Párta,ravencrest,1491,warrior,arms,106,52,54
Pumpadzhîja,outland,1491,warrior,arms,66,32,34
Vectarrior,eredar,1491,warrior,arms,60,29,31
Стенденсх,howling-fjord,1491,warrior,arms,161,77,84
Gantsrip,stormscale,1491,warrior,arms,88,41,47
Вимор,soulflayer,1491,warrior,arms,39,18,21
Øzak,outland,1491,warrior,arms,62,28,34
Exoblade,silvermoon,1491,warrior,arms,88,37,51
Picciocino,nemesis,1491,warrior,arms,88,36,52
Hitmanler,frostmane,1490,warrior,arms,168,87,81
Kilsorrow,silvermoon,1490,warrior,arms,84,38,46
Allmight,gorgonnash,1490,warrior,arms,54,19,35
Tddyy,silvermoon,1489,warrior,arms,42,21,21
Dagouor,twisting-nether,1489,warrior,arms,99,48,51
Wardrior,stormscale,1489,warrior,arms,62,30,32
Северот,deepholm,1489,warrior,arms,59,28,31
Ishi,archimonde,1489,warrior,arms,46,19,27
Bigbroh,grim-batol,1488,warrior,arms,159,89,70
Ilovealma,kiljaeden,1488,warrior,arms,107,49,58
Hindbærsaft,stormscale,1487,warrior,arms,55,32,23
Gnomeð,blackrock,1487,warrior,arms,105,49,56
Jimei,temple-noir,1486,warrior,arms,30,16,14
Reider,kazzak,1486,warrior,arms,63,33,30
Imfiñe,outland,1486,warrior,arms,179,85,94
Rázgriz,argent-dawn,1486,warrior,arms,99,47,52
Getjuiced,tarren-mill,1486,warrior,arms,54,21,33
Longy,mazrigos,1485,warrior,arms,75,39,36
Calmdownbrú,frostmane,1485,warrior,arms,119,60,59
Ðraço,kazzak,1485,warrior,arms,68,34,34
Aromë,argent-dawn,1485,warrior,arms,36,18,18
Mfdoöm,draenor,1485,warrior,arms,172,85,87
Paow,tarren-mill,1485,warrior,arms,77,37,40
Nainculay,kaelthas,1485,warrior,arms,48,23,25
Vveerdy,stormreaver,1485,warrior,arms,96,45,51
Anarki,kaelthas,1485,warrior,arms,87,39,48
Угхпах,soulflayer,1485,warrior,arms,107,44,63
Omgihithard,draenor,1484,warrior,arms,57,28,29
Keksspec,ungoro,1484,warrior,arms,114,54,60
Fizzywarrior,blackmoore,1484,warrior,arms,63,29,34
Zévi,ravencrest,1484,warrior,arms,42,18,24
Arturo,blackmoore,1484,warrior,arms,70,27,43
Kaylì,ravencrest,1484,warrior,arms,53,20,33
Мерсилессх,gordunni,1483,warrior,arms,114,57,57
Rambô,frostwolf,1483,warrior,arms,42,17,25
Денеур,gordunni,1483,warrior,arms,146,58,88
Æñtrø,frostwolf,1483,warrior,arms,42,16,26
Ocecute,tarren-mill,1482,warrior,arms,60,33,27
Галактозар,soulflayer,1482,warrior,arms,285,148,137
Lortèn,stormscale,1482,warrior,arms,48,24,24
Каргром,howling-fjord,1482,warrior,arms,45,20,25
Leomance,hyjal,1481,warrior,arms,32,20,12
Orgazam,xavius,1481,warrior,arms,83,45,38
Henco,twisting-nether,1481,warrior,arms,84,43,41
Runhex,veknilash,1481,warrior,arms,53,26,27
Duaig,pozzo-delleternità,1481,warrior,arms,53,19,34
Hôrn,stormscale,1480,warrior,arms,70,40,30
Blacksliide,blackmoore,1480,warrior,arms,30,17,13
Frankius,ravencrest,1480,warrior,arms,114,59,55
Hatefury,twisting-nether,1480,warrior,arms,162,83,79
Gramr,silvermoon,1480,warrior,arms,71,36,35
Alinash,aegwynn,1480,warrior,arms,87,44,43
Airowar,drakthul,1480,warrior,arms,47,23,24
Doba,madmortem,1480,warrior,arms,103,50,53
Arenameister,blackmoore,1480,warrior,arms,48,23,25
Warmâchine,burning-legion,1480,warrior,arms,301,141,160
Rathis,arathor,1480,warrior,arms,126,54,72
Altimáte,antonidas,1479,warrior,arms,30,18,12
Koboone,tarren-mill,1479,warrior,arms,47,24,23
Мэднас,howling-fjord,1479,warrior,arms,156,79,77
Minitizzr,stormscale,1479,warrior,arms,72,36,36
Равахим,soulflayer,1479,warrior,arms,36,18,18
Ceen,alakir,1479,warrior,arms,71,35,36
Orimis,doomhammer,1479,warrior,arms,48,22,26
Ychro,archimonde,1478,warrior,arms,29,16,13
Raixxon,ragnaros,1478,warrior,arms,246,125,121
Lektor,eredar,1478,warrior,arms,60,26,34
Lezgar,ragnaros,1477,warrior,arms,24,18,6
Трафалльгар,gordunni,1477,warrior,arms,297,156,141
Pajalousta,elune,1477,warrior,arms,120,56,64
Bracki,ysondre,1477,warrior,arms,46,21,25
Trenbullone,kazzak,1476,warrior,arms,51,32,19
Aza,burning-blade,1476,warrior,arms,102,55,47
Freutag,azshara,1476,warrior,arms,114,61,53
Hanna,argent-dawn,1476,warrior,arms,84,42,42
Kamblas,la-croisade-écarlate,1476,warrior,arms,60,24,36
Elinyar,aegwynn,1476,warrior,arms,48,17,31
Argaskurken,ravencrest,1475,warrior,arms,78,38,40
Разрубателл,soulflayer,1475,warrior,arms,66,31,35
Wvanp,tarren-mill,1474,warrior,arms,30,17,13
Metaslave,the-maelstrom,1474,warrior,arms,54,26,28
Gíu,blackhand,1473,warrior,arms,40,23,17
Kelmyst,ragnaros,1473,warrior,arms,86,46,40
Bigbmh,tarren-mill,1473,warrior,arms,54,26,28
Karyoroo,eredar,1473,warrior,arms,48,23,25
Morthôr,grim-batol,1473,warrior,arms,75,34,41
Fidicenz,ysondre,1472,warrior,arms,36,19,17
Becca,rexxar,1472,warrior,arms,36,16,20
Fullzugzug,kazzak,1471,warrior,arms,96,46,50
Роглум,blackscar,1471,warrior,arms,181,81,100
Ansi,argent-dawn,1470,warrior,arms,169,78,91
Romic,guldan,1470,warrior,arms,98,44,54
Razoo,stormscale,1469,warrior,arms,127,63,64
Clellin,silvermoon,1469,warrior,arms,75,37,38
Rumbldore,ragnaros,1469,warrior,arms,66,31,35
Melfis,aegwynn,1468,warrior,arms,64,32,32
Wutend,nemesis,1468,warrior,arms,83,40,43
Jailbâit,baelgun,1468,warrior,arms,48,18,30
Йошихироо,howling-fjord,1467,warrior,arms,60,29,31
Ormert,sylvanas,1467,warrior,arms,60,28,32
Thorgrím,ravencrest,1467,warrior,arms,90,41,49
Rutch,hyjal,1466,warrior,arms,108,56,52
Drushíí,shattrath,1466,warrior,arms,77,39,38
Leopoldx,outland,1465,warrior,arms,111,61,50
Ollyaa,ravencrest,1465,warrior,arms,114,59,55
Bigboibeeper,draenor,1465,warrior,arms,143,72,71
Rikistrike,tarren-mill,1465,warrior,arms,76,37,39
Juicyglutes,turalyon,1465,warrior,arms,58,28,30
Apocrypha,darkspear,1465,warrior,arms,54,26,28
Markorok,kazzak,1465,warrior,arms,72,33,39
Synrosh,hyjal,1464,warrior,arms,69,40,29
Enface,ragnaros,1464,warrior,arms,166,85,81
Esegryel,argent-dawn,1464,warrior,arms,77,34,43
Polywarri,blackrock,1464,warrior,arms,42,17,25
Babb,kazzak,1463,warrior,arms,49,27,22
Judditsbx,draenor,1463,warrior,arms,94,50,44
Казньшалав,gordunni,1463,warrior,arms,171,86,85
Thâarnar,frostwolf,1463,warrior,arms,102,48,54
Сэлфиш,lich-king,1463,warrior,arms,83,38,45
Sanerion,antonidas,1463,warrior,arms,72,30,42
Дотаветеран,soulflayer,1462,warrior,arms,42,23,19
Sorosterv,twisting-nether,1462,warrior,arms,117,63,54
Vauster,draenor,1462,warrior,arms,86,45,41
Worstplàyer,tarren-mill,1462,warrior,arms,143,72,71
Ladoz,ragnaros,1462,warrior,arms,172,86,86
Cucøriedka,burning-blade,1462,warrior,arms,68,24,44
Gorejaws,draenor,1461,warrior,arms,30,19,11
Фогивэн,gordunni,1461,warrior,arms,146,79,67
Лютобор,gordunni,1461,warrior,arms,141,70,71
Friskos,dalaran,1461,warrior,arms,154,73,81
Kieranx,silvermoon,1461,warrior,arms,80,35,45
Azjolnerub,kazzak,1461,warrior,arms,76,29,47
Xraider,ragnaros,1460,warrior,arms,116,61,55
Абабоба,gordunni,1460,warrior,arms,106,55,51
Азаргатан,soulflayer,1460,warrior,arms,62,31,31
Kerador,archimonde,1459,warrior,arms,32,25,7
Teljii,blackmoore,1459,warrior,arms,34,20,14
Greatsword,turalyon,1459,warrior,arms,47,25,22
Anthrazit,stormscale,1459,warrior,arms,159,80,79
Vallahan,argent-dawn,1459,warrior,arms,310,149,161
Màrduk,pozzo-delleternità,1458,warrior,arms,29,16,13
Ramhadat,hyjal,1458,warrior,arms,78,40,38
Màrv,ravencrest,1458,warrior,arms,54,25,29
Ninurtawar,tarren-mill,1458,warrior,arms,75,34,41
Shádówfáxí,outland,1458,warrior,arms,36,16,20
Kneecleaver,darksorrow,1458,warrior,arms,87,38,49
Lisztomaniak,outland,1458,warrior,arms,55,22,33
Beebsy,aegwynn,1457,warrior,arms,26,16,10
Grimsong,antonidas,1457,warrior,arms,43,24,19
Authar,tarren-mill,1457,warrior,arms,190,97,93
Sahl,sylvanas,1457,warrior,arms,204,98,106
Darksworn,alleria,1456,warrior,arms,60,35,25
Zaatar,draenor,1456,warrior,arms,232,122,110
Phenowarri,blackhand,1456,warrior,arms,115,60,55
Testonator,outland,1456,warrior,arms,48,20,28
Reb,thunderhorn,1455,warrior,arms,45,26,19
Knego,ragnaros,1455,warrior,arms,173,99,74
Rodenet,dun-modr,1455,warrior,arms,107,56,51
Zetorc,burning-legion,1455,warrior,arms,410,206,204
Варгана,soulflayer,1455,warrior,arms,198,99,99
Velinde,outland,1455,warrior,arms,52,24,28
Phóó,thrall,1455,warrior,arms,88,39,49
Турбобулка,gordunni,1455,warrior,arms,42,18,24
Belzebud,kazzak,1455,warrior,arms,102,42,60
Ragetotem,doomhammer,1455,warrior,arms,44,18,26
Legendfury,ravencrest,1454,warrior,arms,174,92,82
Râsk,kazzak,1453,warrior,arms,44,24,20
Ginjó,blackhand,1453,warrior,arms,94,49,45
Marcnky,stormscale,1453,warrior,arms,200,102,98
Hexj,tarren-mill,1453,warrior,arms,77,37,40
Ðam,kazzak,1453,warrior,arms,48,20,28
Bäiley,drakthul,1453,warrior,arms,66,27,39
Агтеррокк,deathweaver,1452,warrior,arms,90,48,42
Kioskmupp,ravencrest,1452,warrior,arms,426,217,209
Jailapatate,khaz-modan,1452,warrior,arms,108,52,56
Gorocpt,doomhammer,1452,warrior,arms,110,52,58
Silventus,blackmoore,1452,warrior,arms,47,21,26
Erololi,sanguino,1452,warrior,arms,74,32,42
Blackaxe,sylvanas,1451,warrior,arms,29,18,11
Soofies,madmortem,1451,warrior,arms,36,20,16
Roadsick,outland,1451,warrior,arms,30,16,14
Warriar,sylvanas,1451,warrior,arms,53,25,28
Belgabad,rexxar,1451,warrior,arms,107,47,60
Alqaqa,ragnaros,1451,warrior,arms,47,16,31
Sazurah,ravencrest,1450,warrior,arms,30,18,12
Stahlhund,silvermoon,1450,warrior,arms,30,18,12
Гардринг,howling-fjord,1450,warrior,arms,102,59,43
Ðjlækker,silvermoon,1450,warrior,arms,42,22,20
Dranush,onyxia,1450,warrior,arms,303,156,147
Ràkar,stormscale,1450,warrior,arms,110,53,57
Horizonx,blackrock,1449,warrior,arms,92,48,44
Daelator,ravencrest,1449,warrior,arms,73,37,36
Irén,hellfire,1449,warrior,arms,121,59,62
Miko,ysondre,1449,warrior,arms,120,56,64
Audítóre,proudmoore,1449,warrior,arms,48,22,26
Opticsynfel,argent-dawn,1449,warrior,arms,68,29,39
Størpïx,drakthul,1448,warrior,arms,141,76,65
Akión,zuljin,1448,warrior,arms,72,37,35
Medaur,frostmane,1448,warrior,arms,203,103,100
Mazzkze,silvermoon,1448,warrior,arms,301,152,149
Vyctimz,ravencrest,1448,warrior,arms,53,26,27
Wøokz,argent-dawn,1448,warrior,arms,58,28,30
Бижек,gordunni,1448,warrior,arms,138,66,72
Draer,sanguino,1448,warrior,arms,47,21,26
Herigan,burning-legion,1448,warrior,arms,87,38,49
Norinhell,ravencrest,1448,warrior,arms,48,20,28
Amarthon,sylvanas,1448,warrior,arms,63,20,43
Гантелявухо,blackscar,1447,warrior,arms,46,23,23
Mërkürÿ,draenor,1447,warrior,arms,36,18,18
Gakgora,twisting-nether,1447,warrior,arms,36,18,18
Hoomeer,sylvanas,1447,warrior,arms,96,46,50
Ugardosh,burning-legion,1447,warrior,arms,99,46,53
Vegilhenvin,stormscale,1447,warrior,arms,92,41,51
Isenstrider,burning-legion,1447,warrior,arms,66,25,41
Endan,kelthuzad,1446,warrior,arms,66,37,29
Riann,silvermoon,1446,warrior,arms,71,30,41
Elorîl,stormscale,1445,warrior,arms,30,18,12
Askawar,sylvanas,1445,warrior,arms,30,16,14
Ordovis,silvermoon,1445,warrior,arms,63,32,31
Oceangg,silvermoon,1445,warrior,arms,178,90,88
Адво,gordunni,1445,warrior,arms,114,56,58
Nardak,blackmoore,1445,warrior,arms,38,18,20
Tyrax,blackrock,1445,warrior,arms,64,29,35
Swaxx,ravencrest,1445,warrior,arms,83,35,48
Garrodan,doomhammer,1445,warrior,arms,72,30,42
Gruxx,ragnaros,1445,warrior,arms,62,25,37
Yoilenno,argent-dawn,1444,warrior,arms,42,23,19
Крискинпи,deathguard,1444,warrior,arms,89,45,44
Calel,ravencrest,1444,warrior,arms,116,58,58
Spodnick,ragnaros,1444,warrior,arms,47,23,24
Crayz,twisting-nether,1444,warrior,arms,60,27,33
Дообрыйшмель,soulflayer,1443,warrior,arms,51,32,19
Alopunch,kazzak,1443,warrior,arms,96,50,46
Антурим,howling-fjord,1443,warrior,arms,83,42,41
Каниме,howling-fjord,1443,warrior,arms,70,34,36
Рагаксес,blackscar,1443,warrior,arms,82,36,46
Tealbell,chamber-of-aspects,1442,warrior,arms,211,110,101
Blackwólf,bloodhoof,1442,warrior,arms,360,176,184
Pøps,hyjal,1441,warrior,arms,110,66,44
Зеленыйжмых,thermaplugg,1441,warrior,arms,243,122,121
Nucleargrab,twilights-hammer,1441,warrior,arms,283,141,142
Gipsylove,twisting-nether,1441,warrior,arms,54,24,30
Sergra,ysondre,1441,warrior,arms,66,24,42
Karimlebrave,hyjal,1440,warrior,arms,68,33,35
Pyyrha,argent-dawn,1440,warrior,arms,78,35,43
Lfhvnlvn,ravencrest,1439,warrior,arms,24,15,9
Zeneve,auchindoun,1439,warrior,arms,30,17,13
Трэйдар,blackscar,1439,warrior,arms,30,15,15
Сеш,lich-king,1439,warrior,arms,246,118,128
Krodunn,argent-dawn,1439,warrior,arms,77,34,43
ßrink,ysondre,1439,warrior,arms,44,19,25
Makerrw,ravencrest,1438,warrior,arms,50,26,24
Schlierkamp,aegwynn,1438,warrior,arms,30,15,15
Dundulinka,outland,1438,warrior,arms,129,64,65
Иктиннос,gordunni,1438,warrior,arms,106,52,54
Чпокерз,gordunni,1438,warrior,arms,94,46,48
Ryle,anubarak,1438,warrior,arms,142,63,79
Juggawumba,kazzak,1438,warrior,arms,72,31,41
Srbinator,turalyon,1437,warrior,arms,376,190,186
Garouzo,hellfire,1437,warrior,arms,64,32,32
Ylana,eldrethalas,1437,warrior,arms,183,91,92
Lakhovsky,hyjal,1437,warrior,arms,77,38,39
Intrepid,dun-modr,1437,warrior,arms,90,43,47
Hobo,ravencrest,1437,warrior,arms,176,82,94
Banshe,ragnaros,1437,warrior,arms,48,16,32
Bravest,ragnaros,1436,warrior,arms,48,26,22
Tomhankz,ravencrest,1436,warrior,arms,48,25,23
Whyduck,silvermoon,1436,warrior,arms,50,25,25
Varyian,sporeggar,1436,warrior,arms,143,65,78
Sholong,antonidas,1436,warrior,arms,72,32,40
Crizby,twisting-nether,1436,warrior,arms,45,17,28
Zames,ravencrest,1435,warrior,arms,42,23,19
Brutøs,conseil-des-ombres,1435,warrior,arms,78,39,39
Hvalross,ravencrest,1435,warrior,arms,30,15,15
Hackamore,suramar,1435,warrior,arms,102,49,53
Randix,antonidas,1435,warrior,arms,66,31,35
Blondboomer,neptulon,1435,warrior,arms,84,34,50
Swifty,bronzebeard,1434,warrior,arms,43,23,20
Mljecho,kazzak,1434,warrior,arms,215,110,105
Dafok,rashgarroth,1434,warrior,arms,42,19,23
Gromkarg,draenor,1434,warrior,arms,128,53,75
Détaire,archimonde,1433,warrior,arms,24,15,9
Heracles,jaedenar,1433,warrior,arms,36,18,18
Lostbull,kazzak,1433,warrior,arms,66,31,35
Slunecniq,azjolnerub,1433,warrior,arms,93,43,50
Kaloche,hyjal,1433,warrior,arms,36,16,20
Каоссвар,howling-fjord,1433,warrior,arms,36,15,21
Xmartha,tarren-mill,1432,warrior,arms,128,70,58
Téldrus,blackrock,1432,warrior,arms,72,37,35
Гладиакрис,gordunni,1432,warrior,arms,345,171,174
Лагалиер,borean-tundra,1432,warrior,arms,96,47,49
Барнаул,gordunni,1432,warrior,arms,48,23,25
Raznon,magtheridon,1432,warrior,arms,96,45,51
Shædøw,archimonde,1432,warrior,arms,58,27,31
Нетконечно,howling-fjord,1432,warrior,arms,66,29,37
Оркы,soulflayer,1432,warrior,arms,36,15,21
Erzotz,kazzak,1431,warrior,arms,57,34,23
Adurìn,silvermoon,1431,warrior,arms,113,59,54
Savh,silvermoon,1431,warrior,arms,66,34,32
Architectman,twisting-nether,1431,warrior,arms,399,200,199
Raley,ragnaros,1431,warrior,arms,346,172,174
Mezugzugyou,draenor,1431,warrior,arms,95,46,49
Lokkara,blackrock,1431,warrior,arms,98,47,51
Текайко,eversong,1431,warrior,arms,54,23,31
Dragão,kazzak,1431,warrior,arms,42,17,25
Otiep,blackmoore,1430,warrior,arms,36,24,12
Impulsivve,outland,1430,warrior,arms,24,15,9
Zecelei,tarren-mill,1430,warrior,arms,115,61,54
Alkuwaity,outland,1430,warrior,arms,47,22,25
Ajhogan,ravencrest,1430,warrior,arms,42,19,23
Valyron,ravencrest,1430,warrior,arms,40,17,23
Scud,frostwhisper,1429,warrior,arms,70,37,33
Lollydhur,nemesis,1429,warrior,arms,78,37,41
Gamöra,kirin-tor,1429,warrior,arms,72,33,39
Wolvéshôwl,aegwynn,1429,warrior,arms,141,64,77
Nabb,outland,1429,warrior,arms,56,25,31
Aîdogar,ysondre,1429,warrior,arms,72,32,40
Garroxx,blackrock,1429,warrior,arms,42,15,27
Neîka,archimonde,1428,warrior,arms,63,33,30
Execútioner,sylvanas,1428,warrior,arms,122,59,63
Borgalit,ragnaros,1428,warrior,arms,76,35,41
Âwfulwarriør,blackhand,1427,warrior,arms,24,15,9
Гетрайт,galakrond,1427,warrior,arms,49,27,22
Chakrator,la-croisade-écarlate,1427,warrior,arms,345,173,172
Tarkosha,terokkar,1427,warrior,arms,636,316,320
Faustà,nemesis,1427,warrior,arms,167,80,87
Imotekh,eredar,1427,warrior,arms,70,33,37
Гопниг,deepholm,1427,warrior,arms,149,70,79
Evosk,drakthul,1427,warrior,arms,36,15,21
Аузерг,soulflayer,1426,warrior,arms,77,40,37
Berzzerker,tarren-mill,1426,warrior,arms,108,56,52
Orwêll,uldum,1426,warrior,arms,350,176,174
Hashokx,draenor,1426,warrior,arms,36,18,18
Bráïnléss,silvermoon,1426,warrior,arms,36,17,19
Adamchen,blackmoore,1426,warrior,arms,79,35,44
Zellxd,stormscale,1425,warrior,arms,42,24,18
Ragark,quelthalas,1425,warrior,arms,129,72,57
Cássándráh,argent-dawn,1425,warrior,arms,149,76,73
Genç,ysondre,1425,warrior,arms,204,103,101
Zerberos,drakthul,1425,warrior,arms,76,37,39
Pakusrage,defias-brotherhood,1425,warrior,arms,110,53,57
Sànkâ,ysondre,1425,warrior,arms,49,21,28
Krônôs,thrall,1425,warrior,arms,42,17,25
Эвоэ,soulflayer,1425,warrior,arms,48,16,32
Discordîan,twisting-nether,1424,warrior,arms,24,15,9
Bigboyx,kazzak,1424,warrior,arms,256,118,138
Thickslam,argent-dawn,1424,warrior,arms,64,29,35
Grdez,archimonde,1424,warrior,arms,56,23,33
Инелутабл,eversong,1423,warrior,arms,29,19,10
Diolucido,shattered-hand,1423,warrior,arms,31,16,15
Арсонист,gordunni,1423,warrior,arms,72,37,35
Ball,zirkel-des-cenarius,1423,warrior,arms,131,67,64
Whiterebel,ravencrest,1423,warrior,arms,30,15,15
Faltzan,bronze-dragonflight,1423,warrior,arms,101,48,53
Meistarinn,draenor,1423,warrior,arms,72,27,45
Hamonbophis,kirin-tor,1422,warrior,arms,54,29,25
Кринжеверт,howling-fjord,1422,warrior,arms,90,48,42
Beelzebuu,blackhand,1422,warrior,arms,139,73,66
Bigbosscho,draenor,1422,warrior,arms,71,37,34
Racore,aegwynn,1422,warrior,arms,33,17,16
Peack,ravencrest,1422,warrior,arms,208,107,101
Ranran,emerald-dream,1422,warrior,arms,44,20,24
Kriegernuss,blackmoore,1421,warrior,arms,60,33,27
Nobelisarius,norgannon,1421,warrior,arms,88,48,40
Endeawour,ravencrest,1421,warrior,arms,306,163,143
Colq,doomhammer,1421,warrior,arms,149,78,71
Xsann,argent-dawn,1421,warrior,arms,89,45,44
Goldins,drakthul,1421,warrior,arms,77,38,39
Xatit,ravencrest,1421,warrior,arms,72,35,37
Bdm,sylvanas,1421,warrior,arms,36,17,19
Smashtv,ragnaros,1421,warrior,arms,63,28,35
Unverbal,silvermoon,1421,warrior,arms,36,15,21
Дютенфлай,ashenvale,1421,warrior,arms,48,16,32
Mecaguarro,dun-modr,1420,warrior,arms,36,22,14
Jigsar,argent-dawn,1420,warrior,arms,181,98,83
Ragestick,stormscale,1420,warrior,arms,54,28,26
Паракур,soulflayer,1420,warrior,arms,136,67,69
Jáson,kazzak,1420,warrior,arms,71,33,38
Leapling,blackmoore,1420,warrior,arms,36,16,20
Ähäkutti,frostmane,1419,warrior,arms,83,47,36
Nuahka,blackmoore,1419,warrior,arms,96,48,48
Carljøhnson,dalaran,1419,warrior,arms,411,200,211
Бавовник,howling-fjord,1419,warrior,arms,75,31,44
Tedbuckland,blackrock,1418,warrior,arms,60,36,24
Refl,kazzak,1418,warrior,arms,112,49,63
Carras,confrérie-du-thorium,1417,warrior,arms,365,180,185
Tìera,ravencrest,1417,warrior,arms,33,16,17
Gridra,dun-morogh,1417,warrior,arms,60,28,32
Llestatl,hyjal,1416,warrior,arms,83,42,41
Wuksa,kazzak,1416,warrior,arms,37,18,19
Kekru,silvermoon,1416,warrior,arms,75,31,44
Ciocaboca,draenor,1415,warrior,arms,30,17,13
Grudu,la-croisade-écarlate,1415,warrior,arms,30,17,13
Ayelsyssup,silvermoon,1415,warrior,arms,457,233,224
Lyfttokyo,tarren-mill,1415,warrior,arms,104,53,51
Vectus,zuljin,1415,warrior,arms,48,23,25
Ðynaxz,aegwynn,1415,warrior,arms,36,17,19
Zugzugernaut,stormscale,1415,warrior,arms,36,16,20
Flurie,sylvanas,1415,warrior,arms,46,20,26
Smásher,frostmourne,1415,warrior,arms,36,15,21
Центварвар,soulflayer,1414,warrior,arms,78,39,39
Drvx,twisting-nether,1414,warrior,arms,30,15,15
Дзертуф,fordragon,1414,warrior,arms,30,15,15
Lolpuîk,archimonde,1414,warrior,arms,72,31,41
Roland,earthen-ring,1414,warrior,arms,56,24,32
Phantastix,dun-modr,1413,warrior,arms,282,151,131
Maraximus,ragnaros,1413,warrior,arms,83,43,40
Úwúwúwúwúwúw,stormscale,1413,warrior,arms,54,27,27
Szelenamoon,outland,1413,warrior,arms,44,22,22
Rebiy,ravencrest,1413,warrior,arms,58,27,31
Dewclaw,stormscale,1413,warrior,arms,42,16,26
Succel,drakthul,1412,warrior,arms,70,31,39
Fion,kult-der-verdammten,1412,warrior,arms,73,31,42
Guruntar,kirin-tor,1411,warrior,arms,119,62,57
Pelicos,grim-batol,1411,warrior,arms,42,21,21
Голдфингер,gordunni,1411,warrior,arms,211,105,106
Thomasw,argent-dawn,1411,warrior,arms,96,43,53
Пиапиа,gordunni,1410,warrior,arms,24,15,9
Hundar,archimonde,1410,warrior,arms,120,65,55
Vulperizing,draenor,1410,warrior,arms,35,18,17
Nharzvog,archimonde,1410,warrior,arms,54,26,28
Gromchatte,elune,1410,warrior,arms,43,20,23
Pavard,arakarahm,1410,warrior,arms,56,26,30
Selestro,outland,1409,warrior,arms,36,20,16
Frams,draenor,1409,warrior,arms,41,22,19
Bootyclapper,runetotem,1409,warrior,arms,43,22,21
Эксихард,gordunni,1409,warrior,arms,78,34,44
Atiradeon,kazzak,1409,warrior,arms,36,15,21
Realz,malganis,1408,warrior,arms,131,75,56
Reidunøks,kazzak,1408,warrior,arms,206,99,107
Deadyet,mugthol,1407,warrior,arms,24,15,9
Zhønya,aegwynn,1407,warrior,arms,42,24,18
Kirowarrior,silvermoon,1407,warrior,arms,249,129,120
Kianit,ravencrest,1407,warrior,arms,548,272,276
Chaohz,grim-batol,1407,warrior,arms,41,17,24
Khalen,grim-batol,1407,warrior,arms,66,27,39
Mikogød,ravencrest,1407,warrior,arms,66,24,42
Svënja,ysondre,1406,warrior,arms,150,67,83
Dariman,aegwynn,1406,warrior,arms,78,34,44
Masomlejnek,burning-blade,1406,warrior,arms,42,18,24
Spargebuci,draenor,1406,warrior,arms,48,17,31
Teronth,burning-legion,1406,warrior,arms,78,27,51
Alborozie,archimonde,1405,warrior,arms,120,57,63
Papipulki,zuljin,1405,warrior,arms,104,47,57
Zugpump,tarren-mill,1404,warrior,arms,92,52,40
Diablozhørs,ysondre,1404,warrior,arms,115,62,53
Enraged,tarren-mill,1404,warrior,arms,30,15,15
Elyozz,silvermoon,1404,warrior,arms,114,56,58
Mortus,baelgun,1404,warrior,arms,143,70,73
Josgrout,silvermoon,1404,warrior,arms,118,53,65
Minimcgregor,sanguino,1404,warrior,arms,48,19,29
Неосим,gordunni,1403,warrior,arms,48,29,19
Høxy,outland,1403,warrior,arms,53,29,24
Mekkagrind,ravencrest,1403,warrior,arms,124,66,58
Youokhun,kazzak,1403,warrior,arms,204,106,98
Bjösk,stormscale,1403,warrior,arms,45,23,22
Ysgrammorr,magtheridon,1403,warrior,arms,66,32,34
Арбузикхаха,soulflayer,1403,warrior,arms,68,32,36
Mkone,ravencrest,1403,warrior,arms,42,16,26
Mgw,blackrock,1402,warrior,arms,30,17,13
Tatabaf,ysondre,1402,warrior,arms,45,23,22
Дозен,soulflayer,1402,warrior,arms,139,69,70
Zyzy,arathor,1402,warrior,arms,64,30,34
Luküs,dun-modr,1402,warrior,arms,82,38,44
Razyk,zuljin,1401,warrior,arms,40,26,14
Летакс,fordragon,1401,warrior,arms,31,15,16
Bloodmyst,kazzak,1401,warrior,arms,60,27,33
Strapnslap,argent-dawn,1401,warrior,arms,107,48,59
Tonifox,nemesis,1401,warrior,arms,66,26,40
Solle,blackrock,1400,warrior,arms,61,34,27
Peldreas,silvermoon,1400,warrior,arms,64,31,33
Андэрс,gordunni,1400,warrior,arms,142,68,74
Nyokosuzi,grim-batol,1400,warrior,arms,137,63,74
Шпингалетыч,howling-fjord,1400,warrior,arms,48,22,26
Джанобу,soulflayer,1400,warrior,arms,54,22,32
Evilrage,ravencrest,1399,warrior,arms,65,40,25
Caelgarn,twisting-nether,1399,warrior,arms,45,27,18
Ogvico,stormscale,1399,warrior,arms,67,37,30
Weareinspace,stormscale,1399,warrior,arms,189,99,90
Taurosk,burning-legion,1399,warrior,arms,194,101,93
Mangonneau,archimonde,1399,warrior,arms,60,30,30
Grimlyr,twisting-nether,1398,warrior,arms,47,23,24
Грэйм,gordunni,1398,warrior,arms,113,54,59
Zalameh,sylvanas,1398,warrior,arms,42,19,23
Ericmontana,draenor,1398,warrior,arms,36,15,21
Jumbodolmen,tarren-mill,1397,warrior,arms,106,53,53
Santorro,drakthul,1397,warrior,arms,36,17,19
Blackin,blackmoore,1396,warrior,arms,33,19,14
Arithael,dun-modr,1396,warrior,arms,372,188,184
Скользкийбро,gordunni,1396,warrior,arms,315,158,157
Toxicmade,drakthul,1396,warrior,arms,78,39,39
Farianna,burning-legion,1396,warrior,arms,279,139,140
Èscøbar,dalaran,1396,warrior,arms,63,27,36
Nevergladx,kazzak,1396,warrior,arms,57,23,34
Sàt,kazzak,1395,warrior,arms,40,24,16
ßladex,azshara,1395,warrior,arms,47,27,20
Conanh,pozzo-delleternità,1395,warrior,arms,234,120,114
Mortalgrim,ravencrest,1395,warrior,arms,58,29,29
Xaqt,die-nachtwache,1395,warrior,arms,35,17,18
Gorzan,dragonmaw,1395,warrior,arms,113,51,62
Psixi,stormscale,1395,warrior,arms,48,20,28
Rapidinhas,aggra-português,1394,warrior,arms,28,17,11
Megatronman,ravencrest,1394,warrior,arms,34,19,15
Bládez,ravencrest,1394,warrior,arms,66,36,30
Кефтеме,fordragon,1394,warrior,arms,219,106,113
Dolphini,argent-dawn,1394,warrior,arms,52,23,29
Einherjer,burning-legion,1393,warrior,arms,186,98,88
Royoxo,blackrock,1393,warrior,arms,59,31,28
Dirtyjoe,khaz-modan,1393,warrior,arms,406,209,197
Icybladez,kazzak,1393,warrior,arms,115,58,57
Sombrenuit,kaelthas,1393,warrior,arms,73,35,38
Thaitouri,eredar,1393,warrior,arms,36,15,21
Cäbbs,stormscale,1393,warrior,arms,36,15,21
Maikeiru,kul-tiras,1392,warrior,arms,81,41,40
Tarbhfathach,draenor,1392,warrior,arms,88,44,44
Iperiom,dun-modr,1391,warrior,arms,85,52,33
Jisoowar,blackhand,1391,warrior,arms,110,57,53
Hørror,nemesis,1391,warrior,arms,138,69,69
Алексвайтт,gordunni,1391,warrior,arms,47,23,24
Azdrubal,outland,1391,warrior,arms,36,17,19
Graghz,archimonde,1391,warrior,arms,64,30,34
Äzathoth,silvermoon,1391,warrior,arms,89,38,51
Astven,blackmoore,1391,warrior,arms,46,18,28
Hellrokk,drakthul,1390,warrior,arms,54,29,25
Hemèra,hyjal,1390,warrior,arms,72,36,36
Azik,burning-legion,1390,warrior,arms,96,47,49
Sidiøøus,hyjal,1390,warrior,arms,152,74,78
Vãle,argent-dawn,1390,warrior,arms,59,27,32
Qweoamsd,sylvanas,1390,warrior,arms,42,18,24
Equality,ragnaros,1389,warrior,arms,142,70,72
Запахвесны,howling-fjord,1389,warrior,arms,64,30,34
Wanzzeur,hyjal,1389,warrior,arms,150,70,80
Nuijija,stormscale,1389,warrior,arms,90,41,49
Hogu,nemesis,1389,warrior,arms,82,36,46
Rúsher,ragnaros,1388,warrior,arms,60,34,26
Cryonix,drakthul,1388,warrior,arms,87,47,40
Farrusco,nemesis,1388,warrior,arms,202,98,104
Xiszos,ravencrest,1388,warrior,arms,44,21,23
Hgfe,doomhammer,1388,warrior,arms,66,28,38
Nabul,thunderhorn,1387,warrior,arms,48,26,22
Birikkin,draenor,1387,warrior,arms,52,28,24
Tankdepalo,sanguino,1387,warrior,arms,30,16,14
Нифро,fordragon,1387,warrior,arms,89,45,44
Frézzér,blackrock,1387,warrior,arms,51,22,29
Binsaueramk,ravencrest,1387,warrior,arms,48,20,28
Yuriko,onyxia,1386,warrior,arms,77,38,39
Ferpylél,ragnaros,1386,warrior,arms,37,18,19
Folsack,sanguino,1386,warrior,arms,71,33,38
Drekh,kazzak,1386,warrior,arms,48,21,27
Dargonedt,blackrock,1386,warrior,arms,53,22,31
Woximus,ravencrest,1386,warrior,arms,66,27,39
Cárbo,silvermoon,1385,warrior,arms,133,74,59
Oyv,tarren-mill,1385,warrior,arms,36,20,16
Kyösti,defias-brotherhood,1385,warrior,arms,38,21,17
Kastraveci,outland,1385,warrior,arms,68,33,35
Megtorló,ragnaros,1385,warrior,arms,86,41,45
Баварриор,greymane,1385,warrior,arms,60,27,33
Дикийппц,gordunni,1384,warrior,arms,54,30,24
Diástasi,twisting-nether,1384,warrior,arms,90,48,42
Êlbæjynløl,ambossar,1384,warrior,arms,42,22,20
Blackblades,defias-brotherhood,1383,warrior,arms,82,48,34
Алол,gordunni,1383,warrior,arms,35,18,17
Pokopo,blackrock,1383,warrior,arms,391,193,198
Éls,argent-dawn,1383,warrior,arms,46,22,24
Андервульф,booty-bay,1383,warrior,arms,59,26,33
Dixo,nathrezim,1382,warrior,arms,36,25,11
Мастхэв,gordunni,1382,warrior,arms,96,49,47
Nøcturnaqq,silvermoon,1382,warrior,arms,102,48,54
Tmp,blackrock,1382,warrior,arms,66,31,35
Gnomop,ravencrest,1382,warrior,arms,66,30,36
Cêlty,aegwynn,1382,warrior,arms,100,41,59
Ærion,die-aldor,1381,warrior,arms,42,23,19
Delvirx,draenor,1381,warrior,arms,84,39,45
Rukkeg,silvermoon,1381,warrior,arms,62,27,35
Faugh,tarren-mill,1380,warrior,arms,54,32,22
Shehalk,stormscale,1380,warrior,arms,63,36,27
Kirus,ravencrest,1380,warrior,arms,93,45,48
Reezax,blackrock,1379,warrior,arms,90,50,40
Deckluhm,sinstralis,1379,warrior,arms,72,38,34
Brutalz,kazzak,1379,warrior,arms,42,22,20
Glørïn,hyjal,1379,warrior,arms,108,56,52
Adzipotlewap,burning-legion,1379,warrior,arms,108,54,54
Варбаул,soulflayer,1379,warrior,arms,121,58,63
Скрежет,gordunni,1379,warrior,arms,78,33,45
Maheri,antonidas,1378,warrior,arms,30,15,15
Maidenlless,ravencrest,1378,warrior,arms,322,157,165
Vilass,silvermoon,1378,warrior,arms,95,43,52
Sokarbey,twisting-nether,1377,warrior,arms,58,30,28
Warrouner,khaz-modan,1377,warrior,arms,151,74,77
Vrykhul,silvermoon,1377,warrior,arms,152,67,85
Qforína,stormscale,1377,warrior,arms,36,15,21
Auroree,ragnaros,1377,warrior,arms,60,24,36
Xaheld,blackrock,1376,warrior,arms,30,16,14
Espröc,kazzak,1376,warrior,arms,339,172,167
Mograinê,blackmoore,1376,warrior,arms,144,73,71
Djarenn,defias-brotherhood,1376,warrior,arms,36,16,20
Анманерка,ashenvale,1376,warrior,arms,36,16,20
Telderion,terokkar,1376,warrior,arms,72,30,42
Temprament,ravencrest,1375,warrior,arms,36,21,15
Bumbx,kazzak,1375,warrior,arms,132,68,64
Ajgreedy,grim-batol,1375,warrior,arms,66,30,36
Flawla,blackmoore,1375,warrior,arms,103,45,58
Farewe,lightbringer,1375,warrior,arms,73,27,46
Zargor,kazzak,1374,warrior,arms,58,35,23
Juoppó,tarren-mill,1374,warrior,arms,192,96,96
Бларк,goldrinn,1374,warrior,arms,84,41,43
Kimboslice,ragnaros,1374,warrior,arms,47,21,26
Sprutx,tarren-mill,1374,warrior,arms,42,18,24
Cléàvage,silvermoon,1374,warrior,arms,81,32,49
Nethra,archimonde,1373,warrior,arms,30,18,12
Gritch,ysondre,1373,warrior,arms,81,40,41
Spärtan,dun-modr,1373,warrior,arms,123,58,65
Нунара,eversong,1373,warrior,arms,70,28,42
Borga,blackrock,1372,warrior,arms,77,39,38
Агамемнан,soulflayer,1372,warrior,arms,457,230,227
Anaxiam,drakthul,1372,warrior,arms,81,39,42
Donátos,aegwynn,1371,warrior,arms,155,79,76
Lexras,blackhand,1371,warrior,arms,56,27,29
Johnston,frostmane,1371,warrior,arms,48,18,30
Морталвлицо,gordunni,1370,warrior,arms,23,15,8
Mercedesamg,blackmoore,1370,warrior,arms,56,28,28
Craghak,twisting-nether,1370,warrior,arms,255,124,131
Kalarar,blackrock,1370,warrior,arms,209,98,111
Roykór,auchindoun,1370,warrior,arms,156,71,85
Arriess,drakthul,1369,warrior,arms,89,45,44
Informatica,doomhammer,1369,warrior,arms,65,31,34
Nargez,outland,1369,warrior,arms,130,55,75
Kazos,twisting-nether,1369,warrior,arms,65,27,38
Lynton,sylvanas,1369,warrior,arms,61,24,37
Брозя,gordunni,1368,warrior,arms,64,32,32
Геленфорд,soulflayer,1368,warrior,arms,60,28,32
Toby,rexxar,1367,warrior,arms,93,50,43
Nicperh,dun-modr,1367,warrior,arms,114,55,59
Chisco,kazzak,1367,warrior,arms,79,37,42
Davari,ravencrest,1367,warrior,arms,39,15,24
Gnarok,archimonde,1366,warrior,arms,157,86,71
Kaliroll,ysondre,1366,warrior,arms,140,70,70
Arkcules,ghostlands,1366,warrior,arms,42,21,21
Dasbiest,malorne,1366,warrior,arms,71,35,36
Iuska,malganis,1366,warrior,arms,66,29,37
Погоныч,soulflayer,1365,warrior,arms,71,39,32
Marothul,dun-modr,1365,warrior,arms,36,17,19
Brabüs,kazzak,1364,warrior,arms,114,58,56
Petrixens,drakthul,1364,warrior,arms,78,39,39
Тоштайн,gordunni,1364,warrior,arms,80,35,45
Ressolwen,silvermoon,1364,warrior,arms,41,16,25
Rahaaxhia,kaelthas,1363,warrior,arms,56,33,23
Mogolaki,twilights-hammer,1363,warrior,arms,184,90,94
Qiz,silvermoon,1362,warrior,arms,140,71,69
Lomu,bloodscalp,1362,warrior,arms,50,25,25
Propanex,kazzak,1361,warrior,arms,42,26,16
Vølverinwar,thrall,1361,warrior,arms,82,37,45
Letmeteachya,kazzak,1361,warrior,arms,177,79,98
Pyrohand,arthas,1361,warrior,arms,38,16,22
Gärròsh,kazzak,1361,warrior,arms,42,16,26
Fløxswarri,blackmoore,1360,warrior,arms,48,27,21
Kröma,hyjal,1360,warrior,arms,42,23,19
Kolxoz,doomhammer,1360,warrior,arms,71,35,36
Garwarr,twisting-nether,1360,warrior,arms,85,38,47
Авентадорх,deathguard,1360,warrior,arms,147,65,82
Rakwarrior,blackhand,1359,warrior,arms,42,25,17
Mino,theradras,1359,warrior,arms,62,31,31
Shakeef,turalyon,1359,warrior,arms,41,19,22
Grahatia,magtheridon,1358,warrior,arms,99,54,45
Staribrko,outland,1358,warrior,arms,366,179,187
Zonash,kazzak,1358,warrior,arms,84,41,43
Тандэр,borean-tundra,1358,warrior,arms,60,27,33
Kymari,sanguino,1358,warrior,arms,63,28,35
Onefourthree,silvermoon,1358,warrior,arms,42,17,25
Suksori,kazzak,1358,warrior,arms,67,27,40
Shayarielle,zirkel-des-cenarius,1357,warrior,arms,59,33,26
Zbra,draenor,1357,warrior,arms,71,34,37
Tyrag,eredar,1357,warrior,arms,36,17,19
Nuclearrage,outland,1357,warrior,arms,77,35,42
Befit,quelthalas,1356,warrior,arms,108,54,54
Apashe,drakthul,1356,warrior,arms,70,35,35
Spaceløl,archimonde,1356,warrior,arms,42,18,24
Démigodx,stormscale,1356,warrior,arms,76,32,44
Кэфтэмэ,soulflayer,1355,warrior,arms,133,65,68
Raxur,kazzak,1355,warrior,arms,77,37,40
Maroshko,burning-blade,1353,warrior,arms,38,20,18
Mllmmxxm,kargath,1353,warrior,arms,89,40,49
Grokalus,eredar,1353,warrior,arms,54,23,31
Skya,burning-blade,1352,warrior,arms,30,16,14
Deviousjr,ragnaros,1352,warrior,arms,88,42,46
Фикпопадешь,lich-king,1352,warrior,arms,111,51,60
Niouswar,kazzak,1352,warrior,arms,54,24,30
Idchargethat,ragnaros,1352,warrior,arms,42,18,24
Draleckx,sanguino,1351,warrior,arms,380,191,189
Mladris,outland,1351,warrior,arms,49,24,25
Atälànte,ysondre,1350,warrior,arms,161,83,78
Cyrø,blackmoore,1350,warrior,arms,38,17,21
Steinsteg,antonidas,1349,warrior,arms,75,40,35
Exeqty,the-maelstrom,1349,warrior,arms,36,18,18
Каштоуны,howling-fjord,1348,warrior,arms,66,31,35
Huor,tarren-mill,1348,warrior,arms,66,27,39
Redcloak,outland,1347,warrior,arms,84,41,43
Zarakï,zuljin,1347,warrior,arms,96,43,53
Eseishard,hyjal,1347,warrior,arms,50,22,28
Lupacha,exodar,1346,warrior,arms,101,55,46
Warriornrv,ysondre,1346,warrior,arms,89,48,41
Ральдвин,gordunni,1346,warrior,arms,230,120,110
Kratosgr,defias-brotherhood,1346,warrior,arms,41,21,20
Ordwinz,silvermoon,1346,warrior,arms,155,76,79
Tazkax,archimonde,1346,warrior,arms,64,29,35
Krigarjag,kazzak,1345,warrior,arms,47,27,20
ßzv,veklor,1345,warrior,arms,38,21,17
Luckyfelix,blackmoore,1345,warrior,arms,62,31,31
Axemurdererr,draenor,1345,warrior,arms,94,45,49
Vohnkar,emeriss,1345,warrior,arms,158,70,88
Pummelpete,grim-batol,1344,warrior,arms,24,14,10
Давилкагеев,howling-fjord,1344,warrior,arms,109,52,57
Pazl,outland,1344,warrior,arms,36,17,19
Garthro,antonidas,1344,warrior,arms,60,28,32
Henzelhoff,stormreaver,1343,warrior,arms,64,39,25
Aomen,ravencrest,1343,warrior,arms,50,27,23
Jigokuno,kazzak,1343,warrior,arms,183,91,92
Billorc,twisting-nether,1343,warrior,arms,294,140,154
Rookrage,eredar,1343,warrior,arms,42,19,23
Deathrazór,stormscale,1343,warrior,arms,48,19,29
Salpaaja,tarren-mill,1343,warrior,arms,36,14,22
Galganiec,burning-legion,1342,warrior,arms,30,20,10
Bàhàmût,anetheron,1342,warrior,arms,35,22,13
Fedevalverde,sanguino,1342,warrior,arms,55,34,21
Eekz,haomarush,1342,warrior,arms,48,26,22
Zouwar,hyjal,1342,warrior,arms,48,24,24
Murandin,outland,1342,warrior,arms,71,34,37
Kímó,silvermoon,1342,warrior,arms,77,34,43
Schwarzkoviç,hyjal,1342,warrior,arms,64,28,36
Клайминг,soulflayer,1341,warrior,arms,89,54,35
Хазгора,howling-fjord,1341,warrior,arms,106,58,48
Ratko,auchindoun,1341,warrior,arms,51,26,25
Хьялдэргодр,deathguard,1341,warrior,arms,116,59,57
Stkacha,sanguino,1341,warrior,arms,30,14,16
Akáme,frostwolf,1341,warrior,arms,151,69,82
Krøn,stormscale,1340,warrior,arms,58,31,27
Radge,hyjal,1340,warrior,arms,112,55,57
Wãrby,ravencrest,1340,warrior,arms,97,47,50
Tcrujo,uldum,1340,warrior,arms,30,14,16
Barvaron,argent-dawn,1340,warrior,arms,40,17,23
Pablitø,silvermoon,1340,warrior,arms,36,14,22
Warara,archimonde,1340,warrior,arms,40,15,25
Kriegsfürsti,antonidas,1340,warrior,arms,42,15,27
Pag,hyjal,1339,warrior,arms,23,15,8
Hasira,xavius,1339,warrior,arms,43,26,17
Norganw,die-aldor,1339,warrior,arms,24,14,10
Hoxxywar,drakthul,1339,warrior,arms,59,33,26
Kbeast,kazzak,1339,warrior,arms,64,34,30
Отключатель,howling-fjord,1339,warrior,arms,110,58,52
Kravaiski,argent-dawn,1339,warrior,arms,231,115,116
Moowar,defias-brotherhood,1339,warrior,arms,129,62,67
Keriw,kazzak,1339,warrior,arms,30,14,16
Мобсто,soulflayer,1339,warrior,arms,65,30,35
Kundrakiz,kazzak,1339,warrior,arms,108,48,60
Nylseana,turalyon,1339,warrior,arms,60,26,34
Acidumcremor,burning-legion,1339,warrior,arms,36,14,22
Uretirips,archimonde,1338,warrior,arms,24,14,10
Yaystorm,stormscale,1338,warrior,arms,24,14,10
Анархорок,howling-fjord,1338,warrior,arms,24,14,10
Bladestorm,hyjal,1338,warrior,arms,24,14,10
Übelzord,thrall,1338,warrior,arms,313,149,164
Kimura,archimonde,1338,warrior,arms,30,14,16
Rajä,anubarak,1338,warrior,arms,65,29,36
Brutalx,twisting-nether,1337,warrior,arms,50,25,25
Nanathiel,laughing-skull,1337,warrior,arms,30,14,16
Hradball,twilights-hammer,1337,warrior,arms,92,42,50
Faløn,archimonde,1337,warrior,arms,125,57,68
Knôxx,eredar,1337,warrior,arms,79,35,44
Warbringer,burning-blade,1337,warrior,arms,105,44,61
Vajira,blackrock,1337,warrior,arms,36,14,22
Jhoakim,argent-dawn,1336,warrior,arms,24,14,10
Antewarrior,kazzak,1336,warrior,arms,24,14,10
Littlebugger,ravencrest,1336,warrior,arms,24,14,10
Mëc,twisting-nether,1336,warrior,arms,153,79,74
Инкреасес,soulflayer,1336,warrior,arms,174,86,88
Gunga,ravenholdt,1336,warrior,arms,45,22,23
Tchral,burning-legion,1336,warrior,arms,39,18,21
Рокэнрольщик,fordragon,1336,warrior,arms,84,36,48
Voldyh,draenor,1336,warrior,arms,36,15,21
Metmaschine,antonidas,1336,warrior,arms,43,15,28
Loliclapper,grim-batol,1335,warrior,arms,74,36,38
Razzimak,eredar,1334,warrior,arms,40,28,12
Nightjarr,draenor,1334,warrior,arms,24,14,10
Bleckwarrior,ravencrest,1334,warrior,arms,157,78,79
Mkazy,kirin-tor,1334,warrior,arms,42,19,23
Madswarrior,tarren-mill,1334,warrior,arms,35,15,20
Iloveit,draenor,1334,warrior,arms,36,14,22
Bjergo,drakthul,1333,warrior,arms,22,15,7
Anaerion,argent-dawn,1333,warrior,arms,177,86,91
Darkwa,azjolnerub,1333,warrior,arms,35,17,18
Critwar,silvermoon,1333,warrior,arms,54,25,29
Клоузер,blackscar,1333,warrior,arms,53,23,30
Экзекуторх,gordunni,1332,warrior,arms,18,14,4
Шорпит,howling-fjord,1332,warrior,arms,220,113,107
Derentis,echsenkessel,1332,warrior,arms,219,105,114
Ríta,silvermoon,1332,warrior,arms,90,40,50
Delarosa,drakthul,1332,warrior,arms,42,17,25
Kryszii,ragnaros,1332,warrior,arms,36,14,22
Флэксик,soulflayer,1331,warrior,arms,24,14,10
Neverkind,twisting-nether,1331,warrior,arms,120,65,55
Thisguyfax,the-venture-co,1331,warrior,arms,121,63,58
Iluwar,ragnaros,1331,warrior,arms,553,271,282
Багрон,goldrinn,1331,warrior,arms,30,14,16
Bovingus,tarren-mill,1330,warrior,arms,24,16,8
Cecill,silvermoon,1330,warrior,arms,157,86,71
Shãne,ysondre,1330,warrior,arms,58,31,27
Сырилисуп,soulflayer,1330,warrior,arms,134,71,63
Daddie,silvermoon,1330,warrior,arms,69,27,42
Sugmanutz,argent-dawn,1329,warrior,arms,24,14,10
Xanthias,nathrezim,1329,warrior,arms,90,47,43
Geckoo,emerald-dream,1329,warrior,arms,238,113,125
Batalius,dalaran,1329,warrior,arms,48,21,27
Urbanturban,tarren-mill,1329,warrior,arms,49,21,28
Àke,darksorrow,1328,warrior,arms,107,61,46
Ismellurfeet,ravencrest,1328,warrior,arms,60,34,26
Zzeed,auchindoun,1328,warrior,arms,77,33,44
Haewon,burning-legion,1328,warrior,arms,42,16,26
Contrariety,ravencrest,1327,warrior,arms,107,59,48
Tucomessuelo,cthun,1327,warrior,arms,104,52,52
Ангрол,grom,1327,warrior,arms,77,35,42
Pepao,zuljin,1327,warrior,arms,180,81,99
Ðrews,kazzak,1326,warrior,arms,24,14,10
Weedo,ragnaros,1326,warrior,arms,42,23,19
Shelied,twisting-nether,1326,warrior,arms,215,108,107
Oruka,mannoroth,1326,warrior,arms,88,44,44
Giantknob,tarren-mill,1326,warrior,arms,143,67,76
Меффект,howling-fjord,1326,warrior,arms,30,14,16
Deadchïld,drakthul,1326,warrior,arms,30,14,16
Studzianki,argent-dawn,1326,warrior,arms,30,14,16
Kosttya,argent-dawn,1326,warrior,arms,95,44,51
Hílfiger,kazzak,1326,warrior,arms,242,112,130
Robsuéy,blackmoore,1326,warrior,arms,138,60,78
ßigarms,ravencrest,1325,warrior,arms,24,14,10
Burøxx,doomhammer,1325,warrior,arms,26,14,12
Franzbardon,archimonde,1325,warrior,arms,444,220,224
Lægend,hyjal,1325,warrior,arms,329,163,166
Fizé,blackmoore,1325,warrior,arms,30,14,16
Khagor,kazzak,1325,warrior,arms,60,23,37
Bxnx,aegwynn,1324,warrior,arms,42,23,19
Malalulu,burning-legion,1324,warrior,arms,294,144,150
Mortalik,silvermoon,1324,warrior,arms,166,77,89
Ðalf,sargeras,1324,warrior,arms,33,15,18
Kløyva,ravencrest,1323,warrior,arms,24,14,10
Lovkal,twisting-nether,1323,warrior,arms,74,33,41
Shanai,silvermoon,1323,warrior,arms,41,17,24
Varrig,silvermoon,1321,warrior,arms,192,95,97
Medborgerlig,twisting-nether,1321,warrior,arms,60,27,33
Ashiku,zuljin,1321,warrior,arms,54,23,31
Lobsters,emeriss,1321,warrior,arms,41,16,25
Беркуть,deepholm,1320,warrior,arms,24,15,9
Braìnwashed,eredar,1320,warrior,arms,36,21,15
Throck,drakthul,1320,warrior,arms,41,18,23
Gacel,dun-modr,1320,warrior,arms,65,28,37
Domineon,mannoroth,1319,warrior,arms,31,15,16
Кассаб,soulflayer,1319,warrior,arms,30,14,16
Warrmax,darksorrow,1319,warrior,arms,87,40,47
Keshâr,blackhand,1319,warrior,arms,66,30,36
Monforte,silvermoon,1319,warrior,arms,68,24,44
Sená,stormscale,1318,warrior,arms,24,14,10
Tozz,azuremyst,1318,warrior,arms,60,34,26
Perry,proudmoore,1318,warrior,arms,30,17,13
Уравниттель,gordunni,1318,warrior,arms,117,64,53
Ozok,blackrock,1318,warrior,arms,36,16,20
Vikktor,doomhammer,1318,warrior,arms,42,14,28
Ragnacore,ravencrest,1317,warrior,arms,131,69,62
Deko,magtheridon,1317,warrior,arms,38,20,18
Onee,terrordar,1317,warrior,arms,168,82,86
Mynutzx,draenor,1317,warrior,arms,96,45,51
Martøswarr,uldum,1317,warrior,arms,30,14,16
Skyut,archimonde,1317,warrior,arms,72,33,39
Zøllka,dalaran,1317,warrior,arms,142,60,82
Grimhew,argent-dawn,1317,warrior,arms,42,17,25
Zuuk,malganis,1317,warrior,arms,36,14,22
Vasabi,anetheron,1316,warrior,arms,54,28,26
Zhenshii,blackmoore,1316,warrior,arms,42,21,21
Highz,grim-batol,1316,warrior,arms,77,38,39
Yotanwa,aegwynn,1316,warrior,arms,42,20,22
Bønecleaver,blackrock,1316,warrior,arms,30,14,16
Zcratch,silvermoon,1316,warrior,arms,58,27,31
Matchoo,archimonde,1316,warrior,arms,86,39,47
Xanatos,khazgoroth,1316,warrior,arms,69,24,45
Rayguerrero,blackrock,1316,warrior,arms,64,22,42
Tozzabancøne,nemesis,1315,warrior,arms,30,16,14
Jkarus,die-ewige-wacht,1315,warrior,arms,107,52,55
Iljaana,blackrock,1315,warrior,arms,102,49,53
Stompare,tarren-mill,1315,warrior,arms,37,17,20
Mikylothar,kazzak,1315,warrior,arms,36,16,20
Pahgorim,blackhand,1315,warrior,arms,60,26,34
Vymd,archimonde,1315,warrior,arms,76,31,45
Atlantia,ravencrest,1315,warrior,arms,48,17,31
Ràgnarok,chogall,1314,warrior,arms,72,39,33
Dimitrow,frostmane,1314,warrior,arms,108,57,51
Reichas,ragnaros,1314,warrior,arms,92,48,44
Buyya,ravencrest,1314,warrior,arms,64,33,31
Malevolént,silvermoon,1314,warrior,arms,93,46,47
Qvate,twisting-nether,1314,warrior,arms,77,36,41
Kmica,khadgar,1314,warrior,arms,61,27,34
Elénir,dalaran,1313,warrior,arms,36,20,16
Lácrima,dun-modr,1313,warrior,arms,36,18,18
Gorchak,blackmoore,1313,warrior,arms,254,123,131
Minoke,antonidas,1313,warrior,arms,60,28,32
Yaggurtz,archimonde,1313,warrior,arms,42,19,23
Bigdbigarms,tarren-mill,1312,warrior,arms,24,14,10
Doxinator,silvermoon,1312,warrior,arms,105,42,63
Cogne,illidan,1311,warrior,arms,24,14,10
Torpus,outland,1311,warrior,arms,104,56,48
Оморальный,soulflayer,1311,warrior,arms,88,39,49
Deicamus,tyrande,1310,warrior,arms,91,47,44
Nings,rashgarroth,1310,warrior,arms,88,44,44
Artheim,silvermoon,1310,warrior,arms,60,24,36
Lanahan,argent-dawn,1309,warrior,arms,23,14,9
Ninebites,chamber-of-aspects,1309,warrior,arms,143,73,70
Ruzbie,silvermoon,1309,warrior,arms,36,15,21
Sinbuay,malygos,1309,warrior,arms,48,19,29
Varmok,draenor,1309,warrior,arms,42,14,28
Argadea,archimonde,1308,warrior,arms,165,87,78
Дейниксис,howling-fjord,1308,warrior,arms,30,14,16
Barathor,kult-der-verdammten,1308,warrior,arms,38,17,21
Zappstorm,frostwolf,1307,warrior,arms,58,32,26
Колятурбо,gordunni,1307,warrior,arms,49,26,23
Tontonsmoky,hyjal,1307,warrior,arms,142,67,75
Pihvikostaja,stormreaver,1307,warrior,arms,30,14,16
Humanoç,dun-modr,1307,warrior,arms,36,16,20
Dodgeslam,eredar,1307,warrior,arms,88,39,49
Byorr,marécage-de-zangar,1307,warrior,arms,42,17,25
Rasselbandé,blackhand,1306,warrior,arms,48,27,21
Lûckystríké,blackmoore,1305,warrior,arms,81,40,41
Kâine,blackmoore,1305,warrior,arms,186,91,95
Bøgatyr,draenor,1305,warrior,arms,29,14,15
Steelian,kazzak,1305,warrior,arms,41,18,23
Avïlîa,dalaran,1305,warrior,arms,42,15,27
Манхув,gordunni,1304,warrior,arms,30,14,16
Puurplecloud,kazzak,1304,warrior,arms,96,42,54
Вениамин,deathweaver,1304,warrior,arms,137,59,78
Neltharon,silvermoon,1303,warrior,arms,51,33,18
Roctah,auchindoun,1303,warrior,arms,52,26,26
Nocton,blackhand,1303,warrior,arms,96,44,52
Dreschus,blackrock,1303,warrior,arms,92,41,51
Alaë,archimonde,1303,warrior,arms,79,33,46
Ankzz,archimonde,1302,warrior,arms,84,45,39
Taylorswifty,twisting-nether,1302,warrior,arms,130,66,64
Brokenqt,ravencrest,1302,warrior,arms,67,34,33
Кунгфурик,soulflayer,1302,warrior,arms,84,42,42
Zosska,burning-legion,1302,warrior,arms,81,36,45
Laciater,burning-legion,1302,warrior,arms,38,16,22
Bossít,doomhammer,1301,warrior,arms,80,44,36
Nakkelam,twisting-nether,1300,warrior,arms,36,21,15
Prs,defias-brotherhood,1300,warrior,arms,54,31,23
Диктаторвар,soulflayer,1300,warrior,arms,30,15,15
Doragon,nemesis,1300,warrior,arms,106,52,54
Katxirulo,tyrande,1300,warrior,arms,72,34,38
Knussnacker,sanguino,1300,warrior,arms,193,89,104
Bjornska,defias-brotherhood,1300,warrior,arms,42,18,24
Imaginefun,ragnaros,1300,warrior,arms,66,28,38
Âdept,tarren-mill,1300,warrior,arms,102,43,59
Ðræms,eldrethalas,1299,warrior,arms,104,51,53
Banesan,stormscale,1299,warrior,arms,30,14,16
Earshy,ragnaros,1299,warrior,arms,30,14,16
Buncljin,draenor,1299,warrior,arms,85,38,47
Slamona,ravencrest,1298,warrior,arms,29,15,14
Brondir,archimonde,1298,warrior,arms,41,21,20
Anubisra,alakir,1298,warrior,arms,49,24,25
Golonko,burning-legion,1298,warrior,arms,119,58,61
Banshor,ysondre,1298,warrior,arms,44,19,25
Bedryl,burning-legion,1298,warrior,arms,69,29,40
Ferrum,sunstrider,1297,warrior,arms,36,19,17
Skullcrasher,draenor,1297,warrior,arms,69,35,34
Cbahorde,outland,1297,warrior,arms,128,62,66
Rabiolika,sanguino,1297,warrior,arms,41,18,23
Pitii,burning-legion,1297,warrior,arms,38,16,22
Executorä,stormscale,1297,warrior,arms,69,24,45
Aylîx,dun-modr,1296,warrior,arms,42,27,15
Infusione,nemesis,1296,warrior,arms,60,36,24
Slapface,blackmoore,1296,warrior,arms,50,28,22
Mågne,tarren-mill,1296,warrior,arms,138,68,70
Joewahl,ragnaros,1296,warrior,arms,151,68,83
Bämoida,eredar,1296,warrior,arms,58,26,32
Армсец,howling-fjord,1296,warrior,arms,42,16,26
Atelier,magtheridon,1295,warrior,arms,96,56,40
Seliasbro,kazzak,1295,warrior,arms,30,15,15
Ramlosa,stormscale,1295,warrior,arms,40,17,23
Addy,twisting-nether,1294,warrior,arms,30,15,15
Zuchtrind,blackrock,1293,warrior,arms,60,34,26
Viridas,stormscale,1293,warrior,arms,230,106,124
Protecc,burning-legion,1292,warrior,arms,189,94,95
Wtchmyblades,blackmoore,1292,warrior,arms,29,14,15
Hellripper,antonidas,1292,warrior,arms,30,14,16
Tikej,silvermoon,1292,warrior,arms,58,26,32
Mölntuss,emeriss,1292,warrior,arms,41,14,27
Bulwrak,eredar,1291,warrior,arms,269,132,137
Perkoulator,archimonde,1291,warrior,arms,299,146,153
Zeroskllz,outland,1291,warrior,arms,76,36,40
Zyn,outland,1291,warrior,arms,54,25,29
Inelegant,tarren-mill,1290,warrior,arms,60,32,28
Mödhan,archimonde,1290,warrior,arms,123,61,62
Ghorglukk,lightnings-blade,1290,warrior,arms,60,28,32
Garganelli,tarren-mill,1290,warrior,arms,68,30,38
Elyrax,dun-modr,1290,warrior,arms,36,15,21
Gaarrossh,kazzak,1290,warrior,arms,41,14,27
Tommia,burning-legion,1289,warrior,arms,78,41,37
Rådne,argent-dawn,1289,warrior,arms,42,21,21
Geraltf,tarren-mill,1289,warrior,arms,203,97,106
Purjon,twilights-hammer,1289,warrior,arms,109,50,59
Tenramar,silvermoon,1289,warrior,arms,36,15,21
Шизам,howling-fjord,1289,warrior,arms,95,39,56
Степанычь,gordunni,1288,warrior,arms,41,22,19
Dwarphex,outland,1288,warrior,arms,48,25,23
Vexxenn,outland,1288,warrior,arms,36,16,20
Pawn,twisting-nether,1288,warrior,arms,48,21,27
Nellyqt,draenor,1288,warrior,arms,58,23,35
Dutteh,tarren-mill,1287,warrior,arms,42,23,19
Jasperr,nemesis,1287,warrior,arms,133,70,63
Mfull,tarren-mill,1287,warrior,arms,72,35,37
Tsu,karazhan,1287,warrior,arms,63,29,34
Deeper,twisting-nether,1287,warrior,arms,48,22,26
Kronstris,veklor,1287,warrior,arms,66,29,37
Hellspin,argent-dawn,1286,warrior,arms,156,74,82
Vegäpunk,nemesis,1286,warrior,arms,60,28,32
Metawar,blackhand,1286,warrior,arms,66,30,36
Gantór,blackrock,1286,warrior,arms,54,23,31
Slam,blackrock,1285,warrior,arms,42,14,28
Tumuerte,dun-modr,1284,warrior,arms,79,45,34
Cromix,blackrock,1283,warrior,arms,95,53,42
Unarde,silvermoon,1283,warrior,arms,257,128,129
Кентаныч,howling-fjord,1283,warrior,arms,62,30,32
Vorns,silvermoon,1283,warrior,arms,46,22,24
Tíabeanie,silvermoon,1283,warrior,arms,30,14,16
Leonidæs,frostwolf,1283,warrior,arms,105,48,57
Maglajs,burning-blade,1283,warrior,arms,48,19,29
Kekwd,burning-legion,1283,warrior,arms,48,17,31
Dreadstyle,burning-legion,1282,warrior,arms,65,36,29
Sigmundsdotr,outland,1282,warrior,arms,90,46,44
Bonesz,jaedenar,1282,warrior,arms,229,114,115
Phovoss,stormscale,1282,warrior,arms,106,44,62
Màgh,ravencrest,1282,warrior,arms,54,20,34
Рагнарг,goldrinn,1281,warrior,arms,102,57,45
Ènteqt,antonidas,1281,warrior,arms,99,52,47
Mixiko,khadgar,1281,warrior,arms,59,28,31
Titanioa,draenor,1281,warrior,arms,84,38,46
Buttslaper,burning-legion,1280,warrior,arms,35,19,16
Дрейсен,gordunni,1280,warrior,arms,52,26,26
Foxaz,burning-legion,1280,warrior,arms,109,54,55
Jjokkerr,magtheridon,1280,warrior,arms,29,14,15
Гогрикк,ashenvale,1279,warrior,arms,72,35,37
Larrydankin,draenor,1279,warrior,arms,202,95,107
Ludjack,tarren-mill,1279,warrior,arms,63,29,34
Grolbein,blackhand,1278,warrior,arms,89,42,47
Izestyi,blackrock,1278,warrior,arms,125,58,67
Yayoflauta,sanguino,1278,warrior,arms,96,43,53
Qree,dun-morogh,1277,warrior,arms,36,19,17
Armsstrong,blackhand,1277,warrior,arms,29,14,15
Klanky,draenor,1277,warrior,arms,86,41,45
Sfarpi,burning-legion,1276,warrior,arms,108,60,48
Wolfgladius,cthun,1276,warrior,arms,48,22,26
Narkololzz,marécage-de-zangar,1276,warrior,arms,91,41,50
Боадрог,soulflayer,1276,warrior,arms,54,22,32
Ванпанчвумен,borean-tundra,1275,warrior,arms,24,14,10
Xaah,dun-modr,1275,warrior,arms,68,35,33
Тысячидуш,gordunni,1275,warrior,arms,78,38,40
Kultigin,ravencrest,1275,warrior,arms,122,53,69
Газрош,howling-fjord,1275,warrior,arms,88,38,50
Màndø,archimonde,1275,warrior,arms,102,42,60
Aggamemnus,ravencrest,1274,warrior,arms,74,42,32
Loreven,silvermoon,1274,warrior,arms,29,14,15
Sertigan,dun-modr,1274,warrior,arms,150,67,83
Vazzle,nethersturm,1274,warrior,arms,78,29,49
Friedhard,aegwynn,1273,warrior,arms,130,69,61
Pegazón,outland,1273,warrior,arms,120,57,63
Neekero,burning-legion,1273,warrior,arms,116,54,62
Ishíì,twisting-nether,1273,warrior,arms,98,45,53
Матумбо,gordunni,1273,warrior,arms,127,58,69
Optitt,dethecus,1273,warrior,arms,59,26,33
Fàlconry,kazzak,1273,warrior,arms,140,60,80
Chargelife,sylvanas,1272,warrior,arms,24,14,10
Luunk,ravencrest,1272,warrior,arms,132,71,61
Asmongnome,ravencrest,1272,warrior,arms,63,32,31
Rindermett,eredar,1272,warrior,arms,46,22,24
Акумираг,soulflayer,1272,warrior,arms,108,43,65
Aloia,stormscale,1271,warrior,arms,63,32,31
Narox,arathor,1271,warrior,arms,74,36,38
Сигберт,gordunni,1271,warrior,arms,42,19,23
Smeshh,burning-legion,1270,warrior,arms,102,58,44
Hofftor,eredar,1270,warrior,arms,61,32,29
Sphínxx,malfurion,1270,warrior,arms,56,26,30
Sayaká,twisting-nether,1270,warrior,arms,34,14,20
Olesbawro,ragnaros,1270,warrior,arms,108,43,65
Sorassa,eredar,1270,warrior,arms,36,14,22
Jujuwa,tarren-mill,1270,warrior,arms,83,32,51
Thorkell,genjuros,1269,warrior,arms,101,55,46
Rhonack,ragnaros,1269,warrior,arms,68,32,36
Джондо,gordunni,1269,warrior,arms,30,14,16
Zarolk,rashgarroth,1269,warrior,arms,84,38,46
Warriotrix,tarren-mill,1269,warrior,arms,43,18,25
Lamme,darksorrow,1268,warrior,arms,31,16,15
Crotoss,ravencrest,1268,warrior,arms,89,45,44
Духолоов,gordunni,1268,warrior,arms,312,156,156
Milanxxalian,outland,1268,warrior,arms,69,34,35
Tyëlin,elune,1268,warrior,arms,137,63,74
Осгаард,gordunni,1268,warrior,arms,114,49,65
Kriegerlutz,blackmoore,1268,warrior,arms,35,15,20
Semanor,aegwynn,1267,warrior,arms,54,26,28
Misiaczek,the-maelstrom,1267,warrior,arms,53,23,30
Kriticah,sanguino,1267,warrior,arms,104,44,60
Garodis,blackmoore,1267,warrior,arms,36,14,22
Funknîco,wrathbringer,1266,warrior,arms,55,29,26
Bellator,arakarahm,1266,warrior,arms,119,54,65
Plt,talnivarr,1265,warrior,arms,76,44,32
Oneshót,norgannon,1265,warrior,arms,162,80,82
Exot,eredar,1264,warrior,arms,90,47,43
Aliasus,outland,1264,warrior,arms,36,16,20
Aiarm,twisting-nether,1263,warrior,arms,222,117,105
Утонаган,fordragon,1263,warrior,arms,60,28,32
Хардскар,ashenvale,1263,warrior,arms,42,14,28
Morrzerk,sylvanas,1262,warrior,arms,53,29,24
Abnôrmus,tarren-mill,1262,warrior,arms,48,25,23
Trundledaddy,silvermoon,1262,warrior,arms,29,14,15
Skederon,chogall,1262,warrior,arms,30,14,16
Братишкаа,gordunni,1262,warrior,arms,65,28,37
Аранья,howling-fjord,1262,warrior,arms,40,15,25
Gintonnic,sanguino,1261,warrior,arms,48,22,26
Poronga,sanguino,1260,warrior,arms,30,14,16
Тассэй,eversong,1260,warrior,arms,130,59,71
Leyshan,archimonde,1260,warrior,arms,94,39,55
Hellevorn,hyjal,1259,warrior,arms,59,30,29
Gorok,culte-de-la-rive-noire,1259,warrior,arms,59,28,31
Kirsche,blackrock,1258,warrior,arms,72,41,31
Соловейч,howling-fjord,1258,warrior,arms,36,20,16
Bolski,ravencrest,1258,warrior,arms,81,42,39
Критико,lich-king,1258,warrior,arms,30,14,16
Kíngsafa,rexxar,1258,warrior,arms,36,15,21
Tarau,archimonde,1258,warrior,arms,39,16,23
Донткарлеон,howling-fjord,1258,warrior,arms,53,18,35
Shengu,kazzak,1257,warrior,arms,78,46,32
Serbo,stormscale,1257,warrior,arms,42,19,23
Оптимпрайм,blackscar,1257,warrior,arms,54,24,30
Himarshal,kazzak,1257,warrior,arms,79,32,47
Hurricane,sylvanas,1257,warrior,arms,42,15,27
Balyndâ,aegwynn,1256,warrior,arms,44,25,19
Gigac,ragnaros,1256,warrior,arms,78,38,40
Krigsdunken,draenor,1256,warrior,arms,105,49,56
Рейнджровер,howling-fjord,1256,warrior,arms,94,43,51
Сифончик,ashenvale,1256,warrior,arms,69,30,39
Delenia,twisting-nether,1255,warrior,arms,118,60,58
Zelfire,magtheridon,1255,warrior,arms,48,22,26
Slaughteredd,kazzak,1255,warrior,arms,114,52,62
Zalhym,archimonde,1254,warrior,arms,157,75,82
Buntstift,thrall,1254,warrior,arms,42,14,28
Doveloo,kazzak,1253,warrior,arms,84,47,37
Lûxn,ragnaros,1253,warrior,arms,223,112,111
Блэйзерх,gordunni,1253,warrior,arms,43,14,29
Lëime,ravencrest,1252,warrior,arms,84,42,42
Bluntsword,twisting-nether,1252,warrior,arms,65,30,35
Roimyv,archimonde,1252,warrior,arms,42,14,28
Azëlls,archimonde,1251,warrior,arms,144,74,70
Wyshh,silvermoon,1251,warrior,arms,213,107,106
Gids,silvermoon,1251,warrior,arms,36,17,19
Taikyokuken,hyjal,1251,warrior,arms,96,43,53
Hatethisgame,frostwolf,1251,warrior,arms,99,44,55
Luffydono,stormscale,1251,warrior,arms,160,71,89
Ironstep,silvermoon,1250,warrior,arms,42,27,15
Dicaprios,silvermoon,1250,warrior,arms,72,36,36
Кимиюки,gordunni,1250,warrior,arms,110,53,57
Фоссбро,gordunni,1250,warrior,arms,129,59,70
Shihoh,blackhand,1250,warrior,arms,171,75,96
Caíne,drakthul,1249,warrior,arms,174,85,89
Tidrick,argent-dawn,1249,warrior,arms,36,17,19
Nårgaí,kargath,1249,warrior,arms,124,58,66
Lydianite,stormrage,1249,warrior,arms,37,16,21
Sajw,tarren-mill,1248,warrior,arms,18,13,5
Зуботычник,gordunni,1248,warrior,arms,30,17,13
Behemothwr,kazzak,1248,warrior,arms,141,67,74
Brandylover,outland,1248,warrior,arms,32,15,17
Sûpêrgâzî,twisting-nether,1248,warrior,arms,43,20,23
Fargon,ravencrest,1248,warrior,arms,178,82,96
Cárlsberg,pozzo-delleternità,1248,warrior,arms,81,36,45
Кориалвар,gordunni,1247,warrior,arms,24,14,10
Regulators,outland,1247,warrior,arms,26,14,12
Kailyy,kazzak,1247,warrior,arms,27,14,13
Empero,draenor,1247,warrior,arms,30,15,15
Hellthõr,silvermoon,1247,warrior,arms,78,37,41
Daymio,twisting-nether,1247,warrior,arms,30,13,17
Kásúxøxøw,ravencrest,1247,warrior,arms,30,13,17
Maggisauce,aegwynn,1246,warrior,arms,118,64,54
Hønks,antonidas,1246,warrior,arms,24,13,11
Algazarra,aggra-português,1246,warrior,arms,78,42,36
Vurra,zuljin,1246,warrior,arms,80,40,40
Kardinell,blackhand,1246,warrior,arms,66,30,36
Фрокешер,howling-fjord,1246,warrior,arms,87,39,48
Sponkss,tarren-mill,1246,warrior,arms,30,13,17
Tehmountain,ravencrest,1246,warrior,arms,30,13,17
Shará,eredar,1246,warrior,arms,114,49,65
Xiphiatwo,ravencrest,1246,warrior,arms,36,13,23
Epyøn,stormscale,1245,warrior,arms,21,13,8
Teraa,the-maelstrom,1245,warrior,arms,82,50,32
Jethiss,ravencrest,1245,warrior,arms,26,13,13
Atus,dun-modr,1245,warrior,arms,77,38,39
Sixteen,darkmoon-faire,1245,warrior,arms,156,74,82
Woosaah,ravencrest,1245,warrior,arms,34,16,18
Grinrok,thrall,1245,warrior,arms,78,36,42
Csíbór,ragnaros,1245,warrior,arms,48,18,30
Ken,twisting-nether,1245,warrior,arms,46,14,32
Tragomorfos,ravencrest,1244,warrior,arms,24,13,11
Addicty,sylvanas,1244,warrior,arms,347,178,169
Zeldaixi,twisting-nether,1244,warrior,arms,46,23,23
Silabozija,ravencrest,1244,warrior,arms,120,58,62
Вардроу,howling-fjord,1244,warrior,arms,104,50,54
Gotural,ravencrest,1243,warrior,arms,18,13,5
Rhazeél,blackrock,1243,warrior,arms,18,13,5
Arkalolz,hyjal,1243,warrior,arms,24,13,11
Zaerna,draenor,1243,warrior,arms,24,13,11
Zeryyo,blackrock,1243,warrior,arms,24,13,11
Kiriwarr,dun-modr,1243,warrior,arms,24,13,11
Dianâ,der-abyssische-rat,1243,warrior,arms,47,25,22
Xunaakt,nemesis,1243,warrior,arms,81,39,42
Rocktastic,blackrock,1243,warrior,arms,41,16,25
Soundso,blackmoore,1242,warrior,arms,26,15,11
Narcx,kazzak,1242,warrior,arms,24,13,11
Oldhatreds,twisting-nether,1242,warrior,arms,52,25,27
Átlás,blackmoore,1242,warrior,arms,43,19,24
Сильваняшка,gordunni,1241,warrior,arms,24,13,11
Notvisionary,ravencrest,1241,warrior,arms,24,13,11
Dréck,aegwynn,1241,warrior,arms,101,45,56
Ivailowar,ravencrest,1241,warrior,arms,78,34,44
Тарартзу,soulflayer,1241,warrior,arms,30,13,17
Recklessness,drakthul,1239,warrior,arms,24,13,11
Hedral,hyjal,1239,warrior,arms,24,13,11
Issatank,frostmane,1239,warrior,arms,132,64,68
Romzz,malganis,1239,warrior,arms,108,52,56
Arnnau,dun-modr,1239,warrior,arms,30,14,16
Nixtor,defias-brotherhood,1239,warrior,arms,132,61,71
Vagor,aegwynn,1239,warrior,arms,114,52,62
Ironballs,saurfang,1239,warrior,arms,30,13,17
Eragdagh,thrall,1239,warrior,arms,62,26,36
Ayawa,silvermoon,1239,warrior,arms,42,16,26
Ghettogødx,outland,1239,warrior,arms,36,13,23
Chargekanta,antonidas,1238,warrior,arms,24,13,11
Khalghara,dun-modr,1238,warrior,arms,48,19,29
Vøs,hyjal,1237,warrior,arms,24,13,11
Rorix,blackrock,1237,warrior,arms,24,13,11
Jésusiskíng,amanthul,1237,warrior,arms,24,13,11
Batrâx,eldrethalas,1237,warrior,arms,91,41,50
Orquewarrior,stormscale,1237,warrior,arms,143,64,79
Tinker,crushridge,1237,warrior,arms,30,13,17
Kampfente,blackrock,1237,warrior,arms,30,13,17
Tahzwolf,stormscale,1236,warrior,arms,18,13,5
Fractale,kirin-tor,1236,warrior,arms,22,14,8
Данилатитич,howling-fjord,1236,warrior,arms,107,53,54
Казгримм,howling-fjord,1236,warrior,arms,98,42,56
Smackaroon,draenor,1235,warrior,arms,24,13,11
Эсвексия,gordunni,1234,warrior,arms,24,14,10
Сэмвариор,gordunni,1234,warrior,arms,24,13,11
Zøom,ysondre,1234,warrior,arms,178,90,88
Pacosky,burning-legion,1234,warrior,arms,63,30,33
Heimdål,antonidas,1234,warrior,arms,64,26,38
Gealt,outland,1234,warrior,arms,77,31,46
Sentenzah,arakarahm,1234,warrior,arms,48,19,29
Tempii,ragnaros,1234,warrior,arms,48,18,30
Imorphius,silvermoon,1234,warrior,arms,36,13,23
Nøøbisator,archimonde,1233,warrior,arms,103,55,48
Xardäs,ysondre,1233,warrior,arms,30,13,17
Kromt,shendralar,1232,warrior,arms,36,24,12
Kloppnîx,blackmoore,1232,warrior,arms,80,44,36
Soulcleaver,stormreaver,1232,warrior,arms,118,59,59
Gelforn,argent-dawn,1232,warrior,arms,59,29,30
Shtormguard,ravencrest,1232,warrior,arms,48,20,28
Gladiatoor,terenas,1232,warrior,arms,36,13,23
Nezriq,neptulon,1231,warrior,arms,24,13,11
Kaydren,durotan,1231,warrior,arms,24,13,11
Makote,uldum,1231,warrior,arms,24,13,11
Rochful,frostwolf,1231,warrior,arms,80,41,39
Goragthor,thrall,1230,warrior,arms,36,19,17
Arinator,les-sentinelles,1230,warrior,arms,105,46,59
Waegon,twisting-nether,1230,warrior,arms,30,13,17
Orcanism,nozdormu,1229,warrior,arms,117,62,55
Draken,tarren-mill,1229,warrior,arms,30,13,17
Caraquru,silvermoon,1228,warrior,arms,54,33,21
Dautis,dun-modr,1228,warrior,arms,33,17,16
Thehans,grim-batol,1228,warrior,arms,44,18,26
Furius,zuljin,1227,warrior,arms,41,20,21
Diggawhat,antonidas,1226,warrior,arms,267,129,138
Cyniczny,draenor,1226,warrior,arms,45,21,24
Leàn,nemesis,1226,warrior,arms,36,13,23
Бруталдэз,deathguard,1226,warrior,arms,50,16,34
Lögösh,la-croisade-écarlate,1225,warrior,arms,24,13,11
Prater,draenor,1225,warrior,arms,35,18,17
Regna,eredar,1225,warrior,arms,132,65,67
Синнэр,blackscar,1225,warrior,arms,36,13,23
Sephirotth,burning-legion,1224,warrior,arms,30,13,17
Бардеон,gordunni,1224,warrior,arms,30,13,17
Fidélgastro,ysondre,1224,warrior,arms,61,25,36
Synthasixx,twisting-nether,1224,warrior,arms,54,20,34
Ragedotcom,archimonde,1223,warrior,arms,60,33,27
Raggnnar,blackrock,1223,warrior,arms,55,28,27
Erayu,outland,1223,warrior,arms,30,13,17
Isidoro,ravencrest,1223,warrior,arms,78,31,47
Горячийогонь,soulflayer,1223,warrior,arms,69,25,44
Demonraze,hyjal,1222,warrior,arms,42,27,15
Kaazzuraa,hyjal,1222,warrior,arms,66,38,28
Solaría,garona,1222,warrior,arms,30,15,15
Kallor,burning-legion,1222,warrior,arms,99,49,50
Nightwatchs,outland,1222,warrior,arms,108,53,55
Energo,drakthul,1222,warrior,arms,36,17,19
Evvii,terenas,1222,warrior,arms,30,13,17
Gorrashar,drakthul,1222,warrior,arms,42,17,25
Blaackbeard,blackmoore,1221,warrior,arms,48,22,26
Gachiwarri,blackhand,1221,warrior,arms,30,13,17
Akarakhan,sanguino,1221,warrior,arms,108,46,62
Krieguer,sanguino,1221,warrior,arms,48,20,28
Gèrralt,hyjal,1221,warrior,arms,41,16,25
Bloodpyre,nemesis,1221,warrior,arms,53,15,38
Bigtulipe,archimonde,1220,warrior,arms,77,39,38
Vandras,hyjal,1220,warrior,arms,65,29,36
Brubaker,hyjal,1220,warrior,arms,30,13,17
Araxoth,silvermoon,1220,warrior,arms,103,43,60
Boomxi,burning-legion,1220,warrior,arms,47,17,30
Shäshken,archimonde,1220,warrior,arms,102,28,74
Ðamokles,silvermoon,1219,warrior,arms,73,36,37
Диодемма,gordunni,1219,warrior,arms,84,38,46
Moshpít,antonidas,1219,warrior,arms,36,13,23
Ethon,antonidas,1218,warrior,arms,28,15,13
Номер,eversong,1218,warrior,arms,63,33,30
Cuuz,outland,1217,warrior,arms,35,20,15
Tyragon,thrall,1217,warrior,arms,120,61,59
Disturbance,eredar,1217,warrior,arms,54,27,27
Drbanner,hyjal,1217,warrior,arms,120,57,63
Дедсдрыном,howling-fjord,1217,warrior,arms,71,33,38
Goroth,vashj,1217,warrior,arms,36,14,22
Kerisandra,silvermoon,1216,warrior,arms,49,29,20
Konstantin,grim-batol,1216,warrior,arms,191,89,102
Titanstriker,silvermoon,1216,warrior,arms,30,13,17
Gromlogosh,stormscale,1216,warrior,arms,30,13,17
Ghostwarx,blackmoore,1215,warrior,arms,38,19,19
Sistabossen,magtheridon,1215,warrior,arms,30,15,15
Crocbait,ravencrest,1214,warrior,arms,42,22,20
Rogirb,drakthul,1214,warrior,arms,42,21,21
Раздолбатель,razuvious,1214,warrior,arms,87,41,46
Вилькария,eversong,1214,warrior,arms,34,15,19
Batourga,marécage-de-zangar,1214,warrior,arms,57,22,35
Varrhok,tarren-mill,1214,warrior,arms,36,13,23
Twinblyat,defias-brotherhood,1213,warrior,arms,48,21,27
Bullburzt,ragnaros,1212,warrior,arms,35,15,20
Watsabe,kazzak,1212,warrior,arms,93,36,57
Атон,gordunni,1211,warrior,arms,224,109,115
Zool,madmortem,1211,warrior,arms,272,132,140
Monifes,kazzak,1211,warrior,arms,36,16,20
Лэркус,howling-fjord,1211,warrior,arms,30,13,17
Nonescape,twisting-nether,1211,warrior,arms,99,42,57
Weezing,argent-dawn,1211,warrior,arms,70,28,42
Woterz,twisting-nether,1211,warrior,arms,40,13,27
Wargasm,burning-blade,1210,warrior,arms,58,31,27
Tazdingowar,antonidas,1210,warrior,arms,94,38,56
Huuln,outland,1210,warrior,arms,62,24,38
Gilettepenge,draenor,1209,warrior,arms,233,115,118
Тибат,howling-fjord,1209,warrior,arms,79,34,45
Жлобьен,howling-fjord,1209,warrior,arms,36,13,23
Zellóx,stormscale,1208,warrior,arms,23,13,10
Lyarinsky,tyrande,1208,warrior,arms,118,65,53
Jaru,alleria,1208,warrior,arms,69,35,34
Lukkass,ravencrest,1208,warrior,arms,33,14,19
Iarsonn,drakthul,1208,warrior,arms,54,21,33
Ферхар,galakrond,1207,warrior,arms,42,23,19
Dardi,blackrock,1206,warrior,arms,36,17,19
Hoggle,runetotem,1205,warrior,arms,94,54,40
Yayoqt,sylvanas,1205,warrior,arms,136,67,69
Zuharakì,nemesis,1205,warrior,arms,428,208,220
Upholder,xavius,1205,warrior,arms,35,17,18
Mysteryman,defias-brotherhood,1205,warrior,arms,142,68,74
Valus,earthen-ring,1205,warrior,arms,30,14,16
Оверфлок,howling-fjord,1205,warrior,arms,30,13,17
Маллал,soulflayer,1204,warrior,arms,126,57,69
Nelfx,aggra-português,1203,warrior,arms,193,105,88
Astrid,rajaxx,1203,warrior,arms,57,28,29
Whimbux,stormscale,1203,warrior,arms,86,38,48
Totalterror,ragnaros,1203,warrior,arms,72,31,41
Vrokoda,quelthalas,1203,warrior,arms,36,14,22
Мегаяйца,gordunni,1203,warrior,arms,41,13,28
Excutíé,twisting-nether,1202,warrior,arms,30,18,12
Fluxerella,azjolnerub,1202,warrior,arms,24,13,11
Lezúziuszh,ragnaros,1202,warrior,arms,44,21,23
Wardam,terokkar,1202,warrior,arms,30,13,17
Lurádin,kargath,1202,warrior,arms,42,18,24
Williamx,archimonde,1202,warrior,arms,60,24,36
Enemywarrior,argent-dawn,1201,warrior,arms,94,51,43
Крахгал,soulflayer,1201,warrior,arms,159,80,79
Pillorrior,ambossar,1201,warrior,arms,30,13,17
Saitäma,burning-legion,1200,warrior,arms,24,14,10
Animaul,dalaran,1200,warrior,arms,43,21,22
Onyi,onyxia,1200,warrior,arms,36,13,23
Thylegorn,argent-dawn,1199,warrior,arms,25,16,9
Ärama,sanguino,1198,warrior,arms,48,26,22
Matrafox,stormscale,1198,warrior,arms,141,66,75
Rayeron,sanguino,1198,warrior,arms,39,16,23
Gnuhl,eredar,1197,warrior,arms,41,21,20
Mozterwar,ravencrest,1197,warrior,arms,66,28,38
Mifuune,argent-dawn,1196,warrior,arms,56,28,28
Välkyries,archimonde,1195,warrior,arms,63,36,27
Nøiir,malfurion,1195,warrior,arms,36,18,18
Mellvorr,malganis,1195,warrior,arms,95,32,63
Nukefun,blackrock,1194,warrior,arms,28,15,13
Berserkpwnz,silvermoon,1194,warrior,arms,60,32,28
Beans,argent-dawn,1194,warrior,arms,127,55,72
Madsizen,ravencrest,1194,warrior,arms,36,14,22
Rèâpèr,kazzak,1193,warrior,arms,42,27,15
Лысыч,gordunni,1193,warrior,arms,35,18,17
Франкенштэйн,borean-tundra,1193,warrior,arms,30,13,17
Vojownik,argent-dawn,1193,warrior,arms,72,31,41
Барикадо,eversong,1193,warrior,arms,42,16,26
Donetenk,silvermoon,1192,warrior,arms,101,48,53
Холипротовар,fordragon,1192,warrior,arms,118,56,62
Medov,outland,1192,warrior,arms,72,34,38
Meslammin,draenor,1192,warrior,arms,96,44,52
Xlings,auchindoun,1192,warrior,arms,128,53,75
Parasite,the-maelstrom,1191,warrior,arms,72,38,34
Kaidewarr,kazzak,1191,warrior,arms,102,52,50
Брокксигарр,borean-tundra,1191,warrior,arms,59,23,36
Waxxo,frostwolf,1190,warrior,arms,41,19,22
Aegís,drakthul,1190,warrior,arms,54,22,32
Wärfäcë,blades-edge,1190,warrior,arms,36,14,22
Xeratis,malganis,1189,warrior,arms,30,16,14
Aesiva,die-aldor,1189,warrior,arms,48,23,25
Kllinac,kazzak,1189,warrior,arms,71,33,38
Marcusk,thunderhorn,1189,warrior,arms,42,16,26
Xensation,kult-der-verdammten,1188,warrior,arms,83,36,47
Rövskunk,silvermoon,1188,warrior,arms,40,13,27
Skatbo,shattered-hand,1187,warrior,arms,55,20,35
Fullkraft,tarren-mill,1186,warrior,arms,139,72,67
Harska,ragnaros,1186,warrior,arms,88,45,43
Ахе,deathguard,1186,warrior,arms,66,32,34
Thunderage,stormscale,1186,warrior,arms,36,16,20
Математик,razuvious,1185,warrior,arms,45,25,20
Kval,kazzak,1185,warrior,arms,30,14,16
Palthor,drakthul,1185,warrior,arms,161,72,89
Pyret,outland,1185,warrior,arms,40,14,26
Originel,outland,1184,warrior,arms,30,14,16
Scrèàm,tarren-mill,1184,warrior,arms,67,29,38
Redow,stormreaver,1184,warrior,arms,114,49,65
Gathika,arathor,1183,warrior,arms,24,14,10
Cowlunderowl,tarren-mill,1183,warrior,arms,50,20,30
Kwesta,kazzak,1182,warrior,arms,23,13,10
Methaniwths,twisting-nether,1182,warrior,arms,162,79,83
Daddycool,haomarush,1182,warrior,arms,118,52,66
Saddoh,outland,1182,warrior,arms,54,19,35
Beserk,defias-brotherhood,1181,warrior,arms,94,58,36
Shinnok,stormreaver,1181,warrior,arms,274,147,127
Neaka,archimonde,1181,warrior,arms,29,13,16
Colosius,stormscale,1180,warrior,arms,96,51,45
Wifioffline,silvermoon,1180,warrior,arms,42,15,27
Ragébar,tarren-mill,1179,warrior,arms,109,50,59
Jólasveinn,saurfang,1179,warrior,arms,30,13,17
Чузен,galakrond,1178,warrior,arms,75,35,40
Дрекзот,howling-fjord,1177,warrior,arms,27,15,12
Audelia,sunstrider,1177,warrior,arms,74,40,34
Дрейтон,eversong,1177,warrior,arms,102,51,51
Lîliana,ysondre,1177,warrior,arms,46,23,23
Radîtz,blackmoore,1177,warrior,arms,32,15,17
Geneazyx,silvermoon,1177,warrior,arms,33,13,20
Ксапур,soulflayer,1177,warrior,arms,62,24,38
Виднокрай,gordunni,1177,warrior,arms,36,13,23
Kalregg,outland,1176,warrior,arms,114,46,68
Warstickz,kazzak,1176,warrior,arms,60,21,39
Tengriy,wildhammer,1175,warrior,arms,32,20,12
Imbakarimbá,blackrock,1175,warrior,arms,47,22,25
Фаталлес,galakrond,1175,warrior,arms,41,17,24
Elyalol,ragnaros,1174,warrior,arms,33,15,18
Ruppydeluxe,frostwolf,1174,warrior,arms,74,27,47
Korvjnus,burning-blade,1173,warrior,arms,180,87,93
Frozenevil,kazzak,1173,warrior,arms,119,57,62
Strânge,gorgonnash,1172,warrior,arms,107,57,50
Donjanna,ravencrest,1172,warrior,arms,54,27,27
Etelä,stormreaver,1172,warrior,arms,37,17,20
Buffettleapx,kazzak,1172,warrior,arms,68,29,39
Wâtchmefear,blackrock,1171,warrior,arms,33,14,19
Jupio,stormscale,1170,warrior,arms,27,15,12
Suolijumppa,stormreaver,1170,warrior,arms,77,37,40
Pwettygal,tarren-mill,1170,warrior,arms,96,46,50
Latta,blackmoore,1170,warrior,arms,30,14,16
Tongsto,outland,1170,warrior,arms,72,31,41
Dödslängtan,terokkar,1169,warrior,arms,64,35,29
Lucciouss,sylvanas,1169,warrior,arms,30,16,14
Elendurel,outland,1169,warrior,arms,100,50,50
Bladestorm,dun-morogh,1169,warrior,arms,35,15,20
Vohok,jaedenar,1169,warrior,arms,75,31,44
Imora,silvermoon,1169,warrior,arms,54,22,32
Index,tarren-mill,1169,warrior,arms,42,16,26
Роккар,gordunni,1168,warrior,arms,42,22,20
Палачубийца,deathguard,1168,warrior,arms,131,68,63
Jonalina,gilneas,1168,warrior,arms,114,57,57
Piedbot,archimonde,1168,warrior,arms,100,43,57
Knownwarrior,antonidas,1168,warrior,arms,45,18,27
Habaneroo,zuljin,1168,warrior,arms,48,17,31
Kriegerkraut,silvermoon,1167,warrior,arms,40,26,14
Остинс,soulflayer,1167,warrior,arms,23,13,10
Arminvilhelm,argent-dawn,1167,warrior,arms,30,14,16
Gëaldýr,kazzak,1167,warrior,arms,114,49,65
Voidteen,argent-dawn,1167,warrior,arms,68,27,41
Whàtsup,stormscale,1166,warrior,arms,36,17,19
Pesroc,blackmoore,1165,warrior,arms,24,15,9
Dreadshanks,doomhammer,1165,warrior,arms,84,50,34
Daguangming,outland,1165,warrior,arms,59,23,36
Rojobull,stormscale,1165,warrior,arms,42,15,27
Shuraj,hyjal,1164,warrior,arms,82,37,45
Sabøtage,aggra-português,1164,warrior,arms,78,31,47
Cramatao,shadowsong,1163,warrior,arms,95,41,54
Warbringer,ravencrest,1163,warrior,arms,42,15,27
Merdé,blackhand,1162,warrior,arms,207,108,99
Zuggizug,draenor,1162,warrior,arms,96,46,50
Экзекутэр,soulflayer,1162,warrior,arms,72,34,38
Garosh,drakthul,1162,warrior,arms,84,39,45
Xamp,madmortem,1161,warrior,arms,26,14,12
Xaena,archimonde,1161,warrior,arms,48,22,26
Lø,chogall,1161,warrior,arms,107,48,59
Малграш,goldrinn,1161,warrior,arms,127,53,74
Gallaghër,ysondre,1160,warrior,arms,64,33,31
Epepseyer,sanguino,1160,warrior,arms,83,38,45
Rühlsbester,thrall,1160,warrior,arms,101,46,55
Gilgarez,twisting-nether,1160,warrior,arms,42,15,27
Dolforden,burning-legion,1159,warrior,arms,35,13,22
Lithanør,silvermoon,1159,warrior,arms,38,13,25
Helenius,ravencrest,1159,warrior,arms,48,16,32
Happynoobs,silvermoon,1159,warrior,arms,48,16,32
Пифс,soulflayer,1158,warrior,arms,97,52,45
Agamemnon,frostmane,1158,warrior,arms,68,31,37
Kenzai,aegwynn,1158,warrior,arms,31,13,18
Иалаи,howling-fjord,1156,warrior,arms,38,21,17
Sudosolo,burning-blade,1156,warrior,arms,174,85,89
Gakosh,sanguino,1155,warrior,arms,66,33,33
Zargala,stormscale,1155,warrior,arms,30,14,16
Элейд,thermaplugg,1153,warrior,arms,53,23,30
Devìlscandy,stormscale,1152,warrior,arms,18,12,6
Fknslow,ravencrest,1152,warrior,arms,18,12,6
Bulfwart,zuljin,1152,warrior,arms,18,12,6
Ordínaryname,blackrock,1152,warrior,arms,646,327,319
Porsea,ravencrest,1152,warrior,arms,24,12,12
Omnity,stormscale,1152,warrior,arms,24,12,12
Uselessblâme,archimonde,1152,warrior,arms,24,12,12
Chilp,archimonde,1152,warrior,arms,79,32,47
Raizø,aegwynn,1152,warrior,arms,67,26,41
Schero,aegwynn,1151,warrior,arms,18,12,6
Brinkorf,silvermoon,1151,warrior,arms,24,12,12
Frankstyle,sanguino,1151,warrior,arms,45,20,25
Smèdbérg,ravencrest,1151,warrior,arms,30,12,18
Pikemiwarr,sanguino,1150,warrior,arms,18,12,6
Wutraa,kazzak,1150,warrior,arms,18,12,6
Exorcisten,silvermoon,1150,warrior,arms,18,12,6
Tëc,silvermoon,1150,warrior,arms,42,22,20
Enzylolz,sanguino,1150,warrior,arms,24,12,12
Crazykind,kazzak,1150,warrior,arms,24,12,12
Zidbi,argent-dawn,1150,warrior,arms,24,12,12
Panzerpung,outland,1150,warrior,arms,36,12,24
Crushonyou,aegwynn,1149,warrior,arms,24,12,12
Raivorouva,stormreaver,1149,warrior,arms,42,19,23
Ovcharq,steamwheedle-cartel,1149,warrior,arms,112,49,63
Laakes,eredar,1149,warrior,arms,36,12,24
Тактоядобрый,ashenvale,1148,warrior,arms,18,12,6
Goretterog,ysondre,1148,warrior,arms,24,12,12
Noisey,sanguino,1148,warrior,arms,24,12,12
Халльборн,howling-fjord,1148,warrior,arms,30,12,18
Chillycheesy,blackmoore,1148,warrior,arms,42,12,30
Zwerk,rajaxx,1147,warrior,arms,24,12,12
Пасасайка,galakrond,1147,warrior,arms,30,12,18
Zlotjko,ravencrest,1147,warrior,arms,30,12,18
Trenbolonpap,twisting-nether,1146,warrior,arms,18,12,6
Draemmer,minahonda,1146,warrior,arms,30,15,15
Senshin,sanguino,1146,warrior,arms,24,12,12
Graumann,dun-morogh,1146,warrior,arms,28,13,15
Vagor,draenor,1146,warrior,arms,94,42,52
Stillpetao,dun-modr,1146,warrior,arms,36,12,24
Rieku,kazzak,1146,warrior,arms,36,12,24
Voltrim,blackmoore,1145,warrior,arms,86,43,43
Nodance,doomhammer,1145,warrior,arms,46,23,23
Warbigboss,draenor,1145,warrior,arms,24,12,12
Ванмак,gordunni,1145,warrior,arms,107,51,56
Ezop,burning-blade,1145,warrior,arms,30,12,18
Slappcuzz,blackrock,1145,warrior,arms,30,12,18
Тонкрик,goldrinn,1144,warrior,arms,42,22,20
Zugzugsmash,thrall,1144,warrior,arms,24,12,12
Kirzan,silvermoon,1144,warrior,arms,24,12,12
Warriovar,draenor,1144,warrior,arms,24,12,12
Mañtís,argent-dawn,1144,warrior,arms,86,42,44
Nélow,khaz-modan,1144,warrior,arms,60,29,31
Hammerfall,uldum,1144,warrior,arms,90,42,48
Teoggr,kazzak,1144,warrior,arms,30,13,17
Jäime,dun-modr,1144,warrior,arms,40,17,23
Parriwarr,sanguino,1144,warrior,arms,60,24,36
Warristyles,arygos,1144,warrior,arms,30,12,18
Davyj,silvermoon,1144,warrior,arms,31,12,19
Smashu,outland,1143,warrior,arms,18,12,6
Karnacîer,archimonde,1143,warrior,arms,30,19,11
Poör,silvermoon,1143,warrior,arms,42,23,19
Tbomb,stormscale,1142,warrior,arms,24,12,12
Bulduzer,kazzak,1142,warrior,arms,149,66,83
Kurzen,voljin,1142,warrior,arms,65,28,37
Monsterborn,bloodhoof,1142,warrior,arms,39,15,24
Freestýlz,archimonde,1141,warrior,arms,18,13,5
Carnaí,tarren-mill,1141,warrior,arms,22,13,9
Nurychïc,twisting-nether,1141,warrior,arms,75,37,38
Yolal,twisting-nether,1141,warrior,arms,165,75,90
Bolvarson,malganis,1141,warrior,arms,36,12,24
Syhtis,hyjal,1140,warrior,arms,24,13,11
Themasterlen,nordrassil,1140,warrior,arms,65,32,33
Alphachadwar,azjolnerub,1140,warrior,arms,30,12,18
Gnomekek,sylvanas,1140,warrior,arms,36,12,24
Björnd,hyjal,1140,warrior,arms,42,12,30
Warriortimi,blackhand,1139,warrior,arms,24,12,12
Abelgf,exodar,1139,warrior,arms,44,18,26
Utero,drakthul,1139,warrior,arms,30,12,18
Realstars,tichondrius,1139,warrior,arms,33,13,20
Бланкк,deathweaver,1138,warrior,arms,49,30,19
Lanïmal,eitrigg,1138,warrior,arms,27,15,12
Vrii,eredar,1138,warrior,arms,41,22,19
Kilsera,blackmoore,1137,warrior,arms,42,22,20
Lucasqt,magtheridon,1137,warrior,arms,24,12,12
Альмас,galakrond,1137,warrior,arms,28,13,15
Jimli,malygos,1137,warrior,arms,30,12,18
Димаджер,razuvious,1136,warrior,arms,30,16,14
Maelvos,ravencrest,1136,warrior,arms,72,37,35
Príde,kilrogg,1136,warrior,arms,112,49,63
Rìght,kazzak,1135,warrior,arms,25,16,9
Vlader,dun-modr,1135,warrior,arms,206,94,112
Юигама,gordunni,1134,warrior,arms,25,13,12
Unstorm,drakthul,1134,warrior,arms,48,13,35
Weedshoter,burning-legion,1133,warrior,arms,18,12,6
Titanhaut,frostwolf,1133,warrior,arms,40,21,19
Xyum,pozzo-delleternità,1133,warrior,arms,149,78,71
Dreamkil,archimonde,1133,warrior,arms,252,123,129
Goldenward,silvermoon,1133,warrior,arms,71,33,38
Vandnox,nozdormu,1133,warrior,arms,28,13,15
Cloudstomper,ravenholdt,1133,warrior,arms,70,31,39
Някитила,gordunni,1133,warrior,arms,67,28,39
Halsandre,hyjal,1133,warrior,arms,77,31,46
Despacitus,burning-legion,1133,warrior,arms,77,29,48
Киефси,howling-fjord,1131,warrior,arms,114,59,55
Obscurìa,argent-dawn,1131,warrior,arms,586,288,298
Quarantino,ysondre,1131,warrior,arms,116,53,63
Clemmins,deathwing,1131,warrior,arms,65,24,41
Азероф,gordunni,1130,warrior,arms,18,12,6
Bangbros,archimonde,1130,warrior,arms,24,13,11
Tajiri,alakir,1130,warrior,arms,87,44,43
Zogyall,ysondre,1130,warrior,arms,66,29,37
Razt,bronze-dragonflight,1129,warrior,arms,24,12,12
Indiannaa,draenor,1129,warrior,arms,28,13,15
Warzy,eredar,1129,warrior,arms,66,29,37
Tycho,exodar,1129,warrior,arms,30,12,18
Klyvern,ragnaros,1129,warrior,arms,60,20,40
Battall,ysondre,1128,warrior,arms,54,30,24
Hietfield,twisting-nether,1128,warrior,arms,24,12,12
Онлихелл,howling-fjord,1128,warrior,arms,118,54,64
Brahlus,frostwolf,1128,warrior,arms,61,25,36
Gnomzilla,blackhand,1127,warrior,arms,48,16,32
Katyparry,ragnaros,1127,warrior,arms,36,12,24
Director,aegwynn,1124,warrior,arms,24,14,10
Oralinde,silvermoon,1124,warrior,arms,178,95,83
Милославский,gordunni,1124,warrior,arms,82,42,40
Midgardsormr,blackrock,1124,warrior,arms,89,42,47
Xxoorrwarr,tarren-mill,1123,warrior,arms,47,25,22
Dísplacement,draenor,1123,warrior,arms,24,12,12
Алибастор,galakrond,1123,warrior,arms,105,51,54
Gladiattus,drakthul,1121,warrior,arms,84,42,42
Yüle,uldaman,1121,warrior,arms,30,15,15
Fairly,burning-blade,1121,warrior,arms,30,14,16
Minetaur,burning-legion,1121,warrior,arms,30,12,18
Догерон,grom,1120,warrior,arms,36,20,16
Brùtus,exodar,1120,warrior,arms,30,16,14
Mistawolf,ravencrest,1120,warrior,arms,87,36,51
Sway,eonar,1118,warrior,arms,156,72,84
Bennybryt,frostmane,1117,warrior,arms,23,12,11
Thiccrich,argent-dawn,1117,warrior,arms,48,25,23
Karden,doomhammer,1117,warrior,arms,104,44,60
Creezê,blackmoore,1117,warrior,arms,30,12,18
Draktul,aegwynn,1116,warrior,arms,24,14,10
Мутобой,soulflayer,1116,warrior,arms,82,37,45
Cliwar,ragnaros,1115,warrior,arms,58,35,23
Brisky,tarren-mill,1115,warrior,arms,30,13,17
Piixxz,hyjal,1114,warrior,arms,30,16,14
Truxiw,silvermoon,1114,warrior,arms,60,28,32
Darkchao,madmortem,1114,warrior,arms,26,12,14
Opseagull,defias-brotherhood,1114,warrior,arms,57,25,32
Cremas,cthun,1114,warrior,arms,96,37,59
Ельмара,gordunni,1113,warrior,arms,37,16,21
Hojalator,minahonda,1112,warrior,arms,28,13,15
Orcaz,eredar,1112,warrior,arms,52,23,29
Djiozz,khaz-modan,1111,warrior,arms,36,12,24
Muetzchen,blackhand,1110,warrior,arms,60,31,29
Ayatolah,kazzak,1110,warrior,arms,59,30,29
Мошер,fordragon,1110,warrior,arms,24,12,12
Вениамин,fordragon,1110,warrior,arms,38,14,24
Sandalwood,wildhammer,1109,warrior,arms,39,18,21
Белриэль,gordunni,1109,warrior,arms,72,25,47
Sûgma,blackhand,1108,warrior,arms,44,23,21
Górut,zuljin,1108,warrior,arms,90,40,50
Pips,minahonda,1108,warrior,arms,54,20,34
Agitoyami,defias-brotherhood,1106,warrior,arms,48,22,26
Rugal,dragonmaw,1106,warrior,arms,35,15,20
Slambadicoot,draenor,1106,warrior,arms,72,24,48
Боевыещёчки,eversong,1105,warrior,arms,34,16,18
Turmund,turalyon,1105,warrior,arms,48,18,30
Quiño,sanguino,1104,warrior,arms,24,12,12
Claytøn,khaz-modan,1104,warrior,arms,85,38,47
Wørgenn,hyjal,1104,warrior,arms,62,25,37
Payßack,drakthul,1104,warrior,arms,30,12,18
Casty,blackrock,1103,warrior,arms,23,12,11
Gunka,tarren-mill,1103,warrior,arms,191,95,96
Дэйст,ashenvale,1102,warrior,arms,62,31,31
Миранир,soulflayer,1102,warrior,arms,62,30,32
Ironsteve,blackmoore,1102,warrior,arms,546,260,286
Pappkopf,rexxar,1102,warrior,arms,36,17,19
Røiivar,hyjal,1102,warrior,arms,169,74,95
Рф,thermaplugg,1102,warrior,arms,32,13,19
Córswain,silvermoon,1102,warrior,arms,42,17,25
Керсантус,gordunni,1101,warrior,arms,17,12,5
Джейимсбонд,soulflayer,1101,warrior,arms,33,16,17
Корофер,galakrond,1100,warrior,arms,47,27,20
Доминатори,grom,1100,warrior,arms,55,21,34
Ceb,drakthul,1100,warrior,arms,78,29,49
Sloppychoppy,silvermoon,1099,warrior,arms,71,32,39
Bobbi,gilneas,1099,warrior,arms,102,44,58
Rutrah,ysondre,1099,warrior,arms,30,12,18
Tiopollo,sanguino,1099,warrior,arms,30,12,18
Justawarrior,twisting-nether,1098,warrior,arms,56,21,35
Serakhan,argent-dawn,1097,warrior,arms,168,86,82
Crixusxx,sanguino,1096,warrior,arms,25,13,12
Ugbruk,blackhand,1095,warrior,arms,69,35,34
Fdmachine,kazzak,1095,warrior,arms,48,21,27
Набосуюногу,gordunni,1095,warrior,arms,29,12,17
Kugghalfswor,doomhammer,1094,warrior,arms,418,201,217
Vannié,blackhand,1094,warrior,arms,32,14,18
Thok,blades-edge,1093,warrior,arms,72,32,40
Варка,gordunni,1093,warrior,arms,30,12,18
Magrintor,blackmoore,1091,warrior,arms,49,29,20
Crasher,dentarg,1091,warrior,arms,42,21,21
Копенгаген,ashenvale,1091,warrior,arms,33,13,20
Ñoxpløde,tarren-mill,1090,warrior,arms,23,13,10
Дикийлёха,soulflayer,1090,warrior,arms,42,22,20
Артэгиусх,blackscar,1090,warrior,arms,108,55,53
Xerkohs,thrall,1090,warrior,arms,41,18,23
Nakroll,sanguino,1090,warrior,arms,42,17,25
Bäru,ysondre,1087,warrior,arms,42,22,20
Joesalamanca,ragnaros,1086,warrior,arms,48,21,27
Katmai,nemesis,1085,warrior,arms,30,14,16
Bitethedust,darkspear,1085,warrior,arms,48,14,34
Willraxx,draenor,1084,warrior,arms,48,15,33
Бежа,gordunni,1083,warrior,arms,66,37,29
Крешер,howling-fjord,1082,warrior,arms,136,60,76
Hulkkis,outland,1082,warrior,arms,56,19,37
Ezsnacks,blackrock,1081,warrior,arms,110,56,54
Erenowski,twisting-nether,1080,warrior,arms,37,23,14
Scartle,dun-modr,1080,warrior,arms,165,77,88
Ushio,darkmoon-faire,1079,warrior,arms,23,12,11
Zarani,antonidas,1078,warrior,arms,36,13,23
Ianez,nemesis,1077,warrior,arms,83,37,46
Inticam,durotan,1076,warrior,arms,67,35,32
Stuble,blackhand,1076,warrior,arms,41,19,22
Jebzmiecza,kazzak,1075,warrior,arms,30,13,17
Blufurys,nemesis,1073,warrior,arms,86,41,45
Безбожник,eversong,1073,warrior,arms,171,79,92
Ziñs,silvermoon,1072,warrior,arms,28,13,15
Auriwariah,silvermoon,1072,warrior,arms,67,29,38
Fatbeard,twilights-hammer,1072,warrior,arms,72,31,41
Джагенвард,soulflayer,1071,warrior,arms,100,50,50
Jackisop,outland,1071,warrior,arms,60,26,34
Salom,illidan,1069,warrior,arms,84,34,50
Crook,doomhammer,1069,warrior,arms,141,57,84
Tobigforu,draenor,1068,warrior,arms,57,28,29
Láviana,aegwynn,1066,warrior,arms,52,25,27
Wrtxnexor,blackhand,1066,warrior,arms,46,21,25
Prime,outland,1066,warrior,arms,34,12,22
Отпустите,howling-fjord,1066,warrior,arms,37,12,25
Manymen,outland,1065,warrior,arms,119,58,61
Verany,antonidas,1065,warrior,arms,32,13,19
Varzeluu,sylvanas,1063,warrior,arms,69,29,40
Smásher,thrall,1063,warrior,arms,37,14,23
Gormac,ragnaros,1062,warrior,arms,22,12,10
Thebiggreen,twisting-nether,1062,warrior,arms,25,12,13
Koliastra,magtheridon,1062,warrior,arms,87,41,46
Keksparrow,antonidas,1061,warrior,arms,48,22,26
Donedone,blackrock,1061,warrior,arms,42,16,26
Katzz,dun-morogh,1061,warrior,arms,44,15,29
Глинм,gordunni,1060,warrior,arms,243,115,128
Davoda,kazzak,1059,warrior,arms,30,17,13
Kundan,antonidas,1059,warrior,arms,89,46,43
Jimbock,eredar,1059,warrior,arms,43,16,27
Haipaz,draenor,1058,warrior,arms,94,46,48
Ttz,tarren-mill,1057,warrior,arms,74,34,40
Oxascand,kazzak,1057,warrior,arms,53,18,35
Рексторм,soulflayer,1056,warrior,arms,12,11,1
Sufentaniili,frostwhisper,1056,warrior,arms,12,11,1
Dzahboss,archimonde,1056,warrior,arms,18,11,7
Cmonbrah,ravencrest,1056,warrior,arms,18,11,7
Mâlitek,archimonde,1056,warrior,arms,18,11,7
Mahomes,ravencrest,1056,warrior,arms,18,11,7
Scheroh,aegwynn,1056,warrior,arms,24,11,13
Proffsét,ravencrest,1056,warrior,arms,24,11,13
Proeliator,argent-dawn,1056,warrior,arms,24,11,13
Кросвуд,gordunni,1056,warrior,arms,24,11,13
Гатсх,blackscar,1056,warrior,arms,24,11,13
Määh,frostmane,1056,warrior,arms,30,11,19
Kalym,malygos,1055,warrior,arms,18,11,7
Jayus,stormrage,1055,warrior,arms,18,11,7
Krâgx,kazzak,1055,warrior,arms,18,11,7
Achsin,eredar,1055,warrior,arms,87,43,44
Pedergun,defias-brotherhood,1055,warrior,arms,53,25,28
Chipstjuven,tarren-mill,1055,warrior,arms,37,17,20
Kehnan,blackrock,1055,warrior,arms,24,11,13
Khvor,blackmoore,1055,warrior,arms,24,11,13
Xdpromtius,dun-modr,1055,warrior,arms,24,11,13
Bikgusdickus,drakthul,1055,warrior,arms,24,11,13
Лимор,howling-fjord,1055,warrior,arms,24,11,13
Doritoslove,sanguino,1055,warrior,arms,24,11,13
Амаззони,howling-fjord,1055,warrior,arms,24,11,13
Quotxwar,stormscale,1055,warrior,arms,24,11,13
Luxurious,argent-dawn,1055,warrior,arms,33,12,21
Tiimbs,tarren-mill,1054,warrior,arms,18,11,7
Lænet,twisting-nether,1054,warrior,arms,149,75,74
Bonkors,bronzebeard,1054,warrior,arms,24,11,13
Fruitstick,tarren-mill,1054,warrior,arms,24,11,13
Tromka,stormscale,1054,warrior,arms,24,11,13
Râmi,perenolde,1054,warrior,arms,24,11,13
Doomz,die-aldor,1054,warrior,arms,24,11,13
Фастод,greymane,1054,warrior,arms,90,40,50
Gramash,grim-batol,1054,warrior,arms,58,25,33
Kzagan,outland,1054,warrior,arms,30,11,19
Apollos,der-mithrilorden,1054,warrior,arms,30,11,19
Orcenjoyer,kazzak,1054,warrior,arms,30,11,19
Himarsenko,silvermoon,1053,warrior,arms,24,11,13
Синглдем,gordunni,1053,warrior,arms,24,11,13
Swàck,mazrigos,1053,warrior,arms,24,11,13
Skaylulz,ragnaros,1053,warrior,arms,24,11,13
Besån,ragnaros,1053,warrior,arms,25,11,14
Bassenheim,deathwing,1053,warrior,arms,30,12,18
Khoroc,die-aldor,1053,warrior,arms,30,11,19
Scusi,burning-blade,1053,warrior,arms,30,11,19
Salamandar,zenedar,1053,warrior,arms,36,11,25
Arhzag,garona,1052,warrior,arms,30,14,16
Scràvity,blackhand,1052,warrior,arms,24,11,13
Polak,tirion,1052,warrior,arms,24,11,13
Arenatogo,blackmoore,1052,warrior,arms,24,11,13
Nejd,alakir,1052,warrior,arms,37,16,21
Таккураги,blackscar,1051,warrior,arms,24,11,13
Âxti,blackrock,1050,warrior,arms,24,11,13
Hjondon,argent-dawn,1049,warrior,arms,24,11,13
Råín,stormscale,1049,warrior,arms,29,13,16
Borion,blackmoore,1049,warrior,arms,36,11,25
Dexter,outland,1048,warrior,arms,18,11,7
ßílly,defias-brotherhood,1048,warrior,arms,24,11,13
Jacktorrance,nemesis,1048,warrior,arms,31,13,18
Câttiva,blackmoore,1048,warrior,arms,30,11,19
Обиванкенобя,soulflayer,1048,warrior,arms,66,24,42
Icyelk,silvermoon,1047,warrior,arms,18,11,7
Dragoncry,rexxar,1047,warrior,arms,18,11,7
Knegt,stormreaver,1047,warrior,arms,109,52,57
Каррагор,howling-fjord,1047,warrior,arms,24,11,13
Lebronjones,sylvanas,1047,warrior,arms,153,68,85
Diliul,doomhammer,1047,warrior,arms,52,23,29
Mokthal,medivh,1047,warrior,arms,29,12,17
Clukao,kazzak,1047,warrior,arms,30,11,19
Supersonîc,aegwynn,1046,warrior,arms,24,11,13
Тевивар,gordunni,1046,warrior,arms,24,11,13
Bravestarrz,ungoro,1046,warrior,arms,30,11,19
Velikan,tarren-mill,1046,warrior,arms,30,11,19
Тэсхард,blackscar,1045,warrior,arms,60,37,23
Trondilon,tarren-mill,1045,warrior,arms,23,11,12
Wilæm,ravencrest,1045,warrior,arms,36,17,19
Roponmatsu,draenor,1045,warrior,arms,24,11,13
Ninja,bronze-dragonflight,1045,warrior,arms,24,11,13
Coko,kirin-tor,1045,warrior,arms,30,11,19
Neoh,onyxia,1044,warrior,arms,93,47,46
Lippir,stormrage,1044,warrior,arms,24,11,13
Tuskyr,silvermoon,1044,warrior,arms,30,11,19
Masster,argent-dawn,1043,warrior,arms,18,11,7
Uwuaraqtlol,stormscale,1043,warrior,arms,22,12,10
Тычо,soulflayer,1043,warrior,arms,78,36,42
Opwarrko,drakthul,1043,warrior,arms,24,11,13
Nocturia,archimonde,1043,warrior,arms,30,11,19
Buullz,twisting-nether,1042,warrior,arms,39,20,19
Satanås,silvermoon,1042,warrior,arms,185,91,94
Difalco,archimonde,1042,warrior,arms,152,74,78
Spaiché,azshara,1042,warrior,arms,24,11,13
Gpointt,lordaeron,1042,warrior,arms,60,22,38
Тралмош,razuvious,1042,warrior,arms,30,11,19
Kirkwood,terokkar,1041,warrior,arms,30,18,12
Зед,blackscar,1041,warrior,arms,37,20,17
Altroox,malorne,1041,warrior,arms,24,11,13
Эсканорд,gordunni,1041,warrior,arms,96,43,53
Karng,zenedar,1041,warrior,arms,122,54,68
Chocoroko,draenor,1040,warrior,arms,66,30,36
Innos,gorgonnash,1040,warrior,arms,29,13,16
Heavenheart,bronzebeard,1039,warrior,arms,28,19,9
Stweye,frostmane,1038,warrior,arms,24,11,13
Nokturnâl,silvermoon,1037,warrior,arms,18,11,7
Noomel,twisting-nether,1037,warrior,arms,168,82,86
Ехасе,gordunni,1037,warrior,arms,52,24,28
Gutworm,stormscale,1037,warrior,arms,24,11,13
Mæuzl,draenor,1036,warrior,arms,24,11,13
Stampsalot,deathwing,1036,warrior,arms,24,11,13
Koorkhan,outland,1036,warrior,arms,24,11,13
Wärlør,ravencrest,1036,warrior,arms,34,14,20
Endermite,magtheridon,1035,warrior,arms,65,28,37
Havooc,ragnaros,1034,warrior,arms,18,11,7
Skeleton,los-errantes,1034,warrior,arms,70,32,38
Бенчмаркпоу,gordunni,1034,warrior,arms,29,13,16
Schoolbus,outland,1034,warrior,arms,29,12,17
Whitebêârd,antonidas,1033,warrior,arms,71,30,41
Лаврентии,soulflayer,1032,warrior,arms,48,15,33
Raldjorn,hyjal,1031,warrior,arms,30,16,14
Kydecnick,kazzak,1031,warrior,arms,130,52,78
Teñseî,archimonde,1030,warrior,arms,18,11,7
Meeyu,blackhand,1029,warrior,arms,18,11,7
Brvbert,antonidas,1029,warrior,arms,24,11,13
Kante,frostmane,1029,warrior,arms,24,11,13
Elaniâ,die-nachtwache,1029,warrior,arms,24,11,13
Troncodepino,nemesis,1028,warrior,arms,42,14,28
Tochka,kazzak,1028,warrior,arms,76,25,51
Smaxi,kazzak,1027,warrior,arms,30,11,19
Chatoon,elune,1025,warrior,arms,69,37,32
Larkor,frostwolf,1025,warrior,arms,94,40,54
Крохвар,gordunni,1025,warrior,arms,66,27,39
Rastaboo,ravencrest,1024,warrior,arms,24,11,13
Krostapunk,colinas-pardas,1024,warrior,arms,42,15,27
Panickill,ravencrest,1022,warrior,arms,24,11,13
Acestrike,defias-brotherhood,1021,warrior,arms,18,11,7
Mótleycrüe,sanguino,1021,warrior,arms,24,12,12
Shinydjuwlz,turalyon,1021,warrior,arms,36,17,19
Соплезоид,howling-fjord,1021,warrior,arms,26,12,14
Ronflatter,blackrock,1021,warrior,arms,60,20,40
Matthaeos,nemesis,1019,warrior,arms,17,13,4
Olagkhan,minahonda,1019,warrior,arms,25,14,11
Бравурный,gordunni,1019,warrior,arms,48,19,29
Áosr,ravencrest,1018,warrior,arms,88,43,45
Клавиатурный,soulflayer,1018,warrior,arms,29,11,18
Ironfists,kilrogg,1017,warrior,arms,24,11,13
Ruga,echsenkessel,1016,warrior,arms,143,73,70
Явперед,soulflayer,1014,warrior,arms,24,11,13
Loddels,frostwolf,1013,warrior,arms,61,33,28
Rîchy,blackrock,1013,warrior,arms,28,15,13
Dübèl,blackrock,1012,warrior,arms,70,33,37
Chrisred,dun-modr,1010,warrior,arms,33,20,13
Owarr,grim-batol,1010,warrior,arms,24,13,11
Etharedon,kul-tiras,1007,warrior,arms,142,62,80
Uclat,archimonde,1007,warrior,arms,125,54,71
Tanoras,kazzak,1006,warrior,arms,23,11,12
Kolgrimor,blackhand,1006,warrior,arms,30,14,16
Sanhaevel,ravencrest,1006,warrior,arms,50,23,27
Falcowar,minahonda,1006,warrior,arms,24,11,13
Smkw,kazzak,1004,warrior,arms,56,32,24
Antraex,zuljin,1004,warrior,arms,30,13,17
Rajaka,archimonde,1003,warrior,arms,30,15,15
Xturn,aegwynn,1003,warrior,arms,37,12,25
Ezjau,blackmoore,1002,warrior,arms,120,61,59
Athérøs,outland,1002,warrior,arms,29,11,18
Gatlok,kazzak,1001,warrior,arms,24,11,13
Nêithan,dun-modr,1001,warrior,arms,42,16,26
Dénis,onyxia,1000,warrior,arms,30,15,15
Khuzz,hyjal,1000,warrior,arms,28,11,17
Badazz,thunderhorn,999,warrior,arms,30,12,18
Kvanyrius,archimonde,999,warrior,arms,42,13,29
Ziyetin,blackmoore,998,warrior,arms,24,11,13
Seraphys,ravencrest,998,warrior,arms,28,12,16
Pmk,pozzo-delleternità,998,warrior,arms,76,30,46
Tercio,exodar,997,warrior,arms,171,78,93
Ethem,twisting-nether,995,warrior,arms,259,133,126
Boek,drakthul,995,warrior,arms,38,12,26
Mentalysane,outland,994,warrior,arms,32,12,20
Bulgan,thrall,994,warrior,arms,45,11,34
Roninwar,the-maelstrom,993,warrior,arms,64,32,32
Sangarane,archimonde,992,warrior,arms,63,36,27
Dêrion,blackmoore,992,warrior,arms,25,12,13
Executioner,ravencrest,992,warrior,arms,54,20,34
Thoròk,antonidas,991,warrior,arms,48,20,28
Gvngx,zuljin,991,warrior,arms,89,30,59
Sepsys,eredar,991,warrior,arms,48,15,33
Joka,dun-modr,990,warrior,arms,88,37,51
Skarnir,blackhand,990,warrior,arms,59,20,39
Serpeiro,ravencrest,990,warrior,arms,34,11,23
Deasyo,thrall,990,warrior,arms,36,11,25
Dazed,kazzak,989,warrior,arms,32,17,15
Медэвил,deepholm,989,warrior,arms,48,23,25
Wfx,kazzak,989,warrior,arms,23,11,12
Knotteddickk,teldrassil,989,warrior,arms,23,11,12
Strengjahz,ragnaros,988,warrior,arms,22,11,11
Фурозинка,deepholm,988,warrior,arms,35,11,24
Ätreides,sanguino,985,warrior,arms,29,11,18
Remylacroix,blackrock,984,warrior,arms,22,11,11
Narki,sporeggar,984,warrior,arms,96,43,53
Dattebane,silvermoon,984,warrior,arms,49,19,30
Ragnarr,ravencrest,982,warrior,arms,28,11,17
Dearmooses,stormscale,980,warrior,arms,48,26,22
Бачус,eversong,979,warrior,arms,30,11,19
Stonemasson,doomhammer,978,warrior,arms,35,19,16
Lazaza,tarren-mill,975,warrior,arms,79,26,53
Brindzema,doomhammer,973,warrior,arms,54,30,24
Thewitcher,stormscale,973,warrior,arms,30,11,19
Fknmoo,kazzak,971,warrior,arms,62,31,31
Elbarbaguti,silvermoon,970,warrior,arms,29,11,18
Scill,silvermoon,969,warrior,arms,103,47,56
Warsky,archimonde,968,warrior,arms,42,24,18
Smaugman,nemesis,968,warrior,arms,136,62,74
Dj,ragnaros,966,warrior,arms,38,20,18
Dariusvolt,argent-dawn,965,warrior,arms,71,34,37
Mangore,tyrande,964,warrior,arms,104,48,56
Orcil,terenas,964,warrior,arms,24,11,13
Chépérøs,kaelthas,964,warrior,arms,112,46,66
Executeme,sylvanas,961,warrior,arms,36,18,18
Wintertimex,stormscale,960,warrior,arms,12,10,2
Keanew,tarren-mill,960,warrior,arms,12,10,2
Bigschnäbi,blackhand,960,warrior,arms,12,10,2
Ryonâgai,aegwynn,960,warrior,arms,18,10,8
Jà,kazzak,960,warrior,arms,18,10,8
Phalekxox,twisting-nether,960,warrior,arms,18,10,8
Joelopes,archimonde,960,warrior,arms,18,10,8
Milant,antonidas,960,warrior,arms,18,10,8
Oneoneseven,archimonde,960,warrior,arms,18,10,8
Solatika,alexstrasza,960,warrior,arms,243,116,127
Andabad,silvermoon,960,warrior,arms,24,10,14
Repó,twisting-nether,960,warrior,arms,24,10,14
Реклэсс,blackscar,960,warrior,arms,24,10,14
Dvigar,drakthul,960,warrior,arms,24,10,14
Téarz,blackrock,960,warrior,arms,89,35,54
Îwar,ysondre,960,warrior,arms,114,44,70
Sereiz,tarren-mill,960,warrior,arms,30,10,20
Sindrener,ysondre,960,warrior,arms,30,10,20
Axxtm,ravencrest,959,warrior,arms,18,10,8
Кэмптон,soulflayer,959,warrior,arms,18,10,8
Raul,ravencrest,959,warrior,arms,18,10,8
Chadgrave,argent-dawn,959,warrior,arms,18,10,8
Fearmedear,sylvanas,959,warrior,arms,18,10,8
Dulex,draenor,959,warrior,arms,18,10,8
Сарамортал,howling-fjord,959,warrior,arms,18,10,8
Ânhur,blackmoore,959,warrior,arms,18,10,8
Zdi,blackrock,959,warrior,arms,18,10,8
Bíanco,blackrock,959,warrior,arms,18,10,8
Trushk,antonidas,959,warrior,arms,18,10,8
Renatoma,stormscale,959,warrior,arms,21,10,11
Bizzey,aegwynn,959,warrior,arms,24,10,14
Груббоб,booty-bay,959,warrior,arms,24,10,14
Boonur,arthas,959,warrior,arms,24,10,14
Deackinw,kazzak,959,warrior,arms,24,10,14
Gór,area-52,959,warrior,arms,24,10,14
Легендор,howling-fjord,959,warrior,arms,24,10,14
Silencxý,blackrock,959,warrior,arms,24,10,14
Warhero,burning-legion,959,warrior,arms,24,10,14
Ironhulk,blackrock,959,warrior,arms,24,10,14
Pioneer,blackhand,959,warrior,arms,24,10,14
Necrio,kazzak,959,warrior,arms,24,10,14
Carksn,blackmoore,959,warrior,arms,28,11,17
Реззи,deathweaver,959,warrior,arms,30,10,20
Péridotruite,hyjal,959,warrior,arms,30,10,20
Chrowley,antonidas,959,warrior,arms,70,23,47
Garou,uldum,958,warrior,arms,12,10,2
Braindeady,burning-legion,958,warrior,arms,18,10,8
Shorrag,outland,958,warrior,arms,18,10,8
Gorlemar,blackmoore,958,warrior,arms,18,10,8
Majestatix,doomhammer,958,warrior,arms,18,10,8
Xilquib,darksorrow,958,warrior,arms,18,10,8
Darlith,azshara,958,warrior,arms,18,10,8
Zeekar,ravencrest,958,warrior,arms,18,10,8
Betonica,burning-legion,958,warrior,arms,18,10,8
Hyogan,malganis,958,warrior,arms,18,10,8
Khélian,nemesis,958,warrior,arms,18,10,8
Воинточкару,gordunni,958,warrior,arms,18,10,8
Bavet,sylvanas,958,warrior,arms,25,11,14
Onidrake,nemesis,958,warrior,arms,24,10,14
Qwaggie,draenor,958,warrior,arms,24,10,14
Aestl,blackhand,958,warrior,arms,24,10,14
ßbç,ysondre,958,warrior,arms,24,10,14
Uthric,azuremyst,958,warrior,arms,24,10,14
Sezomih,outland,958,warrior,arms,25,10,15
Glevran,turalyon,958,warrior,arms,30,11,19
Aauv,twisting-nether,958,warrior,arms,30,10,20
Rowr,argent-dawn,958,warrior,arms,30,10,20
Bânkai,aegwynn,958,warrior,arms,30,10,20
Ølolo,stormscale,957,warrior,arms,15,11,4
Qvicfrito,ravencrest,957,warrior,arms,18,10,8
Bèrserkir,tarren-mill,957,warrior,arms,18,10,8
Zevlovéx,kazzak,957,warrior,arms,18,10,8
Neíd,antonidas,957,warrior,arms,18,10,8
Discotrosan,outland,957,warrior,arms,79,34,45
Волдунер,gordunni,957,warrior,arms,24,10,14
Zamorák,twisting-nether,957,warrior,arms,24,10,14
Iuliaa,ravencrest,957,warrior,arms,24,10,14
Topozugzug,tarren-mill,957,warrior,arms,30,10,20
Sanguìnius,nemesis,957,warrior,arms,30,10,20
Pílot,ravencrest,956,warrior,arms,18,10,8
Anndersen,defias-brotherhood,956,warrior,arms,18,10,8
Berzker,ragnaros,956,warrior,arms,18,10,8
Огра,blackscar,956,warrior,arms,18,10,8
Roshas,twisting-nether,956,warrior,arms,18,10,8
Nadelicious,kazzak,956,warrior,arms,24,10,14
Quihc,outland,956,warrior,arms,24,10,14
Teramuhl,eredar,956,warrior,arms,24,10,14
Elesharde,sanguino,956,warrior,arms,27,11,16
Mìsà,ysondre,956,warrior,arms,29,10,19
Headshot,zenedar,956,warrior,arms,36,10,26
Mishkeh,silvermoon,955,warrior,arms,18,10,8
Deanx,ragnaros,955,warrior,arms,18,10,8
Nightbeard,twisting-nether,955,warrior,arms,18,10,8
Sazø,culte-de-la-rive-noire,955,warrior,arms,18,10,8
Асхана,howling-fjord,955,warrior,arms,18,10,8
Odonko,blackmoore,955,warrior,arms,60,29,31
Xarmog,hyjal,955,warrior,arms,24,10,14
Khara,frostwolf,955,warrior,arms,24,10,14
Rngcarrier,sylvanas,955,warrior,arms,24,10,14
Whoraclë,tarren-mill,955,warrior,arms,24,10,14
Gramrosh,eredar,955,warrior,arms,24,10,14
Neíd,malganis,955,warrior,arms,30,10,20
Fluffycute,blackhand,955,warrior,arms,30,10,20
Profftols,draenor,955,warrior,arms,30,10,20
Zutto,conseil-des-ombres,954,warrior,arms,18,10,8
Smob,ragnaros,954,warrior,arms,18,10,8
Rawne,kirin-tor,954,warrior,arms,18,10,8
Protecmoo,drakthul,954,warrior,arms,24,10,14
Труперсила,howling-fjord,954,warrior,arms,24,10,14
Acour,elune,954,warrior,arms,24,10,14
Smushbrok,stormscale,954,warrior,arms,24,10,14
Ôwndbylx,aegwynn,954,warrior,arms,27,11,16
Yngvar,darksorrow,954,warrior,arms,30,10,20
Øfè,ysondre,954,warrior,arms,30,10,20
Lõókåtmêñöw,hyjal,953,warrior,arms,12,10,2
Camaon,outland,953,warrior,arms,18,10,8
Fehrax,eredar,953,warrior,arms,18,10,8
Kattyparry,tarren-mill,953,warrior,arms,24,10,14
Æxcoast,ravencrest,953,warrior,arms,30,10,20
Bisuko,archimonde,953,warrior,arms,36,10,26
Ginò,stormscale,952,warrior,arms,18,10,8
Blanchysnow,hyjal,952,warrior,arms,18,10,8
Decreased,dun-modr,952,warrior,arms,18,10,8
Papawaffle,stormscale,952,warrior,arms,18,10,8
Unkmòr,pozzo-delleternità,952,warrior,arms,42,22,20
Hexzo,ravencrest,952,warrior,arms,24,10,14
Partajorma,ravencrest,952,warrior,arms,24,10,14
Micromachìne,sanguino,952,warrior,arms,30,10,20
Кейнорин,howling-fjord,952,warrior,arms,34,11,23
Rayenna,dalaran,951,warrior,arms,12,10,2
Думрайт,gordunni,951,warrior,arms,18,10,8
Marciano,dalaran,951,warrior,arms,24,12,12
Зарган,howling-fjord,951,warrior,arms,65,25,40
Hellungo,hyjal,951,warrior,arms,30,10,20
Nðjn,archimonde,950,warrior,arms,18,10,8
Дядядмг,blackscar,950,warrior,arms,18,10,8
Tonberry,frostwolf,950,warrior,arms,24,10,14
Xlugan,kazzak,950,warrior,arms,42,10,32
Zodiakós,burning-legion,950,warrior,arms,42,10,32
Zerm,draenor,949,warrior,arms,18,10,8
Carsannies,stormscale,949,warrior,arms,136,59,77
Qvil,sanguino,948,warrior,arms,99,34,65
Hanvik,zuljin,948,warrior,arms,30,10,20
Obitron,argent-dawn,947,warrior,arms,24,10,14
Pyxis,argent-dawn,947,warrior,arms,24,10,14
Kharmog,hyjal,947,warrior,arms,54,18,36
Nyu,kirin-tor,946,warrior,arms,89,41,48
Waescanor,ragnaros,946,warrior,arms,54,21,33
Omglolnoob,magtheridon,946,warrior,arms,26,10,16
Çbr,silvermoon,945,warrior,arms,36,10,26
Geicoo,dalaran,944,warrior,arms,77,39,38
Warrgob,outland,944,warrior,arms,30,10,20
Abrogatio,emeriss,943,warrior,arms,18,10,8
Skullhammer,burning-legion,943,warrior,arms,36,16,20
Jackycoke,blackhand,943,warrior,arms,30,10,20
Dorya,aegwynn,942,warrior,arms,23,10,13
Snägärikovin,stormreaver,941,warrior,arms,24,10,14
Shpitzu,stormscale,941,warrior,arms,26,10,16
Mathej,drakthul,940,warrior,arms,23,10,13
Илийя,razuvious,940,warrior,arms,29,10,19
Ervanw,sylvanas,939,warrior,arms,89,29,60
Prag,silvermoon,938,warrior,arms,40,22,18
Danoriix,drakthul,937,warrior,arms,30,10,20
Overdose,anetheron,936,warrior,arms,29,16,13
Shieldwall,norgannon,935,warrior,arms,36,20,16
Шарж,greymane,935,warrior,arms,106,47,59
Kaerz,ysondre,934,warrior,arms,18,10,8
Vooice,sylvanas,933,warrior,arms,29,10,19
Murgrimm,die-silberne-hand,932,warrior,arms,54,29,25
Zoulaani,argent-dawn,932,warrior,arms,155,64,91
Bubciu,burning-legion,932,warrior,arms,30,10,20
Lapyy,drakthul,931,warrior,arms,36,18,18
Vcorvin,dun-modr,931,warrior,arms,54,23,31
Йомхар,howling-fjord,931,warrior,arms,30,10,20
Gauklerbaron,blackmoore,928,warrior,arms,67,26,41
Furiax,dalaran,927,warrior,arms,18,10,8
Ganik,malganis,927,warrior,arms,23,10,13
Rèlion,pozzo-delleternità,926,warrior,arms,21,11,10
Джеймсчейз,blackscar,926,warrior,arms,23,10,13
Vandervil,los-errantes,924,warrior,arms,18,10,8
Léonie,arakarahm,924,warrior,arms,23,10,13
Ørkk,pozzo-delleternità,923,warrior,arms,14,11,3
Perseó,minahonda,923,warrior,arms,84,32,52
Дозикк,ashenvale,923,warrior,arms,38,11,27
Fugrim,draenor,921,warrior,arms,24,10,14
Espanyol,sanguino,920,warrior,arms,68,35,33
Всемкуяолд,gordunni,920,warrior,arms,24,11,13
Pigleto,ravencrest,919,warrior,arms,99,46,53
Grimmbearock,amanthul,919,warrior,arms,24,10,14
Falaliss,elune,918,warrior,arms,34,13,21
Bukî,blackmoore,917,warrior,arms,29,10,19
Gizmaxe,tarren-mill,916,warrior,arms,20,11,9
Pizdicä,twisting-nether,916,warrior,arms,23,12,11
Боевойму,howling-fjord,916,warrior,arms,248,114,134
Takashia,ravencrest,915,warrior,arms,22,11,11
Wonne,silvermoon,915,warrior,arms,29,10,19
Hammerfíst,kazzak,913,warrior,arms,112,53,59
Kirix,aegwynn,911,warrior,arms,42,19,23
Justop,ravencrest,907,warrior,arms,23,10,13
Durmithor,silvermoon,906,warrior,arms,35,10,25
Энлами,gordunni,905,warrior,arms,21,10,11
Glut,drakthul,905,warrior,arms,24,11,13
Karbeg,ravencrest,905,warrior,arms,27,10,17
Elsinner,ravencrest,905,warrior,arms,35,10,25
Искристый,howling-fjord,903,warrior,arms,18,11,7
Cryze,ravencrest,903,warrior,arms,21,10,11
Spoofie,doomhammer,903,warrior,arms,27,10,17
Adrï,draenor,901,warrior,arms,124,63,61
Ispor,shattered-halls,901,warrior,arms,161,78,83
Ileei,kazzak,901,warrior,arms,38,12,26
Обнимаш,ashenvale,900,warrior,arms,20,11,9
Cléveland,argent-dawn,900,warrior,arms,28,11,17
Poluneikos,turalyon,900,warrior,arms,40,12,28
Mundigor,medivh,899,warrior,arms,30,11,19
Shtygar,doomhammer,898,warrior,arms,36,13,23
Креспекс,gordunni,896,warrior,arms,28,10,18
Bòónki,ravencrest,893,warrior,arms,93,41,52
Gothmog,magtheridon,893,warrior,arms,28,10,18
Goodvibez,silvermoon,893,warrior,arms,36,10,26
Talaganos,twisting-nether,890,warrior,arms,31,17,14
Dlstroyer,eonar,890,warrior,arms,41,22,19
Биграма,howling-fjord,890,warrior,arms,26,10,16
Мембершримп,howling-fjord,890,warrior,arms,38,10,28
Valtýr,skullcrusher,889,warrior,arms,35,17,18
Рагнарульв,gordunni,885,warrior,arms,14,10,4
Wulfgâr,dun-modr,883,warrior,arms,60,30,30
Arschal,khaz-modan,883,warrior,arms,44,22,22
Дотрен,galakrond,883,warrior,arms,42,20,22
Braûsepulver,guldan,883,warrior,arms,138,65,73
Rejectofrage,ragnaros,882,warrior,arms,66,29,37
Ajsiboy,burning-legion,880,warrior,arms,71,27,44
Nebezpeka,silvermoon,878,warrior,arms,19,10,9
Bazsika,ragnaros,877,warrior,arms,78,30,48
Авврорра,gordunni,874,warrior,arms,145,68,77
Kokonut,twisting-nether,873,warrior,arms,51,26,25
Spartazo,turalyon,873,warrior,arms,48,18,30
Nerealni,kazzak,871,warrior,arms,21,10,11
Razecraz,ysondre,869,warrior,arms,36,17,19
Kreaten,chamber-of-aspects,868,warrior,arms,120,45,75
Jôst,rexxar,867,warrior,arms,23,10,13
Yuushi,doomhammer,865,warrior,arms,58,25,33
Gladwfriends,ravencrest,864,warrior,arms,12,9,3
Marqinios,archimonde,864,warrior,arms,12,9,3
Zeetx,les-clairvoyants,864,warrior,arms,12,9,3
Antìcìdè,ravencrest,864,warrior,arms,12,9,3
Bâyer,burning-legion,864,warrior,arms,18,9,9
Moldamis,blackhand,864,warrior,arms,18,9,9
Zorn,blackmoore,864,warrior,arms,18,9,9
Psinovich,sylvanas,864,warrior,arms,18,9,9
Precel,burning-legion,864,warrior,arms,18,9,9
Cerßeres,archimonde,864,warrior,arms,18,9,9
Earthshatter,emeriss,864,warrior,arms,18,9,9
Trensexual,twisting-nether,864,warrior,arms,18,9,9
Ирклейн,howling-fjord,864,warrior,arms,18,9,9
Émalkay,tarren-mill,864,warrior,arms,18,9,9
Khalidax,hyjal,864,warrior,arms,18,9,9
Pantsonfire,blackmoore,864,warrior,arms,24,9,15
Dmgsponge,stormscale,864,warrior,arms,24,9,15
Комбобрэйкер,grom,864,warrior,arms,24,9,15
Tenthøusand,sylvanas,864,warrior,arms,24,9,15
Deskslammer,tarren-mill,864,warrior,arms,24,9,15
Gember,silvermoon,864,warrior,arms,24,9,15
Vulkân,aerie-peak,864,warrior,arms,24,9,15
Motres,sylvanas,864,warrior,arms,24,9,15
Stóna,blackmoore,864,warrior,arms,24,9,15
Tháládor,tarren-mill,864,warrior,arms,24,9,15
Хохатунчик,gordunni,864,warrior,arms,30,9,21
Bandfør,archimonde,863,warrior,arms,12,9,3
Mjol,silvermoon,863,warrior,arms,18,9,9
Luchanka,the-maelstrom,863,warrior,arms,18,9,9
Deathgreyø,nemesis,863,warrior,arms,18,9,9
Валлй,blackscar,863,warrior,arms,18,9,9
Мелефесента,gordunni,863,warrior,arms,18,9,9
Risara,outland,863,warrior,arms,18,9,9
Elpap,draenor,863,warrior,arms,18,9,9
Drøgma,tyrande,863,warrior,arms,18,9,9
Súbzéró,argent-dawn,863,warrior,arms,18,9,9
Cebystance,kazzak,863,warrior,arms,18,9,9
Fitø,shendralar,863,warrior,arms,18,9,9
Pexqt,blackmoore,863,warrior,arms,18,9,9
Хастурхотеп,gordunni,863,warrior,arms,18,9,9
Слоз,gordunni,863,warrior,arms,18,9,9
Theolcostaud,archimonde,863,warrior,arms,18,9,9
Тягуч,howling-fjord,863,warrior,arms,18,9,9
Punisherhulk,stormscale,863,warrior,arms,18,9,9
Pacheco,eredar,863,warrior,arms,21,10,11
Agres,zuluhed,863,warrior,arms,24,9,15
Borndet,eredar,863,warrior,arms,24,9,15
Shiikaa,hyjal,863,warrior,arms,24,9,15
Johnfogerty,twisting-nether,863,warrior,arms,24,9,15
Visari,kiljaeden,863,warrior,arms,24,9,15
Abibe,aggra-português,863,warrior,arms,24,9,15
Stepchildx,silvermoon,863,warrior,arms,24,9,15
Darkblader,dalvengyr,863,warrior,arms,24,9,15
Danaüs,twisting-nether,863,warrior,arms,24,9,15
Scarlettjo,outland,863,warrior,arms,33,10,23
Symx,tarren-mill,863,warrior,arms,30,9,21
Nyxo,argent-dawn,863,warrior,arms,30,9,21
Grimblade,kazzak,863,warrior,arms,30,9,21
Adalyn,azjolnerub,862,warrior,arms,12,9,3
Onkra,malganis,862,warrior,arms,18,9,9
Tuncis,aszune,862,warrior,arms,18,9,9
Veeg,blackmoore,862,warrior,arms,18,9,9
Stratoz,ragnaros,862,warrior,arms,18,9,9
Modenae,archimonde,862,warrior,arms,18,9,9
Realdrdob,kazzak,862,warrior,arms,24,9,15
Камрадшторм,borean-tundra,862,warrior,arms,24,9,15
Bekkey,lightbringer,862,warrior,arms,24,9,15
Slowfeet,stormscale,861,warrior,arms,12,9,3
Sax,ravencrest,861,warrior,arms,18,9,9
Nêlê,thrall,861,warrior,arms,18,9,9
Nêgan,stormscale,861,warrior,arms,18,9,9
Мономер,soulflayer,861,warrior,arms,24,9,15
Nameless,malganis,861,warrior,arms,24,9,15
Amar,defias-brotherhood,861,warrior,arms,29,10,19
Bigbaduglyy,twisting-nether,861,warrior,arms,30,9,21
Bobbys,kazzak,860,warrior,arms,12,9,3
Grokha,eredar,860,warrior,arms,18,9,9
Andoror,nemesis,860,warrior,arms,18,9,9
Emmá,neptulon,860,warrior,arms,18,9,9
Bezark,kazzak,860,warrior,arms,18,9,9
Arrhennius,kazzak,860,warrior,arms,18,9,9
Rzelazko,burning-legion,860,warrior,arms,18,9,9
Zersei,los-errantes,860,warrior,arms,24,9,15
Gueboparado,sanguino,860,warrior,arms,24,9,15
Казырной,soulflayer,860,warrior,arms,24,9,15
Woopzi,twisting-nether,860,warrior,arms,36,9,27
Jarlerkin,ragnaros,859,warrior,arms,18,9,9
Stits,chromaggus,859,warrior,arms,18,9,9
Wakoff,tarren-mill,859,warrior,arms,24,9,15
Buffury,twisting-nether,859,warrior,arms,24,9,15
Маханхет,soulflayer,859,warrior,arms,24,9,15
Brúgar,antonidas,859,warrior,arms,24,9,15
Aeh,blackmoore,859,warrior,arms,24,9,15
Toiscour,archimonde,859,warrior,arms,30,9,21
Syruz,malganis,859,warrior,arms,43,9,34
Crud,die-silberne-hand,858,warrior,arms,18,9,9
Tojaraa,kazzak,858,warrior,arms,18,9,9
Voodoowarr,rexxar,858,warrior,arms,18,9,9
Zion,zenedar,858,warrior,arms,24,9,15
Micou,ysondre,858,warrior,arms,30,9,21
Kronnosh,tarren-mill,857,warrior,arms,12,9,3
Варбыкмашина,howling-fjord,857,warrior,arms,18,9,9
Tyranitar,pozzo-delleternità,857,warrior,arms,24,9,15
Ruioz,draenor,857,warrior,arms,24,9,15
Тревзор,gordunni,857,warrior,arms,24,9,15
Exitod,thrall,857,warrior,arms,31,10,21
Tweener,azjolnerub,856,warrior,arms,20,9,11
Chrimo,silvermoon,856,warrior,arms,30,9,21
Gucix,tarren-mill,855,warrior,arms,18,9,9
Pvpstyle,bloodscalp,855,warrior,arms,24,9,15
Легионарус,gordunni,855,warrior,arms,24,9,15
Siegbêrt,frostmourne,855,warrior,arms,30,9,21
Bjornn,azjolnerub,854,warrior,arms,18,9,9
Caloomsa,hellfire,854,warrior,arms,18,9,9
Rézinplin,archimonde,854,warrior,arms,18,9,9
Ejecute,minahonda,854,warrior,arms,78,29,49
Discogoon,twilights-hammer,854,warrior,arms,87,32,55
Ruuster,norgannon,853,warrior,arms,30,9,21
Janeu,nozdormu,852,warrior,arms,18,9,9
Aemirage,doomhammer,851,warrior,arms,120,60,60
Syforce,ravencrest,850,warrior,arms,18,9,9
Warclone,ravencrest,850,warrior,arms,18,9,9
Ostoppandi,sylvanas,849,warrior,arms,18,9,9
Vãnquish,archimonde,848,warrior,arms,30,12,18
Gidra,stormscale,847,warrior,arms,17,9,8
Orchëstre,eitrigg,846,warrior,arms,244,121,123
Gogoplata,antonidas,845,warrior,arms,18,9,9
Leesh,ravenholdt,845,warrior,arms,92,44,48
Zêrklatscher,lordaeron,845,warrior,arms,54,13,41
Derbayn,tarren-mill,844,warrior,arms,26,10,16
Xienia,dun-morogh,841,warrior,arms,30,10,20
Vlajko,kazzak,839,warrior,arms,60,21,39
Лесковер,howling-fjord,831,warrior,arms,23,9,14
Nâgata,ravencrest,830,warrior,arms,22,9,13
Lockia,chogall,829,warrior,arms,20,10,10
Greeneroi,khaz-modan,829,warrior,arms,35,9,26
Raufí,antonidas,828,warrior,arms,72,34,38
Фелсикт,gordunni,828,warrior,arms,23,9,14
Warwaw,twisting-nether,822,warrior,arms,27,11,16
Glorywhory,drakthul,821,warrior,arms,23,9,14
Bashion,ghostlands,818,warrior,arms,60,23,37
Veed,nozdormu,815,warrior,arms,17,9,8
Fonky,sylvanas,815,warrior,arms,21,10,11
Darkmidgét,silvermoon,815,warrior,arms,21,9,12
Станеслав,gordunni,810,warrior,arms,23,9,14
Kixx,twisting-nether,809,warrior,arms,78,35,43
Cristoforo,the-shatar,806,warrior,arms,76,20,56
Saintßerko,ravencrest,805,warrior,arms,26,10,16
Actuallyorc,twisting-nether,799,warrior,arms,14,9,5
Слэймодх,howling-fjord,799,warrior,arms,17,9,8
Jiñnx,outland,798,warrior,arms,11,9,2
Unchåined,burning-legion,798,warrior,arms,14,9,5
Zaccollini,burning-legion,798,warrior,arms,16,9,7
Fürchtenix,blackmoore,798,warrior,arms,26,9,17
Ahmedmohsen,kazzak,796,warrior,arms,20,9,11
Alothar,khaz-modan,796,warrior,arms,129,54,75
Asurian,runetotem,796,warrior,arms,99,39,60
Aùrora,frostmourne,792,warrior,arms,53,20,33
Turøc,illidan,791,warrior,arms,42,16,26
Steels,outland,788,warrior,arms,43,19,24
Finalsmasher,thrall,784,warrior,arms,42,16,26
Peterli,norgannon,784,warrior,arms,30,11,19
Tynyas,dalaran,782,warrior,arms,103,48,55
Panduf,rashgarroth,781,warrior,arms,11,9,2
Thoon,teldrassil,772,warrior,arms,36,14,22
Cáráxés,ravencrest,768,warrior,arms,12,8,4
Dagon,gorgonnash,768,warrior,arms,12,8,4
Выбьюглазик,gordunni,768,warrior,arms,12,8,4
Bigdøngfur,archimonde,768,warrior,arms,12,8,4
Spiokra,hellscream,768,warrior,arms,12,8,4
Badon,burning-legion,768,warrior,arms,12,8,4
Бигбэйбитейп,greymane,768,warrior,arms,12,8,4
Ballin,dragonblight,768,warrior,arms,12,8,4
Zalazinjo,stormscale,768,warrior,arms,12,8,4
Muyubu,eredar,768,warrior,arms,12,8,4
Nihm,ravencrest,768,warrior,arms,12,8,4
Audrin,twisting-nether,768,warrior,arms,12,8,4
Sinfay,gorgonnash,768,warrior,arms,12,8,4
Piré,tarren-mill,768,warrior,arms,12,8,4
Drragosh,tarren-mill,768,warrior,arms,12,8,4
Éliøkor,outland,768,warrior,arms,12,8,4
Escapeartíst,ravencrest,768,warrior,arms,12,8,4
Beiskaldí,blackrock,768,warrior,arms,12,8,4
Sevenheavy,draenor,768,warrior,arms,12,8,4
Отвечай,gordunni,768,warrior,arms,12,8,4
Möuntian,kazzak,768,warrior,arms,12,8,4
Rageside,draenor,768,warrior,arms,12,8,4
Syjin,antonidas,768,warrior,arms,12,8,4
Smorccroms,stormscale,768,warrior,arms,12,8,4
Reckxpeep,twisting-nether,768,warrior,arms,12,8,4
Masakerr,ragnaros,768,warrior,arms,15,9,6
Madßud,ravencrest,768,warrior,arms,14,8,6
Hørdiiwar,ravencrest,768,warrior,arms,18,8,10
Akkixx,die-aldor,768,warrior,arms,18,8,10
Shreedshot,blackmoore,768,warrior,arms,18,8,10
Pride,azshara,768,warrior,arms,18,8,10
Zeover,ragnaros,768,warrior,arms,18,8,10
Shewbynette,archimonde,768,warrior,arms,18,8,10
Specter,das-syndikat,768,warrior,arms,18,8,10
Maven,thrall,768,warrior,arms,18,8,10
Nutz,archimonde,768,warrior,arms,18,8,10
Steelride,silvermoon,768,warrior,arms,18,8,10
Yxolike,blackmoore,768,warrior,arms,18,8,10
Vermis,stormscale,768,warrior,arms,18,8,10
Андрюхабш,soulflayer,768,warrior,arms,18,8,10
Styxwr,blackhand,768,warrior,arms,18,8,10
Sreym,dun-modr,768,warrior,arms,18,8,10
Epicc,alleria,768,warrior,arms,18,8,10
Notzage,les-sentinelles,768,warrior,arms,18,8,10
Crebushi,burning-legion,768,warrior,arms,18,8,10
Eifachöppis,blackhand,768,warrior,arms,18,8,10
Makaveli,twisting-nether,768,warrior,arms,18,8,10
Belmønt,archimonde,768,warrior,arms,18,8,10
Safaribob,kazzak,768,warrior,arms,18,8,10
Ликано,greymane,768,warrior,arms,18,8,10
Dréngr,blackrock,768,warrior,arms,18,8,10
Nerfelepls,ravencrest,768,warrior,arms,21,9,12
Guerriax,les-sentinelles,768,warrior,arms,24,8,16
Caffeinë,ravencrest,768,warrior,arms,24,8,16
Sublexgg,blackrock,768,warrior,arms,24,8,16
Galiusx,malganis,768,warrior,arms,24,8,16
Leavyu,silvermoon,768,warrior,arms,24,8,16
Whydeadbro,twisting-nether,768,warrior,arms,30,8,22
Boenvik,burning-legion,768,warrior,arms,30,8,22
Kytee,draenor,768,warrior,arms,36,8,28
Huevon,draenor,767,warrior,arms,12,8,4
Critwar,draenor,767,warrior,arms,12,8,4
Smikka,jaedenar,767,warrior,arms,12,8,4
Druubak,aggra-português,767,warrior,arms,12,8,4
Brokenmachin,antonidas,767,warrior,arms,12,8,4
Atzex,blackmoore,767,warrior,arms,12,8,4
Dikastis,kul-tiras,767,warrior,arms,15,9,6
Fullfäyä,hyjal,767,warrior,arms,18,8,10
Mòrzàr,outland,767,warrior,arms,18,8,10
Yoruíchi,sunstrider,767,warrior,arms,18,8,10
Громорашман,grom,767,warrior,arms,18,8,10
Oxey,ragnaros,767,warrior,arms,18,8,10
Cowstomperx,ravencrest,767,warrior,arms,18,8,10
Instamerk,doomhammer,767,warrior,arms,18,8,10
Vahrion,burning-blade,767,warrior,arms,18,8,10
Míngxuan,tarren-mill,767,warrior,arms,18,8,10
Hermosse,dalaran,767,warrior,arms,18,8,10
Grimmvard,blackhand,767,warrior,arms,18,8,10
Снорре,soulflayer,767,warrior,arms,18,8,10
Craíne,antonidas,767,warrior,arms,18,8,10
Dtraque,kaelthas,767,warrior,arms,18,8,10
Broxiw,darkspear,767,warrior,arms,18,8,10
Yasuk,archimonde,767,warrior,arms,18,8,10
Bosancheros,the-maelstrom,767,warrior,arms,18,8,10
Josimar,kazzak,767,warrior,arms,18,8,10
Litlijón,ravencrest,767,warrior,arms,18,8,10
Kalopsia,drakthul,767,warrior,arms,18,8,10
Vexari,twisting-nether,767,warrior,arms,18,8,10
Arigbökh,hyjal,767,warrior,arms,18,8,10
Kasperw,kazzak,767,warrior,arms,18,8,10
Sïmstärxzy,hakkar,767,warrior,arms,18,8,10
Alexwar,draenor,767,warrior,arms,18,8,10
Wólfguard,silvermoon,767,warrior,arms,18,8,10
Horseye,eredar,767,warrior,arms,18,8,10
Zonïa,ysondre,767,warrior,arms,18,8,10
Nithradien,blades-edge,767,warrior,arms,18,8,10
Béhrus,blackmoore,767,warrior,arms,18,8,10
Reckless,saurfang,767,warrior,arms,18,8,10
Akim,ysondre,767,warrior,arms,18,8,10
Sheíld,nordrassil,767,warrior,arms,18,8,10
Kunodontas,draenor,767,warrior,arms,18,8,10
Kaske,alexstrasza,767,warrior,arms,23,8,15
Qdex,kazzak,767,warrior,arms,24,8,16
Rylbrah,blackmoore,767,warrior,arms,24,8,16
Spacemachine,kazzak,767,warrior,arms,24,8,16
Smorkadormi,silvermoon,767,warrior,arms,24,8,16
Mønsterz,archimonde,767,warrior,arms,24,8,16
Nuhilug,tarren-mill,767,warrior,arms,24,8,16
Linkeador,zuljin,767,warrior,arms,24,8,16
Tremuwar,tyrande,766,warrior,arms,12,8,4
Bonkonator,stormscale,766,warrior,arms,12,8,4
Celean,darksorrow,766,warrior,arms,12,8,4
Newgáte,silvermoon,766,warrior,arms,12,8,4
Свиногуб,soulflayer,766,warrior,arms,12,8,4
Willadimore,ravencrest,766,warrior,arms,18,8,10
Beamis,ragnaros,766,warrior,arms,18,8,10
Zerxees,tarren-mill,766,warrior,arms,18,8,10
Lylïth,sinstralis,766,warrior,arms,18,8,10
Byrnjolf,zuljin,766,warrior,arms,18,8,10
Booya,laughing-skull,766,warrior,arms,18,8,10
Tharokk,blackmoore,766,warrior,arms,18,8,10
Gùts,stormreaver,766,warrior,arms,18,8,10
Хэлвид,soulflayer,766,warrior,arms,18,8,10
Rageaholic,blackmoore,766,warrior,arms,18,8,10
Ulmo,blackrock,766,warrior,arms,18,8,10
Нэиро,howling-fjord,766,warrior,arms,24,8,16
Noonoo,silvermoon,766,warrior,arms,24,8,16
Smarkz,nemesis,766,warrior,arms,24,8,16
Kekzero,kazzak,766,warrior,arms,24,8,16
Xongoku,blackrock,765,warrior,arms,12,8,4
Suldren,cthun,765,warrior,arms,12,8,4
Кырно,gordunni,765,warrior,arms,18,8,10
Dschiraa,anetheron,765,warrior,arms,18,8,10
Firebladë,ravencrest,765,warrior,arms,18,8,10
Fortësque,uldaman,765,warrior,arms,18,8,10
Escà,archimonde,765,warrior,arms,18,8,10
Vingmyr,silvermoon,765,warrior,arms,18,8,10
Tamathos,frostwhisper,765,warrior,arms,18,8,10
Feydal,thrall,765,warrior,arms,24,8,16
Eyolf,thunderhorn,765,warrior,arms,24,8,16
Younes,ravencrest,765,warrior,arms,24,8,16
Intcx,silvermoon,765,warrior,arms,24,8,16
Leaply,kazzak,765,warrior,arms,24,8,16
Platerz,aggramar,765,warrior,arms,24,8,16
Кордупэль,gordunni,765,warrior,arms,24,8,16
Hirbus,ravencrest,765,warrior,arms,25,8,17
Kotto,defias-brotherhood,765,warrior,arms,30,8,22
Варинуб,soulflayer,764,warrior,arms,18,10,8
Berree,outland,764,warrior,arms,18,8,10
Lìón,blackhand,764,warrior,arms,24,8,16
Okke,thunderhorn,764,warrior,arms,24,8,16
Tinull,silvermoon,764,warrior,arms,24,8,16
Wærriør,argent-dawn,763,warrior,arms,18,8,10
Ireincarnate,argent-dawn,763,warrior,arms,18,8,10
Giggadaddy,tarren-mill,763,warrior,arms,18,8,10
Repzcanor,silvermoon,763,warrior,arms,18,8,10
Xenör,archimonde,763,warrior,arms,24,8,16
Ripper,scarshield-legion,763,warrior,arms,30,8,22
Leyon,blades-edge,762,warrior,arms,12,8,4
Даммодар,howling-fjord,762,warrior,arms,18,8,10
Previse,argent-dawn,762,warrior,arms,18,8,10
Boindal,senjin,762,warrior,arms,18,8,10
Bigbibbs,tarren-mill,762,warrior,arms,24,8,16
Fanfurik,silvermoon,762,warrior,arms,30,8,22
Øruch,draenor,761,warrior,arms,18,8,10
Grimdorf,frostmane,761,warrior,arms,24,8,16
Cøbe,arthas,761,warrior,arms,24,8,16
Отнулядоста,gordunni,761,warrior,arms,24,8,16
Saghal,skullcrusher,761,warrior,arms,24,8,16
Encounter,nefarian,760,warrior,arms,12,8,4
Alhexander,dun-modr,760,warrior,arms,18,8,10
Alysa,ravencrest,760,warrior,arms,24,8,16
Грруд,galakrond,760,warrior,arms,24,8,16
Машамеч,blackscar,760,warrior,arms,30,8,22
Ceteris,eredar,759,warrior,arms,12,8,4
Legendkév,ravencrest,759,warrior,arms,24,8,16
Stallion,blackmoore,758,warrior,arms,30,8,22
Kãzzgot,burning-legion,757,warrior,arms,18,8,10
Upturn,ravencrest,757,warrior,arms,24,8,16
Goreskull,hellfire,754,warrior,arms,18,8,10
Bisøu,marécage-de-zangar,754,warrior,arms,30,8,22
Patriotdk,runetotem,750,warrior,arms,163,64,99
Calipp,die-aldor,750,warrior,arms,24,8,16
Ètc,ravencrest,749,warrior,arms,25,11,14
Kyr,bladefist,749,warrior,arms,23,8,15
Shadrassil,eonar,747,warrior,arms,18,8,10
Galidras,nemesis,747,warrior,arms,29,8,21
Короноварус,greymane,746,warrior,arms,138,62,76
Furraxx,elune,736,warrior,arms,18,8,10
Irontouch,draenor,735,warrior,arms,11,8,3
Hazzaogx,draenor,735,warrior,arms,23,8,15
Eltaré,hyjal,734,warrior,arms,14,9,5
Kramix,thrall,734,warrior,arms,16,9,7
Megaloddon,ravencrest,734,warrior,arms,17,8,9
Madict,outland,733,warrior,arms,18,8,10
Lebengtc,stormscale,732,warrior,arms,23,8,15
Magyarsas,ragnaros,730,warrior,arms,23,8,15
Koruds,outland,720,warrior,arms,15,8,7
Incompetent,twisting-nether,719,warrior,arms,21,8,13
Renji,proudmoore,718,warrior,arms,17,8,9
Gorlosh,eredar,718,warrior,arms,20,9,11
Chidòri,tarren-mill,718,warrior,arms,20,9,11
Joblôb,guldan,717,warrior,arms,15,9,6
Железныйбард,gordunni,717,warrior,arms,23,8,15
Brutariz,silvermoon,716,warrior,arms,30,12,18
Ahlda,hyjal,716,warrior,arms,27,8,19
Rezume,ravencrest,712,warrior,arms,26,9,17
Olkowski,silvermoon,709,warrior,arms,17,8,9
Каюха,soulflayer,703,warrior,arms,16,8,8
Ferv,tarren-mill,703,warrior,arms,17,8,9
Келлендрос,soulflayer,703,warrior,arms,20,8,12
Warbek,tarren-mill,703,warrior,arms,20,8,12
Goringbame,draenor,703,warrior,arms,20,8,12
Рударим,gordunni,702,warrior,arms,20,8,12
Isoton,kazzak,702,warrior,arms,20,8,12
Daxhter,sanguino,702,warrior,arms,20,8,12
Bulwork,blackhand,702,warrior,arms,22,8,14
Parabellum,dun-modr,701,warrior,arms,14,8,6
Stratic,blackmoore,697,warrior,arms,26,8,18
Melców,eredar,687,warrior,arms,11,8,3
Punishers,ysondre,687,warrior,arms,368,148,220
Bendeur,ysondre,686,warrior,arms,13,8,5
Pemex,stormreaver,686,warrior,arms,13,8,5
Жекабустер,borean-tundra,685,warrior,arms,13,8,5
Аскольд,deathguard,679,warrior,arms,32,11,21
Cromosom,draenor,672,warrior,arms,10,8,2
Neismz,hyjal,672,warrior,arms,12,7,5
Whitefirecba,dun-modr,672,warrior,arms,12,7,5
Bìgre,la-croisade-écarlate,672,warrior,arms,12,7,5
Bta,burning-legion,672,warrior,arms,12,7,5
Smasherx,draenor,672,warrior,arms,12,7,5
Динамикс,soulflayer,672,warrior,arms,12,7,5
Lisera,thrall,672,warrior,arms,12,7,5
Grrpow,sanguino,672,warrior,arms,12,7,5
Mauser,thrall,672,warrior,arms,12,7,5
Джераса,borean-tundra,672,warrior,arms,12,7,5
Blinkcharge,frostmane,672,warrior,arms,12,7,5
Chuck,ravencrest,672,warrior,arms,12,7,5
Gannondork,sunstrider,672,warrior,arms,12,7,5
Itsamewario,outland,672,warrior,arms,12,7,5
Chazbo,arakarahm,672,warrior,arms,12,7,5
Engalxsol,tarren-mill,672,warrior,arms,12,7,5
Ryse,nemesis,672,warrior,arms,12,7,5
Korvan,frostwolf,672,warrior,arms,12,7,5
Sveafy,ravencrest,672,warrior,arms,12,7,5
Asnw,hyjal,672,warrior,arms,12,7,5
Khorage,silvermoon,672,warrior,arms,12,7,5
Shînsø,dalaran,672,warrior,arms,12,7,5
Yoz,uldaman,672,warrior,arms,12,7,5
Antïsøcial,thrall,672,warrior,arms,12,7,5
Crøwñd,twisting-nether,672,warrior,arms,12,7,5
Azarek,blackmoore,672,warrior,arms,12,7,5
Djchmogodx,kazzak,672,warrior,arms,12,7,5
Iamouz,ravencrest,672,warrior,arms,12,7,5
Вннд,galakrond,672,warrior,arms,12,7,5
Cruor,stormscale,672,warrior,arms,12,7,5
Excalibur,trollbane,672,warrior,arms,12,7,5
Tandrak,ravencrest,672,warrior,arms,12,7,5
Dangeruos,ragnaros,672,warrior,arms,12,7,5
Orelus,darkspear,672,warrior,arms,12,7,5
Bigblackmooh,tarren-mill,672,warrior,arms,12,7,5
Хашонвар,gordunni,672,warrior,arms,12,7,5
Utz,blackrock,672,warrior,arms,12,7,5
Slâkkxz,outland,672,warrior,arms,12,7,5
Bubawarrior,silvermoon,672,warrior,arms,12,7,5
Thirad,shattered-hand,672,warrior,arms,12,7,5
Ragelol,aegwynn,672,warrior,arms,12,7,5
Trembolonio,sanguino,672,warrior,arms,12,7,5
Zelii,ravencrest,672,warrior,arms,12,7,5
Morkzul,sanguino,672,warrior,arms,12,7,5
Nalanis,stormreaver,672,warrior,arms,12,7,5
Database,blackmoore,672,warrior,arms,12,7,5
Thebigtosco,ravencrest,672,warrior,arms,12,7,5
Fearmyrage,ragnaros,672,warrior,arms,12,7,5
Cleavnseagal,ravencrest,672,warrior,arms,12,7,5
Cleppepx,blackmoore,672,warrior,arms,12,7,5
Jäky,ragnaros,672,warrior,arms,12,7,5
Choklatballz,tarren-mill,672,warrior,arms,12,7,5
Chabonara,blackmoore,672,warrior,arms,12,7,5
Creekwarrior,twisting-nether,672,warrior,arms,12,7,5
Kabanoo,silvermoon,672,warrior,arms,15,8,7
Yazgah,blackmoore,672,warrior,arms,16,8,8
Sillken,ravencrest,672,warrior,arms,17,8,9
Skullsmasher,stormscale,672,warrior,arms,18,7,11
Resttanis,arathor,672,warrior,arms,18,7,11
Warrieron,stormscale,672,warrior,arms,18,7,11
Sgbutcher,khaz-modan,672,warrior,arms,18,7,11
Warbender,twisting-nether,672,warrior,arms,18,7,11
Goinhamx,blackhand,672,warrior,arms,18,7,11
Sóuler,blackhand,672,warrior,arms,18,7,11
Jatze,sanguino,672,warrior,arms,18,7,11
Delfrion,pozzo-delleternità,672,warrior,arms,18,7,11
Sërgi,minahonda,672,warrior,arms,18,7,11
Kamapulya,ravencrest,672,warrior,arms,18,7,11
Twoonewin,ragnaros,672,warrior,arms,18,7,11
Лайонхартед,soulflayer,672,warrior,arms,18,7,11
Contdem,kazzak,672,warrior,arms,18,7,11
Furryboner,blackrock,672,warrior,arms,18,7,11
Manký,kazzak,672,warrior,arms,18,7,11
Huxies,draenor,672,warrior,arms,18,7,11
Darkwaar,hyjal,672,warrior,arms,18,7,11
Masida,senjin,672,warrior,arms,18,7,11
Morshak,gorgonnash,672,warrior,arms,18,7,11
Wallenschöld,kazzak,672,warrior,arms,18,7,11
Kåïdø,ravencrest,672,warrior,arms,18,7,11
Xladérz,ravencrest,672,warrior,arms,18,7,11
Avelint,burning-blade,672,warrior,arms,18,7,11
Blacktusk,kazzak,672,warrior,arms,18,7,11
Lalilulelo,argent-dawn,672,warrior,arms,18,7,11
Ici,outland,672,warrior,arms,18,7,11
Kiha,argent-dawn,672,warrior,arms,18,7,11
Imroxy,blackrock,672,warrior,arms,18,7,11
Fullepixx,outland,672,warrior,arms,24,7,17
Лафтэйл,soulflayer,672,warrior,arms,24,7,17
Durändâl,archimonde,672,warrior,arms,24,7,17
Syfér,grim-batol,672,warrior,arms,24,7,17
Vøidwalker,ragnaros,672,warrior,arms,24,7,17
Unßörn,archimonde,672,warrior,arms,24,7,17
Pouckette,hyjal,672,warrior,arms,24,7,17
Donkypunch,tarren-mill,672,warrior,arms,26,7,19
Jigs,twisting-nether,672,warrior,arms,29,7,22
Gôrilla,kazzak,672,warrior,arms,30,7,23
Vez,arathor,671,warrior,arms,12,7,5
Valí,drakthul,671,warrior,arms,12,7,5
Hades,kazzak,671,warrior,arms,12,7,5
Dosenbier,gorgonnash,671,warrior,arms,12,7,5
Nemár,arathor,671,warrior,arms,12,7,5
Schawar,draenor,671,warrior,arms,12,7,5
Schneklinge,blutkessel,671,warrior,arms,12,7,5
Сайлентлайтх,soulflayer,671,warrior,arms,12,7,5
Armadyl,antonidas,671,warrior,arms,12,7,5
Zywarrior,silvermoon,671,warrior,arms,12,7,5
Wårlord,ragnaros,671,warrior,arms,12,7,5
Exether,auchindoun,671,warrior,arms,12,7,5
Gigatscheb,eredar,671,warrior,arms,12,7,5
Greifax,eredar,671,warrior,arms,12,7,5
Вбубенбахен,gordunni,671,warrior,arms,12,7,5
Stèalthy,stormscale,671,warrior,arms,12,7,5
Dukhe,sanguino,671,warrior,arms,12,7,5
Maugette,ysondre,671,warrior,arms,12,7,5
Sakidx,dun-modr,671,warrior,arms,12,7,5
Reykingar,outland,671,warrior,arms,12,7,5
Aëne,kirin-tor,671,warrior,arms,12,7,5
Bulletpants,argent-dawn,671,warrior,arms,12,7,5
Svobodabigz,draenor,671,warrior,arms,12,7,5
Gamôrà,eitrigg,671,warrior,arms,12,7,5
Lvpodvcio,nemesis,671,warrior,arms,12,7,5
Morningstarr,malganis,671,warrior,arms,12,7,5
Когарт,gordunni,671,warrior,arms,12,7,5
Дисфория,soulflayer,671,warrior,arms,15,8,7
Akorax,frostwolf,671,warrior,arms,16,8,8
Кингкраш,gordunni,671,warrior,arms,18,7,11
Lüund,ravencrest,671,warrior,arms,18,7,11
Porkchop,tarren-mill,671,warrior,arms,18,7,11
Segovaxx,twisting-nether,671,warrior,arms,18,7,11
Frimpongz,arathor,671,warrior,arms,18,7,11
Snörlax,the-maelstrom,671,warrior,arms,18,7,11
Intíkam,alleria,671,warrior,arms,18,7,11
Ордоминимус,gordunni,671,warrior,arms,18,7,11
Плечастый,blackscar,671,warrior,arms,18,7,11
Yeahright,ragnaros,671,warrior,arms,18,7,11
Kishkamen,ravencrest,671,warrior,arms,18,7,11
Donczaszka,turalyon,671,warrior,arms,18,7,11
Peppica,draenor,671,warrior,arms,18,7,11
Sanykwarrior,ragnaros,671,warrior,arms,18,7,11
Meganna,ravenholdt,671,warrior,arms,18,7,11
Авентин,lich-king,671,warrior,arms,18,7,11
Jeyay,defias-brotherhood,671,warrior,arms,18,7,11
Qurujaa,kirin-tor,671,warrior,arms,18,7,11
Билатерал,howling-fjord,671,warrior,arms,18,7,11
Salsetti,nemesis,671,warrior,arms,18,7,11
Sydre,nerathor,671,warrior,arms,18,7,11
Darriuso,kazzak,671,warrior,arms,18,7,11
Janestar,stormrage,671,warrior,arms,18,7,11
Yìnkxx,blackmoore,671,warrior,arms,18,7,11
Acudam,stormscale,671,warrior,arms,18,7,11
Wentylator,silvermoon,671,warrior,arms,18,7,11
Futtekriger,ravencrest,671,warrior,arms,21,8,13
Aeons,darksorrow,671,warrior,arms,24,7,17
Ketschup,frostwolf,671,warrior,arms,24,7,17
Fracto,draenor,671,warrior,arms,24,7,17
Mikáel,silvermoon,671,warrior,arms,24,7,17
Sadex,blackmoore,671,warrior,arms,24,7,17
Rïven,los-errantes,671,warrior,arms,24,7,17
Haris,malganis,671,warrior,arms,24,7,17
Jerololz,dun-modr,671,warrior,arms,24,7,17
Сышиш,greymane,671,warrior,arms,24,7,17
Waelkøh,hyjal,670,warrior,arms,13,8,5
Xzaman,blackrock,670,warrior,arms,12,7,5
Eldfast,bladefist,670,warrior,arms,12,7,5
Gimor,ravencrest,670,warrior,arms,12,7,5
Lightit,aegwynn,670,warrior,arms,12,7,5
Grunwi,burning-legion,670,warrior,arms,12,7,5
Haymaker,auchindoun,670,warrior,arms,12,7,5
Marcius,the-maelstrom,670,warrior,arms,12,7,5
Cortix,blackmoore,670,warrior,arms,16,8,8
Dâmso,archimonde,670,warrior,arms,18,7,11
Hammærn,grim-batol,670,warrior,arms,18,7,11
Cesaro,blackhand,670,warrior,arms,18,7,11
Rhark,argent-dawn,670,warrior,arms,18,7,11
Sibbo,destromath,670,warrior,arms,18,7,11
Merll,twisting-nether,670,warrior,arms,18,7,11
Therapyst,sylvanas,670,warrior,arms,18,7,11
Grafted,argent-dawn,670,warrior,arms,18,7,11
Tartadwarf,blackhand,670,warrior,arms,18,7,11
Adyx,the-maelstrom,670,warrior,arms,18,7,11
Pattrock,blackmoore,670,warrior,arms,18,7,11
Rearar,burning-legion,670,warrior,arms,24,7,17
Чсвпони,blackscar,670,warrior,arms,24,7,17
Raminax,turalyon,670,warrior,arms,24,7,17
Гениауч,eversong,670,warrior,arms,30,7,23
Laude,ragnaros,669,warrior,arms,12,7,5
Rivelan,argent-dawn,669,warrior,arms,12,7,5
Meywara,blackhand,669,warrior,arms,12,7,5
Фрт,soulflayer,669,warrior,arms,18,7,11
Mistäke,les-sentinelles,669,warrior,arms,18,7,11
Slappie,kiljaeden,669,warrior,arms,18,7,11
Undatakâh,sanguino,669,warrior,arms,24,7,17
Меехх,howling-fjord,669,warrior,arms,24,7,17
Mistafleex,hyjal,669,warrior,arms,24,7,17
Tf,kazzak,669,warrior,arms,24,7,17
Kavorkxen,argent-dawn,668,warrior,arms,12,7,5
Árkantos,ravencrest,668,warrior,arms,12,7,5
Méfiat,hyjal,668,warrior,arms,12,7,5
Demirkol,outland,668,warrior,arms,15,8,7
Woukong,blackmoore,668,warrior,arms,18,7,11
Yeijing,culte-de-la-rive-noire,668,warrior,arms,18,7,11
Blockheed,arathor,668,warrior,arms,18,7,11
Releave,draenor,668,warrior,arms,18,7,11
Bjornalf,silvermoon,668,warrior,arms,18,7,11
Agriokolos,stormscale,668,warrior,arms,24,7,17
Pipuszka,turalyon,668,warrior,arms,24,7,17
Varzica,twilights-hammer,668,warrior,arms,24,7,17
Axecuters,frostmane,667,warrior,arms,12,7,5
Ghorgutz,kazzak,667,warrior,arms,18,7,11
Papati,twisting-nether,667,warrior,arms,18,7,11
Thorenado,kazzak,667,warrior,arms,27,8,19
Sorgim,dethecus,667,warrior,arms,30,7,23
Bulldozer,frostmourne,667,warrior,arms,30,7,23
Madbert,drakthul,665,warrior,arms,18,7,11
Djhauge,ravencrest,664,warrior,arms,24,7,17
Rimz,blackmoore,663,warrior,arms,18,7,11
Robthebruce,ravencrest,660,warrior,arms,18,7,11
Zuit,blackmoore,655,warrior,arms,17,7,10
Paaki,archimonde,655,warrior,arms,23,7,16
Dunka,cthun,651,warrior,arms,23,7,16
Rutenos,drakthul,649,warrior,arms,18,7,11
Mocka,veknilash,640,warrior,arms,16,7,9
Kaithar,sanguino,638,warrior,arms,16,7,9
Pimagnum,stormscale,638,warrior,arms,17,7,10
Манарет,gordunni,638,warrior,arms,17,7,10
Xiny,blackrock,638,warrior,arms,17,7,10
Nurream,ravencrest,637,warrior,arms,23,7,16
Eltitoyayo,dun-modr,633,warrior,arms,17,7,10
Kakahuete,tarren-mill,624,warrior,arms,15,7,8
Bloodeater,sylvanas,623,warrior,arms,15,7,8
Grunkor,eldrethalas,623,warrior,arms,17,7,10
Likvidãtor,stormscale,623,warrior,arms,21,7,14
Vaxillium,argent-dawn,621,warrior,arms,17,7,10
Deadwily,twisting-nether,619,warrior,arms,20,8,12
Denisamanea,chamber-of-aspects,617,warrior,arms,21,8,13
Facepálm,kazzak,607,warrior,arms,14,7,7
Exekz,hyjal,607,warrior,arms,14,7,7
Matatorero,uldum,607,warrior,arms,21,7,14
Kegslayer,darksorrow,605,warrior,arms,14,7,7
Rhxy,burning-legion,605,warrior,arms,16,7,9
Babyfuryo,kazzak,591,warrior,arms,13,7,6
Olriksen,dentarg,590,warrior,arms,19,8,11
Awares,blackmoore,590,warrior,arms,19,7,12
Hitzo,draenor,576,warrior,arms,6,6,0
Selký,outland,576,warrior,arms,6,6,0
Ragebrand,ravencrest,576,warrior,arms,6,6,0
Watergate,ysondre,576,warrior,arms,6,6,0
Møonsz,ravencrest,576,warrior,arms,6,6,0
Zleyni,blackrock,576,warrior,arms,13,8,5
Rianhh,tarren-mill,576,warrior,arms,12,6,6
Warriur,outland,576,warrior,arms,12,6,6
Жмувихрь,howling-fjord,576,warrior,arms,12,6,6
Neverfear,aegwynn,576,warrior,arms,12,6,6
Terisá,blackmoore,576,warrior,arms,12,6,6
Madswarr,tarren-mill,576,warrior,arms,12,6,6
Solairexc,ravencrest,576,warrior,arms,12,6,6
Kleckzz,blackmoore,576,warrior,arms,12,6,6
Gromvar,draenor,576,warrior,arms,12,6,6
Xqt,laughing-skull,576,warrior,arms,12,6,6
Leetzorz,aszune,576,warrior,arms,12,6,6
Bourbimrgllr,hyjal,576,warrior,arms,12,6,6
Freddio,tarren-mill,576,warrior,arms,12,6,6
Mindblind,ravencrest,576,warrior,arms,12,6,6
Motx,blackmoore,576,warrior,arms,12,6,6
Erawar,kirin-tor,576,warrior,arms,12,6,6
Grímgor,aegwynn,576,warrior,arms,12,6,6
Belov,hyjal,576,warrior,arms,12,6,6
Mogguh,tarren-mill,576,warrior,arms,12,6,6
Extrémex,stormscale,576,warrior,arms,12,6,6
Nastywarrior,burning-legion,576,warrior,arms,12,6,6
Сосопав,howling-fjord,576,warrior,arms,12,6,6
Yuuta,ravencrest,576,warrior,arms,12,6,6
Brutalizar,draenor,576,warrior,arms,12,6,6
Reshnak,die-todeskrallen,576,warrior,arms,12,6,6
Kházad,proudmoore,576,warrior,arms,12,6,6
Finmajor,frostwhisper,576,warrior,arms,12,6,6
Rakhaldin,blackhand,576,warrior,arms,12,6,6
Lucywar,ravencrest,576,warrior,arms,12,6,6
Fankululu,kragjin,576,warrior,arms,12,6,6
Наомирассел,gordunni,576,warrior,arms,12,6,6
Tùcky,ysondre,576,warrior,arms,12,6,6
Råzor,blackhand,576,warrior,arms,12,6,6
Devorta,ysondre,576,warrior,arms,12,6,6
Skullbash,outland,576,warrior,arms,12,6,6
Xíve,terenas,576,warrior,arms,12,6,6
Нерморрог,howling-fjord,576,warrior,arms,12,6,6
Begotten,stormscale,576,warrior,arms,12,6,6
Nialihau,ysondre,576,warrior,arms,12,6,6
Zaddi,blackrock,576,warrior,arms,12,6,6
Teysh,aggramar,576,warrior,arms,12,6,6
Waranach,drakthul,576,warrior,arms,12,6,6
Долирия,gordunni,576,warrior,arms,12,6,6
Äsgeïr,archimonde,576,warrior,arms,12,6,6
Hacci,ragnaros,576,warrior,arms,12,6,6
Радомель,gordunni,576,warrior,arms,12,6,6
Shorane,varimathras,576,warrior,arms,12,6,6
Dajnatarcze,burning-legion,576,warrior,arms,12,6,6
Slám,burning-legion,576,warrior,arms,12,6,6
Хэрест,gordunni,576,warrior,arms,12,6,6
Lacos,drakthul,576,warrior,arms,12,6,6
Kirmizikafa,twisting-nether,576,warrior,arms,12,6,6
Psychðtïc,archimonde,576,warrior,arms,12,6,6
Galous,burning-blade,576,warrior,arms,12,6,6
Noout,elune,576,warrior,arms,12,6,6
Zabrona,turalyon,576,warrior,arms,12,6,6
Bimoje,stormscale,576,warrior,arms,12,6,6
Mauricet,elune,576,warrior,arms,12,6,6
Darkseid,burning-legion,576,warrior,arms,12,6,6
Fantorgass,drakthul,576,warrior,arms,12,6,6
Domixs,blackhand,576,warrior,arms,12,6,6
Hycate,blackrock,576,warrior,arms,12,6,6
Thegullet,draenor,576,warrior,arms,12,6,6
Víoceptíon,blackrock,576,warrior,arms,12,6,6
Tirex,stormscale,576,warrior,arms,12,6,6
Vakios,confrérie-du-thorium,576,warrior,arms,12,6,6
Skelash,blackhand,576,warrior,arms,12,6,6
Nørst,draenor,576,warrior,arms,12,6,6
Torgath,kirin-tor,576,warrior,arms,12,6,6
Bindcry,ahnqiraj,576,warrior,arms,12,6,6
Urmankey,kazzak,576,warrior,arms,12,6,6
Jeqqu,bloodfeather,576,warrior,arms,12,6,6
Coolaa,kazzak,576,warrior,arms,12,6,6
Brutarius,scarshield-legion,576,warrior,arms,12,6,6
Valibunt,drakthul,576,warrior,arms,12,6,6
Toscow,ravencrest,576,warrior,arms,12,6,6
Frayghast,ravencrest,576,warrior,arms,12,6,6
Ветросвист,gordunni,576,warrior,arms,12,6,6
Boomslangen,tarren-mill,576,warrior,arms,12,6,6
Дестингл,gordunni,576,warrior,arms,15,7,8
Громмашенька,howling-fjord,576,warrior,arms,13,6,7
Jivua,blackrock,576,warrior,arms,21,7,14
Pantava,moonglade,576,warrior,arms,18,6,12
Invictàs,hyjal,576,warrior,arms,18,6,12
Gregórry,eredar,576,warrior,arms,18,6,12
Maxisback,ysondre,576,warrior,arms,18,6,12
Ragoar,blackmoore,576,warrior,arms,18,6,12
Handon,die-aldor,576,warrior,arms,18,6,12
Bladestormxx,blackmoore,576,warrior,arms,18,6,12
Zaximos,twisting-nether,576,warrior,arms,18,6,12
Grâkul,twisting-nether,576,warrior,arms,18,6,12
Thuundeer,defias-brotherhood,576,warrior,arms,18,6,12
Rimedalb,aegwynn,576,warrior,arms,18,6,12
Debiljov,ahnqiraj,576,warrior,arms,18,6,12
Durag,argent-dawn,576,warrior,arms,18,6,12
Chadgarrosh,tarren-mill,576,warrior,arms,18,6,12
Späns,ragnaros,576,warrior,arms,18,6,12
Thismetasuck,ravencrest,576,warrior,arms,18,6,12
Progresslol,tarren-mill,576,warrior,arms,18,6,12
Møgwai,sanguino,576,warrior,arms,18,6,12
Chazeryu,stormreaver,576,warrior,arms,18,6,12
Aedanath,dragonblight,576,warrior,arms,18,6,12
Щекорез,soulflayer,576,warrior,arms,18,6,12
Ój,ravencrest,576,warrior,arms,18,6,12
Lakri,chants-éternels,576,warrior,arms,18,6,12
Повстер,howling-fjord,576,warrior,arms,18,6,12
Tótenkopf,ravencrest,576,warrior,arms,18,6,12
Kenet,tarren-mill,576,warrior,arms,18,6,12
Béarnais,khaz-modan,576,warrior,arms,18,6,12
Tóurmaline,tarren-mill,576,warrior,arms,24,6,18
Старыйклоп,blackscar,576,warrior,arms,24,6,18
Wangalang,ravencrest,576,warrior,arms,24,6,18
Luckysop,chants-éternels,576,warrior,arms,24,6,18
Cødi,antonidas,576,warrior,arms,24,6,18
Stalkom,elune,575,warrior,arms,6,6,0
Crocodìle,magtheridon,575,warrior,arms,6,6,0
Rawi,antonidas,575,warrior,arms,12,6,6
Citrok,dun-modr,575,warrior,arms,12,6,6
Kelrior,dun-modr,575,warrior,arms,12,6,6
Ghostlord,dunemaul,575,warrior,arms,12,6,6
Djpuggerino,outland,575,warrior,arms,12,6,6
Waron,dalaran,575,warrior,arms,12,6,6
Paísley,blackrock,575,warrior,arms,12,6,6
Suicidia,outland,575,warrior,arms,12,6,6
Brávéheart,ravencrest,575,warrior,arms,12,6,6
Saevitius,aegwynn,575,warrior,arms,12,6,6
Sushidog,twisting-nether,575,warrior,arms,12,6,6
Beyondmeta,twisting-nether,575,warrior,arms,12,6,6
Bzezita,hyjal,575,warrior,arms,12,6,6
Sígmar,die-ewige-wacht,575,warrior,arms,12,6,6
Lunath,stormscale,575,warrior,arms,12,6,6
Calwar,sanguino,575,warrior,arms,12,6,6
Армирован,howling-fjord,575,warrior,arms,12,6,6
Imafk,darksorrow,575,warrior,arms,12,6,6
Uwazu,kazzak,575,warrior,arms,12,6,6
Thráll,aszune,575,warrior,arms,12,6,6
Scârath,eredar,575,warrior,arms,12,6,6
Nefa,sylvanas,575,warrior,arms,12,6,6
Pector,grim-batol,575,warrior,arms,12,6,6
Тханирох,howling-fjord,575,warrior,arms,12,6,6
Бэдбрэйнс,soulflayer,575,warrior,arms,12,6,6
Phoboss,bloodhoof,575,warrior,arms,12,6,6
Ràgnàmetàl,tarren-mill,575,warrior,arms,12,6,6
Stradgedy,silvermoon,575,warrior,arms,12,6,6
Bobleeragnar,ravencrest,575,warrior,arms,12,6,6
Акози,fordragon,575,warrior,arms,12,6,6
Fótm,sylvanas,575,warrior,arms,12,6,6
Thorast,argent-dawn,575,warrior,arms,12,6,6
Zuroq,antonidas,575,warrior,arms,15,7,8
Chakota,runetotem,575,warrior,arms,15,6,9
Tìmmy,archimonde,575,warrior,arms,21,7,14
Potatoslam,twisting-nether,575,warrior,arms,18,6,12
Xlora,argent-dawn,575,warrior,arms,18,6,12
Furymeep,outland,575,warrior,arms,18,6,12
Haldrium,malganis,575,warrior,arms,18,6,12
Critycall,drakthul,575,warrior,arms,18,6,12
Unga,zuljin,575,warrior,arms,18,6,12
Rubyodin,tarren-mill,575,warrior,arms,18,6,12
Ysmay,dun-morogh,575,warrior,arms,18,6,12
Skulltakerx,draenor,575,warrior,arms,18,6,12
Rezail,silvermoon,575,warrior,arms,18,6,12
Ланцел,gordunni,575,warrior,arms,18,6,12
Letha,twisting-nether,575,warrior,arms,18,6,12
Onga,frostwolf,575,warrior,arms,18,6,12
Pnizsz,draenor,575,warrior,arms,24,6,18
Taei,argent-dawn,575,warrior,arms,24,6,18
Manqk,drakthul,575,warrior,arms,24,6,18
Nostrawolf,sylvanas,574,warrior,arms,12,6,6
Greensmash,hyjal,574,warrior,arms,12,6,6
Maxeyn,kazzak,574,warrior,arms,27,7,20
Sztixi,silvermoon,574,warrior,arms,24,6,18
Prôtectore,hyjal,573,warrior,arms,12,6,6
Sallcon,khaz-modan,573,warrior,arms,13,6,7
Eriqua,archimonde,573,warrior,arms,20,6,14
Phosphonian,outland,573,warrior,arms,24,6,18
Årxex,stormscale,572,warrior,arms,12,6,6
Oombac,lordaeron,572,warrior,arms,12,6,6
Silkismooth,twisting-nether,571,warrior,arms,12,6,6
Laeràzh,archimonde,571,warrior,arms,12,6,6
Raduriel,antonidas,571,warrior,arms,12,6,6
Mìlo,ravencrest,571,warrior,arms,18,6,12
Xavs,grim-batol,571,warrior,arms,18,6,12
Evorian,conseil-des-ombres,571,warrior,arms,27,7,20
Lezuuziusz,ragnaros,571,warrior,arms,24,6,18
Aethwa,stormscale,568,warrior,arms,12,6,6
Wïnqlùlz,archimonde,564,warrior,arms,36,6,30
Casstageul,archimonde,559,warrior,arms,12,7,5
Rãgè,tarren-mill,559,warrior,arms,17,6,11
Aleksande,kazzak,558,warrior,arms,20,7,13
Pillu,stormscale,544,warrior,arms,16,6,10
Krasark,blackmoore,544,warrior,arms,16,6,10
Wahney,thrall,543,warrior,arms,8,7,1
Coldbanê,blackmoore,543,warrior,arms,8,7,1
Großaua,blackrock,543,warrior,arms,12,7,5
Omaahton,magtheridon,543,warrior,arms,11,6,5
Deci,bronzebeard,543,warrior,arms,16,6,10
Чикенсы,gordunni,543,warrior,arms,16,6,10
Krevó,ragnaros,543,warrior,arms,17,6,11
Puppypower,blades-edge,542,warrior,arms,11,6,5
Íchígo,bloodhoof,542,warrior,arms,17,6,11
Cowon,stormscale,539,warrior,arms,14,7,7
Xiennas,stormscale,529,warrior,arms,24,11,13
Kåñéthy,outland,528,warrior,arms,15,7,8
Imabeatyoass,kazzak,527,warrior,arms,11,6,5
Schlopp,teldrassil,527,warrior,arms,11,6,5
Tuxedomask,antonidas,527,warrior,arms,15,7,8
Манндалорец,gordunni,527,warrior,arms,15,6,9
Rexü,dun-modr,527,warrior,arms,17,6,11
Furygoat,draenor,526,warrior,arms,11,6,5
Darkbrutal,archimonde,526,warrior,arms,17,6,11
Ðíñøðøng,ravencrest,522,warrior,arms,16,7,9
Snackzymus,ravencrest,522,warrior,arms,23,7,16
Nuckii,antonidas,521,warrior,arms,21,7,14
Thorzaram,argent-dawn,521,warrior,arms,26,7,19
Ðæðlý,ravencrest,512,warrior,arms,16,6,10
Dzamtule,ravencrest,511,warrior,arms,8,6,2
Гвиневич,blackscar,511,warrior,arms,11,6,5
Crippaooga,tarren-mill,511,warrior,arms,17,7,10
Sorô,antonidas,511,warrior,arms,16,6,10
Kimmwar,tarren-mill,510,warrior,arms,16,6,10
Myryna,exodar,510,warrior,arms,20,6,14
Hardcoregank,blackmoore,509,warrior,arms,11,6,5
Sacros,frostwhisper,496,warrior,arms,13,6,7
Lovehope,stormscale,496,warrior,arms,13,6,7
Marax,spinebreaker,496,warrior,arms,31,6,25
Fvkundercutt,xavius,480,warrior,arms,6,5,1
Angrytoddler,silvermoon,480,warrior,arms,6,5,1
Morkka,defias-brotherhood,480,warrior,arms,6,5,1
Гневныйвиги,howling-fjord,480,warrior,arms,6,5,1
Dunderzug,silvermoon,480,warrior,arms,6,5,1
Rockygifll,sinstralis,480,warrior,arms,6,5,1
Tekmali,archimonde,480,warrior,arms,6,5,1
Hubq,burning-legion,480,warrior,arms,6,5,1
Konnith,outland,480,warrior,arms,6,5,1
Quateh,silvermoon,480,warrior,arms,6,5,1
Sémø,thrall,480,warrior,arms,6,5,1
Revoidnvm,blackmoore,480,warrior,arms,6,5,1
Tørøg,eredar,480,warrior,arms,6,5,1
Critícalx,kazzak,480,warrior,arms,6,5,1
Karmaloop,stormscale,480,warrior,arms,6,5,1
Mumbojumbo,uldum,480,warrior,arms,6,5,1
Hiripuora,doomhammer,480,warrior,arms,6,5,1
Serbia,blackrock,480,warrior,arms,6,5,1
Hópbóp,magtheridon,480,warrior,arms,6,5,1
Slg,tarren-mill,480,warrior,arms,6,5,1
Dreamqt,antonidas,480,warrior,arms,6,5,1
Silentrend,magtheridon,480,warrior,arms,6,5,1
Lurion,malganis,480,warrior,arms,6,5,1
Murp,lightnings-blade,480,warrior,arms,6,5,1
Tørrminator,stormscale,480,warrior,arms,6,5,1
Synix,stormreaver,480,warrior,arms,6,5,1
Jimmyzugzug,draenor,480,warrior,arms,6,5,1
Äkzequte,blackhand,480,warrior,arms,8,5,3
Tishues,kazzak,480,warrior,arms,8,5,3
Ðant,kazzak,480,warrior,arms,12,5,7
Gothgirlgg,argent-dawn,480,warrior,arms,12,5,7
Footsies,ragnaros,480,warrior,arms,12,5,7
Lïyah,eldrethalas,480,warrior,arms,12,5,7
Wardoz,archimonde,480,warrior,arms,12,5,7
Soukha,archimonde,480,warrior,arms,12,5,7
Grundbulten,tarren-mill,480,warrior,arms,12,5,7
Тэратос,soulflayer,480,warrior,arms,12,5,7
Eleborn,tarren-mill,480,warrior,arms,12,5,7
Rohäc,drakthul,480,warrior,arms,12,5,7
Deathbleeder,argent-dawn,480,warrior,arms,12,5,7
Eyenur,drakthul,480,warrior,arms,12,5,7
Kaarvx,ysondre,480,warrior,arms,12,5,7
Hellomoto,archimonde,480,warrior,arms,12,5,7
Onizukarms,hyjal,480,warrior,arms,12,5,7
Alfredmonroe,bloodhoof,480,warrior,arms,12,5,7
Niffen,stormscale,480,warrior,arms,12,5,7
Эрисихтон,soulflayer,480,warrior,arms,12,5,7
Taskov,tarren-mill,480,warrior,arms,12,5,7
Kiukkuné,argent-dawn,480,warrior,arms,12,5,7
Garradoom,stormscale,480,warrior,arms,12,5,7
Bradders,tarren-mill,480,warrior,arms,12,5,7
Zarrgash,blackhand,480,warrior,arms,12,5,7
Dynther,nemesis,480,warrior,arms,12,5,7
Adamastos,ragnaros,480,warrior,arms,12,5,7
Stunwar,ravencrest,480,warrior,arms,12,5,7
Ffz,hyjal,480,warrior,arms,12,5,7
Jurge,twisting-nether,480,warrior,arms,12,5,7
Nazrolä,hyjal,480,warrior,arms,12,5,7
Riash,hyjal,480,warrior,arms,12,5,7
Виткорлеоне,booty-bay,480,warrior,arms,12,5,7
Ïllîçítmêñ,outland,480,warrior,arms,12,5,7
Warricious,outland,480,warrior,arms,12,5,7
Asintended,draenor,480,warrior,arms,12,5,7
Irastah,frostmane,480,warrior,arms,12,5,7
Рэйердан,howling-fjord,480,warrior,arms,12,5,7
Petesnot,outland,480,warrior,arms,12,5,7
Diablous,ragnaros,480,warrior,arms,12,5,7
Slayermaxx,kazzak,480,warrior,arms,12,5,7
Zirriox,wildhammer,480,warrior,arms,12,5,7
Xintha,frostwolf,480,warrior,arms,12,5,7
Marleycx,azshara,480,warrior,arms,12,5,7
Brasta,malganis,480,warrior,arms,12,5,7
Touthi,archimonde,480,warrior,arms,12,5,7
Oplix,antonidas,480,warrior,arms,12,5,7
Vitezandro,stormscale,480,warrior,arms,12,5,7
Leelazero,argent-dawn,480,warrior,arms,12,5,7
Borsha,dalaran,480,warrior,arms,12,5,7
Budwise,stormscale,480,warrior,arms,12,5,7
Steelstormz,ravencrest,480,warrior,arms,12,5,7
Baxyra,aegwynn,480,warrior,arms,12,5,7
Саскачеван,gordunni,480,warrior,arms,12,5,7
Шифик,soulflayer,480,warrior,arms,12,5,7
Garrol,burning-legion,480,warrior,arms,12,5,7
Thirtynine,daggerspine,480,warrior,arms,12,5,7
Síúkanto,blackrock,480,warrior,arms,12,5,7
Pietplofstof,laughing-skull,480,warrior,arms,12,5,7
Фэшнполис,soulflayer,480,warrior,arms,12,5,7
Whysobold,quelthalas,480,warrior,arms,12,5,7
Karkool,the-maelstrom,480,warrior,arms,12,5,7
Анжинерх,gordunni,480,warrior,arms,12,5,7
Jamyty,burning-legion,480,warrior,arms,12,5,7
Abunai,thrall,480,warrior,arms,12,5,7
Mokrakh,blackmoore,480,warrior,arms,12,5,7
Сашарбгх,soulflayer,480,warrior,arms,12,5,7
Calibur,emerald-dream,480,warrior,arms,12,5,7
Бейлеор,gordunni,480,warrior,arms,12,5,7
Gigantous,emerald-dream,480,warrior,arms,12,5,7
Dampbob,draenor,480,warrior,arms,12,5,7
Taxan,onyxia,480,warrior,arms,12,5,7
Oogaboogadps,silvermoon,480,warrior,arms,12,5,7
Ragingclue,draenor,480,warrior,arms,12,5,7
Vendes,defias-brotherhood,480,warrior,arms,12,5,7
Tryitmaxx,blackmoore,480,warrior,arms,12,5,7
Bottekraker,magtheridon,480,warrior,arms,12,5,7
Keäghan,kazzak,480,warrior,arms,12,5,7
Gylfanders,the-maelstrom,480,warrior,arms,12,5,7
Topur,defias-brotherhood,480,warrior,arms,12,5,7
Holloo,destromath,480,warrior,arms,12,5,7
Рыгатрон,galakrond,480,warrior,arms,12,5,7
Nøâh,kazzak,480,warrior,arms,12,5,7
Thravaeg,draenor,480,warrior,arms,12,5,7
Baryna,sanguino,480,warrior,arms,12,5,7
Lazypeon,burning-legion,480,warrior,arms,12,5,7
Орвинг,soulflayer,480,warrior,arms,12,5,7
Nomore,sylvanas,480,warrior,arms,12,5,7
Arakhu,blackmoore,480,warrior,arms,12,5,7
Cuzyxtwo,blackrock,480,warrior,arms,12,5,7
Matiasek,burning-legion,480,warrior,arms,12,5,7
Soe,defias-brotherhood,480,warrior,arms,12,5,7
Harrypotta,silvermoon,480,warrior,arms,12,5,7
Drugo,azjolnerub,480,warrior,arms,12,5,7
Ràgê,silvermoon,480,warrior,arms,12,5,7
Iamfast,blackmoore,480,warrior,arms,12,5,7
Tiridani,dun-morogh,480,warrior,arms,12,5,7
Icharge,dunemaul,480,warrior,arms,12,5,7
Plzdontkite,blackrock,480,warrior,arms,12,5,7
Ansàvage,kazzak,480,warrior,arms,12,5,7
Victôr,silvermoon,480,warrior,arms,12,5,7
Gorkta,uldaman,480,warrior,arms,12,5,7
Ernexpóc,silvermoon,480,warrior,arms,12,5,7
Bullac,blackmoore,480,warrior,arms,12,5,7
Drumsofwar,zuljin,480,warrior,arms,12,5,7
Sidekick,earthen-ring,480,warrior,arms,12,5,7
Nekwar,ravencrest,480,warrior,arms,15,6,9
Развалочка,howling-fjord,480,warrior,arms,16,6,10
Bøyka,sinstralis,480,warrior,arms,14,5,9
Ckn,eredar,480,warrior,arms,15,5,10
Реграм,eversong,480,warrior,arms,18,5,13
Hodenhugo,thrall,480,warrior,arms,18,5,13
Sheñ,antonidas,480,warrior,arms,18,5,13
Ijzereter,argent-dawn,480,warrior,arms,18,5,13
Exhumator,blackhand,480,warrior,arms,18,5,13
Vardias,pozzo-delleternità,480,warrior,arms,18,5,13
Maowiecki,burning-legion,480,warrior,arms,18,5,13
Takagødx,archimonde,480,warrior,arms,18,5,13
Sebotagelol,twisting-nether,480,warrior,arms,18,5,13
Lincwar,stormscale,480,warrior,arms,18,5,13
Pottomxx,ragnaros,480,warrior,arms,18,5,13
Курящийпро,blackscar,480,warrior,arms,18,5,13
Cryos,destromath,480,warrior,arms,18,5,13
Flexay,archimonde,480,warrior,arms,18,5,13
Kussetrold,outland,480,warrior,arms,18,5,13
Erosdulko,silvermoon,480,warrior,arms,18,5,13
Oravedenes,draenor,480,warrior,arms,18,5,13
Shredded,stormscale,480,warrior,arms,18,5,13
Escånør,archimonde,480,warrior,arms,18,5,13
Serratíon,tarren-mill,480,warrior,arms,18,5,13
Kalhmeras,twisting-nether,480,warrior,arms,18,5,13
Stuffed,blackrock,480,warrior,arms,18,5,13
Auguston,argent-dawn,480,warrior,arms,18,5,13
Solgud,bloodfeather,480,warrior,arms,18,5,13
Battusai,outland,480,warrior,arms,18,5,13
Swyklon,stormscale,480,warrior,arms,18,5,13
Unhingéd,stormscale,480,warrior,arms,18,5,13
Warriorussy,ravencrest,480,warrior,arms,19,5,14
Jorund,archimonde,480,warrior,arms,24,5,19
Zhodd,zuljin,480,warrior,arms,24,5,19
Масульмэн,howling-fjord,480,warrior,arms,24,5,19
Gnolimits,antonidas,480,warrior,arms,24,5,19
Vhy,antonidas,480,warrior,arms,25,5,20
Xtu,kazzak,479,warrior,arms,6,5,1
Saey,malorne,479,warrior,arms,6,5,1
Quento,anubarak,479,warrior,arms,6,5,1
Nertz,outland,479,warrior,arms,12,5,7
Swtparanoid,sylvanas,479,warrior,arms,12,5,7
Firethunder,burning-legion,479,warrior,arms,12,5,7
Fréyaá,blackrock,479,warrior,arms,12,5,7
Relüx,ragnaros,479,warrior,arms,12,5,7
Elpit,turalyon,479,warrior,arms,12,5,7
Maxilanthis,eonar,479,warrior,arms,12,5,7
Спарттанка,gordunni,479,warrior,arms,12,5,7
Parts,mazrigos,479,warrior,arms,12,5,7
Kakero,bronzebeard,479,warrior,arms,12,5,7
Dragonforce,blackmoore,479,warrior,arms,12,5,7
Meresin,madmortem,479,warrior,arms,12,5,7
Svinks,sylvanas,479,warrior,arms,12,5,7
Grèèn,turalyon,479,warrior,arms,12,5,7
Einhérjer,thrall,479,warrior,arms,12,5,7
Tötø,archimonde,479,warrior,arms,12,5,7
Dúg,tarren-mill,479,warrior,arms,12,5,7
Gucchy,nemesis,479,warrior,arms,12,5,7
Górgutz,defias-brotherhood,479,warrior,arms,12,5,7
Пушкабамби,soulflayer,479,warrior,arms,21,6,15
Kenpachis,magtheridon,479,warrior,arms,18,5,13
Ravedeath,tarren-mill,479,warrior,arms,18,5,13
Torvyi,kazzak,479,warrior,arms,18,5,13
Gladius,aggra-português,479,warrior,arms,18,5,13
Crazymax,stormscale,479,warrior,arms,18,5,13
Ghaze,blackhand,479,warrior,arms,18,5,13
Модныйклык,eversong,479,warrior,arms,18,5,13
Auggies,outland,479,warrior,arms,18,5,13
Hargash,zenedar,479,warrior,arms,18,5,13
Hepos,quelthalas,479,warrior,arms,18,5,13
Lazaron,tarren-mill,479,warrior,arms,19,5,14
Tafala,blackmoore,478,warrior,arms,6,5,1
Farxy,dun-modr,478,warrior,arms,12,5,7
Nightmareb,magtheridon,478,warrior,arms,12,5,7
Ghorinchai,khazgoroth,478,warrior,arms,12,5,7
Sahaminho,draenor,478,warrior,arms,18,5,13
Swordluw,argent-dawn,478,warrior,arms,18,5,13
Нириэла,howling-fjord,478,warrior,arms,18,5,13
Nierninwa,silvermoon,477,warrior,arms,12,5,7
Лидоний,gordunni,477,warrior,arms,12,5,7
Kennesáw,draenor,477,warrior,arms,12,5,7
Sheriff,dragonblight,475,warrior,arms,12,5,7
Awárøn,aegwynn,473,warrior,arms,12,5,7
Kratosz,magtheridon,472,warrior,arms,27,7,20
Arnorlld,antonidas,471,warrior,arms,12,5,7
Lockdwn,kazzak,468,warrior,arms,18,5,13
Bismárck,nathrezim,457,warrior,arms,17,7,10
Duarel,blackmoore,448,warrior,arms,10,5,5
Zugzuhg,draenor,447,warrior,arms,8,6,2
Kviqr,auchindoun,447,warrior,arms,11,5,6
Takethisduck,stormscale,447,warrior,arms,11,5,6
Onizukawar,archimonde,447,warrior,arms,17,5,12
Чпонькмашина,soulflayer,447,warrior,arms,17,5,12
Kôtarô,blackmoore,447,warrior,arms,17,5,12
Kitano,garona,447,warrior,arms,23,5,18
Pétin,kaelthas,446,warrior,arms,17,5,12
Orkyu,stormrage,444,warrior,arms,11,5,6
Beirmitch,tarren-mill,432,warrior,arms,9,5,4
Инфлэймх,gordunni,431,warrior,arms,11,5,6
Turdgurgler,executus,431,warrior,arms,11,5,6
Cowbatant,darkspear,431,warrior,arms,14,5,9
Toqk,draenor,426,warrior,arms,13,6,7
Mukcho,sylvanas,426,warrior,arms,15,6,9
Goreksson,aegwynn,426,warrior,arms,15,6,9
Leizey,stormscale,426,warrior,arms,15,6,9
Lilsib,outland,426,warrior,arms,19,6,13
Kìrìtosan,pozzo-delleternità,415,warrior,arms,8,5,3
Kylian,aegwynn,415,warrior,arms,11,5,6
Mat,outland,415,warrior,arms,11,5,6
Suduri,drakthul,415,warrior,arms,14,5,9
Disábled,kazzak,414,warrior,arms,16,5,11
Danx,culte-de-la-rive-noire,413,warrior,arms,16,5,11
Varkoz,sylvanas,400,warrior,arms,7,5,2
Justah,silvermoon,400,warrior,arms,13,5,8
Alexdgreat,tarren-mill,384,warrior,arms,6,4,2
Skahmet,dun-modr,384,warrior,arms,6,4,2
Bámf,outland,384,warrior,arms,6,4,2
Fîlzlaus,area-52,384,warrior,arms,6,4,2
Khyuzo,nemesis,384,warrior,arms,6,4,2
Гигасмэш,gordunni,384,warrior,arms,6,4,2
Rowe,dun-modr,384,warrior,arms,6,4,2
Bóobagodx,tarren-mill,384,warrior,arms,6,4,2
Slix,dun-modr,384,warrior,arms,6,4,2
Росана,gordunni,384,warrior,arms,6,4,2
Mayback,pozzo-delleternità,384,warrior,arms,6,4,2
Rastaj,defias-brotherhood,384,warrior,arms,6,4,2
Deadlift,thunderhorn,384,warrior,arms,6,4,2
Rwx,outland,384,warrior,arms,6,4,2
Pappyza,hyjal,384,warrior,arms,6,4,2
Elëk,hyjal,384,warrior,arms,6,4,2
Gundal,silvermoon,384,warrior,arms,6,4,2
Azazelslayer,dethecus,384,warrior,arms,6,4,2
Dallion,azjolnerub,384,warrior,arms,6,4,2
Балкарок,howling-fjord,384,warrior,arms,6,4,2
Tcrunch,dun-modr,384,warrior,arms,6,4,2
Bládestorm,outland,384,warrior,arms,6,4,2
Youstupide,drekthar,384,warrior,arms,6,4,2
Schidøri,blackmoore,384,warrior,arms,6,4,2
Schmackes,terrordar,384,warrior,arms,6,4,2
Highbuffalo,kazzak,384,warrior,arms,6,4,2
Chmg,kirin-tor,384,warrior,arms,6,4,2
Aliyáhh,blackrock,384,warrior,arms,6,4,2
Sucemabanner,hyjal,384,warrior,arms,6,4,2
Volfenstein,burning-legion,384,warrior,arms,6,4,2
Jinró,ravencrest,384,warrior,arms,6,4,2
Eytra,ravencrest,384,warrior,arms,6,4,2
Ddfxz,draenor,384,warrior,arms,6,4,2
Имбасенпай,howling-fjord,384,warrior,arms,6,4,2
Littlee,durotan,384,warrior,arms,6,4,2
Zeó,silvermoon,384,warrior,arms,6,4,2
Alaerion,magtheridon,384,warrior,arms,6,4,2
Tìxoz,archimonde,384,warrior,arms,6,4,2
Alexandriana,veknilash,384,warrior,arms,6,4,2
Warzër,archimonde,384,warrior,arms,6,4,2
Kisoshi,tarren-mill,384,warrior,arms,6,4,2
Квейкс,gordunni,384,warrior,arms,6,4,2
Octtwar,twisting-nether,384,warrior,arms,6,4,2
Ottokerñ,kazzak,384,warrior,arms,6,4,2
Redslam,ysondre,384,warrior,arms,6,4,2
Ceym,twisting-nether,384,warrior,arms,6,4,2
Тартолан,gordunni,384,warrior,arms,6,4,2
Dräparren,ragnaros,384,warrior,arms,6,4,2
Romoth,kazzak,384,warrior,arms,6,4,2
Rimvar,alleria,384,warrior,arms,6,4,2
Sabijach,kazzak,384,warrior,arms,6,4,2
Xtazen,draenor,384,warrior,arms,6,4,2
Swaàg,archimonde,384,warrior,arms,6,4,2
Virgolibra,grim-batol,384,warrior,arms,6,4,2
Милаягномка,azuregos,384,warrior,arms,6,4,2
Tejkopejko,kazzak,384,warrior,arms,6,4,2
Susugar,ysondre,384,warrior,arms,6,4,2
Фиббоначи,deathguard,384,warrior,arms,6,4,2
Zazzu,archimonde,384,warrior,arms,6,4,2
Forsi,draenor,384,warrior,arms,6,4,2
Måydåy,twisting-nether,384,warrior,arms,6,4,2
Garad,frostmane,384,warrior,arms,6,4,2
Jessepinkman,kirin-tor,384,warrior,arms,6,4,2
Slamueljcksn,darksorrow,384,warrior,arms,6,4,2
Fleshwerk,silvermoon,384,warrior,arms,6,4,2
Brittelin,tarren-mill,384,warrior,arms,6,4,2
Agrias,burning-legion,384,warrior,arms,6,4,2
Eldrian,ragnaros,384,warrior,arms,6,4,2
Cyférüs,tarren-mill,384,warrior,arms,6,4,2
Bixxi,eredar,384,warrior,arms,6,4,2
Bruumbrum,blackhand,384,warrior,arms,6,4,2
Darkel,chogall,384,warrior,arms,6,4,2
Voi,jaedenar,384,warrior,arms,6,4,2
Fitzgibbons,ravencrest,384,warrior,arms,6,4,2
Baluste,culte-de-la-rive-noire,384,warrior,arms,6,4,2
Геролт,galakrond,384,warrior,arms,6,4,2
ßelugajosh,outland,384,warrior,arms,6,4,2
Sweetberries,hyjal,384,warrior,arms,6,4,2
Kwautkopf,blackhand,384,warrior,arms,6,4,2
Rëvenge,burning-legion,384,warrior,arms,6,4,2
Slante,darksorrow,384,warrior,arms,6,4,2
Тандеракс,soulflayer,384,warrior,arms,6,4,2
Közel,bladefist,384,warrior,arms,6,4,2
Haîltøkîng,alakir,384,warrior,arms,6,4,2
Thuder,sylvanas,384,warrior,arms,6,4,2
Panexecute,ragnaros,384,warrior,arms,6,4,2
Dregodym,frostwolf,384,warrior,arms,6,4,2
Beznacaj,outland,384,warrior,arms,6,4,2
Kevlarsusan,the-maelstrom,384,warrior,arms,6,4,2
Роудс,soulflayer,384,warrior,arms,6,4,2
Pîz,ravencrest,384,warrior,arms,6,4,2
Wïn,silvermoon,384,warrior,arms,6,4,2
Swig,twisting-nether,384,warrior,arms,6,4,2
Ironrage,frostmane,384,warrior,arms,6,4,2
Bloodstinger,blackrock,384,warrior,arms,6,4,2
Haikyuu,blackhand,384,warrior,arms,6,4,2
Orcìna,blackrock,384,warrior,arms,6,4,2
Elsiâs,aegwynn,384,warrior,arms,6,4,2
Shadowcacau,aggra-português,384,warrior,arms,6,4,2
Frenzerker,outland,384,warrior,arms,6,4,2
Thorbjør,silvermoon,384,warrior,arms,6,4,2
Stiefbrudah,blackmoore,384,warrior,arms,9,5,4
Cptwheelchr,blackmoore,384,warrior,arms,9,5,4
Rândy,confrérie-du-thorium,384,warrior,arms,9,5,4
Sinimfzugzug,eredar,384,warrior,arms,10,5,5
Rdeniro,blackmoore,384,warrior,arms,15,5,10
Merkakis,argent-dawn,384,warrior,arms,15,5,10
Guarn,archimonde,384,warrior,arms,12,4,8
Фаллопиев,borean-tundra,384,warrior,arms,12,4,8
Brokenrage,twisting-nether,384,warrior,arms,12,4,8
Ouryuu,hyjal,384,warrior,arms,12,4,8
Apemonkeydk,kazzak,384,warrior,arms,12,4,8
Арристокррат,soulflayer,384,warrior,arms,12,4,8
Арбелоа,gordunni,384,warrior,arms,12,4,8
Ryuma,lordaeron,384,warrior,arms,12,4,8
Yathaa,hyjal,384,warrior,arms,12,4,8
Huihui,die-aldor,384,warrior,arms,12,4,8
Trillebårtøm,outland,384,warrior,arms,12,4,8
Melivick,burning-legion,384,warrior,arms,12,4,8
Alphamem,sylvanas,384,warrior,arms,12,4,8
Sugraclap,frostwolf,384,warrior,arms,12,4,8
Zenìa,argent-dawn,384,warrior,arms,12,4,8
Booya,zirkel-des-cenarius,384,warrior,arms,12,4,8
Mârcxb,antonidas,384,warrior,arms,12,4,8
Schultze,kazzak,384,warrior,arms,12,4,8
Дахирарг,fordragon,384,warrior,arms,12,4,8
Whitebeardx,tarren-mill,384,warrior,arms,12,4,8
Taukkì,kazzak,384,warrior,arms,12,4,8
Speiker,blackhand,384,warrior,arms,12,4,8
Oglisten,archimonde,384,warrior,arms,12,4,8
Snorg,defias-brotherhood,384,warrior,arms,12,4,8
Rastov,argent-dawn,384,warrior,arms,12,4,8
Orciks,drakthul,384,warrior,arms,12,4,8
Mórghúlís,aegwynn,384,warrior,arms,12,4,8
Raynorwarr,tarren-mill,384,warrior,arms,12,4,8
Rkeköke,draenor,384,warrior,arms,12,4,8
Stragga,eredar,384,warrior,arms,12,4,8
Raïgã,hyjal,384,warrior,arms,12,4,8
Анусбрейкер,soulflayer,384,warrior,arms,12,4,8
Skyrrskyr,blackrock,384,warrior,arms,12,4,8
Smashbrother,eredar,384,warrior,arms,12,4,8
Karadayii,blackmoore,384,warrior,arms,12,4,8
Валдеморд,soulflayer,384,warrior,arms,12,4,8
Draur,archimonde,384,warrior,arms,12,4,8
Claymøre,khaz-modan,384,warrior,arms,12,4,8
Chargezon,drakthul,384,warrior,arms,12,4,8
Fzit,kazzak,384,warrior,arms,12,4,8
Brrochacho,defias-brotherhood,384,warrior,arms,12,4,8
Kronner,blackmoore,384,warrior,arms,12,4,8
Spankprooff,kazzak,384,warrior,arms,12,4,8
Grombatur,tarren-mill,384,warrior,arms,12,4,8
Jesuisgaydsl,archimonde,384,warrior,arms,12,4,8
Sovax,ravencrest,384,warrior,arms,12,4,8
Varix,burning-blade,384,warrior,arms,12,4,8
Rhynot,argent-dawn,384,warrior,arms,12,4,8
Rfgpwhfgjawr,ravencrest,384,warrior,arms,12,4,8
Parachoque,ragnaros,384,warrior,arms,12,4,8
Malefici,eredar,384,warrior,arms,12,4,8
Syel,sinstralis,384,warrior,arms,12,4,8
Pushh,dun-modr,384,warrior,arms,12,4,8
Blackzor,ragnaros,384,warrior,arms,12,4,8
Dataproffs,outland,384,warrior,arms,12,4,8
Woghard,drakthul,384,warrior,arms,12,4,8
Zugbigdam,archimonde,384,warrior,arms,12,4,8
Heavycrit,ravencrest,384,warrior,arms,12,4,8
Ivâar,archimonde,384,warrior,arms,12,4,8
Шмекус,soulflayer,384,warrior,arms,12,4,8
Sonyd,tarren-mill,384,warrior,arms,12,4,8
Taelgorr,draenor,384,warrior,arms,12,4,8
Tyzarwar,draenor,384,warrior,arms,12,4,8
Winedru,bronzebeard,384,warrior,arms,12,4,8
Xállek,veknilash,384,warrior,arms,12,4,8
Linberg,ysondre,384,warrior,arms,12,4,8
Ceojohnny,ravencrest,384,warrior,arms,12,4,8
Coska,stormscale,384,warrior,arms,12,4,8
Waroworgen,terokkar,384,warrior,arms,12,4,8
Connorzqt,ravencrest,384,warrior,arms,12,4,8
Cromash,die-nachtwache,384,warrior,arms,12,4,8
Nerfslam,stormscale,384,warrior,arms,12,4,8
Neozz,ravencrest,384,warrior,arms,12,4,8
Ðræberen,kazzak,384,warrior,arms,12,4,8
Luciferkhan,twisting-nether,384,warrior,arms,12,4,8
Oesche,frostmourne,384,warrior,arms,12,4,8
Traziel,blackmoore,384,warrior,arms,12,4,8
Poppeyex,silvermoon,384,warrior,arms,12,4,8
Klunkepumper,ravencrest,384,warrior,arms,12,4,8
Ambraxon,blackmoore,384,warrior,arms,12,4,8
Reaperet,rexxar,384,warrior,arms,12,4,8
Azurnok,argent-dawn,384,warrior,arms,12,4,8
Mickyrex,hyjal,384,warrior,arms,12,4,8
Starkz,hellscream,384,warrior,arms,12,4,8
Craftorar,defias-brotherhood,384,warrior,arms,12,4,8
Kgx,argent-dawn,384,warrior,arms,12,4,8
Chrid,silvermoon,384,warrior,arms,12,4,8
Zêmin,twisting-nether,384,warrior,arms,12,4,8
Arxnamus,silvermoon,384,warrior,arms,12,4,8
Говяжийвоин,soulflayer,384,warrior,arms,12,4,8
Eýoe,ragnaros,384,warrior,arms,12,4,8
Трапсир,gordunni,384,warrior,arms,12,4,8
Péter,arathor,384,warrior,arms,12,4,8
Evermoon,sanguino,384,warrior,arms,12,4,8
Sinkiss,archimonde,384,warrior,arms,12,4,8
Ellissari,tirion,384,warrior,arms,12,4,8
Osteskanken,ravencrest,384,warrior,arms,12,4,8
Féélmyfury,tarren-mill,384,warrior,arms,12,4,8
Wildblow,ravencrest,384,warrior,arms,12,4,8
Gromock,the-maelstrom,384,warrior,arms,12,4,8
Smashlz,draenor,384,warrior,arms,12,4,8
ßèrserk,hyjal,384,warrior,arms,12,4,8
Веоленс,gordunni,384,warrior,arms,12,4,8
Sveñor,the-maelstrom,384,warrior,arms,12,4,8
Димаказнь,gordunni,384,warrior,arms,12,4,8
Mazelion,ambossar,384,warrior,arms,12,4,8
Adorlyna,silvermoon,384,warrior,arms,12,4,8
Flugan,vashj,384,warrior,arms,12,4,8
Iiam,kilrogg,384,warrior,arms,12,4,8
Cjak,pozzo-delleternità,384,warrior,arms,12,4,8
Hubusan,blackmoore,384,warrior,arms,12,4,8
Uselessbrø,archimonde,384,warrior,arms,12,4,8
Testortv,twisting-nether,384,warrior,arms,12,4,8
Gkhan,draenor,384,warrior,arms,12,4,8
Raikin,aegwynn,384,warrior,arms,12,4,8
Wilko,twisting-nether,384,warrior,arms,12,4,8
Schjøtt,ravencrest,384,warrior,arms,12,4,8
Chickengodx,archimonde,384,warrior,arms,12,4,8
Сэч,gordunni,384,warrior,arms,12,4,8
Hiraclès,archimonde,384,warrior,arms,12,4,8
Xavari,twisting-nether,384,warrior,arms,12,4,8
Inflacija,grim-batol,384,warrior,arms,12,4,8
Utgra,aegwynn,384,warrior,arms,12,4,8
Whitewôlf,stormscale,384,warrior,arms,13,4,9
Phalek,ravencrest,384,warrior,arms,14,4,10
Ilyxw,blackmoore,384,warrior,arms,18,4,14
Kaij,draenor,384,warrior,arms,18,4,14
Ganaroth,tarren-mill,384,warrior,arms,18,4,14
Pwndrizle,blackmoore,384,warrior,arms,18,4,14
Kyorengoku,antonidas,384,warrior,arms,18,4,14
Ykabla,dun-modr,384,warrior,arms,18,4,14
Solidier,archimonde,384,warrior,arms,18,4,14
Gothec,ravencrest,384,warrior,arms,18,4,14
Teñseï,archimonde,384,warrior,arms,18,4,14
Tadruk,stormscale,384,warrior,arms,18,4,14
Kassarn,silvermoon,384,warrior,arms,19,4,15
Vanaxd,blackrock,384,warrior,arms,20,4,16
Wardropeeh,argent-dawn,384,warrior,arms,24,4,20
Sublexgg,blackrock,1862,warrior,protection,73,37,36
Swagenknecht,blackrock,1822,warrior,protection,315,156,159
Blaying,ravencrest,1668,warrior,protection,143,77,66
Doghxnterx,ravencrest,1363,warrior,protection,93,43,50
Brigitá,argent-dawn,1285,warrior,protection,35,14,21
Àlexander,ravencrest,1202,warrior,protection,44,14,30
Ferran,sanguino,1135,warrior,protection,192,98,94
Tríbún,kult-der-verdammten,1129,warrior,protection,89,42,47
Narrative,kazzak,1091,warrior,protection,54,20,34
Grimurg,drakthul,1036,warrior,protection,139,69,70
Carras,confrérie-du-thorium,979,warrior,protection,181,94,87
Флоуби,razuvious,909,warrior,protection,60,26,34
Mandiso,norgannon,862,warrior,protection,113,53,60
Extramudna,azjolnerub,834,warrior,protection,40,12,28
Naofumí,arthas,773,warrior,protection,36,14,22
Фриегар,deathguard,711,warrior,protection,76,29,47
Ylana,eldrethalas,671,warrior,protection,18,7,11
Classmaster,temple-noir,669,warrior,protection,18,7,11
Hubin,defias-brotherhood,662,warrior,protection,30,7,23
Гештальтыч,eversong,626,warrior,protection,36,7,29
Asuvia,argent-dawn,599,warrior,protection,32,7,25
Firemyst,outland,575,warrior,protection,18,6,12
Bloodparade,argent-dawn,480,warrior,protection,12,5,7
Flinn,die-nachtwache,408,warrior,protection,26,6,20
Tokrika,die-aldor,384,warrior,protection,6,4,2
Oralinde,silvermoon,384,warrior,protection,12,4,8
Драчун,thermaplugg,384,warrior,protection,18,4,14
Джубилост,goldrinn,384,warrior,protection,24,4,20
Dianä,argent-dawn,383,warrior,protection,6,4,2
Chadgarrosh,tarren-mill,288,warrior,protection,12,3,9
Thecrackfoxx,silvermoon,288,warrior,protection,12,3,9
Davetsiz,burning-legion,288,warrior,protection,12,3,9
Apacolata,outland,288,warrior,protection,12,3,9
Takautak,kirin-tor,288,warrior,protection,12,3,9
Трейлхард,howling-fjord,287,warrior,protection,12,3,9
Омертин,howling-fjord,192,warrior,protection,6,2,4
Hofftor,eredar,192,warrior,protection,6,2,4
Gaiuscaesar,stormscale,192,warrior,protection,6,2,4
Денеур,gordunni,192,warrior,protection,6,2,4
Маллал,soulflayer,192,warrior,protection,6,2,4
Linzao,archimonde,192,warrior,protection,6,2,4
Markza,turalyon,96,warrior,protection,6,1,5
Leryswarro,sanguino,96,warrior,protection,6,1,5
Warrqury,ravencrest,96,warrior,protection,6,1,5
Montysmash,ravencrest,96,warrior,protection,6,1,5
Sergra,ysondre,96,warrior,protection,6,1,5
Valem,suramar,96,warrior,protection,6,1,5
Killobite,sylvanas,96,warrior,protection,6,1,5
Гневныйвиги,howling-fjord,96,warrior,protection,6,1,5
Draskoé,hyjal,96,warrior,protection,6,1,5
Lørð,frostmane,96,warrior,protection,6,1,5
Layä,krasus,96,warrior,protection,6,1,5
Pahgorim,blackhand,96,warrior,protection,12,1,11
Callipsa,argent-dawn,96,warrior,protection,12,1,11
Jøtas,dun-modr,96,warrior,protection,12,1,11
Lendené,los-errantes,96,warrior,protection,15,1,14
Burningyou,culte-de-la-rive-noire,95,warrior,protection,3,2,1
Throneofwar,silvermoon,95,warrior,protection,6,1,5
Shinnok,stormreaver,95,warrior,protection,9,1,8
Ijzereter,argent-dawn,31,warrior,protection,2,1,1
